id,hash,time,timezoneOffset,created,edited,isPublic,isTrack,distance,s,elapsedTime,elevationUp,elevationDown,elevationUpFile,elevationDownFile,altitudeSource,climbScore,percentageHilly,uphillEfficiency,downhillEfficiency,vam,kcal,pulseAvg,pulseMax,recoveryHr,maxHeartRateDropFrom,maxHeartRateDrop,vo2max,vo2maxByTime,vo2maxWithElevation,useVO2max,fitVO2maxEstimate,fitRecoveryTime,fitTrimp,fitHrvAnalysis,fitTrainingEffect,fitAnaerobicTrainingEffect,fitPerformanceCondition,fitPerformanceConditionEnd,fitFtp,fitSweatLoss,fitDeveloperSessionFields,rpe,subjectiveFeeling,trimp,cadence,gap,xPace,xGap,aerobicDecouplingPace,aerobicDecouplingPower,power,powerWithZero,airPower,isPowerCalculated,xPower,xPowerWithZero,wPrimeBalancePowerAvg,wPrimeBalancePowerMin,wPrimeBalancePaceAvg,wPrimeBalancePaceMin,staminaAvg,staminaMin,staminaPotentialAvg,staminaPotentialMin,zoneDistributionPace,zoneDistributionHr,zoneDistributionPower,totalStrokes,swolf,wheelSize,poolLength,strideLength,groundcontact,groundcontactBalance,verticalOscillation,verticalRatio,avgImpactGsLeft,avgImpactGsRight,avgBrakingGsLeft,avgBrakingGsRight,avgFootstrikeTypeLeft,avgFootstrikeTypeRight,avgPronationExcursionLeft,avgPronationExcursionRight,avgLegSpringStiffness,avgFormPower,avgRespiratoryRate,avgLeftRightBalance,avgLeftTorqueEffectiveness,avgRightTorqueEffectiveness,avgLeftPedalSmoothness,avgRightPedalSmoothness,avgPlatformCenterOffsetLeft,avgPlatformCenterOffsetRight,avgLeftPowerPhaseStartAngle,avgLeftPowerPhaseEndAngle,avgLeftPowerPhasePeakStartAngle,avgLeftPowerPhasePeakEndAngle,avgRightPowerPhaseStartAngle,avgRightPowerPhaseEndAngle,avgRightPowerPhasePeakStartAngle,avgRightPowerPhasePeakEndAngle,cyclingTotalGrit,cyclingTotalGrit2,cyclingAvgFlow,jumps,peakEpoc,peakEpocEstimate,temperature,windSpeed,windDeg,humidity,cloudCover,pressure,uvIndex,ozone,isNight,weatherid,weatherSource,routeName,hasTrackdata,isVirtual,splits,splitsCustom,title,partner,notes,creator,creatorDetails,deviceId,source,externalId,lock,sportid,typeid,accountid,hrv_id,original_file,hrv_avgRR,hrv_rmssd,hrv_sdsd,hrv_sdnn,hrv_sdnn5min,hrv_pnn50,hrv_pnn20,hrv_percentageAnomalies,hrv_dfaA1Avg,hrv_dfaA1Min,hrv_dfaA1Max,hrv_dfaA1PAboveAet,hrv_dfaA1PBelowAnt,hrv_dfaA1PValid,hrv_dfaA1PArtifacts,hrv_estimatedAetPower,hrv_estimatedAetPowerFeasible,hrv_estimatedAetPace,hrv_estimatedAetPaceFeasible,hrv_estimatedAetHr,hrv_estimatedAetHrFeasible,race_officialDistance,race_officialTime,race_officialAscent,race_officialDescent,race_officiallyMeasured,race_name,race_placeTotal,race_placeGender,race_placeAgeclass,race_participantsTotal,race_participantsGender,race_participantsAgeclass,race_priorityLevel,race_status,race_accountid,race_activity_id,race_race_event_id,tags,climbs,equipmentIds
5962126,c90b8c33-b1ec-4187-afdb-5a2fc0d8260e,1349519610,120,1548677380,,0,0,9.72,3806,3852,60,59,,,1,0,0.23,,,,677,,,,,,,29.14,,1,,,,,,,,,,,,,,79,,9.29,10.71,10.8,,,,,,,,,,,,,,,,,"36,10,17,17,10,5,5,0,0",,,,,,,,,,,,,,,,,,,,,,,,,,,,,,,,,,,,,,,,,,,,15,4,220,70,,1016,2,,0,3,3,,1,0,,,,,,,"Polar BEAT",,0,,0,168070,250480,30378,,,,,,,,,,,,,,,,,,,,,,,,,,,,,,,,,,,,,,,,,,,
5962127,87463cb6-1c32-483d-b3a2-56e92204278e,1399496476,120,1548677381,,0,0,20.21,5384,5447,329,335,,,1,3.1,0.59,1.15,1.01,473,910,149,174,,,,66.52,48.5,67.84,1,,,,,,,,,,,,,,135,82,13.77,13.93,14.39,0.8,,,,,,,,,,,,,,,,"3,2,3,8,29,34,19,3,0","0,30,46,24,0",,,,,,137,,,,,,,,,,,,,,,,,,,,,,,,,,,,,,,,,,,,73.1,13,8,251,70,,1014,0,,1,5,3,,1,0,,,,,"Lockerer DL - ~3km rauslaufen am Königshügel",,"Polar BEAT",,0,,0,168070,250480,30378,,,,,,,,,,,,,,,,,,,,,,,,,,,,,,,,,,,,,,,,,,"5,5",
5962128,200ed8aa-5b5b-4c21-88c5-9696e9d2eb82,1502733590,120,1548677382,,0,0,13.01,3369,3371,176,181,,,1,2.1,0.57,1.03,1.03,369,886,162,182,,,,61.29,48.42,62.29,1,,,,,,,,,,,,,,112,81,14.15,13.99,14.35,4.5,,,,,,,,,,,,,,,,"0,0,1,6,20,57,16,0,0","0,4,39,56,1",,,,,,143,,,,,,,,,,,,,,,,,,,,,,,,,,,,,,,,,,,,87.2,25,3,116,55,,1016,2,,0,5,3,,1,0,I1.000|4:29-I1.000|4:09-I1.000|4:20-I1.000|4:20-I1.000|4:12-I1.000|4:29-I1.000|4:45-I1.000|4:18-I1.000|4:25-I1.000|3:57-I1.000|4:24-I1.000|4:20-I1.000|3:58-I0.014|0:04,,Running,,,,"Polar M430",43,0,,0,168070,250480,30378,,,,,,,,,,,,,,,,,,,,,,,,,,,,,,,,,,,,,,,,,,4,
5962129,b3db2f9a-4b70-41ef-b5df-cf4780506ccd,1420281701,60,1548677382,,0,0,23.01,5865,5968,116,144,,,1,0,0.18,,,,1551,,,,,,,51.58,,1,,,,,,,,,,,,,,121,86,14.18,14.26,14.36,,,,,,,,,,,,,,,,,"3,0,1,2,10,62,22,0,0",,,,,,,137,,,,,,,,,,,,,,,,,,,,,,,,,,,,,,,,,,,,,3,13,225,88,,,0,,0,5,3,,1,0,,,,,"Langer zügiger DL",,"Polar BEAT",,0,,0,168070,250480,30378,,,,,,,,,,,,,,,,,,,,,,,,,,,,,,,,,,,,,,,,,,,
5962130,640345d8-fa9a-44df-b590-3293f739b2ec,1407359058,120,1548677383,,0,0,16.75,4572,4572,209,208,,,1,1.9,0.54,1.01,1.02,339,687,136,155,,,,72.58,46.45,73.71,1,,,,,,,,,,,,,,80,83,13.39,13.29,13.54,-0.4,,,,,,,,,,,,,,,,"0,1,1,14,36,46,3,0,0","0,70,30,0,0",,,,,,132,,,,,,,,,,,,,,,,,,,,,,,,,,,,,,,,,,,,24.7,16,4,175,96,,1015,0,,1,6,3,,1,0,,,,,"Lockerer DL",,"Polar BEAT",,0,,0,168070,250480,30378,,,,,,,,,,,,,,,,,,,,,,,,,,,,,,,,,,,,,,,,,,4,
5962131,65a7926b-d97f-47cb-809c-3cd39319cf5f,1521221335,60,1548677384,,0,0,10.94,1667,1668,43,30,,,1,0,0.09,2.43,,,295,128,151,,,,,,,1,,,,,,,,,,,,,,23,,,24.45,,9.2,-13.6,125,109,,1,143,131,,,,,,,,,"6,11,27,57,0,0,0","0,95,5,0,0","84,6,0,0,10",,,,,,,,,,,,,,,,,,,,,,,,,,,,,,,,,,,,,,,,,14.9,12,3,256,64,,,0,,0,5,3,,1,0,,,Cycling,,,,"Polar M430",43,0,,0,168072,,30378,,,,,,,,,,,,,,,,,,,,,,,,,,,,,,,,,,,,,,,,,,,
5962132,b05dd1f0-3d6a-447a-b4a6-552a497248ca,1420809651,60,1548677385,,0,0,18.62,5066,5116,288,288,,,1,2.8,0.59,,,471,1257,,,,,,,47.03,,1,,,,,,,,,,,,,,105,84,13.54,13.4,13.74,,,,,,,,,,,,,,,,,"1,1,6,12,28,42,9,0,0",,,,,,,131,,,,,,,,,,,,,,,,,,,,,,,,,,,,,,,,,,,,,9,20,240,94,,1021,1,,0,4,3,,1,0,,,,,"Längerer DL",,"Polar BEAT",,0,,0,168070,250480,30378,,,,,,,,,,,,,,,,,,,,,,,,,,,,,,,,,,,,,,,,,,"4,5,5",
5962133,,1415044260,60,1548677385,,0,0,4,0,0,,,,,0,,,,,,253,,,,,,,,,1,,,,,,,,,,,,,,0,,,,,,,,,,,,,,,,,,,,,,,,,,,,,,,,,,,,,,,,,,,,,,,,,,,,,,,,,,,,,,,,,,,,,,,,,,1,,,0,0,,,,,Auslaufen,,"Polar BEAT",,0,,0,168070,250480,30378,,,,,,,,,,,,,,,,,,,,,,,,,,,,,,,,,,,,,,,,,,,
5962135,eccf1dea-2e23-48f7-870d-c005df09a6e7,1473507636,120,1548677385,,0,0,3,943,944,44,45,,,1,1.3,0.54,,,290,203,,,,,,,35.05,,1,,,,,,,,,,,,,,19,79,11.83,12.16,12.29,,,,,,,,,,,,,,,,,"8,12,25,20,8,14,12,0,0",,,,,,,121,,,,,,,,,,,,,,,,,,,,,,,,,,,,,,,,,,,,,22,1,215,71,,,,,0,3,3,,1,0,,,,,"Plettenberg Laufen",,"Polar BEAT",,0,,0,168070,250480,30378,,,,,,,,,,,,,,,,,,,,,,,,,,,,,,,,,,,,,,,,,,5,
5962136,031d96ad-43bf-4f73-9892-7b645d1d8681,1364554836,60,1548677385,,0,0,3.18,1025,1048,54,55,,,1,1.4,0.63,,,383,220,,,,,,,34.18,,1,,,,,,,,,,,,,,21,,11.48,12.04,12.27,,,,,,,,,,,,,,,,,"14,7,15,22,20,14,7,0,0",,,,,,,,,,,,,,,,,,,,,,,,,,,,,,,,,,,,,,,,,,,,0,4,269,74,,,3,,0,5,3,,1,0,,,,,,,"Polar BEAT",,0,,0,168070,250480,30378,,,,,,,,,,,,,,,,,,,,,,,,,,,,,,,,,,,,,,,,,,5,
5962137,72bfe715-fce1-4588-82f9-58822e4fcac7,1499287159,120,1548677386,,0,0,4.73,1550,2772,44,40,,,1,0,0.27,,,,325,,,,,,,34.38,,1,,,,,,,,,,,,,,32,76,11.09,11.26,11.29,,,,,,,,,,,,,,,,,"13,8,21,33,18,6,2,0,0",,,,,,,120,,,,,,,,,,,,,,,,,,,,,,,,,,,,,,,,,,,,,24,7,130,48,,1018,,,0,3,3,,1,0,,,,,"Aix-en-Provence Laufen",,"Polar BEAT",,0,,0,168070,250480,30378,,,,,,,,,,,,,,,,,,,,,,,,,,,,,,,,,,,,,,,,,,,
5962138,cd30cf5c-087a-4083-91bf-f8e193ae5916,1465069527,120,1548677386,,0,0,6.24,1929,1929,65,73,,,1,0.7,0.39,,,,431,,,,,,,37.45,,1,,,,,,,,,,,,,,40,80,11.76,11.74,11.94,,,,,,,,,,,,,,,,,"4,3,13,42,32,5,0,0,0",,,,,,,121,,,,,,,,,,,,,,,,,,,,,,,,,,,,,,,,,,,,,18,2,262,91,,1014,0,,0,5,3,,1,0,,,,,"Aachen Laufen",,"Polar BEAT",,0,,0,168070,250480,30378,,,,,,,,,,,,,,,,,,,,,,,,,,,,,,,,,,,,,,,,,,,
5962139,f7089a37-7976-4bd8-b8e5-b8aa349772c1,1505154315,120,1548677386,,0,0,0.64,207,211,15,12,,,1,1.2,0.68,1,0.83,,39,133,152,,,,60.44,28.89,62.55,1,,,,,,,,,,,,,,3,80,11.48,11.11,11.69,8.7,,,,,,,,,,,,,,,,"11,8,22,29,29,1,0,0,0","11,36,53,0,0",,,,,,116,,,,,,,,,,,,,,,,,,,,,,,,,,,,,,,,,,,,7.1,14,25,225,71,,1000,,,0,6,3,,1,0,,,Running,,,,"Polar M430",43,0,,0,168070,250480,30378,,,,,,,,,,,,,,,,,,,,,,,,,,,,,,,,,,,,,,,,,,,
5962140,69a28465-e971-4277-98e0-373da583ec5b,1469138168,120,1548677387,,0,0,15,3681,3809,191,191,,,1,1.6,0.48,,,437,1040,,,,,,,52.09,,1,,,,,,,,,,,,,,76,82,14.96,14.93,15.15,,,,,,,,,,,,,,,,,"2,0,1,5,10,33,41,7,0",,,,,,,149,,,,,,,,,,,,,,,,,,,,,,,,,,,,,,,,,,,,,23,1,307,71,,1017,0,,1,5,3,,1,0,,,,,"Aachen Laufen",,"Polar BEAT",,0,,0,168070,250480,30378,,,,,,,,,,,,,,,,,,,,,,,,,,,,,,,,,,,,,,,,,,"5,5",
5962141,,1547745900,60,1548677387,,0,0,14,3780,3780,,,,,0,,,,,,924,,,,,,,46.38,,1,,,,,,,,,,,,,,78,,,,,,,,,,,,,,,,,,,,,,,,,,,,,,,,,,,,,,,,,,,,,,,,,,,,,,,,,,,,,,,,,,,,,,,,,,1,,,0,0,,,,,,,"no device name available",,0,,0,168070,250480,30378,,,,,,,,,,,,,,,,,,,,,,,,,,,,,,,,,,,,,,,,,,,
5962142,f875cd3b-fa66-4083-9aef-3a16a1dcc4ac,1411988053,120,1548677388,,0,0,8.14,2529,2787,91,91,,,1,1.3,0.52,,,,550,,,,,,,37.86,,1,,,,,,,,,,,,,,52,82,11.74,11.71,11.96,,,,,,,,,,,,,,,,,"5,4,17,35,34,5,1,0,0",,,,,,,118,,,,,,,,,,,,,,,,,,,,,,,,,,,,,,,,,,,,,19,5,198,77,,1023,2,,0,5,3,,1,0,,,,,Auslaufen,,"Polar BEAT",,0,,0,168070,250480,30378,,,,,,,,,,,,,,,,,,,,,,,,,,,,,,,,,,,,,,,,,,,
5962143,d00e722f-65d2-4977-bc51-708f3e1104d1,1501013821,120,1548677388,,0,0,2.33,679,679,29,26,,,1,0.8,0.48,,,,159,,,,,,,37.43,,1,,,,,,,,,,,,,,14,81,12.48,12.62,13.1,,,,,,,,,,,,,,,,,"7,1,6,20,37,28,0,0,0",,,,,,,127,,,,,,,,,,,,,,,,,,,,,,,,,,,,,,,,,,,,,15,10,294,93,,1010,0,,0,6,3,,1,0,,,,,,,"Polar BEAT",,0,,0,168070,250480,30378,,,,,,,,,,,,,,,,,,,,,,,,,,,,,,,,,,,,,,,,,,,
5962144,007a0836-4869-4965-bcdb-fecff3582f5d,1447183804,60,1548677388,,0,0,5.86,1550,1577,58,52,,,1,1,0.45,,,,401,,,,,,,44.87,,1,,,,,,,,,,,,,,32,84,13.82,14.29,14.41,,,,,,,,,,,,,,,,,"6,2,8,16,15,11,36,5,0",,,,,,,135,,,,,,,,,,,,,,,,,,,,,,,,,,,,,,,,,,,,,12,18,225,92,,1026,,,1,4,3,,1,0,,,,,"Aachen Laufen",,"Polar BEAT",,0,,0,168070,250480,30378,,,,,,,,,,,,,,,,,,,,,,,,,,,,,,,,,,,,,,,,,,,
5962145,4b02a767-051e-4aed-b728-9b0dd887a634,1418558785,60,1548677389,,0,0,18.07,3786,3786,195,276,,,1,1.6,0.44,,,609,1209,,,,,,,63.44,,1,,,,,,,,,,,,,,78,89,17.28,17.3,17.4,,,,,,,,,,,,,,,,,"0,0,0,0,1,6,40,51,2",,,,,,,161,,,,,,,,,,,,,,,,,,,,,,,,,,,,,,,,,,,,,3,8,202,86,,1018,,,0,5,3,,1,0,,,,,"ATG Winter Lauf",,"Polar BEAT",,0,,0,168070,250480,30378,,,,,,,,,,,,,,,,,,,,,,,,,,,,,,,,,,,,,,,,,,5,
5962146,4e32aa6a-f40f-4cdc-9a68-e59cf9ef15c6,1525178767,120,1548677389,,0,0,1.79,642,642,7,4,,,1,0,0.1,1.06,0.91,,132,137,144,,,,51.32,28.71,51.68,1,,,,,,,,,,,,,,11,83,10.11,10.16,10.25,-3.5,,,,,,,,,,,,,,,,"22,27,29,18,4,0,0,0,0","3,56,41,0,0",,,,,,101,,,,,,,,,,,,,,,,,,,,,,,,,,,,,,,,,,,,16.6,11,14,258,54,,1013,,,0,5,3,,1,0,I1.000|6:14-I0.791|4:29,,Running,,,,"Polar M430",43,0,,0,168070,250480,30378,,,,,,,,,,,,,,,,,,,,,,,,,,,,,,,,,,,,,,,,,,,
5962148,df37ae1a-c78e-4594-ab60-7d9795df1081,1362418020,60,1548677399,1606294859,0,0,16.58,5400,88125,91,92,,,1,0,0.08,,,,1320,,,,,,,37.8,,1,,,,,,,,,,,,,,133,,0.68,9.71,9.74,,,,,,,,,,,,,,,,,"96,0,0,1,1,1,0,0,0",,,,,,,,,,,,,,,,,,,,,,,,,,,,,,,,,,,,,,,,,,,,6,11,85,59,,1019,0,,1,3,3,,1,0,,,,,,,"Polar BEAT",,0,,0,168070,250480,30378,,,,,,,,,,,,,,,,,,,,,,,,,,,,,,,,,,,,,,,,,,,
5962150,ba1ab702-fc63-43ff-924a-d7156a4bf203,1395170788,60,1548677402,,0,0,9.25,2501,2512,0,2,,,1,0,0,,,,493,159,181,,,,59.7,44.95,59.68,1,,,,,,,,,,,,,,84,82,13.34,15.56,15.57,9.7,,,,,,,,,,,,,,,,"30,1,1,1,1,1,21,42,1","0,26,8,65,1",,,,,,135,,,,,,,,,,,,,,,,,,,,,,,,,,,,,,,,,,,,89.8,8,12,243,82,,1016,0,,1,5,3,,1,0,,,,,"3x 1800m + 3x 1000m",,"Polar BEAT",,0,,0,168070,250480,30378,,,,,,,,,,,,,,,,,,,,,,,,,,,,,,,,,,,,,,,,,,,
5962151,54b4357a-2c10-430d-82ac-fa781b4cd866,1509785611,60,1548677403,,0,0,6.01,1998,1998,24,24,,,1,0,0,,0.99,,485,150,164,,,,50.15,34.28,50.4,1,,,,,,,,,,,,,,50,82,10.87,10.89,10.94,6.1,,,,,,,,,,,,,,,,"7,13,28,42,8,1,0,0,0","0,10,81,9,0",,,,,,110,,,,,,,,,,,,,,,,,,,,,,,,,,,,,,,,,,,,44.2,7,0,65,94,,,0,,0,9,3,,1,0,I1.000|5:40-I1.000|5:31-I1.000|5:21-I1.000|5:42-I1.000|5:32-I1.000|5:29-I0.016|0:05,,Running,,,,"Polar M430",43,0,,0,168070,250480,30378,,,,,,,,,,,,,,,,,,,,,,,,,,,,,,,,,,,,,,,,,,,
5962153,23f26d9d-a867-410d-a039-240aac9a82fb,1520410077,60,1548677404,,0,0,10.53,3060,3062,52,60,,,1,0,0.1,1.11,0.89,,895,171,180,,,,49.04,41.68,49.29,1,,,,,,,,,,,,,,123,82,12.41,12.43,12.5,6.9,,,,,,,,,,,,,,,,"0,0,3,24,68,5,0,0,0","0,3,7,90,0",,,,,,126,,,,,,,,,,,,,,,,,,,,,,,,,,,,,,,,,,,,99.5,5,3,210,91,,,0,,0,4,3,,1,0,I1.000|4:49-I1.000|4:42-I1.000|4:43-I1.000|4:41-I1.000|4:45-I1.000|4:45-I1.000|4:47-I1.000|4:56-I1.000|5:06-I1.000|5:05-I0.538|2:43,,Running,,,,"Polar M430",43,0,,0,168070,250480,30378,,,,,,,,,,,,,,,,,,,,,,,,,,,,,,,,,,,,,,,,,,,
5962154,1ef8b5bd-7621-438e-aa33-3b82b87accb6,1528624041,120,1548677405,,0,0,27.35,7955,7957,658,705,,,1,4.7,0.7,1.18,0.93,507,1856,147,176,,,,60.76,44.83,62.44,1,,,,,,,,,,,,,,185,81,12.86,12.5,13.42,2.9,,,,,,,,,,,,,,,,"2,3,6,23,50,16,1,0,0","0,17,78,5,0",,,,,,127,,,,,,,,,,,,,,,,,,,,,,,,,,,,,,,,,,,,57.6,19,6,320,94,,,,,0,3,3,,1,0,I1.000|5:11-I1.000|4:50-I1.000|5:01-I1.000|4:48-I1.000|5:00-I1.000|5:07-I1.000|4:43-I1.000|4:47-I1.000|4:39-I1.000|4:57-I1.000|4:39-I1.000|4:46-I1.000|4:46-I1.000|4:41-I1.000|4:49-I1.000|4:50-I1.000|4:41-I1.000|4:59-I1.000|4:47-I1.000|4:47-I1.000|4:52-I1.000|5:20-I1.000|4:50-I1.000|5:18-I1.000|4:16-I1.000|4:18-I1.000|5:18-I0.347|1:38,,Running,,,,"Polar M430",43,0,,0,168070,250480,30378,,,,,,,,,,,,,,,,,,,,,,,,,,,,,,,,,,,,,,,,,,"4,4,4,5,5,5,5,5,5,5",
5962155,2aca0e19-86fd-49ea-8b91-fe790aea2536,1429299030,120,1548677405,,0,0,4.96,1417,1603,107,107,,,1,1.4,0.47,,,,340,,,,,,,40.57,,1,,,,,,,,,,,,,,29,83,13.08,12.89,13.39,,,,,,,,,,,,,,,,,"8,1,2,18,37,26,5,4,0",,,,,,,127,,,,,,,,,,,,,,,,,,,,,,,,,,,,,,,,,,,,,10,14,23,51,,1019,,,0,5,3,,1,0,,,,,"Aachen Laufen",,"Polar BEAT",,0,,0,168070,250480,30378,,,,,,,,,,,,,,,,,,,,,,,,,,,,,,,,,,,,,,,,,,,
5962156,4266d0d1-775c-4b71-9a34-65e8e492c7d4,1482225854,60,1548677406,,0,0,3.43,1060,1091,48,49,,,1,1,0.53,,,,233,,,,,,,36.11,,1,,,,,,,,,,,,,,22,80,11.87,11.77,11.93,,,,,,,,,,,,,,,,,"2,11,17,27,38,6,0,0,0",,,,,,,121,,,,,,,,,,,,,,,,,,,,,,,,,,,,,,,,,,,,,0,6,101,80,,1023,0,,0,3,3,,1,0,,,,,"Aachen Laufen",,"Polar BEAT",,0,,0,168070,250480,30378,,,,,,,,,,,,,,,,,,,,,,,,,,,,,,,,,,,,,,,,,,,
5962157,8e26093f-6402-40fb-9d2e-e51f8637280d,1503942519,120,1548677407,,0,0,16.25,4556,4559,292,289,,,1,2.9,0.53,1.08,1.01,743,1165,159,182,,,,57.08,44.93,58.36,1,,,,,,,,,,,,,,144,80,13.26,13,13.61,3.2,,,,,,,,,,,,,,,,"2,3,7,14,37,33,5,0,0","0,6,41,52,1",,,,,,134,,,,,,,,,,,,,,,,,,,,,,,,,,,,,,,,,,,,85,27,4,293,55,,1017,1,,0,5,3,,1,0,I1.000|5:02-I1.000|5:13-I1.000|4:38-I1.000|4:25-I1.000|4:57-I1.000|4:20-I1.000|4:27-I1.000|4:23-I1.000|4:29-I1.000|5:07-I1.000|4:22-I1.000|4:32-I1.000|4:25-I1.000|4:37-I1.000|5:07-I1.000|4:42-I0.259|1:13,,Running,,,,"Polar M430",43,0,,0,168070,250480,30378,,,,,,,,,,,,,,,,,,,,,,,,,,,,,,,,,,,,,,,,,,"4,5,5",
5962158,c66d9fb0-0f54-4ac2-ba08-37bcbce35a87,1521188057,60,1548677407,,0,0,10.62,1448,1448,25,33,,,1,0,0.08,,,,326,147,174,,,,,,,1,,,,,,,,,,,,,,35,,,27.23,,0.5,-25.5,136,122,,1,156,143,,,,,,,,,"0,9,21,52,15,2,0","3,22,56,19,0","67,22,0,0,10",,,,,,,,,,,,,,,,,,,,,,,,,,,,,,,,,,,,,,,,,49.5,8,18,200,93,,1001,,,0,6,1,,1,0,,,Cycling,,,,"Polar M430",43,0,,0,168072,,30378,,,,,,,,,,,,,,,,,,,,,,,,,,,,,,,,,,,,,,,,,,,
5962159,dbdab19b-a99e-4e17-927e-9e5391f18ffd,1541088098,60,1548677407,,0,0,1.5,577,577,2,0,,,1,0,0.06,1.06,0.85,,106,126,165,,,,51.96,25.99,52.13,1,,,,,,,,,,,,,,8,83,9.42,9.84,9.88,-0.7,,,,,,,,,,,,,,,,"41,44,2,2,2,10,0,0,0","4,80,15,1,0",,,,,,94,,,,,,,,,,,,,,,,,,,,,,,,,,,,,,,,,,,,9.7,13,5,300,67,,,,,0,3,3,,1,0,I1.000|6:11-I0.504|3:27,,Running,,,,"Polar M430",43,0,,0,168070,250480,30378,,,,,,,,,,,,,,,,,,,,,,,,,,,,,,,,,,,,,,,,,,,
5962160,7751260a-7c5f-4e03-8b52-54dfb165161a,1467748883,120,1548677408,,0,0,14.81,5387,6221,87,92,,,1,0,0.18,,,125,993,,,,,,,32.89,,1,,,,,,,,,,,,,,111,78,9.96,12.53,12.67,,,,,,,,,,,,,,,,,"33,4,7,12,15,16,2,10,2",,,,,,,106,,,,,,,,,,,,,,,,,,,,,,,,,,,,,,,,,,,,,17,18,294,71,,1018,,,0,5,3,,1,0,,,,,"Aachen Laufen",,"Polar BEAT",,0,,0,168070,250480,30378,,,,,,,,,,,,,,,,,,,,,,,,,,,,,,,,,,,,,,,,,,5,
5962161,6898f667-46b4-475c-92e3-f897919a83ca,1535743128,120,1548677409,,0,0,9.5,2734,2739,38,36,,,1,0,0,1.13,0.92,,615,141,155,,,,64.98,41.86,65.32,1,,,,,,,,,,,,,,54,80,12.55,12.76,12.84,0,,,,,,,,,,,,,,,,"0,0,4,31,53,11,0,0,1","1,37,63,0,0",,,,,,130,,,,,,,,,,,,,,,,,,,,,,,,,,,,,,,,,,,,24.5,16,11,202,94,,1021,,,0,5,3,,1,0,I1.000|4:43-I1.000|4:41-I1.000|4:49-I1.000|4:51-I1.000|4:40-I1.000|4:56-I1.000|5:04-I1.000|4:21-I1.000|5:02-I0.496|2:33,,Running,,,,"Polar M430",43,0,,0,168070,250480,30378,,,,,,,,,,,,,,,,,,,,,,,,,,,,,,,,,,,,,,,,,,,
5962163,966db4cc-8eef-4f78-851b-acacb0f0b433,1518621864,60,1548677410,,0,0,10.45,1868,1900,49,36,,,1,0,0.1,2.52,0.41,,307,123,164,,,,,,,1,,,,,,,,,,,,,,24,,,21.95,,28.8,-1.4,104,89,,1,127,115,,,,,,,,,"14,8,68,10,0,0,0","4,79,15,2,0","89,1,0,1,9",,,,,,,,,,,,,,,,,,,,,,,,,,,,,,,,,,,,,,,,,22.3,5,2,90,50,,,,,0,3,3,,1,0,,,Cycling,,,,"Polar M430",43,0,,0,168072,,30378,,,,,,,,,,,,,,,,,,,,,,,,,,,,,,,,,,,,,,,,,,,
5962165,944d8272-2694-415c-958f-c7fa1a1779e3,1418323924,60,1548677410,,0,0,3.94,1131,1568,59,41,,,1,1.2,0.46,,,326,267,,,,,,,39.76,,1,,,,,,,,,,,,,,23,83,12.97,12.93,13.38,,,,,,,,,,,,,,,,,"10,1,3,7,33,42,4,0,0",,,,,,,126,,,,,,,,,,,,,,,,,,,,,,,,,,,,,,,,,,,,,4,21,232,88,,1011,,,1,5,3,,1,0,,,,,Einlaufen,,"Polar BEAT",,0,,0,168070,250480,30378,,,,,,,,,,,,,,,,,,,,,,,,,,,,,,,,,,,,,,,,,,5,
5962166,04b9ea3e-2468-430c-8b1b-7c93b35c2d24,1504628923,120,1548677411,,0,0,10.34,2541,2541,74,90,,,1,0.3,0.31,1.1,1.01,,717,168,181,,,,61.96,50.64,62.39,1,,,,,,,,,,,,,,95,82,14.67,14.7,14.8,5.8,,,,,,,,,,,,,,,,"0,0,0,1,8,53,38,0,0","1,1,14,83,1",,,,,,149,,,,,,,,,,,,,,,,,,,,,,,,,,,,,,,,,,,,91.7,23,9,218,66,,1016,2,,0,5,3,,1,0,I10.015|40:59-I0.333|1:23,,Running,,,,"Polar M430",43,0,,0,168070,250480,30378,,,,,,,,,,,,,,,,,,,,,,,,,,,,,,,,,,,,,,,,,,,
5962167,1512ee81-643a-4002-9dc9-bd4315b20b32,1472905448,120,1548677411,,0,0,6.55,2145,2173,98,85,,,1,1.3,0.49,,,253,448,,,,,,,35.08,,1,,,,,,,,,,,,,,44,79,11.29,11.67,12.02,,,,,,,,,,,,,,,,,"11,2,9,40,31,6,1,0,0",,,,,,,116,,,,,,,,,,,,,,,,,,,,,,,,,,,,,,,,,,,,,21,3,241,66,,1019,4,,0,5,3,,1,0,,,,,"Aachen Laufen",,"Polar BEAT",,0,,0,168070,250480,30378,,,,,,,,,,,,,,,,,,,,,,,,,,,,,,,,,,,,,,,,,,"5,5",
5962168,5a6a1524-d4ae-41eb-89f1-8be87e076e3c,1393614696,60,1548677412,,0,0,5.22,1770,2716,26,28,,,1,0,0.16,,,,335,,,,,,,33.2,,1,,,,,,,,,,,,,,36,80,10.67,11.3,11.49,,,,,,,,,,,,,,,,,"21,4,7,31,34,3,0,0,0",,,,,,,111,,,,,,,,,,,,,,,,,,,,,,,,,,,,,,,,,,,,,6,8,113,86,,999,0,,1,6,3,,1,0,,,,,"Einlaufen + Lauf ABC ",,"Polar BEAT",,0,,0,168070,250480,30378,,,,,,,,,,,,,,,,,,,,,,,,,,,,,,,,,,,,,,,,,,,
5962169,b374af8b-51cc-499d-90ba-221d240fe85f,1448565157,60,1548677412,,0,0,3.33,1041,1041,58,58,,,1,1.4,0.55,,,373,228,,,,,,,35.55,,1,,,,,,,,,,,,,,21,79,11.88,11.64,12.29,,,,,,,,,,,,,,,,,"3,6,19,39,32,0,0,0,0",,,,,,,121,,,,,,,,,,,,,,,,,,,,,,,,,,,,,,,,,,,,,2,4,197,93,,1022,,,1,3,3,,1,0,,,,,"Aachen Laufen",,"Polar BEAT",,0,,0,168070,250480,30378,,,,,,,,,,,,,,,,,,,,,,,,,,,,,,,,,,,,,,,,,,5,
5962171,6f794612-9fc8-4e15-989b-ff57526977ab,1398805674,120,1548677413,,0,0,9.18,3316,3639,109,111,,,1,1.6,0.47,1.23,1.2,275,488,141,173,,,,49.08,31.94,49.79,1,,,,,,,,,,,,,,68,77,10.12,11.13,11.52,17.1,,,,,,,,,,,,,,,,"19,7,22,31,10,8,3,0,0","1,51,41,7,0",,,,,,108,,,,,,,,,,,,,,,,,,,,,,,,,,,,,,,,,,,,35.9,13,1,32,86,,1012,0,,1,5,3,,1,0,,,,,"Regenerativer DL ",,"Polar BEAT",,0,,0,168070,250480,30378,,,,,,,,,,,,,,,,,,,,,,,,,,,,,,,,,,,,,,,,,,4,
5962172,057a16f5-f458-4388-9ba0-922269ed72ce,1545395510,60,1548677413,,0,0,12.4,3920,3943,45,44,,,1,0,0.04,1.04,0.98,,819,137,166,,,,59.97,38.24,60.25,1,,,,,,,,,,,,,,73,83,11.43,11.62,11.68,10.1,,,,,,,,,,,,,,,,"7,8,23,32,21,4,4,1,0","2,59,35,4,0",,,,,,114,,,,,,,,,,,,,,,,,,,,,,,,,,,,,,,,,,,,32.8,10,43,200,87,,,1,,0,11,3,,1,0,I6.402|32:06-I6.000|33:39,,Running,,,,"Polar M430",43,0,,0,168070,250480,30378,,,,,,,,,,,,,,,,,,,,,,,,,,,,,,,,,,,,,,,,,,,
5962174,,1414576080,60,1548677413,,0,0,5,0,0,,,,,0,,,,,,338,,,,,,,,,1,,,,,,,,,,,,,,0,,,,,,,,,,,,,,,,,,,,,,,,,,,,,,,,,,,,,,,,,,,,,,,,,,,,,,,,,,,,,,,,,,,,,,,,,,1,,,0,0,,,,,"Lauf ABC",,"Polar BEAT",,0,,0,168070,250480,30378,,,,,,,,,,,,,,,,,,,,,,,,,,,,,,,,,,,,,,,,,,,
5962175,d0c4b97f-dfb8-4c42-8795-e76eb67ef65b,1472911795,120,1548677414,,0,0,1.75,600,654,2,0,,,1,0,0.07,,,,97,,,,,,,30.18,,1,,,,,,,,,,,,,,12,71,10.58,12.26,12.39,,,,,,,,,,,,,,,,,"38,2,7,5,6,11,14,15,2",,,,,,,123,,,,,,,,,,,,,,,,,,,,,,,,,,,,,,,,,,,,,23,5,242,58,,1017,4,,0,5,3,,1,0,,,,,"Aachen Laufen",,"Polar BEAT",,0,,0,168070,250480,30378,,,,,,,,,,,,,,,,,,,,,,,,,,,,,,,,,,,,,,,,,,,
5962176,e0816ccd-4979-46df-b190-db9b9257dc1b,1394706398,60,1548677414,,0,0,1.1,367,395,4,27,,,1,0.3,0.37,0.95,0.95,,58,125,143,,,,62.5,29.56,61.17,1,,,,,,,,,,,,,,4,84,10.43,10.85,10.48,-14.2,,,,,,,,,,,,,,,,"20,17,16,18,23,5,0,0,0","4,87,8,0,0",,,,,,107,,,,,,,,,,,,,,,,,,,,,,,,,,,,,,,,,,,,7.2,13,2,283,58,,1029,2,,0,3,3,,1,0,,,,,Auslaufen,,"Polar BEAT",,0,,0,168070,250480,30378,,,,,,,,,,,,,,,,,,,,,,,,,,,,,,,,,,,,,,,,,,,
5962177,84246865-8458-43df-ac02-425de71ae65f,1527403604,120,1548677415,,0,0,15.37,5030,5035,543,542,,,1,5.4,0.83,1.09,1.03,699,1170,148,179,,,,52.06,37.36,54.34,1,,,,,,,,,,,,,,125,82,12.08,11.44,12.68,2.4,,,,,,,,,,,,,,,,"22,12,13,18,23,9,2,0,0","0,37,40,22,0",,,,,,112,,,,,,,,,,,,,,,,,,,,,,,,,,,,,,,,,,,,74.2,,,,,,,,,0,1,3,,1,0,I7.529|37:55-I1.336|9:14-I1.885|9:53-I1.348|9:00-I3.267|17:54,,Running,,,,"Polar M430",43,0,,0,168070,250480,30378,,,,,,,,,,,,,,,,,,,,,,,,,,,,,,,,,,,,,,,,,,"3,4,4,5",
5962178,5cafd444-0efe-42d0-8307-c6f5d66eaa23,1460576473,120,1548677416,,0,0,14.85,4060,5022,267,267,,,1,3.2,0.58,,,493,1021,,,,,,,45.93,,1,,,,,,,,,,,,,,84,83,13.39,13.33,13.7,,,,,,,,,,,,,,,,,"2,0,3,9,37,41,7,0,0",,,,,,,132,,,,,,,,,,,,,,,,,,,,,,,,,,,,,,,,,,,,,11,2,297,80,,1009,0,,0,5,3,,1,0,,,,,"Aachen Laufen",,"Polar BEAT",,0,,0,168070,250480,30378,,,,,,,,,,,,,,,,,,,,,,,,,,,,,,,,,,,,,,,,,,"4,4",
5962179,f1e1d70b-2307-4dfa-9262-9c6d32685cac,1454764471,60,1548677416,,0,0,4.73,1494,1832,12,12,,,1,0,0.09,,,,324,,,,,,,35.92,,1,,,,,,,,,,,,,,31,80,11.42,11.85,11.91,,,,,,,,,,,,,,,,,"17,3,7,28,33,5,6,0,0",,,,,,,119,,,,,,,,,,,,,,,,,,,,,,,,,,,,,,,,,,,,,10,22,202,71,,1010,,,0,5,3,,1,0,,,,,"Mönchengladbach Laufen",,"Polar BEAT",,0,,0,168070,250480,30378,,,,,,,,,,,,,,,,,,,,,,,,5,1494,,,0,"35. Hardter Karnevalslauf",,,,,,,0,0,30378,5962179,9245,,,
5962180,f1567ce2-8f7e-4a38-a21e-b2a409ca849e,1467680931,120,1548677418,,0,0,1.1,333,333,22,25,,,1,0.7,0.45,,,,78,,,,,,,33.01,,1,,,,,,,,,,,,,,6,80,12.17,12.12,12.27,,,,,,,,,,,,,,,,,"6,6,13,36,17,22,0,0,0",,,,,,,124,,,,,,,,,,,,,,,,,,,,,,,,,,,,,,,,,,,,,17,3,226,85,,1018,0,,1,5,3,,1,0,,,,,"Aachen Laufen",,"Polar BEAT",,0,,0,168070,250480,30378,,,,,,,,,,,,,,,,,,,,,,,,,,,,,,,,,,,,,,,,,,,
5962181,de962606-e82a-4aa7-a699-b84c2fc5a24f,1545246444,60,1548677418,,0,0,10.88,2280,2285,50,37,,,1,0,0.11,2.08,,,325,112,142,,,,,,,1,,,,,,,,,,,,,,21,,,18.6,,-2.6,-54,76,65,,1,105,92,,,,,,,,,"25,51,19,4,0,0,0","25,74,1,0,0","87,0,10,2,2",,,,,,,,,,,,,,,,,,,,,,,,,,,,,,,,,,,,,,,,,12.6,5,4,180,97,,,0,,1,5,3,,1,0,,,Cycling,,,,"Polar M430",43,0,,0,168072,,30378,,,,,,,,,,,,,,,,,,,,,,,,,,,,,,,,,,,,,,,,,,,
5962182,64d314ac-19f9-4c9c-a9c1-ebc4720b09f0,1417099633,60,1548677419,,0,0,5.01,1228,1228,50,29,,,1,0.3,0.28,,,,329,,,,,,,48.6,,1,,,,,,,,,,,,,,25,85,15.05,15.08,15.23,,,,,,,,,,,,,,,,,"0,0,5,10,23,7,42,12,0",,,,,,,144,,,,,,,,,,,,,,,,,,,,,,,,,,,,,,,,,,,,,7,6,104,97,,1006,0,,0,6,3,,1,0,,,,,"Kurzer gesteigerter DL",,"Polar BEAT",,0,,0,168070,250480,30378,,,,,,,,,,,,,,,,,,,,,,,,,,,,,,,,,,,,,,,,,,,
5962183,88eca1f8-84b3-4406-8241-e2a3193c81d5,1483725881,60,1548677419,,0,0,15.5,4136,4413,228,242,,,1,2.4,0.54,,,727,1047,,,,,,,47.4,,1,,,,,,,,,,,,,,85,82,13.83,13.81,14.21,,,,,,,,,,,,,,,,,"3,1,6,13,17,35,24,1,0",,,,,,,137,,,,,,,,,,,,,,,,,,,,,,,,,,,,,,,,,,,,,-4,2,159,79,,1040,0,,1,3,3,,1,0,,,,,"Aachen Laufen",,"Polar BEAT",,0,,0,168070,250480,30378,,,,,,,,,,,,,,,,,,,,,,,,,,,,,,,,,,,,,,,,,,4,
5962184,04bce0b0-7639-494d-8116-3455537c698e,1400534252,120,1548677420,,0,0,7.65,2605,2620,108,94,,,1,1.6,0.58,,,,515,,,,,,,33.83,,1,,,,,,,,,,,,,,54,81,10.82,10.68,11.04,,,,,,,,,,,,,,,,,"7,16,37,36,4,0,0,0,0",,,,,,,109,,,,,,,,,,,,,,,,,,,,,,,,,,,,,,,,,,,,,20,3,166,53,,1007,0,,1,3,3,,1,0,,,,,"Regenerativer DL + Lauf ABC",,"Polar BEAT",,0,,0,168070,250480,30378,,,,,,,,,,,,,,,,,,,,,,,,,,,,,,,,,,,,,,,,,,,
5962185,05b8c289-d3d0-4d5c-b537-d019adb04720,1448090735,60,1548677420,,0,0,5.92,1857,1857,105,103,,,1,1.4,0.42,,,237,402,,,,,,,36.7,,1,,,,,,,,,,,,,,38,81,11.87,11.64,12.12,,,,,,,,,,,,,,,,,"5,12,19,27,29,8,0,0,0",,,,,,,118,,,,,,,,,,,,,,,,,,,,,,,,,,,,,,,,,,,,,2,13,233,92,,997,,,1,5,3,,1,0,,,,,"Aachen Laufen",,"Polar BEAT",,0,,0,168070,250480,30378,,,,,,,,,,,,,,,,,,,,,,,,,,,,,,,,,,,,,,,,,,4,
5962186,eda973ae-a51f-47c8-9bc2-1f79a2dc88dd,1420976769,60,1548677421,,0,0,22.36,6263,6931,299,300,,,1,2.3,0.5,,,341,1502,,,,,,,46.14,,1,,,,,,,,,,,,,,130,84,13.12,13.24,13.63,,,,,,,,,,,,,,,,,"7,2,3,11,28,40,10,0,0",,,,,,,128,,,,,,,,,,,,,,,,,,,,,,,,,,,,,,,,,,,,,4,16,254,83,,1022,1,,0,5,3,,1,0,,,,,"Langer DL",,"Polar BEAT",,0,,0,168070,250480,30378,,,,,,,,,,,,,,,,,,,,,,,,,,,,,,,,,,,,,,,,,,4,
5962187,d398a3cf-db30-47c0-a09b-ec4a91205736,1422910598,60,1548677422,,0,0,11.78,3042,3078,131,122,,,1,1,0.46,,,,785,,,,,,,48.23,,1,,,,,,,,,,,,,,63,85,14.12,14.19,14.39,,,,,,,,,,,,,,,,,"3,1,3,4,17,38,33,1,0",,,,,,,137,,,,,,,,,,,,,,,,,,,,,,,,,,,,,,,,,,,,,0,7,252,94,,1004,0,,1,5,3,,1,0,,,,,"Aachen Laufen",,"Polar BEAT",,0,,0,168070,250480,30378,,,,,,,,,,,,,,,,,,,,,,,,,,,,,,,,,,,,,,,,,,,
5962188,4b70317a-da95-4278-8508-4f8160ca4cb7,1419934594,60,1548677422,,0,0,2.77,791,791,31,32,,,1,0,0.29,,,,188,,,,,,,38.93,,1,,,,,,,,,,,,,,16,84,12.81,12.94,13,,,,,,,,,,,,,,,,,"4,4,9,36,12,16,20,0,0",,,,,,,125,,,,,,,,,,,,,,,,,,,,,,,,,,,,,,,,,,,,,1,5,255,99,,,0,,0,5,3,,1,0,,,,,"Balve Laufen",,"Polar BEAT",,0,,0,168070,250480,30378,,,,,,,,,,,,,,,,,,,,,,,,,,,,,,,,,,,,,,,,,,,
5962189,1afb6a0a-307a-427e-969e-811d0346fd33,1544799654,60,1548677423,,0,0,10.89,2934,2937,200,197,,,1,2.7,0.57,1.11,0.97,551,691,146,176,,,,67.4,45.64,68.96,1,,,,,,,,,,,,,,69,82,13.81,13.51,14.17,-0.3,,,,,,,,,,,,,,,,"1,1,4,11,25,47,11,0,0","0,33,51,16,0",,,,,,136,,,,,,,,,,,,,,,,,,,,,,,,,,,,,,,,,,,,54.9,0,9,85,66,,,0,,0,5,3,,1,0,I1.000|4:42-I1.000|4:37-I1.000|4:25-I1.000|4:28-I1.000|4:51-I1.000|4:36-I1.000|4:15-I1.000|4:08-I1.000|4:09-I1.000|4:28-I0.892|4:19,,Running,,,,"Polar M430",43,0,,0,168070,250480,30378,,,,,,,,,,,,,,,,,,,,,,,,,,,,,,,,,,,,,,,,,,"4,5",
5962190,cca5e06d-2814-4012-b48f-9489814e7f07,1367527059,120,1548677424,,0,0,12.56,4511,6314,162,203,,,1,0.4,0.27,,,,823,,,,,,,32.95,,1,,,,,,,,,,,,,,93,,10.11,13.74,13.86,,,,,,,,,,,,,,,,,"41,6,7,9,7,6,5,9,10",,,,,,,,,,,,,,,,,,,,,,,,,,,,,,,,,,,,,,,,,,,,15,7,40,65,,1018,0,,1,5,3,,1,0,,,,,,,"Polar BEAT",,0,,0,168070,250480,30378,,,,,,,,,,,,,,,,,,,,,,,,,,,,,,,,,,,,,,,,,,,
5962191,80cd5a9e-8788-4779-ab73-59b1e4d841f6,1453749855,60,1548677424,,0,0,7.71,2460,3227,127,136,,,1,1.4,0.58,,,,528,,,,,,,36.56,,1,,,,,,,,,,,,,,51,80,11.46,11.91,12.05,,,,,,,,,,,,,,,,,"13,2,8,22,35,18,1,0,0",,,,,,,118,,,,,,,,,,,,,,,,,,,,,,,,,,,,,,,,,,,,,9,17,193,64,,1025,,,1,3,3,,1,0,,,,,"Aachen Laufen",,"Polar BEAT",,0,,0,168070,250480,30378,,,,,,,,,,,,,,,,,,,,,,,,,,,,,,,,,,,,,,,,,,,
5962192,33305eb5-7c05-46d1-89ba-4fd5f20a71a5,1437078843,120,1548677424,,0,0,6.76,2050,2100,22,25,,,1,0,0.1,,,,380,,,,,,,38.5,,1,,,,,,,,,,,,,,42,79,11.97,14.54,14.55,,,,,,,,,,,,,,,,,"41,4,3,3,3,4,6,21,14",,,,,,,125,,,,,,,,,,,,,,,,,,,,,,,,,,,,,,,,,,,,,24,10,55,64,,1014,,,0,5,3,,1,0,,,,,"Aachen Laufen",,"Polar BEAT",,0,,0,168070,250480,30378,,,,,,,,,,,,,,,,,,,,,,,,,,,,,,,,,,,,,,,,,,,
5962193,94448e19-3af3-4f84-9906-f8f0fc9b23f1,1488719024,60,1548677426,,0,0,32.27,8875,13324,40,37,,,1,0,0.01,,,,866,,,,,,,,,1,,,,,,,,,,,,,,99,,,15.95,,,,43,32,,1,59,50,,,,,,,,,"41,49,9,0,0,0,0",,"87,12,0,0,0",,,,,,,,,,,,,,,,,,,,,,,,,,,,,,,,,,,,,,,,,,10,15,192,62,,997,2,,0,5,3,,1,0,,,,,"Geldrop Radfahren",,"Polar BEAT",,0,,0,168072,,30378,,,,,,,,,,,,,,,,,,,,,,,,,,,,,,,,,,,,,,,,,,,
5962194,fff1e07b-4b07-4814-9dbc-6e696282abda,1451822464,60,1548677426,,0,0,15.08,3850,3888,176,176,,,1,1.3,0.44,,,685,1024,,,,,,,49.78,,1,,,,,,,,,,,,,,79,84,14.31,14.32,14.6,,,,,,,,,,,,,,,,,"2,0,1,5,11,52,29,0,0",,,,,,,140,,,,,,,,,,,,,,,,,,,,,,,,,,,,,,,,,,,,,6,18,185,85,,1005,,,0,4,3,,1,0,,,,,"Aachen Laufen",,"Polar BEAT",,0,,0,168070,250480,30378,,,,,,,,,,,,,,,,,,,,,,,,,,,,,,,,,,,,,,,,,,5,
5962195,d242d1fe-1d75-47e9-92de-3a8fd7bb4171,1421662503,60,1548677427,,0,0,13.56,4361,4897,280,281,,,1,3.5,0.64,,,423,907,,,,,,,37.75,,1,,,,,,,,,,,,,,90,82,11.63,11.5,12.45,,,,,,,,,,,,,,,,,"10,4,15,35,31,5,1,0,0",,,,,,,114,,,,,,,,,,,,,,,,,,,,,,,,,,,,,,,,,,,,,-1,1,156,95,,1013,0,,0,5,3,,1,0,,,,,"Aachen Laufen",,"Polar BEAT",,0,,0,168070,250480,30378,,,,,,,,,,,,,,,,,,,,,,,,,,,,,,,,,,,,,,,,,,"4,4,5,5",
5962196,40fbdc06-37b7-4891-acee-dd70c28b94e4,1501326126,120,1548677427,,0,0,3.79,1186,1189,53,36,,,1,0.8,0.47,1.02,1,,243,138,158,,,,60.19,35.83,61.57,1,,,,,,,,,,,,,,22,81,11.85,11.63,12,-0.1,,,,,,,,,,,,,,,,"6,5,20,34,28,6,1,0,0","2,56,42,0,0",,,,,,118,,,,,,,,,,,,,,,,,,,,,,,,,,,,,,,,,,,,20.5,21,12,229,70,,1014,4,,0,5,3,,1,0,I1.495|7:52-I2.296|11:57,,Running,,,,"Polar M430",43,0,,0,168070,250480,30378,,,,,,,,,,,,,,,,,,,,,,,,,,,,,,,,,,,,,,,,,,,
5962197,8bdd9776-1cd9-4269-80f3-8d05a0251ad3,1411474205,120,1548677428,,0,0,5.06,1522,1850,56,62,,,1,0.5,0.24,,,409,341,,,,,,,38.22,,1,,,,,,,,,,,,,,31,81,12.07,12.31,12.95,,,,,,,,,,,,,,,,,"12,5,8,17,32,21,4,1,0",,,,,,,123,,,,,,,,,,,,,,,,,,,,,,,,,,,,,,,,,,,,,14,2,196,67,,1022,3,,0,3,3,,1,0,,,,,"Auslaufen und Lauf ABC",,"Polar BEAT",,0,,0,168070,250480,30378,,,,,,,,,,,,,,,,,,,,,,,,,,,,,,,,,,,,,,,,,,5,
5962198,c8905ece-2c24-4392-93cd-b16115d8787f,1456666256,60,1548677429,,0,0,22.65,7715,8536,390,390,,,1,3.5,0.58,,,317,1564,,,,,,,36.73,,1,,,,,,,,,,,,,,160,80,10.89,11.75,12.22,,,,,,,,,,,,,,,,,"18,5,12,21,27,14,3,0,0",,,,,,,110,,,,,,,,,,,,,,,,,,,,,,,,,,,,,,,,,,,,,4,24,40,56,,1017,,,0,5,3,,1,0,,,,,"Aachen Laufen",,"Polar BEAT",,0,,0,168070,250480,30378,,,,,,,,,,,,,,,,,,,,,,,,,,,,,,,,,,,,,,,,,,"4,4,5",
5962199,f7369d99-fd8b-4ec8-918f-800b2092bd0b,1465294972,120,1548677429,,0,0,1.07,384,384,16,8,,,1,1,0.63,,,,75,,,,,,,27.11,,1,,,,,,,,,,,,,,7,79,10.41,10.06,10.57,,,,,,,,,,,,,,,,,"14,31,46,9,0,0,0,0,0",,,,,,,106,,,,,,,,,,,,,,,,,,,,,,,,,,,,,,,,,,,,,23,0,157,74,,1021,4,,0,5,3,,1,0,,,,,"Aachen Laufen",,"Polar BEAT",,0,,0,168070,250480,30378,,,,,,,,,,,,,,,,,,,,,,,,,,,,,,,,,,,,,,,,,,,
5962200,7047e39c-df13-4d20-9ae2-c50778371400,1481225571,60,1548677429,,0,0,3.25,997,1308,42,41,,,1,0.9,0.5,,,,219,,,,,,,36.29,,1,,,,,,,,,,,,,,20,81,11.93,12.6,12.94,,,,,,,,,,,,,,,,,"11,10,20,24,9,8,14,5,0",,,,,,,121,,,,,,,,,,,,,,,,,,,,,,,,,,,,,,,,,,,,,6,9,219,68,,1030,0,,1,5,3,,1,0,,,,,"Aachen Laufen",,"Polar BEAT",,0,,0,168070,250480,30378,,,,,,,,,,,,,,,,,,,,,,,,,,,,,,,,,,,,,,,,,,,
5962201,27b9a1bb-581b-42d0-bc25-55ff52155857,1423823595,60,1548677430,,0,0,13.51,4412,4884,187,186,,,1,1.7,0.52,,,131,924,,,,,,,37.06,,1,,,,,,,,,,,,,,91,80,11.21,12.37,12.62,,,,,,,,,,,,,,,,,"15,1,3,16,49,12,3,2,0",,,,,,,115,,,,,,,,,,,,,,,,,,,,,,,,,,,,,,,,,,,,,3,7,157,82,,1017,1,,0,3,3,,1,0,,,,,"Aachen Laufen",,"Polar BEAT",,0,,0,168070,250480,30378,,,,,,,,,,,,,,,,,,,,,,,,,,,,,,,,,,,,,,,,,,5,
5962202,9131c5cc-6900-4fd8-b350-3c349c06311f,1399412040,120,1548677431,1707427263,0,1,3,549,549,0,3,,,1,0,0,,,,189,,,,,,,65.06,,1,,,,,,,,,,,,,,11,91,19.9,19.89,19.85,,,,,,,,,,,,,,,,,"0,0,0,0,0,0,0,62,38",,,,,,,180,,,,,,,,,,,,,,,,,,,,,,,,,,,,,,,,,,,,,13,7,217,96,,1009,0,,1,6,3,,1,0,,,,,"WK 3.000m Bahn",,"Polar BEAT",,0,,0,168070,250480,30378,,,,,,,,,,,,,,,,,,,,,,,,3,549,,,0,,,,,,,,0,0,30378,5962202,,,,
5962203,ead751e8-c7e8-43b8-8d47-f7fcdcc10ec1,1451572202,60,1548677431,,0,0,14.95,3071,3071,28,23,,,1,0,0.03,,,,1029,,,,,,,64,,1,,,,,,,,,,,,,,63,87,17.57,17.54,17.58,,,,,,,,,,,,,,,,,"0,0,0,0,0,1,23,76,0",,,,,,,168,,,,,,,,,,,,,,,,,,,,,,,,,,,,,,,,,,,,,9,18,217,72,,1019,,,0,5,3,,1,0,,,,,"Werl Laufen",,"Polar BEAT",,0,,0,168070,250480,30378,,,,,,,,,,,,,,,,,,,,,,,,15,3071,,,0,"34. Internationaler Silvesterlauf Werl Soest",,,,,,,0,0,30378,5962203,244,,,
5962204,1f770d0f-4042-4949-bed6-8ca8ff9bb654,1471614320,120,1548677432,,0,0,9.89,2734,2825,99,99,,,1,0.1,0.33,,,,702,,,,,,,44,,1,,,,,,,,,,,,,,56,82,13.11,13.43,13.74,,,,,,,,,,,,,,,,,"4,1,8,33,20,10,17,7,0",,,,,,,132,,,,,,,,,,,,,,,,,,,,,,,,,,,,,,,,,,,,,22,1,204,73,,,,,0,3,3,,1,0,,,,,"Naujac-sur-Mer Laufen",,"Polar BEAT",,0,,0,168070,250480,30378,,,,,,,,,,,,,,,,,,,,,,,,,,,,,,,,,,,,,,,,,,,
5962205,667f441f-3b11-4b18-9d23-e65e3c1218b3,1416943834,60,1548677433,,0,0,10.28,2764,2823,106,99,,,1,1,0.45,,,,666,,,,,,,45.57,,1,,,,,,,,,,,,,,57,85,13.35,14.37,14.92,,,,,,,,,,,,,,,,,"10,5,12,20,5,7,21,19,2",,,,,,,131,,,,,,,,,,,,,,,,,,,,,,,,,,,,,,,,,,,,,4,14,99,83,,1020,,,1,5,3,,1,0,,,,,"5x (hoch zügig runter trab sprint trab)",,"Polar BEAT",,0,,0,168070,250480,30378,,,,,,,,,,,,,,,,,,,,,,,,,,,,,,,,,,,,,,,,,,,
5962206,9d21b75f-e898-48ea-86aa-3ec0bddface2,1404729771,120,1548677434,,0,0,10,2359,2382,119,112,,,1,1.1,0.51,,,508,660,,,,,,,53,,1,,,,,,,,,,,,,,48,85,15.49,15.34,15.62,,,,,,,,,,,,,,,,,"0,0,1,2,6,25,63,3,0",,,,,,,150,,,,,,,,,,,,,,,,,,,,,,,,,,,,,,,,,,,,,17,5,253,71,,1018,4,,0,5,3,,1,0,,,,,TDL,,"Polar BEAT",,0,,0,168070,250480,30378,,,,,,,,,,,,,,,,,,,,,,,,,,,,,,,,,,,,,,,,,,5,
5962207,f27eea8c-df21-4c8a-b467-e1f08110091d,1502355217,120,1548677435,,0,0,13.01,3782,3783,8,8,,,1,0,0,,,,895,152,168,,,,58.13,42.33,58.18,1,,,,,,,,,,,,,,98,80,12.4,12.44,12.46,-0.8,,,,,,,,,,,,,,,,"1,2,5,21,60,9,1,0,0","0,8,85,7,0",,,,,,129,,,,,,,,,,,,,,,,,,,,,,,,,,,,,,,,,,,,47.3,18,3,331,77,,1020,,,0,3,3,,1,0,I1.000|5:09-I1.000|4:41-I1.000|4:41-I1.000|4:44-I1.000|4:46-I1.000|4:44-I1.000|4:50-I1.000|4:48-I1.000|5:01-I1.000|5:05-I1.000|4:57-I1.000|4:58-I1.000|4:33-I0.016|0:06,,Running,,,,"Polar M430",43,0,,0,168070,250480,30378,,,,,,,,,,,,,,,,,,,,,,,,,,,,,,,,,,,,,,,,,,,
5962208,12c4c60e-50a2-4ea0-9d1f-aecbdfbf5ce1,1440615924,120,1548677435,,0,0,5.66,1612,1612,104,104,,,1,2.1,0.64,,,263,390,,,,,,,41.03,,1,,,,,,,,,,,,,,33,82,13.02,12.77,13.43,,,,,,,,,,,,,,,,,"0,1,5,27,39,21,5,0,0",,,,,,,128,,,,,,,,,,,,,,,,,,,,,,,,,,,,,,,,,,,,,25,15,160,49,,1009,,,0,5,3,,1,0,,,,,"Aachen Laufen",,"Polar BEAT",,0,,0,168070,250480,30378,,,,,,,,,,,,,,,,,,,,,,,,,,,,,,,,,,,,,,,,,,4,
5962209,1a280c1b-965b-4383-a40c-4ceb02115995,1520327044,60,1548677436,,0,0,10.84,1714,1718,49,62,,,1,0,0.11,,,,387,148,166,,,,,,,1,,,,,,,,,,,,,,42,,,24.33,,10.4,-16.2,121,102,,1,141,127,,,,,,,,,"9,12,23,57,0,0,0","0,21,67,12,0","86,4,0,0,10",,,,,,,,,,,,,,,,,,,,,,,,,,,,,,,,,,,,,,,,,42.7,2,0,79,84,,,1,,0,3,3,,1,0,,,Cycling,,,,"Polar M430",43,0,,0,168072,,30378,,,,,,,,,,,,,,,,,,,,,,,,,,,,,,,,,,,,,,,,,,,
5962210,c1566b24-480f-48d3-b2ba-0a20d770c3cd,1416942485,60,1548677436,,0,0,3.16,998,1103,20,24,,,1,0.2,0.32,,,,210,,,,,,,35,,1,,,,,,,,,,,,,,20,81,11.45,11.85,11.9,,,,,,,,,,,,,,,,,"11,1,12,26,39,11,0,0,0",,,,,,,117,,,,,,,,,,,,,,,,,,,,,,,,,,,,,,,,,,,,,4,14,99,83,,1020,,,1,5,3,,1,0,,,,,Einlaufen,,"Polar BEAT",,0,,0,168070,250480,30378,,,,,,,,,,,,,,,,,,,,,,,,,,,,,,,,,,,,,,,,,,,
5962212,2491280b-45e5-4458-b894-78393b809b1a,1521660444,60,1548677436,,0,0,15.91,3025,3028,68,59,,,1,0,0.11,2.36,,,572,132,152,,,,,,,1,,,,,,,,,,,,,,47,,,19.91,,-0.8,-58.4,96,73,,1,118,100,,,,,,,,,"13,33,51,4,0,0,0","0,84,16,0,0","82,1,15,0,2",,,,,,,,,,,,,,,,,,,,,,,,,,,,,,,,,,,,,,,,,21.8,3,0,23,46,,,0,,1,3,3,,1,0,,,Cycling,,,,"Polar M430",43,0,,0,168072,,30378,,,,,,,,,,,,,,,,,,,,,,,,,,,,,,,,,,,,,,,,,,,
5962213,cbb19af6-47a9-41ee-8e2b-236291703f4c,1428076994,120,1548677436,,0,0,4.84,1206,1206,68,70,,,1,1.5,0.58,,,328,327,,,,,,,47.57,,1,,,,,,,,,,,,,,25,85,14.68,14.65,14.94,,,,,,,,,,,,,,,,,"0,1,2,2,20,39,28,7,0",,,,,,,142,,,,,,,,,,,,,,,,,,,,,,,,,,,,,,,,,,,,,9,4,252,46,,1018,,,0,3,3,,1,0,,,,,"Balve Laufen",,"Polar BEAT",,0,,0,168070,250480,30378,,,,,,,,,,,,,,,,,,,,,,,,,,,,,,,,,,,,,,,,,,5,
5962214,5c851faf-2071-4ae4-ade1-ce0e9861da5a,1499898251,120,1548677437,,0,0,5.05,1272,1272,60,64,,,1,0.7,0.36,,,340,346,,,,,,,47.1,,1,,,,,,,,,,,,,,26,80,14.46,14.47,14.73,,,,,,,,,,,,,,,,,"0,2,2,3,17,39,36,1,0",,,,,,,149,,,,,,,,,,,,,,,,,,,,,,,,,,,,,,,,,,,,,27,19,299,48,,1016,0,,1,3,3,,1,0,,,,,"Aix-en-Provence Laufen",,"Polar BEAT",,0,,0,168070,250480,30378,,,,,,,,,,,,,,,,,,,,,,,,,,,,,,,,,,,,,,,,,,5,
5962215,b5580583-1532-4681-841d-ce81478d5b45,1530699769,120,1548677438,,0,0,20.39,6632,6634,568,569,,,1,5.2,0.72,1.12,1,535,1571,146,166,,,,53.41,38.48,55.25,1,,,,,,,,,,,,,,151,81,11.76,11.31,12.37,-0.1,,,,,,,,,,,,,,,,"11,14,20,25,24,5,0,0,0","0,26,72,2,0",,,,,,114,,,,,,,,,,,,,,,,,,,,,,,,,,,,,,,,,,,,39.1,25,4,341,41,,1014,,,0,5,3,,1,0,I10.817|59:20-I9.577|51:15,,Running,,,,"Polar M430",43,0,,0,168070,250480,30378,,,,,,,,,,,,,,,,,,,,,,,,,,,,,,,,,,,,,,,,,,"3,4,5",
5962216,1a440a22-e0c8-4b46-b205-690aadfb930b,1502532950,120,1548677438,,0,0,4.52,1410,1410,0,0,,,1,0,0,,,,288,138,149,,,,60.42,36.36,60.42,1,,,,,,,,,,,,,,26,80,11.54,11.58,11.6,0.8,,,,,,,,,,,,,,,,"3,1,14,55,26,0,0,0,0","1,61,37,0,0",,,,,,120,,,,,,,,,,,,,,,,,,,,,,,,,,,,,,,,,,,,19.4,15,15,207,97,,1011,,,0,6,3,,1,0,I1.000|5:19-I1.000|5:07-I1.000|5:09-I1.000|4:59-I0.526|2:56,,Running,,,,"Polar M430",43,0,,0,168070,250480,30378,,,,,,,,,,,,,,,,,,,,,,,,,,,,,,,,,,,,,,,,,,,
5962217,ca2f5afd-c66e-40fa-82af-12cd77a73495,1534838683,120,1548677438,,0,0,9.13,1359,1398,38,47,,,1,0,0.09,,0.76,,278,137,161,,,,,,,1,,,,,,,,,,,,,,25,,,25.35,,15.5,-7.1,125,108,,1,142,129,,,,,,,,,"6,3,33,47,10,0,0","0,60,40,0,0","76,13,0,0,10",,,,,,,,,,,,,,,,,,,,,,,,,,,,,,,,,,,,,,,,,25.4,17,5,70,88,,1020,,,0,3,3,,1,0,,,Cycling,,,,"Polar M430",43,0,,0,168072,,30378,,,,,,,,,,,,,,,,,,,,,,,,,,,,,,,,,,,,,,,,,,,
5962218,e8749f47-178c-482d-ab44-630ff34a6ec2,1455559658,60,1548677439,,0,0,11.54,3728,3729,248,252,,,1,3,0.53,,,822,790,,,,,,,37.08,,1,,,,,,,,,,,,,,77,80,11.5,13.1,13.74,,,,,,,,,,,,,,,,,"22,1,2,8,16,31,19,0,0",,,,,,,116,,,,,,,,,,,,,,,,,,,,,,,,,,,,,,,,,,,,,1,10,4,75,,1024,,,1,5,3,,1,0,,,,,"Aachen Laufen",,"Polar BEAT",,0,,0,168070,250480,30378,,,,,,,,,,,,,,,,,,,,,,,,,,,,,,,,,,,,,,,,,,4,
5962219,4d91e2f2-18d8-4b46-a939-4097f4e0a646,1421782849,60,1548677439,,0,0,8.6,2132,2132,93,86,,,1,1,0.45,,,,562,,,,,,,49.53,,1,,,,,,,,,,,,,,44,87,14.52,14.95,15.45,,,,,,,,,,,,,,,,,"1,1,6,16,19,7,29,20,1",,,,,,,139,,,,,,,,,,,,,,,,,,,,,,,,,,,,,,,,,,,,,-1,4,144,80,,1014,,,1,5,3,,1,0,,,,,"5x Sprintrunden - Erste Runde fehlt hier",,"Polar BEAT",,0,,0,168070,250480,30378,,,,,,,,,,,,,,,,,,,,,,,,,,,,,,,,,,,,,,,,,,,
5962220,fc6c723e-52ac-4f3b-bb7f-b21d4016af7a,1465730802,120,1548677440,,0,0,30.01,9365,9396,456,457,,,1,3.6,0.55,,,505,2076,,,,,,,41.52,,1,,,,,,,,,,,,,,194,81,11.86,11.96,12.33,,,,,,,,,,,,,,,,,"8,4,13,26,37,11,1,0,0",,,,,,,119,,,,,,,,,,,,,,,,,,,,,,,,,,,,,,,,,,,,,17,3,254,88,,1010,5,,0,5,3,,1,0,,,,,"Aachen Laufen",,"Polar BEAT",,0,,0,168070,250480,30378,,,,,,,,,,,,,,,,,,,,,,,,,,,,,,,,,,,,,,,,,,"4,4,5,5",
5962221,414aa573-f5bd-480a-bba3-14cfe1b28d29,1494768125,120,1548677441,,0,0,10.79,3206,3503,201,181,,,1,2.2,0.49,,,468,756,,,,,,,40.69,,1,,,,,,,,,,,,,,66,81,12.67,12.39,12.98,,,,,,,,,,,,,,,,,"7,2,9,22,32,27,0,0,0",,,,,,,125,,,,,,,,,,,,,,,,,,,,,,,,,,,,,,,,,,,,,19,19,242,50,,1021,,,0,5,3,,1,0,,,,,"Aachen Laufen",,"Polar BEAT",,0,,0,168070,250480,30378,,,,,,,,,,,,,,,,,,,,,,,,,,,,,,,,,,,,,,,,,,"4,5",
5962222,70525a5e-0726-494c-b377-e926dbaad621,1432156692,120,1548677441,,0,0,10.23,2026,2026,125,125,,,1,1.1,0.56,,,,683,,,,,,,65.15,,1,,,,,,,,,,,,,,42,88,18.4,18.29,18.49,,,,,,,,,,,,,,,,,"0,0,0,0,0,1,27,57,14",,,,,,,172,,,,,,,,,,,,,,,,,,,,,,,,,,,,,,,,,,,,,9,10,267,70,,,,,1,3,3,,1,0,,,,,"Dortmund Laufen",,"Polar BEAT",,0,,0,168070,250480,30378,,,,,,,,,,,,,,,,,,,,,,,,,,,,,,,,,,,,,,,,,,,
5962223,44143196-b7e3-45f9-ab22-78fe4b0658a6,1414528219,60,1548677442,,0,0,2.25,791,792,26,20,,,1,1.2,0.64,,,,148,,,,,,,30.03,,1,,,,,,,,,,,,,,16,82,10.46,10.44,10.75,,,,,,,,,,,,,,,,,"13,20,32,35,0,0,0,0,0",,,,,,,104,,,,,,,,,,,,,,,,,,,,,,,,,,,,,,,,,,,,,6,6,185,90,,1017,0,,1,5,3,,1,0,,,,,Auslaufen,,"Polar BEAT",,0,,0,168070,250480,30378,,,,,,,,,,,,,,,,,,,,,,,,,,,,,,,,,,,,,,,,,,,
5962224,,1546452480,60,1548677442,,0,0,7,2100,2100,,,,,0,,,,,,292,,,,,,,,,1,,,,,,,,,,,,,,23,,,,,,,,,,,,,,,,,,,,,,,,,,,,,,,,,,,,,,,,,,,,,,,,,,,,,,,,,,,,,,,,,,,,,,,,,,1,,,0,0,,,,,,,"no device name available",,0,,0,168075,,30378,,,,,,,,,,,,,,,,,,,,,,,,,,,,,,,,,,,,,,,,,,,
5962225,,1464045780,120,1548677442,,0,0,,0,0,,,,,0,,,,,,377,,,,,,,,,1,,,,,,,,,,,,,,0,,,,,,,,,,,,,,,,,,,,,,,,,,,,,,,,,,,,,,,,,,,,,,,,,,,,,,,,,,,,,,,,,,,,,,,,,,1,,,0,0,,,,,Gym,,"Polar BEAT",,0,,0,168075,,30378,,,,,,,,,,,,,,,,,,,,,,,,,,,,,,,,,,,,,,,,,,,
5962226,fb195064-5444-4a15-8b9c-cc898acc1866,1496955108,120,1548677442,,0,0,0.12,36,37,6,0,,,1,1.2,1,,,,6,,,,,,,28.71,,1,,,,,,,,,,,,,,0,97,13.41,13.74,15.73,,,,,,,,,,,,,,,,,"22,6,6,11,8,14,14,19,0",,,,,,,103,,,,,,,,,,,,,,,,,,,,,,,,,,,,,,,,,,,,,22,7,228,57,,1013,0,,0,5,3,,1,0,,,,,"Aachen Laufen",,"Polar BEAT",,0,,0,168070,250480,30378,,,,,,,,,,,,,,,,,,,,,,,,,,,,,,,,,,,,,,,,,,,
5962227,6653408f-93d9-4f4e-9940-2ca31c2cc91f,1368652505,120,1548677442,,0,0,9.95,2151,2151,106,106,,,1,1.1,0.51,,,,684,,,,,,,58.68,,1,,,,,,,,,,,,,,44,,16.83,16.75,16.9,,,,,,,,,,,,,,,,,"0,0,0,0,0,14,48,38,0",,,,,,,,,,,,,,,,,,,,,,,,,,,,,,,,,,,,,,,,,,,,14,1,233,75,,,0,,1,3,3,,1,0,,,,,,,"Polar BEAT",,0,,0,168070,250480,30378,,,,,,,,,,,,,,,,,,,,,,,,,,,,,,,,,,,,,,,,,,,
5962228,f2a28df5-b538-458d-95fd-43e02f853516,1451314468,60,1548677442,,0,0,1.62,503,541,12,17,,,1,0.8,0.5,,,,110,,,,,,,33.52,,1,,,,,,,,,,,,,,10,81,11.59,11.67,11.67,,,,,,,,,,,,,,,,,"5,6,16,30,43,0,0,0,0",,,,,,,119,,,,,,,,,,,,,,,,,,,,,,,,,,,,,,,,,,,,,11,15,125,64,,1025,,,0,3,3,,1,0,,,,,"Balve Laufen",,"Polar BEAT",,0,,0,168070,250480,30378,,,,,,,,,,,,,,,,,,,,,,,,,,,,,,,,,,,,,,,,,,,
5962229,595409b9-0732-41c2-bf9f-38f86b06abb1,1445799223,60,1548677443,,0,0,12.73,3919,4190,135,136,,,1,0.6,0.38,,,211,878,,,,,,,39.53,,1,,,,,,,,,,,,,,81,83,11.85,12.15,12.36,,,,,,,,,,,,,,,,,"7,1,5,30,43,13,0,0,0",,,,,,,117,,,,,,,,,,,,,,,,,,,,,,,,,,,,,,,,,,,,,10,4,80,93,,1026,,,1,5,3,,1,0,,,,,"Aachen Laufen",,"Polar BEAT",,0,,0,168070,250480,30378,,,,,,,,,,,,,,,,,,,,,,,,,,,,,,,,,,,,,,,,,,5,
5962230,a9639371-e11a-490c-b3af-af44ca59373d,1409931935,120,1548677443,,0,0,4.59,1308,1308,47,32,,,1,0.1,0.25,,,,312,,,,,,,40.5,,1,,,,,,,,,,,,,,27,82,12.88,12.76,12.99,,,,,,,,,,,,,,,,,"2,1,6,25,35,31,1,0,0",,,,,,,128,,,,,,,,,,,,,,,,,,,,,,,,,,,,,,,,,,,,,23,2,243,62,,1014,3,,0,5,3,,1,0,,,,,"Einlaufen + Lauf ABC ",,"Polar BEAT",,0,,0,168070,250480,30378,,,,,,,,,,,,,,,,,,,,,,,,,,,,,,,,,,,,,,,,,,,
5962231,cf44ab6b-9dc8-478a-82d6-5d53314ca138,1438893636,120,1548677445,,0,0,6.35,1978,1984,0,2,,,1,0,0.01,,,,381,,,,,,,37.16,,1,,,,,,,,,,,,,,41,74,11.79,13.58,13.6,,,,,,,,,,,,,,,,,"44,2,2,3,3,4,6,35,1",,,,,,,130,,,,,,,,,,,,,,,,,,,,,,,,,,,,,,,,,,,,,24,6,292,49,,1015,,,0,3,3,,1,0,,,,,"Aachen Laufen",,"Polar BEAT",,0,,0,168070,250480,30378,,,,,,,,,,,,,,,,,,,,,,,,,,,,,,,,,,,,,,,,,,,
5962232,ee33963e-2f06-4569-a08f-29bf24de9535,1534786654,120,1548677445,,0,0,6.22,1958,1959,24,24,,,1,0,0.03,1.17,0.93,,441,142,155,,,,57.64,36.65,57.92,1,,,,,,,,,,,,,,39,81,11.49,11.48,11.59,3.4,,,,,,,,,,,,,,,,"1,3,22,51,23,1,0,0,0","1,17,82,0,0",,,,,,118,,,,,,,,,,,,,,,,,,,,,,,,,,,,,,,,,,,,23.6,28,10,334,44,,1018,,,0,5,3,,1,0,I1.000|5:14-I1.000|5:18-I1.000|5:13-I1.000|5:05-I1.000|5:10-I1.000|5:25-I0.230|1:14,,Running,,,,"Polar M430",43,0,,0,168070,250480,30378,,,,,,,,,,,,,,,,,,,,,,,,,,,,,,,,,,,,,,,,,,,
5962233,b7eed527-081f-47a6-a7db-8229b251132e,1543161006,60,1548677446,,0,0,13.56,3933,3936,65,65,,,1,0,0.09,1.11,0.9,,930,146,168,,,,61.52,42.58,61.89,1,,,,,,,,,,,,,,93,82,12.44,13,13.1,14.7,,,,,,,,,,,,,,,,"5,13,24,9,8,22,19,0,0","1,37,36,27,0",,,,,,126,,,,,,,,,,,,,,,,,,,,,,,,,,,,,,,,,,,,56.6,9,19,21,74,,1008,0,326,0,4,3,,1,0,I1.000|5:10-I1.000|5:14-I1.000|3:59-I1.000|4:01-I1.000|4:03-I1.000|4:07-I1.000|4:03-I1.000|4:14-I1.000|5:33-I1.000|3:49-I1.000|5:52-I1.000|6:05-I1.000|6:03-I0.561|3:24,,Running,,,,"Polar M430",43,0,,0,168070,250480,30378,,,,,,,,,,,,,,,,,,,,,,,,,,,,,,,,,,,,,,,,,,,
5962234,73eaa0bc-8658-4123-8c44-fdcd71fa46b6,1412942022,120,1548677447,,0,0,11.31,3262,3503,131,131,,,1,1.7,0.46,1.02,1.03,,508,138,159,,,,66.58,42.27,67.53,1,,,,,,,,,,,,,,60,82,12.72,12.61,12.86,-0.6,,,,,,,,,,,,,,,,"4,3,4,15,52,20,1,0,0","1,56,43,0,0",,,,,,127,,,,,,,,,,,,,,,,,,,,,,,,,,,,,,,,,,,,23.9,15,7,224,81,,1015,2,,0,5,3,,1,0,,,,,"Langsamer DL",,"Polar BEAT",,0,,0,168070,250480,30378,,,,,,,,,,,,,,,,,,,,,,,,,,,,,,,,,,,,,,,,,,,
5962235,66e5eada-a1b8-4741-8793-5a1484bfb7d6,1474577876,120,1548677447,,0,0,4.48,1589,1589,72,153,,,1,2,0.78,,,493,301,,,,,,,31.18,,1,,,,,,,,,,,,,,33,79,10.24,10.38,10.69,,,,,,,,,,,,,,,,,"24,12,25,32,7,0,0,0,0",,,,,,,107,,,,,,,,,,,,,,,,,,,,,,,,,,,,,,,,,,,,,14,1,189,81,,1022,0,,1,5,3,,1,0,,,,,"Aachen Laufen",,"Polar BEAT",,0,,0,168070,250480,30378,,,,,,,,,,,,,,,,,,,,,,,,,,,,,,,,,,,,,,,,,,4,
5962236,fc0167f8-ae00-4d1a-8e1e-546837224610,1500817826,120,1548677448,,0,0,21.74,6819,7835,369,373,,,1,3.1,0.59,,,521,1492,,,,,,,40.35,,1,,,,,,,,,,,,,,141,80,11.78,11.9,12.42,,,,,,,,,,,,,,,,,"9,6,11,27,34,14,0,0,0",,,,,,,120,,,,,,,,,,,,,,,,,,,,,,,,,,,,,,,,,,,,,18,12,224,68,,1015,5,,0,5,3,,1,0,,,,,"Aachen Laufen",,"Polar BEAT",,0,,0,168070,250480,30378,,,,,,,,,,,,,,,,,,,,,,,,,,,,,,,,,,,,,,,,,,"4,4",
5962237,a756c5aa-7048-423e-92cd-1441d3e8ce56,1479923568,60,1548677448,,0,0,0.72,229,229,10,12,,,1,1.3,0.84,,,,52,,,,,,,29.8,,1,,,,,,,,,,,,,,4,79,11.38,11.92,12.28,,,,,,,,,,,,,,,,,"14,8,33,18,6,9,11,1,0",,,,,,,119,,,,,,,,,,,,,,,,,,,,,,,,,,,,,,,,,,,,,11,3,73,88,,1017,0,,1,5,3,,1,0,,,,,"Aachen Laufen",,"Polar BEAT",,0,,0,168070,250480,30378,,,,,,,,,,,,,,,,,,,,,,,,,,,,,,,,,,,,,,,,,,,
5962238,b54b1406-3f79-470b-a8a2-090d2a50ebb6,1345206075,120,1548677450,,0,0,60.65,7882,8156,1571,1570,,,1,4.8,0.51,,,1040,2262,,,,,,,,,1,,,,,,,,,,,,,,88,,,35,,,,445,292,,1,633,479,,,,,,,,,"18,12,17,12,14,7,20",,"51,12,8,5,24",,,,,,,,,,,,,,,,,,,,,,,,,,,,,,,,,,,,,,,,,,25,9,203,48,,1020,5,,0,5,3,,1,0,,,,,,,"Polar BEAT",,0,,0,168072,,30378,,,,,,,,,,,,,,,,,,,,,,,,,,,,,,,,,,,,,,,,,,"4,4,4,4,4,4,4,4,5,5,5,5",
5962239,95c20710-1e2e-4d44-8c37-b64e05c4d8e6,1516044923,60,1548677451,,0,0,11.12,2094,2210,45,37,,,1,0,0.07,,,,264,104,128,,,,,,,1,,,,,,,,,,,,,,14,,,19.53,,-2.7,-42.8,82,70,,1,99,89,,,,,,,,,"5,55,39,1,0,0,0","31,69,0,0,0","87,0,11,1,1",,,,,,,,,,,,,,,,,,,,,,,,,,,,,,,,,,,,,,,,,4.2,6,8,194,84,,,0,,1,6,3,,1,0,,,Cycling,,,,"Polar M430",43,0,,0,168072,,30378,,,,,,,,,,,,,,,,,,,,,,,,,,,,,,,,,,,,,,,,,,,
5962240,18ffa36f-16e6-4ecf-ae6c-b93893650815,1460666394,120,1548677451,,0,0,3.42,942,942,0,2,,,1,0,0,,,,189,,,,,,,41.3,,1,,,,,,,,,,,,,,19,80,13.05,15.12,15.13,,,,,,,,,,,,,,,,,"28,3,2,5,6,8,10,32,7",,,,,,,136,,,,,,,,,,,,,,,,,,,,,,,,,,,,,,,,,,,,,11,2,141,77,,1011,0,,1,5,3,,1,0,,,,,"Aachen Laufen",,"Polar BEAT",,0,,0,168070,250480,30378,,,,,,,,,,,,,,,,,,,,,,,,,,,,,,,,,,,,,,,,,,,
5962241,596db3dd-7648-44b7-9f4a-2d3db6de0e63,1407784755,120,1548677452,,0,0,24,7191,7525,403,403,,,1,3.1,0.56,1.04,1.02,472,951,135,158,,,,65.25,42.89,66.61,1,,,,,,,,,,,,,,124,81,12.33,12.33,12.74,2.9,,,,,,,,,,,,,,,,"8,7,13,19,29,19,4,1,0","0,69,31,0,0",,,,,,124,,,,,,,,,,,,,,,,,,,,,,,,,,,,,,,,,,,,30,15,5,238,83,,1013,0,,0,6,3,,1,0,,,,,"Langsamer Langer DL",,"Polar BEAT",,0,,0,168070,250480,30378,,,,,,,,,,,,,,,,,,,,,,,,,,,,,,,,,,,,,,,,,,"4,5,5",
5962242,2868ad11-f986-485b-8194-93bcf3558da4,1475927457,120,1548677452,,0,0,2.48,696,696,3,32,,,1,0,0.19,,,,173,,,,,,,39.31,,1,,,,,,,,,,,,,,14,81,12.5,13.04,12.61,,,,,,,,,,,,,,,,,"3,0,2,16,39,40,0,0,0",,,,,,,132,,,,,,,,,,,,,,,,,,,,,,,,,,,,,,,,,,,,,11,7,42,76,,1023,2,,0,5,3,,1,0,,,,,"Aachen Laufen",,"Polar BEAT",,0,,0,168070,250480,30378,,,,,,,,,,,,,,,,,,,,,,,,,,,,,,,,,,,,,,,,,,,
5962243,9d537f11-0798-425e-961f-870304009f87,1463001273,120,1548677453,,0,0,10.14,2151,2151,124,124,,,1,0.9,0.46,,,,702,,,,,,,60.07,,1,,,,,,,,,,,,,,44,86,17.11,17.06,17.27,,,,,,,,,,,,,,,,,"0,0,0,0,0,8,46,43,3",,,,,,,164,,,,,,,,,,,,,,,,,,,,,,,,,,,,,,,,,,,,,21,6,75,51,,,0,,1,3,3,,1,0,,,,,"Dortmund Laufen",,"Polar BEAT",,0,,0,168070,250480,30378,,,,,,,,,,,,,,,,,,,,,,,,,,,,,,,,,,,,,,,,,,,
5962244,eb1a58aa-c857-442f-ab75-64124123aa65,1401710649,120,1548677453,,0,0,3.11,901,910,32,41,,,1,1,0.58,,,,203,,,,,,,38.66,,1,,,,,,,,,,,,,,18,84,12.55,12.54,12.71,,,,,,,,,,,,,,,,,"2,2,8,21,37,30,0,0,0",,,,,,,123,,,,,,,,,,,,,,,,,,,,,,,,,,,,,,,,,,,,,18,1,323,48,,1019,6,,0,5,3,,1,0,,,,,Auslaufen,,"Polar BEAT",,0,,0,168070,250480,30378,,,,,,,,,,,,,,,,,,,,,,,,,,,,,,,,,,,,,,,,,,,
5962245,433bb064-9c1d-4703-a7e3-01239f3fea5f,1521620604,60,1548677453,,0,0,11.05,1881,1881,33,46,,,1,0,0.09,,0.51,,387,144,170,,,,,,,1,,,,,,,,,,,,,,40,,,22.47,,13.4,-4.7,101,86,,1,117,107,,,,,,,,,"7,16,67,11,0,0,0","0,32,61,7,0","89,2,0,1,9",,,,,,,,,,,,,,,,,,,,,,,,,,,,,,,,,,,,,,,,,35.7,0,2,31,80,,,1,,0,3,3,,1,0,,,Cycling,,,,"Polar M430",43,0,,0,168072,,30378,,,,,,,,,,,,,,,,,,,,,,,,,,,,,,,,,,,,,,,,,,,
5962246,09bca8c8-df0e-4d12-8ba7-92feec1eaa5a,1494681080,120,1548677454,,0,0,3.3,964,964,61,60,,,1,1.6,0.63,,,421,224,,,,,,,38.46,,1,,,,,,,,,,,,,,20,79,12.74,12.46,13.15,,,,,,,,,,,,,,,,,"3,4,14,17,41,14,7,0,0",,,,,,,130,,,,,,,,,,,,,,,,,,,,,,,,,,,,,,,,,,,,,19,11,228,61,,1011,6,,0,5,3,,1,0,,,,,"Aachen Laufen",,"Polar BEAT",,0,,0,168070,250480,30378,,,,,,,,,,,,,,,,,,,,,,,,,,,,,,,,,,,,,,,,,,5,
5962247,55b83b4c-9bc8-48a4-b6bf-3bcf56ce11b9,1398516414,120,1548677454,,0,0,4.54,1422,1493,65,30,,,1,0.7,0.4,1.05,1,,265,145,161,,,,56.46,36.19,58,1,,,,,,,,,,,,,,31,80,11.86,12.09,12.58,4.9,,,,,,,,,,,,,,,,"14,8,13,30,24,4,4,2,2","0,19,81,0,0",,,,,,120,,,,,,,,,,,,,,,,,,,,,,,,,,,,,,,,,,,,28.3,16,10,189,53,,1011,,,0,5,3,,1,0,,,,,"Einlaufen + Lauf ABC ",,"Polar BEAT",,0,,0,168070,250480,30378,,,,,,,,,,,,,,,,,,,,,,,,,,,,,,,,,,,,,,,,,,,
5962248,f5e78c82-2c03-4d0d-8d13-f1264db40cc0,1440326831,120,1548677454,,0,0,14.58,4130,4393,78,72,,,1,0,0.11,,,,1002,,,,,,,44.01,,1,,,,,,,,,,,,,,85,83,12.76,12.82,12.96,,,,,,,,,,,,,,,,,"3,1,2,11,52,29,1,0,0",,,,,,,128,,,,,,,,,,,,,,,,,,,,,,,,,,,,,,,,,,,,,22,23,121,45,,1006,,,0,3,3,,1,0,,,,,"Aachen Laufen",,"Polar BEAT",,0,,0,168070,250480,30378,,,,,,,,,,,,,,,,,,,,,,,,,,,,,,,,,,,,,,,,,,,
5962249,60b1ff1d-0dbe-4d81-8e8e-87b10abc5cf2,1400186211,120,1548677455,,0,0,3.63,1241,1389,0,2,,,1,0,0,,,,180,,,,,,,32.17,,1,,,,,,,,,,,,,,25,74,10.7,13.67,13.77,,,,,,,,,,,,,,,,,"49,1,4,3,3,6,7,9,17",,,,,,,119,,,,,,,,,,,,,,,,,,,,,,,,,,,,,,,,,,,,,9,5,2,77,,1036,,,0,5,3,,1,0,,,,,"Kurze Schnelle Intervalle",,"Polar BEAT",,0,,0,168070,250480,30378,,,,,,,,,,,,,,,,,,,,,,,,,,,,,,,,,,,,,,,,,,,
5962250,f3920d73-40ef-4a90-91b1-1d9fce1d1f25,1499982226,120,1548677455,,0,0,2.66,801,801,50,54,,,1,1.4,0.62,,,381,183,,,,,,,36.49,,1,,,,,,,,,,,,,,16,78,12.35,12.14,12.5,,,,,,,,,,,,,,,,,"3,11,10,29,23,24,0,0,0",,,,,,,128,,,,,,,,,,,,,,,,,,,,,,,,,,,,,,,,,,,,,26,19,299,42,,1013,0,,1,5,3,,1,0,,,,,"Aix-en-Provence Laufen",,"Polar BEAT",,0,,0,168070,250480,30378,,,,,,,,,,,,,,,,,,,,,,,,,,,,,,,,,,,,,,,,,,5,
5962251,67c889bc-ae88-45c5-929a-6e3559d186e7,1415454093,60,1548677455,,0,0,3.2,959,959,28,60,,,1,0.8,0.56,,,,215,,,,,,,37.25,,1,,,,,,,,,,,,,,19,83,11.93,12.09,12.05,,,,,,,,,,,,,,,,,"3,2,3,36,56,0,0,0,0",,,,,,,121,,,,,,,,,,,,,,,,,,,,,,,,,,,,,,,,,,,,,12,11,190,72,,1011,1,,0,3,3,,1,0,,,,,Auslaufen,,"Polar BEAT",,0,,0,168070,250480,30378,,,,,,,,,,,,,,,,,,,,,,,,,,,,,,,,,,,,,,,,,,,
5962252,cdb84881-f7c0-4a9f-920b-4bfe82966a83,1415301117,60,1548677455,,0,0,2.56,789,831,72,60,,,1,2.2,0.84,,,311,171,,,,,,,35.4,,1,,,,,,,,,,,,,,16,82,12.61,11.81,13.27,,,,,,,,,,,,,,,,,"1,6,24,26,43,0,0,0,0",,,,,,,119,,,,,,,,,,,,,,,,,,,,,,,,,,,,,,,,,,,,,6,6,188,88,,1013,0,,1,3,3,,1,0,,,,,Einlaufen,,"Polar BEAT",,0,,0,168070,250480,30378,,,,,,,,,,,,,,,,,,,,,,,,,,,,,,,,,,,,,,,,,,4,
5962253,25e6a311-2cc4-4c18-9dd0-aa71639ec529,1402051647,120,1548677456,,0,0,8.19,2691,2694,89,89,,,1,1.2,0.49,,,,554,,,,,,,35.45,,1,,,,,,,,,,,,,,55,80,11.1,11.64,11.9,,,,,,,,,,,,,,,,,"11,2,8,36,42,2,0,0,0",,,,,,,114,,,,,,,,,,,,,,,,,,,,,,,,,,,,,,,,,,,,,19,3,139,53,,1017,5,,0,5,3,,1,0,,,,,"Regenerativer DL",,"Polar BEAT",,0,,0,168070,250480,30378,,,,,,,,,,,,,,,,,,,,,,,,,,,,,,,,,,,,,,,,,,,
5962254,66ecb1e5-d3fc-4da6-8c0a-f993a60599ac,1414523585,60,1548677456,,0,0,2.27,766,766,25,32,,,1,0.8,0.53,,,,154,,,,,,,31.53,,1,,,,,,,,,,,,,,15,80,10.73,10.78,10.82,,,,,,,,,,,,,,,,,"5,25,35,26,7,2,0,0,0",,,,,,,111,,,,,,,,,,,,,,,,,,,,,,,,,,,,,,,,,,,,,7,7,194,88,,1018,0,,1,5,3,,1,0,,,,,Einlaufen,,"Polar BEAT",,0,,0,168070,250480,30378,,,,,,,,,,,,,,,,,,,,,,,,,,,,,,,,,,,,,,,,,,,
5962255,365dfcce-7e58-4540-942e-2006b7a1adea,1447700245,60,1548677457,,0,0,10,2338,2338,75,83,,,1,0.3,0.32,,,,669,,,,,,,53.56,,1,,,,,,,,,,,,,,48,84,15.47,15.49,15.59,,,,,,,,,,,,,,,,,"0,0,0,0,5,24,67,3,0",,,,,,,153,,,,,,,,,,,,,,,,,,,,,,,,,,,,,,,,,,,,,11,21,215,92,,1014,,,1,4,3,,1,0,,,,,"Aachen Laufen",,"Polar BEAT",,0,,0,168070,250480,30378,,,,,,,,,,,,,,,,,,,,,,,,,,,,,,,,,,,,,,,,,,,
5962256,6ff9af64-7917-41d2-9d66-5bf7895cfd83,1411153248,120,1548677459,,0,0,1.87,521,521,30,30,,,1,1.1,0.65,,,,124,,,,,,,38.5,,1,,,,,,,,,,,,,,10,78,13.11,13.06,13.41,,,,,,,,,,,,,,,,,"6,1,2,3,28,59,0,0,0",,,,,,,138,,,,,,,,,,,,,,,,,,,,,,,,,,,,,,,,,,,,,19,0,270,86,,,0,,0,5,3,,1,0,,,,,Einlaufen,,"Polar BEAT",,0,,0,168070,250480,30378,,,,,,,,,,,,,,,,,,,,,,,,,,,,,,,,,,,,,,,,,,,
5962257,,1464830100,120,1548677459,,0,0,,0,0,,,,,0,,,,,,377,,,,,,,,,1,,,,,,,,,,,,,,0,,,,,,,,,,,,,,,,,,,,,,,,,,,,,,,,,,,,,,,,,,,,,,,,,,,,,,,,,,,,,,,,,,,,,,,,,,1,,,0,0,,,,,Gym,,"Polar BEAT",,0,,0,168075,,30378,,,,,,,,,,,,,,,,,,,,,,,,,,,,,,,,,,,,,,,,,,,
5962258,0763144a-0820-4f24-9d09-d8ec0d18ad1e,1533575001,120,1548677459,,0,0,10.49,1403,1403,34,27,,,1,0,0.12,2.24,,,249,128,169,,,,,,,1,,,,,,,,,,,,,,25,,,30.07,,18.3,4.5,168,146,,1,213,188,,,,,,,,,"10,20,11,4,38,17,0","32,19,26,23,0","47,40,2,1,10",,,,,,,,,,,,,,,,,,,,,,,,,,,,,,,,,,,,,,,,,45.5,34,1,274,28,,,,,0,3,3,,1,0,,,Cycling,,,,"Polar M430",43,0,,0,168072,,30378,,,,,,,,,,,,,,,,,,,,,,,,,,,,,,,,,,,,,,,,,,,
5962259,4bfd8056-cb42-42e2-b500-088e374a1120,1484328382,60,1548677459,,0,0,0.71,221,221,15,8,,,1,1.2,0.71,,,,52,,,,,,,30.51,,1,,,,,,,,,,,,,,4,82,12.24,11.83,12.45,,,,,,,,,,,,,,,,,"7,9,26,19,15,24,0,0,0",,,,,,,118,,,,,,,,,,,,,,,,,,,,,,,,,,,,,,,,,,,,,1,22,229,89,,1005,,,1,5,3,,1,0,,,,,"Aachen Laufen",,"Polar BEAT",,0,,0,168070,250480,30378,,,,,,,,,,,,,,,,,,,,,,,,,,,,,,,,,,,,,,,,,,,
5962260,4e6eca93-577d-47ab-a4a5-4c4da097cf66,1521569360,60,1548677460,,0,0,15.23,3962,3963,58,59,,,1,0,0.04,,0.93,,1090,163,184,,,,60.4,48.74,60.68,1,,,,,,,,,,,,,,142,84,13.86,13.91,13.97,13.4,,,,,,,,,,,,,,,,"0,0,1,3,23,61,12,0,0","1,20,5,73,1",,,,,,137,,,,,,,,,,,,,,,,,,,,,,,,,,,,,,,,,,,,104.4,3,13,17,72,,1020,,,1,5,3,,1,0,I1.000|4:46-I1.000|4:34-I1.000|4:15-I1.000|4:27-I1.000|4:04-I1.000|4:18-I1.000|4:28-I1.000|4:12-I1.000|4:07-I1.000|4:11-I1.000|4:17-I1.000|4:15-I1.000|4:20-I1.000|4:24-I1.000|4:20-I0.230|1:07,,Running,,,,"Polar M430",43,0,,0,168070,250480,30378,,,,,,,,,,,,,,,,,,,,,,,,,,,,,,,,,,,,,,,,,,,
5962261,3df28f94-4966-4b3c-8def-0bb4c1a713e4,1464562666,120,1548677460,,0,0,7.88,2082,2198,136,138,,,1,2,0.46,,,343,543,,,,,,,45.72,,1,,,,,,,,,,,,,,43,81,13.98,13.93,14.38,,,,,,,,,,,,,,,,,"3,2,6,7,20,34,24,3,0",,,,,,,140,,,,,,,,,,,,,,,,,,,,,,,,,,,,,,,,,,,,,16,5,15,94,,1007,0,,1,5,3,,1,0,,,,,"Aachen Laufen",,"Polar BEAT",,0,,0,168070,250480,30378,,,,,,,,,,,,,,,,,,,,,,,,,,,,,,,,,,,,,,,,,,"4,5",
5962262,8f4a4c33-213c-463a-a830-beb31253ecc1,1393004279,60,1548677461,,0,0,12.52,3250,3559,180,169,,,1,1.1,0.4,1.03,0.93,240,664,157,178,,,,63.92,48.15,65.13,1,,,,,,,,,,,,,,98,84,14.25,14.4,14.87,-5,,,,,,,,,,,,,,,,"7,1,3,5,13,28,42,2,0","0,11,44,45,0",,,,,,138,,,,,,,,,,,,,,,,,,,,,,,,,,,,,,,,,,,,82.3,5,16,231,80,,1010,,,1,5,3,,1,0,,,,,"TDL mit Lauf ABC ",,"Polar BEAT",,0,,0,168070,250480,30378,,,,,,,,,,,,,,,,,,,,,,,,,,,,,,,,,,,,,,,,,,"5,5",
5962263,aec382e0-8eaf-41a5-9450-0c5a274a1f54,1447404072,60,1548677461,,0,0,9.56,3302,3363,190,190,,,1,2.6,0.53,,,390,654,,,,,,,33.79,,1,,,,,,,,,,,,,,68,81,10.82,10.64,11.16,,,,,,,,,,,,,,,,,"18,13,22,39,6,1,0,0,0",,,,,,,107,,,,,,,,,,,,,,,,,,,,,,,,,,,,,,,,,,,,,12,19,226,83,,1022,,,0,4,3,,1,0,,,,,"Aachen Laufen",,"Polar BEAT",,0,,0,168070,250480,30378,,,,,,,,,,,,,,,,,,,,,,,,,,,,,,,,,,,,,,,,,,"4,5,5",
5962264,ec9b1b23-57b8-4389-83fc-a6745305da65,1473274518,120,1548677461,,0,0,4.45,1471,1472,53,52,,,1,0.9,0.5,,,,303,,,,,,,33.9,,1,,,,,,,,,,,,,,30,80,11.1,11.09,11.25,,,,,,,,,,,,,,,,,"12,5,19,48,15,0,0,0,0",,,,,,,113,,,,,,,,,,,,,,,,,,,,,,,,,,,,,,,,,,,,,25,6,76,51,,1015,,,0,3,3,,1,0,,,,,"Aachen Laufen",,"Polar BEAT",,0,,0,168070,250480,30378,,,,,,,,,,,,,,,,,,,,,,,,,,,,,,,,,,,,,,,,,,,
5962265,ff6bc8e6-176d-4f16-a847-2deb0b5fef1c,1448712833,60,1548677462,,0,0,3.34,1029,1029,64,63,,,1,1.7,0.64,,,406,222,,,,,,,36.18,,1,,,,,,,,,,,,,,21,82,12.09,11.84,12.48,,,,,,,,,,,,,,,,,"1,7,26,27,27,11,1,0,0",,,,,,,119,,,,,,,,,,,,,,,,,,,,,,,,,,,,,,,,,,,,,5,19,256,80,,1016,,,0,5,3,,1,0,,,,,"Aachen Laufen",,"Polar BEAT",,0,,0,168070,250480,30378,,,,,,,,,,,,,,,,,,,,,,,,,,,,,,,,,,,,,,,,,,5,
5962266,95888549-33ac-445a-b48e-f0d305da19c5,1395948815,60,1548677462,,0,0,4.15,1096,1103,33,33,,,1,0,0.03,0.59,,,220,152,180,,,,65.45,43.99,66.1,1,,,,,,,,,,,,,,30,87,13.76,15.24,15.28,-0.2,,,,,,,,,,,,,,,,"26,6,7,4,4,6,8,21,17","0,23,32,45,0",,,,,,131,,,,,,,,,,,,,,,,,,,,,,,,,,,,,,,,,,,,50.8,10,4,101,54,,1012,0,,1,5,3,,1,0,,,,,"2x (500 200 500 200)",,"Polar BEAT",,0,,0,168070,250480,30378,,,,,,,,,,,,,,,,,,,,,,,,,,,,,,,,,,,,,,,,,,,
5962267,c640eec7-d8d8-47ed-9cd0-fe48f59a204b,1407495578,120,1548677463,,0,0,17.04,4402,4407,223,233,,,1,2,0.59,1.03,1.04,760,759,144,166,,,,72.3,49.58,73.42,1,,,,,,,,,,,,,,96,83,14.14,14.03,14.36,1.3,,,,,,,,,,,,,,,,"0,0,1,6,17,59,16,0,0","0,38,57,5,0",,,,,,140,,,,,,,,,,,,,,,,,,,,,,,,,,,,,,,,,,,,38.6,21,4,129,76,,1012,3,,0,5,3,,1,0,,,,,"Zügiger DL",,"Polar BEAT",,0,,0,168070,250480,30378,,,,,,,,,,,,,,,,,,,,,,,,,,,,,,,,,,,,,,,,,,4,
5962268,48b71c28-a852-4e51-9f20-7faf1435470e,1445114276,120,1548677463,,0,0,1.79,534,534,33,25,,,1,1.2,0.66,,,,125,,,,,,,35.46,,1,,,,,,,,,,,,,,11,82,12.52,12.07,12.73,,,,,,,,,,,,,,,,,"0,0,12,43,34,8,3,0,0",,,,,,,123,,,,,,,,,,,,,,,,,,,,,,,,,,,,,,,,,,,,,5,7,149,93,,1018,,,1,4,3,,1,0,,,,,"Simmerath Laufen",,"Polar BEAT",,0,,0,168070,250480,30378,,,,,,,,,,,,,,,,,,,,,,,,,,,,,,,,,,,,,,,,,,,
5962269,07efdc6b-8829-47c8-a18a-f0add72917dd,1395777580,60,1548677463,,0,0,0.43,75,75,0,1,,,1,0,0,,,,14,156,176,,,,,57.65,,1,,,,,,,,,,,,,,2,100,20.31,21.32,21.04,28.9,,,,,,,,,,,,,,,,"0,0,0,0,0,0,0,24,76","0,25,7,68,0",,,,,,172,,,,,,,,,,,,,,,,,,,,,,,,,,,,,,,,,,,,7.2,5,4,81,70,,1012,0,,1,5,3,,1,0,,,,,"1x 400m",,"Polar BEAT",,0,,0,168070,250480,30378,,,,,,,,,,,,,,,,,,,,,,,,,,,,,,,,,,,,,,,,,,,
5962270,ee203ab5-08c0-408e-9967-e5a09cbf0f7c,1517428831,60,1548677464,,0,0,11.13,2231,2340,47,40,,,1,0,0.07,,,,308,109,128,,,,,,,1,,,,,,,,,,,,,,18,,,19.87,,16.7,-37.2,86,67,,1,109,96,,,,,,,,,"13,35,49,4,0,0,0","12,88,0,0,0","88,0,7,3,1",,,,,,,,,,,,,,,,,,,,,,,,,,,,,,,,,,,,,,,,,6,7,11,217,88,,,0,,1,6,3,,1,0,,,Cycling,,,,"Polar M430",43,0,,0,168072,,30378,,,,,,,,,,,,,,,,,,,,,,,,,,,,,,,,,,,,,,,,,,,
5962271,8ead6aa5-4e9d-4f58-a2d8-555ad67492e9,1412855693,120,1548677464,,0,0,11.91,3744,3872,144,147,,,1,1.7,0.46,1.04,0.97,422,566,132,154,,,,63.17,38.37,64.09,1,,,,,,,,,,,,,,59,81,11.6,11.57,11.87,3.1,,,,,,,,,,,,,,,,"5,8,13,44,27,3,1,0,0","0,83,17,0,0",,,,,,118,,,,,,,,,,,,,,,,,,,,,,,,,,,,,,,,,,,,21.2,15,7,202,88,,1006,2,,0,5,3,,1,0,,,,,"Langsamer DL",,"Polar BEAT",,0,,0,168070,250480,30378,,,,,,,,,,,,,,,,,,,,,,,,,,,,,,,,,,,,,,,,,,"5,5",
5962272,f8d81998-3690-4ea5-80fe-dddc99de77dd,1471544293,120,1548677465,,0,0,4.9,1341,1341,20,18,,,1,0,0.21,,,,351,,,,,,,42.64,,1,,,,,,,,,,,,,,27,80,13.22,13.24,13.32,,,,,,,,,,,,,,,,,"0,0,0,12,51,31,5,1,0",,,,,,,137,,,,,,,,,,,,,,,,,,,,,,,,,,,,,,,,,,,,,21,5,261,73,,,,,0,3,3,,1,0,,,,,"Naujac-sur-Mer Laufen",,"Polar BEAT",,0,,0,168070,250480,30378,,,,,,,,,,,,,,,,,,,,,,,,,,,,,,,,,,,,,,,,,,,
5962273,dc080364-3a7a-49c7-818b-216d60460d29,1473356615,120,1548677465,,0,0,0.68,221,221,12,8,,,1,1.4,1,,,,52,,,,,,,28.91,,1,,,,,,,,,,,,,,4,82,11.58,11.23,11.55,,,,,,,,,,,,,,,,,"21,19,7,6,40,7,0,0,0",,,,,,,113,,,,,,,,,,,,,,,,,,,,,,,,,,,,,,,,,,,,,27,7,254,47,,1012,1,,0,3,3,,1,0,,,,,"Aachen Laufen",,"Polar BEAT",,0,,0,168070,250480,30378,,,,,,,,,,,,,,,,,,,,,,,,,,,,,,,,,,,,,,,,,,,
5962274,a582f9bc-21e0-4d4e-aa52-58897380b495,1446750618,60,1548677465,,0,0,3.33,993,993,60,60,,,1,1.5,0.61,,,431,224,,,,,,,37.58,,1,,,,,,,,,,,,,,20,80,12.42,12.17,12.97,,,,,,,,,,,,,,,,,"1,2,6,42,34,15,0,0,0",,,,,,,126,,,,,,,,,,,,,,,,,,,,,,,,,,,,,,,,,,,,,15,14,171,79,,1019,,,1,5,3,,1,0,,,,,"Aachen Laufen",,"Polar BEAT",,0,,0,168070,250480,30378,,,,,,,,,,,,,,,,,,,,,,,,,,,,,,,,,,,,,,,,,,5,
5962275,,1334406709,120,1548677465,,0,0,16.84,0,0,,,,,0,,,,,,1104,,,,,,,,,1,,,,,,,,,,,,,,0,,,,,,,,,,,,,,,,,,,,,,,,,,,,,,,,,,,,,,,,,,,,,,,,,,,,,,,,,,,,,,,,,,,,,,,,,,1,,,0,0,,,,,,,"Polar BEAT",,0,,0,168070,250480,30378,,,,,,,,,,,,,,,,,,,,,,,,,,,,,,,,,,,,,,,,,,,
5962276,1048c76d-c3f3-4c2b-8ccd-b97680c5ba56,1477843987,60,1548677466,,0,0,27.95,3693,3893,372,428,,,1,2.8,0.49,,,617,1036,,,,,,,,,1,,,,,,,,,,,,,,41,,,31.72,,,,214,164,,1,255,209,,,,,,,,,"9,19,18,15,14,14,12",,"51,11,18,7,13",,,,,,,,,,,,,,,,,,,,,,,,,,,,,,,,,,,,,,,,,,12,0,74,83,,1015,0,,0,5,3,,1,0,,,,,"Balve Radfahren",,"Polar BEAT",,0,,0,168072,,30378,,,,,,,,,,,,,,,,,,,,,,,,,,,,,,,,,,,,,,,,,,"4,5",
5962277,a6605aec-03c1-4605-b3bb-4a46777727b7,1413637932,120,1548677466,,0,0,3.35,997,997,85,81,,,1,2,0.76,,,529,220,,,,,,,37.68,,1,,,,,,,,,,,,,,20,82,12.65,12.28,13.56,,,,,,,,,,,,,,,,,"6,9,10,16,30,26,3,0,0",,,,,,,123,,,,,,,,,,,,,,,,,,,,,,,,,,,,,,,,,,,,,21,9,186,73,,1019,2,,0,3,3,,1,0,,,,,Einlaufen,,"Polar BEAT",,0,,0,168070,250480,30378,,,,,,,,,,,,,,,,,,,,,,,,,,,,,,,,,,,,,,,,,,4,
5962278,570cc641-2ad6-4dff-aba8-dec7fa5ce8db,1400498099,120,1548677467,,0,0,18.44,5326,5367,276,278,,,1,2.4,0.45,1.01,0.95,538,855,147,177,,,,61.29,43.85,62.42,1,,,,,,,,,,,,,,126,83,12.75,12.7,13.07,-2.4,,,,,,,,,,,,,,,,"5,5,10,19,35,18,8,1,0","0,26,64,10,0",,,,,,125,,,,,,,,,,,,,,,,,,,,,,,,,,,,,,,,,,,,48.9,21,5,134,51,,1007,6,,0,3,3,,1,0,,,,,"Regenerativer DL",,"Polar BEAT",,0,,0,168070,250480,30378,,,,,,,,,,,,,,,,,,,,,,,,,,,,,,,,,,,,,,,,,,"4,5",
5962279,10c0f3cf-5f96-4a66-a9b3-7c9e8388ee85,1461424859,120,1548677467,,0,0,3.88,1484,2030,68,70,,,1,1.7,0.53,,,229,259,,,,,,,28.23,,1,,,,,,,,,,,,,,30,80,9.7,10.92,11.46,,,,,,,,,,,,,,,,,"33,4,13,27,12,5,6,0,0",,,,,,,98,,,,,,,,,,,,,,,,,,,,,,,,,,,,,,,,,,,,,8,12,343,89,,1009,,,0,6,3,,1,0,,,,,"Bad Liebenzell Laufen",,"Polar BEAT",,0,,0,168070,250480,30378,,,,,,,,,,,,,,,,,,,,,,,,,,,,,,,,,,,,,,,,,,4,
5962280,c1df6280-9ac5-48da-b911-91f2fa3c2fbf,1408823525,120,1548677468,,0,0,2.91,904,904,24,49,,,1,0.6,0.48,,,,195,,,,,,,35.45,,1,,,,,,,,,,,,,,18,82,11.52,11.72,11.65,,,,,,,,,,,,,,,,,"6,5,17,36,26,9,1,0,0",,,,,,,118,,,,,,,,,,,,,,,,,,,,,,,,,,,,,,,,,,,,,13,4,244,85,,1015,0,,0,6,3,,1,0,,,,,Auslaufen,,"Polar BEAT",,0,,0,168070,250480,30378,,,,,,,,,,,,,,,,,,,,,,,,,,,,,,,,,,,,,,,,,,,
5962281,fe7f1223-fada-49e3-83cc-48d183ecc87c,1477512306,120,1548677469,,0,0,7.83,2821,2857,70,70,,,1,0,0.3,,,,533,,,,,,,31.68,,1,,,,,,,,,,,,,,58,78,10.13,10.13,10.28,,,,,,,,,,,,,,,,,"24,21,33,22,0,0,0,0,0",,,,,,,107,,,,,,,,,,,,,,,,,,,,,,,,,,,,,,,,,,,,,7,4,194,93,,1031,,,1,3,3,,1,0,,,,,"Aachen Laufen",,"Polar BEAT",,0,,0,168070,250480,30378,,,,,,,,,,,,,,,,,,,,,,,,,,,,,,,,,,,,,,,,,,,
5962282,f12ea630-4f23-4c03-9cca-ebd9ad473d0e,1534753208,120,1548677470,,0,0,8.5,2601,2604,32,33,,,1,0,0.09,1.11,0.93,,571,140,168,,,,60.77,38.65,61.05,1,,,,,,,,,,,,,,51,82,11.82,11.92,12.01,4.6,,,,,,,,,,,,,,,,"2,4,17,41,26,5,4,0,0","1,50,45,4,0",,,,,,120,,,,,,,,,,,,,,,,,,,,,,,,,,,,,,,,,,,,34,17,5,215,87,,,,,0,3,3,,1,0,I1.000|5:12-I1.000|5:06-I1.000|5:20-I1.000|5:03-I1.000|5:15-I1.000|5:29-I1.000|4:46-I1.000|4:47-I0.506|2:29,,Running,,,,"Polar M430",43,0,,0,168070,250480,30378,,,,,,,,,,,,,,,,,,,,,,,,,,,,,,,,,,,,,,,,,,,
5962283,6cb0f1c0-b775-451b-a5cb-771735e96754,1345067303,120,1548677471,,0,0,28.94,3591,4573,590,588,,,1,3.5,0.59,,,792,1042,,,,,,,,,1,,,,,,,,,,,,,,40,,,35.05,,,,411,293,,1,562,444,,,,,,,,,"14,8,18,14,14,10,23",,"51,7,10,5,28",,,,,,,,,,,,,,,,,,,,,,,,,,,,,,,,,,,,,,,,,,24,4,138,53,,1010,0,,1,4,3,,1,0,,,,,,,"Polar BEAT",,0,,0,168072,,30378,,,,,,,,,,,,,,,,,,,,,,,,,,,,,,,,,,,,,,,,,,"4,5,5",
5962284,5a4f149a-51c0-4fa5-b211-4fb95b4f9629,1428528650,120,1548677471,,0,0,6.08,1785,2063,83,84,,,1,1.8,0.63,,,426,414,,,,,,,39.75,,1,,,,,,,,,,,,,,37,82,12.36,12.43,12.56,,,,,,,,,,,,,,,,,"2,1,12,22,40,22,0,0,0",,,,,,,125,,,,,,,,,,,,,,,,,,,,,,,,,,,,,,,,,,,,,7,6,84,85,,1032,,,1,3,3,,1,0,,,,,"Aachen Laufen",,"Polar BEAT",,0,,0,168070,250480,30378,,,,,,,,,,,,,,,,,,,,,,,,,,,,,,,,,,,,,,,,,,5,
5962285,d3b5f57e-0b70-4a79-a41f-45430114daba,1449420883,60,1548677472,,0,0,4.82,1731,1790,90,88,,,1,1.4,0.5,,,,334,,,,,,,30.84,,1,,,,,,,,,,,,,,35,79,10.3,11.02,11.4,,,,,,,,,,,,,,,,,"21,6,11,33,27,1,0,0,0",,,,,,,106,,,,,,,,,,,,,,,,,,,,,,,,,,,,,,,,,,,,,10,23,210,80,,1025,,,1,5,3,,1,0,,,,,"Aachen Laufen",,"Polar BEAT",,0,,0,168070,250480,30378,,,,,,,,,,,,,,,,,,,,,,,,,,,,,,,,,,,,,,,,,,,
5962286,d824169a-51db-4ed3-bece-e6bc58e27a35,1393529565,60,1548677472,,0,0,3.92,900,900,48,47,,,1,1.2,0.64,2,1.92,,201,171,183,,,,65.6,51.53,66.61,1,,,,,,,,,,,,,,36,89,15.82,16.18,16.46,5.7,,,,,,,,,,,,,,,,"10,6,4,5,5,7,11,38,13","0,1,5,88,6",,,,,,147,,,,,,,,,,,,,,,,,,,,,,,,,,,,,,,,,,,,83,4,12,208,90,,1010,0,,1,5,3,,1,0,,,,,"4x Hoch Runter",,"Polar BEAT",,0,,0,168070,250480,30378,,,,,,,,,,,,,,,,,,,,,,,,,,,,,,,,,,,,,,,,,,,
5962287,9cdcb9d0-1a0e-48fd-aefd-3760ecbffc0c,1418383100,60,1548677472,,0,0,3.94,1129,1530,61,62,,,1,1.1,0.51,,,403,268,,,,,,,39.84,,1,,,,,,,,,,,,,,23,84,12.93,12.95,13.1,,,,,,,,,,,,,,,,,"5,4,12,14,22,34,9,0,0",,,,,,,125,,,,,,,,,,,,,,,,,,,,,,,,,,,,,,,,,,,,,8,22,217,89,,1001,0,,0,6,3,,1,0,,,,,"Einlaufen + Lauf ABC",,"Polar BEAT",,0,,0,168070,250480,30378,,,,,,,,,,,,,,,,,,,,,,,,,,,,,,,,,,,,,,,,,,5,
5962288,f078e26c-faa0-4a86-91b3-0c1647a12e90,1536397645,120,1548677473,,0,0,10.54,3261,3263,45,48,,,1,0,0.1,1.14,0.87,,677,134,159,,,,63.28,38.74,63.59,1,,,,,,,,,,,,,,57,81,11.66,11.68,11.78,23.5,,,,,,,,,,,,,,,,"0,1,16,55,26,2,0,0,0","2,43,55,0,0",,,,,,120,,,,,,,,,,,,,,,,,,,,,,,,,,,,,,,,,,,,32.9,13,,,86,,,,,0,3,3,,1,0,I1.000|5:08-I1.000|5:03-I1.000|4:54-I1.000|5:09-I1.000|4:58-I1.000|5:14-I1.000|5:18-I1.000|5:16-I1.000|5:20-I1.000|5:14-I0.543|2:53,,Running,,,,"Polar M430",43,0,,0,168070,250480,30378,,,,,,,,,,,,,,,,,,,,,,,,,,,,,,,,,,,,,,,,,,,
5962289,711ac0d8-9db6-4b33-8142-3ae4151d0f2f,1450965541,60,1548677473,,0,0,2.25,681,681,5,4,,,1,0,0,,,,152,,,,,,,35.72,,1,,,,,,,,,,,,,,14,82,11.9,11.91,11.96,,,,,,,,,,,,,,,,,"0,4,7,45,42,2,0,0,0",,,,,,,121,,,,,,,,,,,,,,,,,,,,,,,,,,,,,,,,,,,,,13,24,189,68,,1016,,,0,5,3,,1,0,,,,,"Menden Laufen",,"Polar BEAT",,0,,0,168070,250480,30378,,,,,,,,,,,,,,,,,,,,,,,,,,,,,,,,,,,,,,,,,,,
5962290,2f8e9d87-4d0f-4f23-856d-377f8ae0b484,1477928678,60,1548677474,,0,0,12.59,3332,3495,161,184,,,1,2.2,0.6,,,423,853,,,,,,,47.09,,1,,,,,,,,,,,,,,69,80,13.79,13.69,13.98,,,,,,,,,,,,,,,,,"0,1,1,5,28,56,8,0,0",,,,,,,142,,,,,,,,,,,,,,,,,,,,,,,,,,,,,,,,,,,,,15,3,45,73,,1026,0,,0,3,3,,1,0,,,,,"Aachen Laufen",,"Polar BEAT",,0,,0,168070,250480,30378,,,,,,,,,,,,,,,,,,,,,,,,,,,,,,,,,,,,,,,,,,4,
5962291,f1bfffba-8251-4c4e-8242-899c33cd21a0,1493474888,120,1548677474,,0,0,1.35,341,341,16,17,,,1,0,0.25,,,,91,,,,,,,41.42,,1,,,,,,,,,,,,,,7,86,14.19,14.51,14.64,,,,,,,,,,,,,,,,,"12,7,4,6,7,13,23,28,0",,,,,,,138,,,,,,,,,,,,,,,,,,,,,,,,,,,,,,,,,,,,,11,6,16,46,,1018,,,0,5,3,,1,0,,,,,"Aachen Laufen",,"Polar BEAT",,0,,0,168070,250480,30378,,,,,,,,,,,,,,,,,,,,,,,,,,,,,,,,,,,,,,,,,,,
5962292,c5814e29-8529-446c-a5a8-525a698d69e3,1469044970,120,1548677475,,0,0,16.21,4454,4601,266,269,,,1,2.4,0.47,,,450,1124,,,,,,,45.98,,1,,,,,,,,,,,,,,92,82,13.43,13.27,13.72,,,,,,,,,,,,,,,,,"3,2,4,11,33,39,8,0,0",,,,,,,133,,,,,,,,,,,,,,,,,,,,,,,,,,,,,,,,,,,,,28,4,213,52,,1012,0,,0,5,3,,1,0,,,,,"Aachen Laufen",,"Polar BEAT",,0,,0,168070,250480,30378,,,,,,,,,,,,,,,,,,,,,,,,,,,,,,,,,,,,,,,,,,"4,5",
5962293,f71674d1-c8ad-4bdf-8b6c-eac0d11a4a18,1425809168,60,1548677475,,0,0,12.87,3807,3832,168,167,,,1,1.8,0.52,,,277,888,,,,,,,41.45,,1,,,,,,,,,,,,,,79,83,12.36,12.24,12.54,,,,,,,,,,,,,,,,,"3,2,4,26,60,5,0,0,0",,,,,,,122,,,,,,,,,,,,,,,,,,,,,,,,,,,,,,,,,,,,,10,6,198,48,,1026,2,,0,5,3,,1,0,,,,,"Aachen Laufen",,"Polar BEAT",,0,,0,168070,250480,30378,,,,,,,,,,,,,,,,,,,,,,,,,,,,,,,,,,,,,,,,,,5,
5962294,813f8768-3564-4f5f-86d0-957aefa5eac2,1410204889,120,1548677476,,0,0,27.31,7617,7618,378,374,,,1,2.9,0.55,1.04,1.01,564,1186,147,166,,,,64,47.07,65.1,1,,,,,,,,,,,,,,177,82,13.17,13.03,13.43,2,,,,,,,,,,,,,,,,"1,1,6,13,39,35,4,0,0","0,25,70,4,0",,,,,,131,,,,,,,,,,,,,,,,,,,,,,,,,,,,,,,,,,,,45.3,18,3,0,75,,1019,0,,1,3,3,,1,0,,,,,"Lockerer Langer DL",,"Polar BEAT",,0,,0,168070,250480,30378,,,,,,,,,,,,,,,,,,,,,,,,,,,,,,,,,,,,,,,,,,"4,5",
5962295,088387ad-d386-4847-8728-bb4cbea6aa0f,1402917888,120,1548677477,,0,0,3.02,870,870,30,29,,,1,0.4,0.33,,,,208,,,,,,,38.82,,1,,,,,,,,,,,,,,18,82,12.67,12.65,12.77,,,,,,,,,,,,,,,,,"0,2,9,17,49,23,0,0,0",,,,,,,127,,,,,,,,,,,,,,,,,,,,,,,,,,,,,,,,,,,,,15,6,351,69,,1024,4,,0,5,3,,1,0,,,,,Einlaufen,,"Polar BEAT",,0,,0,168070,250480,30378,,,,,,,,,,,,,,,,,,,,,,,,,,,,,,,,,,,,,,,,,,,
5962296,14be3159-05bb-49d0-a9aa-1185e38ef0f6,1400583446,120,1548677477,,0,0,5.09,1454,1502,65,46,,,1,0.7,0.33,,,,337,,,,,,,40.64,,1,,,,,,,,,,,,,,30,82,12.91,12.73,13.1,,,,,,,,,,,,,,,,,"4,2,3,22,36,33,0,0,0",,,,,,,128,,,,,,,,,,,,,,,,,,,,,,,,,,,,,,,,,,,,,21,7,164,56,,1011,4,,0,5,3,,1,0,,,,,Einlaufen,,"Polar BEAT",,0,,0,168070,250480,30378,,,,,,,,,,,,,,,,,,,,,,,,,,,,,,,,,,,,,,,,,,,
5962297,e67683a9-20e9-4e58-8029-458d255d6c5b,1401224746,120,1548677478,,0,0,1.46,486,486,11,16,,,1,0,0.17,,,,95,,,,,,,30.61,,1,,,,,,,,,,,,,,10,81,10.72,11.05,11.04,,,,,,,,,,,,,,,,,"19,15,16,30,13,7,0,0,0",,,,,,,111,,,,,,,,,,,,,,,,,,,,,,,,,,,,,,,,,,,,,13,9,251,95,,1012,0,,0,4,3,,1,0,,,,,Auslaufen,,"Polar BEAT",,0,,0,168070,250480,30378,,,,,,,,,,,,,,,,,,,,,,,,,,,,,,,,,,,,,,,,,,,
5962298,3144696a-aafa-4463-b039-cc063728f412,1400856088,120,1548677478,,0,0,11.3,3666,3906,135,136,,,1,1.6,0.43,,,404,764,,,,,,,36.83,,1,,,,,,,,,,,,,,76,81,11.22,11.42,11.8,,,,,,,,,,,,,,,,,"10,7,14,44,17,8,0,0,0",,,,,,,114,,,,,,,,,,,,,,,,,,,,,,,,,,,,,,,,,,,,,18,6,184,67,,1011,6,,0,5,3,,1,0,,,,,"Regenerativer DL",,"Polar BEAT",,0,,0,168070,250480,30378,,,,,,,,,,,,,,,,,,,,,,,,,,,,,,,,,,,,,,,,,,"5,5",
5962299,814a343d-8d37-48e4-a28b-c8c41e60bfd4,1521882539,60,1548677479,,0,0,8.48,2631,2634,39,37,,,1,0,0.05,1.1,0.91,,649,153,171,,,,53.16,38.02,53.48,1,,,,,,,,,,,,,,70,82,11.65,11.65,11.73,5.9,,,,,,,,,,,,,,,,"2,2,15,56,24,2,0,0,0","0,10,68,22,0",,,,,,118,,,,,,,,,,,,,,,,,,,,,,,,,,,,,,,,,,,,54.5,4,4,68,87,,,1,,0,9,3,,1,0,I1.000|5:08-I1.000|5:09-I1.000|5:07-I1.000|5:16-I1.000|5:11-I1.000|5:16-I1.000|5:14-I1.000|5:07-I0.482|2:27,,Running,,,,"Polar M430",43,0,,0,168070,250480,30378,,,,,,,,,,,,,,,,,,,,,,,,,,,,,,,,,,,,,,,,,,,
5962300,f85b5b31-82d8-44a3-b03f-f37f94845426,1544464311,60,1548677479,,0,0,3.11,1065,1066,12,12,,,1,0,0.22,1.13,0.92,,208,131,157,,,,57.35,31.78,57.62,1,,,,,,,,,,,,,,16,79,10.57,10.6,10.72,-10,,,,,,,,,,,,,,,,"9,18,39,27,6,0,0,0,0","2,71,27,0,0",,,,,,111,,,,,,,,,,,,,,,,,,,,,,,,,,,,,,,,,,,,17.7,5,17,186,87,,1024,0,332,1,5,3,,1,0,I1.000|5:54-I1.000|5:30-I1.000|5:46-I0.115|0:38,,Running,,,,"Polar M430",43,0,,0,168070,250480,30378,,,,,,,,,,,,,,,,,,,,,,,,,,,,,,,,,,,,,,,,,,,
5962301,9dd15be6-866b-4e6b-9d51-6173abf7251b,1369509684,120,1548677480,,0,0,47.04,6032,6131,636,638,,,1,3,0.48,,,754,1667,,,,,,,,,1,,,,,,,,,,,,,,67,,,34.58,,,,326,243,,1,422,358,,,,,,,,,"18,14,15,12,12,8,21",,"45,16,11,7,22",,,,,,,,,,,,,,,,,,,,,,,,,,,,,,,,,,,,,,,,,,11,9,304,70,,1015,1,,0,5,3,,1,0,,,,,,,"Polar BEAT",,0,,0,168072,,30378,,,,,,,,,,,,,,,,,,,,,,,,,,,,,,,,,,,,,,,,,,"4,4,4",
5962302,64a09d4f-f2c8-44db-b899-9c8b2b5f0a2d,1468317014,120,1548677481,,0,0,0.7,231,231,4,2,,,1,0,0.13,,,,52,,,,,,,28.49,,1,,,,,,,,,,,,,,4,81,11.04,11.2,11.42,,,,,,,,,,,,,,,,,"10,17,30,25,9,9,0,0,0",,,,,,,112,,,,,,,,,,,,,,,,,,,,,,,,,,,,,,,,,,,,,18,9,247,68,,1014,3,,0,5,3,,1,0,,,,,"Aachen Laufen",,"Polar BEAT",,0,,0,168070,250480,30378,,,,,,,,,,,,,,,,,,,,,,,,,,,,,,,,,,,,,,,,,,,
5962303,dec56f18-6278-4adc-9c03-328887a611f1,1531328993,120,1548677481,,0,0,0.67,199,199,12,4,,,1,0,0.1,3.96,0.39,,37,128,145,,,,,,,1,,,,,,,,,,,,,,3,,,12.12,,10.5,,61,60,,1,84,83,,,,,,,,,"100,0,0,0,0,0,0","11,54,35,0,0","95,0,0,0,5",,,,,,,,,,,,,,,,,,,,,,,,,,,,,,,,,,,,,,,,,5.9,21,8,318,45,,1016,3,,0,5,3,,1,0,,,Cycling,,,,"Polar M430",43,0,,0,168072,,30378,,,,,,,,,,,,,,,,,,,,,,,,,,,,,,,,,,,,,,,,,,,
5962304,7f6f4baa-3b9e-4281-aeec-8583a504ab64,1402004385,120,1548677481,,0,0,10.45,4102,4474,171,170,,,1,1.7,0.48,,,157,702,,,,,,,29.22,,1,,,,,,,,,,,,,,85,77,9.43,10.41,10.77,,,,,,,,,,,,,,,,,"23,8,23,39,6,0,0,0,0",,,,,,,99,,,,,,,,,,,,,,,,,,,,,,,,,,,,,,,,,,,,,14,3,223,72,,1016,0,,1,3,3,,1,0,,,,,"Regenerativer DL ",,"Polar BEAT",,0,,0,168070,250480,30378,,,,,,,,,,,,,,,,,,,,,,,,,,,,,,,,,,,,,,,,,,5,
5962305,,1433747451,120,1548677481,,0,0,,11,11,,,,,0,,,,,,3,,,,,,,,,1,,,,,,,,,,,,,,0,,,,,,,,,,,,,,,,,,,,,,,,,,,,,,,,,,,,,,,,,,,,,,,,,,,,,,,,,,,,,,,,,,,,,,,,,,1,,,0,0,,,,,,,"Polar BEAT",,0,,0,168070,250480,30378,,,,,,,,,,,,,,,,,,,,,,,,,,,,,,,,,,,,,,,,,,,
5962306,8063380d-650e-4caa-89cb-cf78e18b4b72,1451733009,60,1548677484,,0,0,27.6,7575,7599,648,647,,,1,4.7,0.66,,,524,1889,,,,,,,48,,1,,,,,,,,,,,,,,157,82,13.67,13.29,14.16,,,,,,,,,,,,,,,,,"3,2,4,10,32,42,7,0,0",,,,,,,133,,,,,,,,,,,,,,,,,,,,,,,,,,,,,,,,,,,,,3,17,127,85,,1012,,,0,6,3,,1,0,,,,,"Balve Laufen",,"Polar BEAT",,0,,0,168070,250480,30378,,,,,,,,,,,,,,,,,,,,,,,,,,,,,,,,,,,,,,,,,,"4,4,4,5,5,5,5,5,5,5,5",
5962307,c4615429-7166-482f-a153-cac954fa46e7,1410101552,120,1548677484,,0,0,2.45,781,1209,6,8,,,1,0,0,,,,160,,,,,,,33.91,,1,,,,,,,,,,,,,,16,80,11.25,11.69,11.72,,,,,,,,,,,,,,,,,"16,7,11,26,24,8,5,2,0",,,,,,,118,,,,,,,,,,,,,,,,,,,,,,,,,,,,,,,,,,,,,21,6,242,62,,1015,,,0,5,3,,1,0,,,,,Einlaufen,,"Polar BEAT",,0,,0,168070,250480,30378,,,,,,,,,,,,,,,,,,,,,,,,,,,,,,,,,,,,,,,,,,,
5962308,9f473267-bc8b-46a7-b34f-6ba43709f709,1512117954,60,1548677485,,0,0,12.07,2447,2449,45,46,,,1,0,0.08,,0.95,,403,123,145,,,,,64.04,,1,,,,,,,,,,,,,,30,57,17.82,19.22,19.25,4.7,,,,,,,,,,,,,,,,"8,0,0,2,2,7,11,28,42","0,99,0,0,0",,,,,,,,,,,,,,,,,,,,,,,,,,,,,,,,,,,,,,,,,,12.3,0,0,,93,,,0,,0,4,3,,1,0,I1.000|2:59-I1.000|2:53-I1.000|3:11-I1.000|3:16-I1.000|3:53-I1.000|3:27-I1.000|3:44-I1.000|3:03-I1.000|2:43-I1.000|2:58-I1.000|3:17-I1.000|3:00-I0.070|2:28,,Running,,,,"Polar M430",43,0,,0,168070,250480,30378,,,,,,,,,,,,,,,,,,,,,,,,,,,,,,,,,,,,,,,,,,,
5962309,b0374015-8fd3-452f-8732-9c9bfe4ab268,1501612665,120,1548677485,,0,0,6.88,1812,1836,75,71,,,1,0,0,0.5,0.67,,428,154,181,,,,64.5,45.52,65.42,1,,,,,,,,,,,,,,51,82,13.84,15.43,15.51,9.2,,,,,,,,,,,,,,,,"28,1,1,2,2,2,19,42,2","0,21,36,43,0",,,,,,139,,,,,,,,,,,,,,,,,,,,,,,,,,,,,,,,,,,,48.8,22,6,358,71,,1016,,,0,5,3,,1,0,I1.013|3:29-I1.007|3:30-I0.216|1:55-I1.013|3:26-I0.155|2:06-I1.015|3:30-I0.190|2:12-I0.494|1:44-I0.069|1:00-I0.508|1:42-I0.078|1:10-I0.508|1:36-I0.066|1:08-I0.518|1:37-I0.025|0:32,,Running,,,,"Polar M430",43,0,,0,168070,250480,30378,,,,,,,,,,,,,,,,,,,,,,,,,,,,,,,,,,,,,,,,,,,
5962310,bde821c1-6d15-4a5e-9747-cf92f8dafe5e,1406462876,120,1548677486,,0,0,7.49,2443,2443,99,100,,,1,1.6,0.57,,,342,498,,,,,,,35.55,,1,,,,,,,,,,,,,,50,80,11.23,11.13,11.38,,,,,,,,,,,,,,,,,"6,9,17,56,11,0,0,0,0",,,,,,,115,,,,,,,,,,,,,,,,,,,,,,,,,,,,,,,,,,,,,22,2,283,73,,1017,5,,0,5,3,,1,0,,,,,"Regenerativer DL ",,"Polar BEAT",,0,,0,168070,250480,30378,,,,,,,,,,,,,,,,,,,,,,,,,,,,,,,,,,,,,,,,,,5,
5962311,0aa0553d-4923-44ce-81e3-ef54736596dc,1364495579,60,1548677486,,0,0,11.47,3121,3141,340,343,,,1,4.1,0.72,,,601,795,,,,,,,45.29,,1,,,,,,,,,,,,,,64,,14.12,13.81,14.96,,,,,,,,,,,,,,,,,"2,3,8,23,27,19,10,5,3",,,,,,,,,,,,,,,,,,,,,,,,,,,,,,,,,,,,,,,,,,,,1,8,59,63,,,0,,1,3,3,,1,0,,,,,,,"Polar BEAT",,0,,0,168070,250480,30378,,,,,,,,,,,,,,,,,,,,,,,,,,,,,,,,,,,,,,,,,,3,
5962312,39a7da18-3ba7-4d09-b3e4-4b226e6c7b00,1539274848,120,1548677487,,0,0,13.61,3474,3476,44,45,,,1,0,0.03,1.15,,,862,151,174,,,,68.89,49.4,69.16,1,,,,,,,,,,,,,,91,83,14.13,14.4,14.46,3.2,,,,,,,,,,,,,,,,"0,0,2,11,25,27,30,5,0","1,25,45,30,0",,,,,,142,,,,,,,,,,,,,,,,,,,,,,,,,,,,,,,,,,,,59.2,18,9,20,76,,,1,,0,5,3,,1,0,I1.000|5:00-I1.000|4:49-I1.000|4:50-I1.000|3:38-I1.000|4:02-I1.000|3:46-I1.000|4:21-I1.000|3:41-I1.000|4:19-I1.000|3:43-I1.000|4:33-I1.000|3:41-I1.000|4:41-I0.614|2:55,,Running,,,,"Polar M430",43,0,,0,168070,250480,30378,,,,,,,,,,,,,,,,,,,,,,,,,,,,,,,,,,,,,,,,,,,
5962313,192091c8-d9eb-4847-a73a-eecfc3358efa,1530558730,120,1548677487,,0,0,2.88,1369,1371,57,67,,,1,1.5,0.77,1.16,0.96,,408,173,195,,,,26.08,21.23,26.62,1,,,,,,,,,,,,,,59,86,7.88,7.88,8.14,2.1,,,,,,,,,,,,,,,,"89,5,4,2,0,0,0,0,0","0,7,9,44,40",,,,,,73,,,,,,,,,,,,,,,,,,,,,,,,,,,,,,,,,,,,117.6,24,13,60,30,,,,,0,3,3,,1,0,I1.261|10:17-I1.287|9:12-I0.327|3:23,,Running,,,,"Polar M430",43,0,,0,168070,250480,30378,,,,,,,,,,,,,,,,,,,,,,,,,,,,,,,,,,,,,,,,,,,
5962314,1a521343-6727-42a1-8d9f-b169666d01ed,1416386919,60,1548677488,,0,0,5.49,1715,3515,63,62,,,1,1,0.37,,,649,373,,,,,,,36.71,,1,,,,,,,,,,,,,,35,83,11.76,11.81,11.98,,,,,,,,,,,,,,,,,"12,9,14,26,27,11,2,0,0",,,,,,,116,,,,,,,,,,,,,,,,,,,,,,,,,,,,,,,,,,,,,7,0,274,98,,1019,0,,0,5,3,,1,0,,,,,"Lauf ABC",,"Polar BEAT",,0,,0,168070,250480,30378,,,,,,,,,,,,,,,,,,,,,,,,,,,,,,,,,,,,,,,,,,5,
5962315,52af8168-ff73-4c3b-9e36-7e271e62a64a,1504461581,120,1548677488,,0,0,5.07,1516,1530,107,110,,,1,2,0.96,1.04,1.25,,334,148,186,,,,58.2,38.49,59.67,1,,,,,,,,,,,,,,37,80,12.79,14.5,14.84,5.9,,,,,,,,,,,,,,,,"38,2,1,2,2,2,25,30,0","0,36,35,26,3",,,,,,125,,,,,,,,,,,,,,,,,,,,,,,,,,,,,,,,,,,,52.2,19,2,202,57,,1014,1,,0,5,3,,1,0,I0.226|2:01-I1.028|3:32-I0.200|1:56-I1.021|3:33-I0.197|2:00-I1.024|3:29-I0.195|2:05-I1.025|3:39-I0.148|3:18,,Running,,,,"Polar M430",43,0,,0,168070,250480,30378,,,,,,,,,,,,,,,,,,,,,,,,,,,,,,,,,,,,,,,,,,,
5962316,1588c226-786d-4d1a-8704-59f011107396,1526727863,120,1548677489,,0,0,4.61,1377,1380,28,28,,,1,0,0.17,1.09,0.93,,280,138,155,,,,63.75,38.32,64.23,1,,,,,,,,,,,,,,26,82,12.09,12.09,12.22,-0.8,,,,,,,,,,,,,,,,"2,3,8,32,45,9,0,0,0","2,40,58,0,0",,,,,,122,,,,,,,,,,,,,,,,,,,,,,,,,,,,,,,,,,,,24.4,16,14,24,64,,1019,,,0,3,3,,1,0,I1.000|5:14-I1.000|5:06-I1.000|4:54-I1.000|4:45-I0.610|3:01,,Running,,,,"Polar M430",43,0,,0,168070,250480,30378,,,,,,,,,,,,,,,,,,,,,,,,,,,,,,,,,,,,,,,,,,,
5962317,99e86716-16da-4042-8e21-55901328da54,1407521098,120,1548677489,,0,0,6.37,1319,1319,51,54,,,1,0.5,0.36,,,,435,,,,,,,60.11,,1,,,,,,,,,,,,,,27,88,17.52,17.49,17.59,,,,,,,,,,,,,,,,,"0,0,0,0,2,2,38,57,2",,,,,,,165,,,,,,,,,,,,,,,,,,,,,,,,,,,,,,,,,,,,,20,5,129,93,,1009,2,,0,6,3,,1,0,,,,,TDL,,"Polar BEAT",,0,,0,168070,250480,30378,,,,,,,,,,,,,,,,,,,,,,,,,,,,,,,,,,,,,,,,,,,
5962318,c8b78983-7b09-41e0-a8aa-27f6aa4c5f51,1447961548,60,1548677489,,0,0,5.26,1300,1325,56,55,,,1,1.1,0.58,,,,328,,,,,,,48.28,,1,,,,,,,,,,,,,,27,88,14.65,15.52,15.96,,,,,,,,,,,,,,,,,"17,4,5,8,6,7,13,26,15",,,,,,,138,,,,,,,,,,,,,,,,,,,,,,,,,,,,,,,,,,,,,8,9,282,98,,1010,,,1,6,3,,1,0,,,,,"Aachen Laufen",,"Polar BEAT",,0,,0,168070,250480,30378,,,,,,,,,,,,,,,,,,,,,,,,,,,,,,,,,,,,,,,,,,,
5962319,1ddb6d4b-7bb6-430b-9dbd-dc904e70f427,1460890184,120,1548677490,,0,0,10,2316,2317,48,54,,,1,0,0.12,,,,682,,,,,,,54.15,,1,,,,,,,,,,,,,,48,86,15.59,15.62,15.67,,,,,,,,,,,,,,,,,"0,0,0,1,2,17,76,4,0",,,,,,,151,,,,,,,,,,,,,,,,,,,,,,,,,,,,,,,,,,,,,21,10,264,47,,1014,4,,0,3,3,,1,0,,,,,"Burjassot Laufen",,"Polar BEAT",,0,,0,168070,250480,30378,,,,,,,,,,,,,,,,,,,,,,,,,,,,,,,,,,,,,,,,,,,
5962320,05bf9bce-0e86-428d-84e4-5a792ac93976,1497809485,120,1548677491,,0,0,16.17,4951,4959,218,219,,,1,2,0.55,,,480,1095,,,,,,,40.54,,1,,,,,,,,,,,,,,102,79,11.98,12.04,12.31,,,,,,,,,,,,,,,,,"4,1,7,33,48,6,0,0,0",,,,,,,124,,,,,,,,,,,,,,,,,,,,,,,,,,,,,,,,,,,,,27,6,74,50,,1022,2,,0,3,3,,1,0,,,,,"Aachen Laufen",,"Polar BEAT",,0,,0,168070,250480,30378,,,,,,,,,,,,,,,,,,,,,,,,,,,,,,,,,,,,,,,,,,4,
5962321,c1f310eb-3780-41f4-99ab-bb01cf6d4c4f,1407620990,120,1548677491,,0,0,4.45,1381,1381,48,28,,,1,0.7,0.36,,,,302,,,,,,,36.55,,1,,,,,,,,,,,,,,28,82,11.89,11.75,11.98,,,,,,,,,,,,,,,,,"4,7,16,27,45,1,0,0,0",,,,,,,118,,,,,,,,,,,,,,,,,,,,,,,,,,,,,,,,,,,,,18,2,162,77,,1013,0,,1,5,3,,1,0,,,,,"Einlaufen + Dehnen",,"Polar BEAT",,0,,0,168070,250480,30378,,,,,,,,,,,,,,,,,,,,,,,,,,,,,,,,,,,,,,,,,,,
5962322,0a0136dd-04eb-443d-8c05-847ee2e77fc2,1497471440,120,1548677491,,0,0,1.27,467,467,6,0,,,1,0,0.05,,,,82,,,,,,,26.89,,1,,,,,,,,,,,,,,9,79,9.99,9.92,10.1,,,,,,,,,,,,,,,,,"26,27,29,17,0,0,0,0,0",,,,,,,103,,,,,,,,,,,,,,,,,,,,,,,,,,,,,,,,,,,,,24,8,52,52,,1016,,,0,3,3,,1,0,,,,,"Aachen Laufen",,"Polar BEAT",,0,,0,168070,250480,30378,,,,,,,,,,,,,,,,,,,,,,,,,,,,,,,,,,,,,,,,,,,
5962323,c6c41677-f425-438f-ac70-395061d10b78,1416842656,60,1548677492,,0,0,12.29,3198,3257,158,132,,,1,1.2,0.51,,,261,825,,,,,,,47.95,,1,,,,,,,,,,,,,,66,83,14.14,13.98,14.28,,,,,,,,,,,,,,,,,"2,1,2,4,17,56,18,0,0",,,,,,,139,,,,,,,,,,,,,,,,,,,,,,,,,,,,,,,,,,,,,9,2,26,74,,1026,0,,0,3,3,,1,0,,,,,"Lockerer DL + Lauf ABC",,"Polar BEAT",,0,,0,168070,250480,30378,,,,,,,,,,,,,,,,,,,,,,,,,,,,,,,,,,,,,,,,,,"5,5",
5962324,c9e07470-1c46-4136-951b-cd533d212e1f,1465504653,120,1548677492,,0,0,0.82,177,177,0,3,,,1,0,0.01,,,,56,,,,,,,46.98,,1,,,,,,,,,,,,,,3,89,16.59,16.97,16.84,,,,,,,,,,,,,,,,,"0,0,0,0,13,5,28,54,0",,,,,,,156,,,,,,,,,,,,,,,,,,,,,,,,,,,,,,,,,,,,,19,3,351,54,,1017,0,,0,3,3,,1,0,,,,,"Aachen Laufen",,"Polar BEAT",,0,,0,168070,250480,30378,,,,,,,,,,,,,,,,,,,,,,,,,,,,,,,,,,,,,,,,,,,
5962325,60f623c3-b773-43e0-afa6-393d619de820,1368138499,120,1548677498,,0,0,1,50950,51274,63,56,,,1,0.9,0.62,,,,53,,,,,,,,,1,,,,,,,,,,,,,,1058,,0.07,4.44,4.73,,,,,,,,,,,,,,,,,"100,0,0,0,0,0,0,0,0",,,,,,,,,,,,,,,,,,,,,,,,,,,,,,,,,,,,,,,,,,,,12,5,242,71,,1013,0,,1,5,3,,1,0,,,,,,,"Polar BEAT",,0,,0,168070,250480,30378,,,,,,,,,,,,,,,,,,,,,,,,,,,,,,,,,,,,,,,,,,,
5962326,40aace9a-c940-416f-bad3-baa76b881a6c,1544519436,60,1548677499,,0,0,11.1,1839,1865,45,51,,,1,0,0.11,,0.58,,322,125,156,,,,,,,1,,,,,,,,,,,,,,24,,,23.18,,13.3,-18.4,114,96,,1,131,118,,,,,,,,,"10,7,61,21,2,0,0","2,89,9,0,0","87,3,0,1,10",,,,,,,,,,,,,,,,,,,,,,,,,,,,,,,,,,,,,,,,,15.3,3,10,220,86,,,0,,0,5,3,,1,0,,,Cycling,,,,"Polar M430",43,0,,0,168072,,30378,,,,,,,,,,,,,,,,,,,,,,,,,,,,,,,,,,,,,,,,,,,
5962327,6b5423d1-422b-4fa6-b028-38e48890a2d2,1416770981,60,1548677500,,0,0,9.35,2902,3687,141,141,,,1,1.8,0.6,,,,602,,,,,,,38.26,,1,,,,,,,,,,,,,,60,83,11.75,11.93,12.54,,,,,,,,,,,,,,,,,"14,15,12,19,26,5,5,5,0",,,,,,,116,,,,,,,,,,,,,,,,,,,,,,,,,,,,,,,,,,,,,12,4,182,86,,1016,0,,1,5,3,,1,0,,,,,"10x 150m/250m traben",,"Polar BEAT",,0,,0,168070,250480,30378,,,,,,,,,,,,,,,,,,,,,,,,,,,,,,,,,,,,,,,,,,,
5962328,b8f25d8c-8c87-4818-86d9-38944cedd3d8,1490202043,60,1548677500,,0,0,13.61,3689,3690,202,197,,,1,2.1,0.6,,,402,968,,,,,,,46.08,,1,,,,,,,,,,,,,,76,81,13.6,13.42,13.74,,,,,,,,,,,,,,,,,"2,2,3,5,39,43,6,0,0",,,,,,,137,,,,,,,,,,,,,,,,,,,,,,,,,,,,,,,,,,,,,10,8,128,60,,1013,1,,0,5,3,,1,0,,,,,"Aachen Laufen",,"Polar BEAT",,0,,0,168070,250480,30378,,,,,,,,,,,,,,,,,,,,,,,,,,,,,,,,,,,,,,,,,,4,
5962329,,1465078500,120,1548677500,,0,0,,0,0,,,,,0,,,,,,189,,,,,,,,,1,,,,,,,,,,,,,,0,,,,,,,,,,,,,,,,,,,,,,,,,,,,,,,,,,,,,,,,,,,,,,,,,,,,,,,,,,,,,,,,,,,,,,,,,,1,,,0,0,,,,,Gym,,"Polar BEAT",,0,,0,168075,,30378,,,,,,,,,,,,,,,,,,,,,,,,,,,,,,,,,,,,,,,,,,,
5962330,,1502892240,120,1548677500,,0,0,1,2400,2400,,,,,0,,,,,,333,,,,,,,,,1,,,,,,,,,,,,,,26,,,,,,,,,,,,,,,,,,,,,,,,,,,,,,,,,,,,,,,,,,,,,,,,,,,,,,,,,,,,,,,,,,,,,,,,,,1,,,0,0,,,Swimming,,,,"no device name available",,0,,0,168075,,30378,,,,,,,,,,,,,,,,,,,,,,,,,,,,,,,,,,,,,,,,,,,
5962332,06cd08dd-75d8-40d6-b1a4-88b2e797d5cd,1393960388,60,1548677502,,0,0,3.22,990,990,61,62,,,1,1.4,0.56,1.12,1.03,406,176,140,163,,,,60.42,36.17,61.81,1,,,,,,,,,,,,,,19,81,12.11,11.86,12.67,3.7,,,,,,,,,,,,,,,,"2,1,20,33,43,0,0,0,0","1,63,31,5,0",,,,,,120,,,,,,,,,,,,,,,,,,,,,,,,,,,,,,,,,,,,25.8,7,7,243,73,,1008,,,1,5,3,,1,0,,,,,Einlaufen,,"Polar BEAT",,0,,0,168070,250480,30378,,,,,,,,,,,,,,,,,,,,,,,,,,,,,,,,,,,,,,,,,,5,
5962333,45760405-0d6e-486f-81cf-8464efb22ee3,1427225204,60,1548677502,,0,0,14.09,3421,3677,309,305,,,1,1.4,0.28,,,,953,,,,,,,52.49,,1,,,,,,,,,,,,,,71,86,15.19,15.75,16.29,,,,,,,,,,,,,,,,,"11,6,3,8,6,8,16,43,0",,,,,,,144,,,,,,,,,,,,,,,,,,,,,,,,,,,,,,,,,,,,,7,2,356,70,,1007,,,1,5,3,,1,0,,,,,"5x 2000m",,"Polar BEAT",,0,,0,168070,250480,30378,,,,,,,,,,,,,,,,,,,,,,,,,,,,,,,,,,,,,,,,,,,
5962334,1fc382cf-5f25-4a1f-8e38-99f8810fc837,1401138357,120,1548677503,,0,0,5.29,3137,3139,101,102,,,1,1.9,0.5,,,151,346,,,,,,,16.61,,1,,,,,,,,,,,,,,65,70,6.19,8.34,8.97,,,,,,,,,,,,,,,,,"65,20,10,4,1,0,0,0,0",,,,,,,72,,,,,,,,,,,,,,,,,,,,,,,,,,,,,,,,,,,,,17,1,103,85,,1012,0,,0,5,3,,1,0,,,,,"Lousberglauf VK",,"Polar BEAT",,0,,0,168070,250480,30378,,,,,,,,,,,,,,,,,,,,,,,,,,,,,,,,,,,,,,,,,,4,
5962335,b298dd43-7150-4cdd-9761-cc6431522acc,1482260649,60,1548677504,,0,0,0.84,287,287,18,17,,,1,1.2,0.97,,,,39,,,,,,,27.91,,1,,,,,,,,,,,,,,5,83,10.35,12.66,14.54,,,,,,,,,,,,,,,,,"59,2,2,5,5,5,4,6,13",,,,,,,106,,,,,,,,,,,,,,,,,,,,,,,,,,,,,,,,,,,,,0,2,185,85,,1023,0,,1,3,3,,1,0,,,,,"Aachen Laufen",,"Polar BEAT",,0,,0,168070,250480,30378,,,,,,,,,,,,,,,,,,,,,,,,,,,,,,,,,,,,,,,,,,,
5962336,6eba347b-1655-4602-bd6b-02f7d72a8d05,1444335101,120,1548677504,,0,0,1.67,546,546,59,21,,,1,1.8,0.76,,,444,115,,,,,,,31.71,,1,,,,,,,,,,,,,,11,83,12.27,11.41,13.52,,,,,,,,,,,,,,,,,"10,3,26,29,33,0,0,0,0",,,,,,,111,,,,,,,,,,,,,,,,,,,,,,,,,,,,,,,,,,,,,11,1,221,94,,1022,,,1,5,3,,1,0,,,,,"Aachen Laufen",,"Polar BEAT",,0,,0,168070,250480,30378,,,,,,,,,,,,,,,,,,,,,,,,,,,,,,,,,,,,,,,,,,5,
5962337,b805453a-afdf-43ea-bcd2-727b39baf12b,1515004575,60,1548677504,,0,0,11.04,3613,3614,36,24,,,1,0,0.07,1.15,0.92,,688,142,167,,,,54.94,36.39,55.24,1,,,,,,,,,,,,,,75,82,11.06,11.03,11.12,5.3,,,,,,,,,,,,,,,,"2,3,38,54,4,0,0,0,0","0,29,70,1,0",,,,,,112,,,,,,,,,,,,,,,,,,,,,,,,,,,,,,,,,,,,32,8,17,256,71,,,0,,1,5,3,,1,0,I1.000|5:22-I1.000|5:20-I1.000|5:20-I1.000|5:23-I1.000|5:27-I1.000|5:32-I1.000|5:27-I1.000|5:36-I1.000|5:25-I1.000|5:27-I1.000|5:40-I0.041|0:16,,Running,,,,"Polar M430",43,0,,0,168070,250480,30378,,,,,,,,,,,,,,,,,,,,,,,,,,,,,,,,,,,,,,,,,,,
5962338,a3a84a8f-5769-4019-a3e5-0f0dd68fd759,1447786356,60,1548677505,,0,0,4.62,1430,1584,65,64,,,1,1.2,0.65,,,,320,,,,,,,36.74,,1,,,,,,,,,,,,,,29,80,11.82,12,12.4,,,,,,,,,,,,,,,,,"15,4,8,18,37,16,2,0,0",,,,,,,121,,,,,,,,,,,,,,,,,,,,,,,,,,,,,,,,,,,,,14,28,212,88,,1007,,,1,6,3,,1,0,,,,,"Aachen Laufen",,"Polar BEAT",,0,,0,168070,250480,30378,,,,,,,,,,,,,,,,,,,,,,,,,,,,,,,,,,,,,,,,,,,
5962339,6eca57de-bab4-4d61-8d57-0c4c55673b04,1460976344,120,1548677505,,0,0,3.91,1173,1222,21,21,,,1,0,0.17,,,,274,,,,,,,37.73,,1,,,,,,,,,,,,,,24,82,12.07,12.06,12.14,,,,,,,,,,,,,,,,,"2,6,13,20,51,7,1,0,0",,,,,,,122,,,,,,,,,,,,,,,,,,,,,,,,,,,,,,,,,,,,,18,12,43,63,,1019,4,,0,3,3,,1,0,,,,,"Valencia Laufen",,"Polar BEAT",,0,,0,168070,250480,30378,,,,,,,,,,,,,,,,,,,,,,,,,,,,,,,,,,,,,,,,,,,
5962340,28f05be4-47e0-405b-ba26-95a9faa8dde6,1447356882,60,1548677505,,0,0,8.34,2267,2267,0,2,,,1,0,0.02,,,,479,,,,,,,44.38,,1,,,,,,,,,,,,,,47,85,13.27,14.88,14.9,,,,,,,,,,,,,,,,,"34,4,3,3,4,5,7,27,13",,,,,,,130,,,,,,,,,,,,,,,,,,,,,,,,,,,,,,,,,,,,,12,8,171,82,,1024,,,1,5,3,,1,0,,,,,"Aachen Laufen",,"Polar BEAT",,0,,0,168070,250480,30378,,,,,,,,,,,,,,,,,,,,,,,,,,,,,,,,,,,,,,,,,,,
5962341,274411a8-e019-4d59-b4a8-d818bf617c7c,1344980938,120,1548677506,,0,0,4.06,1311,1313,6,67,,,1,0.2,0.35,,,,284,,,,,,,34.67,,1,,,,,,,,,,,,,,27,,10.79,11.6,11.29,,,,,,,,,,,,,,,,,"15,9,14,23,23,8,6,1,0",,,,,,,,,,,,,,,,,,,,,,,,,,,,,,,,,,,,,,,,,,,,18,4,90,86,,1014,0,,1,5,3,,1,0,,,,,,,"Polar BEAT",,0,,0,168070,250480,30378,,,,,,,,,,,,,,,,,,,,,,,,,,,,,,,,,,,,,,,,,,,
5962342,8360907e-7883-46b4-abd1-5bbd2a8cc4ae,1458851529,60,1548677506,,0,0,5.06,1672,1694,44,81,,,1,1.2,0.6,,,,352,,,,,,,34.18,,1,,,,,,,,,,,,,,34,79,10.91,11.43,11.57,,,,,,,,,,,,,,,,,"11,9,15,31,23,8,2,0,0",,,,,,,115,,,,,,,,,,,,,,,,,,,,,,,,,,,,,,,,,,,,,6,11,223,75,,1015,,,1,5,3,,1,0,,,,,"Aachen Laufen",,"Polar BEAT",,0,,0,168070,250480,30378,,,,,,,,,,,,,,,,,,,,,,,,,,,,,,,,,,,,,,,,,,,
5962343,,1502786760,120,1548677506,,0,0,3,1080,1080,,,,,0,,,,,,264,,,,,,,29.87,,1,,,,,,,,,,,,,,22,,,,,,,,,,,,,,,,,,,,,,,,,,,,,,,,,,,,,,,,,,,,,,,,,,,,,,,,,,,,,,,,,,,,,,,,,,1,,,0,0,,,,,,,"no device name available",,0,,0,168070,250480,30378,,,,,,,,,,,,,,,,,,,,,,,,,,,,,,,,,,,,,,,,,,,
5962344,687f39c4-53dc-4548-bda4-7737c474b00a,1454349704,60,1548677507,,0,0,12.39,3100,3100,131,139,,,1,1.1,0.41,,,486,852,,,,,,,50.21,,1,,,,,,,,,,,,,,64,83,14.56,14.54,14.8,,,,,,,,,,,,,,,,,"2,1,0,2,11,46,38,0,0",,,,,,,144,,,,,,,,,,,,,,,,,,,,,,,,,,,,,,,,,,,,,11,32,233,79,,1020,,,1,11,3,,1,0,,,,,"Aachen Laufen",,"Polar BEAT",,0,,0,168070,250480,30378,,,,,,,,,,,,,,,,,,,,,,,,,,,,,,,,,,,,,,,,,,5,
5962345,bc8501dd-24b7-413b-84c5-9361c440ed0d,1543342098,60,1548677507,,0,0,13.95,3680,3681,52,52,,,1,0,0.1,0.97,0.94,,962,155,178,,,,63.8,47.64,64.09,1,,,,,,,,,,,,,,105,83,13.7,13.97,14.05,-0.7,,,,,,,,,,,,,,,,"2,2,3,6,32,27,27,0,0","0,7,59,34,0",,,,,,137,,,,,,,,,,,,,,,,,,,,,,,,,,,,,,,,,,,,74.5,4,3,39,92,,1023,0,312,1,5,3,,1,0,I1.000|4:54-I1.000|4:46-I1.000|4:44-I1.000|4:36-I1.000|4:36-I1.000|4:39-I1.000|4:16-I1.000|3:54-I1.000|4:05-I1.000|3:45-I1.000|3:52-I1.000|4:01-I1.000|4:02-I0.950|5:14,,Running,,,,"Polar M430",43,0,,0,168070,250480,30378,,,,,,,,,,,,,,,,,,,,,,,,,,,,,,,,,,,,,,,,,,,
5962346,895362bc-fba7-4cee-aa09-885923fd8208,1398522372,120,1548677508,,0,0,3.98,1490,1759,21,61,,,1,0.4,0.41,0.93,0.84,,253,144,183,,,,45.72,29.01,45.45,1,,,,,,,,,,,,,,31,79,9.59,10.2,10.06,12.3,,,,,,,,,,,,,,,,"21,15,29,31,3,1,0,0,0","0,31,67,2,0",,,,,,101,,,,,,,,,,,,,,,,,,,,,,,,,,,,,,,,,,,,25.4,17,4,184,53,,1011,5,,0,5,3,,1,0,,,,,Auslaufen,,"Polar BEAT",,0,,0,168070,250480,30378,,,,,,,,,,,,,,,,,,,,,,,,,,,,,,,,,,,,,,,,,,,
5962347,d5408d7f-d255-42ad-9115-1f3750c7618a,1536350998,120,1548677508,,0,0,3.05,1027,1027,19,20,,,1,0.1,0.33,1.12,0.8,,195,129,146,,,,59.61,32.37,60.05,1,,,,,,,,,,,,,,15,80,10.73,10.8,10.94,-4.2,,,,,,,,,,,,,,,,"11,14,33,30,10,1,0,0,0","4,90,6,0,0",,,,,,111,,,,,,,,,,,,,,,,,,,,,,,,,,,,,,,,,,,,13,19,7,198,60,,,0,,1,3,3,,1,0,I1.000|5:42-I1.000|5:40-I1.000|5:29-I0.059|0:17,,Running,,,,"Polar M430",43,0,,0,168070,250480,30378,,,,,,,,,,,,,,,,,,,,,,,,,,,,,,,,,,,,,,,,,,,
5962348,9e8d51d0-0a6d-4b71-ab19-11aabf4ca73e,1395064882,60,1548677509,,0,0,9.61,2626,2730,144,143,,,1,1.9,0.55,1.05,1,366,504,151,168,,,,63.32,44.51,64.5,1,,,,,,,,,,,,,,67,84,13.49,13.41,13.77,-4.1,,,,,,,,,,,,,,,,"6,2,2,7,26,47,10,0,0","0,15,71,13,0",,,,,,131,,,,,,,,,,,,,,,,,,,,,,,,,,,,,,,,,,,,43.2,11,9,264,77,,1021,3,,0,5,3,,1,0,,,,,"Regenerativer DL ",,"Polar BEAT",,0,,0,168070,250480,30378,,,,,,,,,,,,,,,,,,,,,,,,,,,,,,,,,,,,,,,,,,4,
5962349,fa99c457-c0a2-487d-bacd-f2636f78e03a,1392653573,60,1548677509,,0,0,13.16,3660,3732,163,163,,,1,1.6,0.45,1.03,1.01,321,636,147,168,,,,64.22,44.6,65.21,1,,,,,,,,,,,,,,85,82,13.24,13.02,13.4,-1.2,,,,,,,,,,,,,,,,"2,1,3,7,51,30,5,0,0","0,21,75,4,0",,,,,,132,,,,,,,,,,,,,,,,,,,,,,,,,,,,,,,,,,,,34.1,9,8,214,71,,1015,0,,0,5,3,,1,0,,,,,Regeneration,,"Polar BEAT",,0,,0,168070,250480,30378,,,,,,,,,,,,,,,,,,,,,,,,,,,,,,,,,,,,,,,,,,5,
5962350,09e792ab-701e-4516-ad95-b0bedabd627a,1532072997,120,1548677510,,0,0,4.98,1363,1364,67,67,,,1,1.2,0.49,1.07,1.07,278,358,155,171,,,,60.96,42.68,61.97,1,,,,,,,,,,,,,,39,83,13.39,13.67,13.8,-6.8,,,,,,,,,,,,,,,,"9,1,5,3,27,37,18,1,0","1,11,52,35,0",,,,,,132,,,,,,,,,,,,,,,,,,,,,,,,,,,,,,,,,,,,50.7,17,6,165,74,,,,,0,3,3,,1,0,I1.000|5:28-I1.000|4:31-I1.000|4:40-I1.000|3:56-I0.987|4:10,,Running,,,,"Polar M430",43,0,,0,168070,250480,30378,,,,,,,,,,,,,,,,,,,,,,,,,,,,,,,,,,,,,,,,,,5,
5962351,63c72621-fff9-4865-afab-11560665eaeb,1405631433,120,1548677510,,0,0,0.89,349,350,17,16,,,1,0.9,0.55,,,,64,,,,,,,23.97,,1,,,,,,,,,,,,,,7,76,9.75,10.66,10.73,,,,,,,,,,,,,,,,,"32,3,22,17,19,6,0,0,0",,,,,,,101,,,,,,,,,,,,,,,,,,,,,,,,,,,,,,,,,,,,,25,4,54,63,,1019,0,,0,3,3,,1,0,,,,,Auslaufen,,"Polar BEAT",,0,,0,168070,250480,30378,,,,,,,,,,,,,,,,,,,,,,,,,,,,,,,,,,,,,,,,,,,
5962353,5c6bed7e-37b4-43a1-b5f5-7594dabbef5c,1395827637,60,1548677511,,0,0,12,3274,3296,161,162,,,1,1.5,0.42,1.11,1.11,323,665,156,177,,,,60.65,45.3,61.65,1,,,,,,,,,,,,,,94,84,13.49,13.51,13.81,-2.9,,,,,,,,,,,,,,,,"6,1,3,8,26,41,14,0,0","0,3,68,30,0",,,,,,131,,,,,,,,,,,,,,,,,,,,,,,,,,,,,,,,,,,,54.6,4,1,9,84,,1015,2,,0,5,3,,1,0,,,,,"Zügiger DL",,"Polar BEAT",,0,,0,168070,250480,30378,,,,,,,,,,,,,,,,,,,,,,,,,,,,,,,,,,,,,,,,,,5,
5962354,40f0878c-9327-4de7-8ede-2fdfecccf9a3,1450115347,60,1548677511,,0,0,10.01,2277,2277,74,81,,,1,0.3,0.32,,,,673,,,,,,,55.31,,1,,,,,,,,,,,,,,47,84,15.89,15.92,16.03,,,,,,,,,,,,,,,,,"1,0,0,0,2,16,69,12,0",,,,,,,157,,,,,,,,,,,,,,,,,,,,,,,,,,,,,,,,,,,,,6,10,178,90,,1020,,,1,3,3,,1,0,,,,,"Aachen Laufen",,"Polar BEAT",,0,,0,168070,250480,30378,,,,,,,,,,,,,,,,,,,,,,,,,,,,,,,,,,,,,,,,,,,
5962355,a47f9a94-6a8f-4782-8f46-56cbf6848b61,1519066067,60,1548677512,,0,0,10.81,2026,2026,55,41,,,1,0,0.17,2.25,,,253,106,121,,,,,,,1,,,,,,,,,,,,,,14,,,20.2,,13.3,-26.5,96,79,,1,116,103,,,,,,,,,"11,26,63,1,0,0,0","21,79,0,0,0","86,0,9,3,3",,,,,,,,,,,,,,,,,,,,,,,,,,,,,,,,,,,,,,,,,4.9,1,1,44,77,,,0,,1,4,3,,1,0,,,Cycling,,,,"Polar M430",43,0,,0,168072,,30378,,,,,,,,,,,,,,,,,,,,,,,,,,,,,,,,,,,,,,,,,,,
5962356,75bd0e31-8c40-4fb1-abf5-f8a04f516cd5,1501782260,120,1548677512,,0,0,10.81,3223,3255,173,171,,,1,1.7,0.48,1.18,0.94,549,681,143,168,,,,61.09,40.53,62.31,1,,,,,,,,,,,,,,69,82,12.32,12.32,12.94,12.8,,,,,,,,,,,,,,,,"8,4,6,20,38,22,2,0,0","2,33,61,5,0",,,,,,123,,,,,,,,,,,,,,,,,,,,,,,,,,,,,,,,,,,,37.7,24,22,251,50,,1012,,,0,3,3,,1,0,I4.975|24:04-I0.124|0:44-I0.089|0:23-I0.121|0:45-I0.094|0:23-I0.116|0:51-I0.096|0:23-I0.103|0:46-I0.080|0:23-I0.125|0:44-I0.087|0:22-I0.113|0:47-I0.091|0:24-I0.106|0:45-I0.090|0:24-I0.115|0:47-I0.078|0:21-I0.124|0:46-I0.084|0:22-I3.997|19:51,,Running,,,,"Polar M430",43,0,,0,168070,250480,30378,,,,,,,,,,,,,,,,,,,,,,,,,,,,,,,,,,,,,,,,,,4,
5962357,5fd2eced-bd2d-4811-bc9f-e94e22b0d711,1500736861,120,1548677513,,0,0,4.09,1357,1357,27,56,,,1,0.5,0.41,,,,280,,,,,,,33.58,,1,,,,,,,,,,,,,,28,79,10.76,11.02,10.95,,,,,,,,,,,,,,,,,"8,13,26,37,15,1,0,0,0",,,,,,,114,,,,,,,,,,,,,,,,,,,,,,,,,,,,,,,,,,,,,26,10,207,47,,1011,5,,0,5,3,,1,0,,,,,"Aachen Laufen",,"Polar BEAT",,0,,0,168070,250480,30378,,,,,,,,,,,,,,,,,,,,,,,,,,,,,,,,,,,,,,,,,,,
5962358,ec2e5e44-559d-4e7c-929a-20a7af427859,1417720486,60,1548677514,,0,0,1.95,604,604,57,22,,,1,1.5,0.59,,,418,131,,,,,,,34.29,,1,,,,,,,,,,,,,,12,82,12.63,11.63,13.15,,,,,,,,,,,,,,,,,"2,3,12,50,33,0,0,0,0",,,,,,,118,,,,,,,,,,,,,,,,,,,,,,,,,,,,,,,,,,,,,2,4,149,91,,1016,,,1,4,3,,1,0,,,,,Einlaufen,,"Polar BEAT",,0,,0,168070,250480,30378,,,,,,,,,,,,,,,,,,,,,,,,,,,,,,,,,,,,,,,,,,5,
5962359,74bae440-3bf5-4727-ab00-aed5472d2db8,1420896601,60,1548677515,,0,0,3.5,987,1004,24,57,,,1,0.7,0.54,,,,236,,,,,,,40.26,,1,,,,,,,,,,,,,,20,84,12.6,12.88,12.78,,,,,,,,,,,,,,,,,"0,1,6,17,43,33,0,0,0",,,,,,,127,,,,,,,,,,,,,,,,,,,,,,,,,,,,,,,,,,,,,11,22,239,87,,1012,1,,0,5,3,,1,0,,,,,Auslaufen,,"Polar BEAT",,0,,0,168070,250480,30378,,,,,,,,,,,,,,,,,,,,,,,,,,,,,,,,,,,,,,,,,,,
5962360,,1403640013,120,1548677515,,0,0,6,0,0,,,,,0,,,,,,,,,,,,,,,1,,,,,,,,,,,,,,0,,,,,,,,,,,,,,,,,,,,,,,,,,,,,,,,,,,,,,,,,,,,,,,,,,,,,,,,,,,,,,,,,,,,,,,,,,1,,,0,0,,,,,Einlaufen,,"Polar BEAT",,0,,0,168070,250480,30378,,,,,,,,,,,,,,,,,,,,,,,,,,,,,,,,,,,,,,,,,,,
5962361,eca77d22-5c08-4d4a-8ad0-3e4c4718f53d,1493553115,120,1548677515,,0,0,0.95,331,331,24,21,,,1,1.4,0.79,,,,68,,,,,,,27.67,,1,,,,,,,,,,,,,,6,81,10.95,10.53,11.2,,,,,,,,,,,,,,,,,"35,16,12,15,21,0,0,0,0",,,,,,,106,,,,,,,,,,,,,,,,,,,,,,,,,,,,,,,,,,,,,15,24,135,36,,1009,,,0,5,3,,1,0,,,,,"Aachen Laufen",,"Polar BEAT",,0,,0,168070,250480,30378,,,,,,,,,,,,,,,,,,,,,,,,,,,,,,,,,,,,,,,,,,,
5962362,20c1cbcf-413f-4d16-985c-1598c9c7a975,1508783628,120,1548677515,,0,0,10.47,2499,2499,81,88,,,1,0.4,0.32,1.18,1.03,,631,155,181,,,,72.22,52.43,72.85,1,,,,,,,,,,,,,,73,83,15.16,15.16,15.27,14.1,,,,,,,,,,,,,,,,"0,0,0,0,4,34,59,2,0","0,29,9,62,0",,,,,,151,,,,,,,,,,,,,,,,,,,,,,,,,,,,,,,,,,,,77.9,13,6,240,83,,1021,,,1,5,3,,1,0,I10.020|39:44-I0.449|1:57,,Running,,,,"Polar M430",43,0,,0,168070,250480,30378,,,,,,,,,,,,,,,,,,,,,,,,,,,,,,,,,,,,,,,,,,,
5962363,c64f596e-4128-4a9c-87b5-0f3312f7cbdc,1430675984,120,1548677516,,0,0,8.14,2343,2369,81,80,,,1,1.1,0.42,1.05,1.06,,444,158,187,,,,55.76,41.42,56.45,1,,,,,,,,,,,,,,76,80,12.7,15.5,15.63,9.4,,,,,,,,,,,,,,,,"43,3,1,1,2,2,3,31,13","0,28,18,37,17",,,,,,130,,,,,,,,,,,,,,,,,,,,,,,,,,,,,,,,,,,,87.6,14,14,165,95,,1001,,,0,4,3,,1,0,,,,,"Menden Laufen",,"Polar BEAT",,0,,0,168070,250480,30378,,,,,,,,,,,,,,,,,,,,,,,,,,,,,,,,,,,,,,,,,,,
5962364,7607fcbe-8fb6-489b-9858-872a6e0dfea9,1425122093,60,1548677516,,0,0,2.37,749,750,31,40,,,1,1.2,0.59,,,,162,,,,,,,34.15,,1,,,,,,,,,,,,,,15,80,11.52,12.7,12.99,,,,,,,,,,,,,,,,,"28,4,4,7,14,30,13,0,0",,,,,,,119,,,,,,,,,,,,,,,,,,,,,,,,,,,,,,,,,,,,,5,8,192,73,,,,,0,3,3,,1,0,,,,,"Lauf ABC",,"Polar BEAT",,0,,0,168070,250480,30378,,,,,,,,,,,,,,,,,,,,,,,,,,,,,,,,,,,,,,,,,,,
5962365,41680ac8-befa-4edb-b72a-b910fbd4feb2,1473716028,120,1548677516,,0,0,8.48,3277,3362,85,87,,,1,0.2,0.33,,,155,576,,,,,,,29.3,,1,,,,,,,,,,,,,,68,80,9.46,9.44,9.59,,,,,,,,,,,,,,,,,"44,34,18,4,0,0,0,0,0",,,,,,,97,,,,,,,,,,,,,,,,,,,,,,,,,,,,,,,,,,,,,22,1,112,73,,1016,0,,1,3,3,,1,0,,,,,"Aachen Laufen",,"Polar BEAT",,0,,0,168070,250480,30378,,,,,,,,,,,,,,,,,,,,,,,,,,,,,,,,,,,,,,,,,,5,
5962366,c8676cdc-5c7c-45db-b5c6-968be9fb7a00,1498770724,120,1548677517,,0,0,1.89,961,1841,16,5,,,1,0,0.11,,,,119,,,,,,,18.96,,1,,,,,,,,,,,,,,19,75,7.16,9.75,10.05,,,,,,,,,,,,,,,,,"51,11,11,8,16,2,0,0,0",,,,,,,79,,,,,,,,,,,,,,,,,,,,,,,,,,,,,,,,,,,,,20,12,227,59,,1008,0,,0,5,3,,1,0,,,,,"Aix-en-Provence Laufen",,"Polar BEAT",,0,,0,168070,250480,30378,,,,,,,,,,,,,,,,,,,,,,,,,,,,,,,,,,,,,,,,,,,
5962367,8a7d123a-41db-4d61-bd34-a8879aa101d8,1363111823,60,1548677517,,0,0,7.89,2661,2780,32,33,,,1,0,0.18,,,,548,,,,,,,34.28,,1,,,,,,,,,,,,,,55,,10.72,11.84,11.94,,,,,,,,,,,,,,,,,"17,10,16,19,19,10,6,1,1",,,,,,,,,,,,,,,,,,,,,,,,,,,,,,,,,,,,,,,,,,,,5,1,28,87,,996,0,,1,4,3,,1,0,,,,,,,"Polar BEAT",,0,,0,168070,250480,30378,,,,,,,,,,,,,,,,,,,,,,,,,,,,,,,,,,,,,,,,,,,
5962368,4c5715fe-2f50-45e7-8f22-c7133e3a33b0,1547370628,60,1548677517,,0,0,0.68,222,222,6,0,,,1,0,0.12,0.92,,,53,149,161,,,,51.75,28.76,52.88,1,,,,,,,,,,,,,,5,84,11.47,11.38,11.56,5.1,,,,,,,,,,,,,,,,"10,13,9,57,11,0,0,0,0","0,18,80,3,0",,,,,,109,,,,,,,,,,,,,,,,,,,,,,,,,,,,,,,,,,,,15,5,20,230,96,,1009,0,316,0,6,3,,1,0,,,Running,,,,"Polar M430",43,0,,0,168070,250480,30378,,,,,,,,,,,,,,,,,,,,,,,,,,,,,,,,,,,,,,,,,,,
5962369,feb49258-b6b3-4d85-a0c1-280e2c37d62b,1538148362,120,1548677518,,0,0,3.83,1229,1230,20,20,,,1,0,0.16,1.15,0.94,,246,132,143,,,,61.58,34.8,61.98,1,,,,,,,,,,,,,,19,79,11.3,11.24,11.41,0.5,,,,,,,,,,,,,,,,"2,4,23,64,9,0,0,0,0","2,93,4,0,0",,,,,,118,,,,,,,,,,,,,,,,,,,,,,,,,,,,,,,,,,,,16.1,21,14,18,38,,1022,,,0,5,3,,1,0,I1.000|5:35-I1.000|5:18-I1.000|5:20-I0.831|4:17,,Running,,,,"Polar M430",43,0,,0,168070,250480,30378,,,,,,,,,,,,,,,,,,,,,,,,,,,,,,,,,,,,,,,,,,,
5962370,ac68daed-25f9-4fad-809a-f7655e2816d6,1507743913,120,1548677518,,0,0,9.08,2804,2811,196,181,,,1,2.4,0.62,1.07,0.99,488,680,152,179,,,,53.95,38.41,55.5,1,,,,,,,,,,,,,,79,81,12.1,12.54,13.41,18.2,,,,,,,,,,,,,,,,"15,7,9,16,27,15,8,2,1","1,29,22,48,0",,,,,,120,,,,,,,,,,,,,,,,,,,,,,,,,,,,,,,,,,,,80.4,16,22,228,77,,1015,,,0,5,3,,1,0,I1.000|4:13-I1.000|4:06-I1.000|4:33-I1.000|4:35-I1.000|4:35-I1.000|5:33-I1.000|4:54-I1.000|6:01-I1.000|8:11-I0.157|0:10,,Running,,,,"Polar M430",43,0,,0,168070,250480,30378,,,,,,,,,,,,,,,,,,,,,,,,,,,,,,,,,,,,,,,,,,"4,5",
5962371,94080a58-b9d0-49ea-81ff-2af8f4e438b2,1438805031,120,1548677519,,0,0,13.94,3556,3556,168,186,,,1,1.9,0.51,,,437,939,,,,,,,49.53,,1,,,,,,,,,,,,,,73,82,14.3,14.43,14.75,,,,,,,,,,,,,,,,,"1,1,2,6,23,44,13,10,0",,,,,,,143,,,,,,,,,,,,,,,,,,,,,,,,,,,,,,,,,,,,,24,8,136,51,,1013,,,0,5,3,,1,0,,,,,"Aachen Laufen",,"Polar BEAT",,0,,0,168070,250480,30378,,,,,,,,,,,,,,,,,,,,,,,,,,,,,,,,,,,,,,,,,,4,
5962372,f075c571-5539-4305-8eec-6984eb210c8d,1474056184,120,1548677519,,0,0,3.26,416,424,10,34,,,1,0,0.24,,,,112,,,,,,,,,1,,,,,,,,,,,,,,4,,,31.92,,,,173,160,,1,201,188,,,,,,,,,"13,4,16,13,20,24,9",,"41,30,25,0,5",,,,,,,,,,,,,,,,,,,,,,,,,,,,,,,,,,,,,,,,,,18,3,192,73,,1013,0,,1,5,3,,1,0,,,,,"Aachen Radfahren",,"Polar BEAT",,0,,0,168072,,30378,,,,,,,,,,,,,,,,,,,,,,,,,,,,,,,,,,,,,,,,,,,
5962373,30b34fd1-3516-4eff-bcac-da8683a14d5f,1344679686,120,1548677521,,0,0,60.45,7727,7853,1705,1705,,,1,5.8,0.63,,,1178,2086,,,,,,,,,1,,,,,,,,,,,,,,86,,,30.89,,,,523,308,,1,714,480,,,,,,,,,"9,8,16,22,22,11,11",,"53,10,7,5,25",,,,,,,,,,,,,,,,,,,,,,,,,,,,,,,,,,,,,,,,,,16,6,72,74,,1025,3,,0,5,3,,1,0,,,,,,,"Polar BEAT",,0,,0,168072,,30378,,,,,,,,,,,,,,,,,,,,,,,,,,,,,,,,,,,,,,,,,,"4,4,4,4,4,4,4,4,4,5,5,5,5,5,5,5,5,5,5,5,5,5,5",
5962374,0e94e8bd-d095-487c-bf1e-e87381d5c36e,1498594581,120,1548677521,,0,0,5.12,1561,1561,32,41,,,1,0,0.13,,,,351,,,,,,,37.63,,1,,,,,,,,,,,,,,32,78,11.79,11.88,11.92,,,,,,,,,,,,,,,,,"0,4,21,31,40,6,0,0,0",,,,,,,126,,,,,,,,,,,,,,,,,,,,,,,,,,,,,,,,,,,,,26,18,128,68,,1005,0,,0,3,3,,1,0,,,,,"Aix-en-Provence Laufen",,"Polar BEAT",,0,,0,168070,250480,30378,,,,,,,,,,,,,,,,,,,,,,,,,,,,,,,,,,,,,,,,,,,
5962375,3b68c0b9-690f-4b38-860f-46411acee6b1,1516731047,60,1548677522,,0,0,15.05,3896,3904,50,52,,,1,0,0.08,1.09,0.94,,997,157,179,,,,64.14,48.98,64.39,1,,,,,,,,,,,,,,116,84,13.95,14.18,14.25,7.8,,,,,,,,,,,,,,,,"1,2,5,7,21,37,21,6,0","1,8,55,37,0",,,,,,138,,,,,,,,,,,,,,,,,,,,,,,,,,,,,,,,,,,,71.5,8,17,203,77,,1026,,,1,5,3,,1,0,I5.977|26:43-I0.214|0:40-I0.236|1:00-I0.233|0:46-I0.206|0:53-I0.225|0:48-I0.178|0:51-I0.983|3:40-I0.223|1:01-I0.993|3:42-I0.185|1:04-I0.952|3:41-I0.189|1:03-I1.063|4:00-I0.136|0:55-I0.163|0:33-I0.299|1:31-I0.224|0:45-I0.191|1:04-I0.208|0:42-I1.969|9:47,,Running,,,,"Polar M430",43,0,,0,168070,250480,30378,,,,,,,,,,,,,,,,,,,,,,,,,,,,,,,,,,,,,,,,,,,
5962376,22dc924d-5de4-4369-8200-4830a9990739,1401628901,120,1548677522,,0,0,15,3671,3671,385,390,,,1,4.4,0.8,,,519,995,,,,,,,52.25,,1,,,,,,,,,,,,,,76,84,15.28,14.98,16.03,,,,,,,,,,,,,,,,,"1,0,1,2,13,42,30,11,0",,,,,,,146,,,,,,,,,,,,,,,,,,,,,,,,,,,,,,,,,,,,,15,6,339,61,,,5,,0,5,3,,1,0,,,,,"Gesteigerter DL",,"Polar BEAT",,0,,0,168070,250480,30378,,,,,,,,,,,,,,,,,,,,,,,,,,,,,,,,,,,,,,,,,,"4,5,5,5,5,5,5",
5962377,70268983-fb22-47f3-bdfe-3c874d75ffa8,1415734193,60,1548677523,,0,0,9.3,2256,2456,89,89,,,1,0.8,0.43,,,,616,,,,,,,51.06,,1,,,,,,,,,,,,,,46,84,14.94,15.64,15.79,,,,,,,,,,,,,,,,,"10,1,1,1,5,14,45,23,0",,,,,,,147,,,,,,,,,,,,,,,,,,,,,,,,,,,,,,,,,,,,,11,7,116,85,,1003,0,,1,5,3,,1,0,,,,,"4x Einzel",,"Polar BEAT",,0,,0,168070,250480,30378,,,,,,,,,,,,,,,,,,,,,,,,,,,,,,,,,,,,,,,,,,,
5962379,09062897-e47d-4c64-9b6a-ea5595498fd7,1465853610,120,1548677523,,0,0,0.34,118,118,4,12,,,1,0.4,0.4,,,,24,,,,,,,25.24,,1,,,,,,,,,,,,,,2,81,9.96,10.31,10.27,,,,,,,,,,,,,,,,,"0,14,86,0,0,0,0,0,0",,,,,,,107,,,,,,,,,,,,,,,,,,,,,,,,,,,,,,,,,,,,,14,5,238,92,,1003,0,,0,6,3,,1,0,,,,,"Aachen Laufen",,"Polar BEAT",,0,,0,168070,250480,30378,,,,,,,,,,,,,,,,,,,,,,,,,,,,,,,,,,,,,,,,,,,
5962380,28a1a680-87f9-4474-9c4f-3dc82fbcee63,1396186223,120,1548677525,,0,0,24,6671,6954,381,382,,,1,2.9,0.61,1.05,0.99,345,1236,153,169,,,,60.89,46.81,62.08,1,,,,,,,,,,,,,,181,84,13.26,13.11,13.53,4.4,,,,,,,,,,,,,,,,"3,1,3,14,34,40,5,0,0","0,8,68,24,0",,,,,,128,,,,,,,,,,,,,,,,,,,,,,,,,,,,,,,,,,,,55.9,20,3,97,37,,1016,4,,0,5,3,,1,0,,,,,"Lockerer langer DL",,"Polar BEAT",,0,,0,168070,250480,30378,,,,,,,,,,,,,,,,,,,,,,,,,,,,,,,,,,,,,,,,,,"4,5",
5962381,742a14f4-bf83-41d0-8920-fa415dfed576,1339782402,120,1548677525,,0,0,8.43,2389,2640,142,180,,,1,2,0.5,,,319,580,,,,,,,42.28,,1,,,,,,,,,,,,,,49,,12.88,14.17,14.75,,,,,,,,,,,,,,,,,"16,2,2,7,13,21,32,7,0",,,,,,,,,,,,,,,,,,,,,,,,,,,,,,,,,,,,,,,,,,,,19,13,221,66,,1014,2,,0,5,3,,1,0,,,,,,,"Polar BEAT",,0,,0,168070,250480,30378,,,,,,,,,,,,,,,,,,,,,,,,,,,,,,,,,,,,,,,,,,4,
5962382,172a6c3f-67dc-48bc-9523-d18db8395485,1513151952,60,1548677526,,0,0,10.88,3025,3027,32,45,,,1,0,0.09,1.1,1.01,,777,157,169,,,,58.72,44,58.85,1,,,,,,,,,,,,,,89,84,12.93,12.99,13.02,1.2,,,,,,,,,,,,,,,,"0,1,2,10,53,34,0,0,0","0,6,55,38,0",,,,,,128,,,,,,,,,,,,,,,,,,,,,,,,,,,,,,,,,,,,60.3,2,5,211,80,,,0,,0,3,3,,1,0,I1.000|5:03-I1.000|4:35-I1.000|4:40-I1.000|4:35-I1.000|4:35-I1.000|4:40-I1.000|4:36-I1.000|4:29-I1.000|4:29-I1.000|4:37-I0.886|4:09,,Running,,,,"Polar M430",43,0,,0,168070,250480,30378,,,,,,,,,,,,,,,,,,,,,,,,,,,,,,,,,,,,,,,,,,,
5962383,ac60150a-8fde-4359-be85-de8d2dc68f5f,1518596203,60,1548677526,,0,0,10.83,1676,1711,34,47,,,1,0,0.13,,0.61,,338,137,163,,,,,,,1,,,,,,,,,,,,,,31,,,24.49,,3.3,-25.1,118,101,,1,138,125,,,,,,,,,"7,8,31,52,3,0,0","3,49,47,1,0","84,6,0,0,9",,,,,,,,,,,,,,,,,,,,,,,,,,,,,,,,,,,,,,,,,27.7,-6,12,85,92,,1016,,,0,2,1,,1,0,,,Cycling,,,,"Polar M430",43,0,,0,168072,,30378,,,,,,,,,,,,,,,,,,,,,,,,,,,,,,,,,,,,,,,,,,,
5962384,8bbcd3d3-bcd6-4520-b707-976273fa15ea,1473197277,120,1548677529,,0,0,3.6,1041,1088,28,53,,,1,0.6,0.44,,,,245,,,,,,,39.17,,1,,,,,,,,,,,,,,21,84,12.33,12.59,12.66,,,,,,,,,,,,,,,,,"3,2,7,15,49,23,0,0,0",,,,,,,124,,,,,,,,,,,,,,,,,,,,,,,,,,,,,,,,,,,,,18,1,104,75,,1025,0,,1,3,3,,1,0,,,,,"Aachen Laufen",,"Polar BEAT",,0,,0,168070,250480,30378,,,,,,,,,,,,,,,,,,,,,,,,,,,,,,,,,,,,,,,,,,,
5962385,012d9438-d815-47cf-bf75-188c70670b78,1419602176,60,1548677529,,0,0,15.01,3891,4107,406,409,,,1,3.8,0.69,1.22,0.88,513,872,165,210,,,,59.59,48.89,61.57,1,,,,,,,,,,,,,,142,85,14.49,14.74,15.88,9.4,,,,,,,,,,,,,,,,"11,1,1,1,7,29,46,5,0","1,8,8,83,0",,,,,,136,,,,,,,,,,,,,,,,,,,,,,,,,,,,,,,,,,,,89.9,3,5,251,91,,,0,,0,5,3,,1,0,,,,,"Zügiger DL - 1km in 9 Minuten weil Klo",,"Polar BEAT",,0,,0,168070,250480,30378,,,,,,,,,,,,,,,,,,,,,,,,,,,,,,,,,,,,,,,,,,"4,5,5,5,5,5",
5962386,2b2395a2-e09c-4a3a-84b4-8b4092fd3b8e,1477742790,120,1548677530,,0,0,12.98,3847,3848,190,192,,,1,2.4,0.64,,,372,884,,,,,,,41.38,,1,,,,,,,,,,,,,,79,80,12.42,12.27,12.55,,,,,,,,,,,,,,,,,"4,3,6,24,54,10,0,0,0",,,,,,,127,,,,,,,,,,,,,,,,,,,,,,,,,,,,,,,,,,,,,12,3,319,93,,1036,1,,0,5,3,,1,0,,,,,"Aachen Laufen",,"Polar BEAT",,0,,0,168070,250480,30378,,,,,,,,,,,,,,,,,,,,,,,,,,,,,,,,,,,,,,,,,,4,
5962387,bd1a50b2-b302-499f-8049-5a852ec74c6f,1525175150,120,1548677531,,0,0,13.01,3462,3463,32,28,,,1,0,0.05,1.15,,,909,160,180,,,,60.34,46.91,60.55,1,,,,,,,,,,,,,,111,83,13.56,13.82,13.91,5.4,,,,,,,,,,,,,,,,"1,1,6,19,16,27,29,0,0","0,3,50,47,0",,,,,,136,,,,,,,,,,,,,,,,,,,,,,,,,,,,,,,,,,,,72.5,10,14,256,55,,1014,,,0,5,3,,1,0,I1.000|4:28-I1.000|4:28-I1.000|3:51-I1.000|4:34-I1.000|3:52-I1.000|4:58-I1.000|3:58-I1.000|5:04-I1.000|4:02-I1.000|5:21-I1.000|3:44-I1.000|5:20-I1.000|4:00-I0.013|0:03,,Running,,,,"Polar M430",43,0,,0,168070,250480,30378,,,,,,,,,,,,,,,,,,,,,,,,,,,,,,,,,,,,,,,,,,,
5962388,,1332357716,60,1548677531,,0,0,2.92,0,0,,,,,0,,,,,,198,,,,,,,,,1,,,,,,,,,,,,,,0,,,,,,,,,,,,,,,,,,,,,,,,,,,,,,,,,,,,,,,,,,,,,,,,,,,,,,,,,,,,,,,,,,,,,,,,,,1,,,0,0,,,,,,,"Polar BEAT",,0,,0,168070,250480,30378,,,,,,,,,,,,,,,,,,,,,,,,,,,,,,,,,,,,,,,,,,,
5962389,4612d430-d546-46ee-a708-fe16b8248691,1479654787,60,1548677531,,0,0,3.28,950,950,29,28,,,1,0.5,0.39,,,,222,,,,,,,38.83,,1,,,,,,,,,,,,,,19,80,12.56,12.55,12.81,,,,,,,,,,,,,,,,,"3,3,3,25,43,20,3,0,0",,,,,,,129,,,,,,,,,,,,,,,,,,,,,,,,,,,,,,,,,,,,,14,20,197,51,,1000,,,0,3,3,,1,0,,,,,"Darmstadt Laufen",,"Polar BEAT",,0,,0,168070,250480,30378,,,,,,,,,,,,,,,,,,,,,,,,,,,,,,,,,,,,,,,,,,,
5962390,2e03699d-7a06-4f7f-9d52-64fad7e66525,1367669521,120,1548677532,,0,0,21.05,7737,8478,341,340,,,1,2.4,0.46,1.28,1.19,362,1432,135,210,,,,50.7,33.38,51.72,1,,,,,,,,,,,,,,146,,10.08,11.58,12,11.5,,,,,,,,,,,,,,,,"34,4,10,16,18,11,4,2,2","2,48,42,7,1",,,,,,,,,,,,,,,,,,,,,,,,,,,,,,,,,,,,,,,,,,49.3,16,8,271,55,,1019,7,,0,3,3,,1,0,,,,,,,"Polar BEAT",,0,,0,168070,250480,30378,,,,,,,,,,,,,,,,,,,,,,,,,,,,,,,,,,,,,,,,,,"4,5,5",
5962391,74d3e8d8-1796-4735-8099-14fdf23e474c,1464435958,120,1548677533,,0,0,10,2377,2514,40,41,,,1,0,0.1,,,,681,,,,,,,52.53,,1,,,,,,,,,,,,,,49,85,15.21,15.45,15.51,,,,,,,,,,,,,,,,,"5,1,1,2,6,13,63,10,0",,,,,,,148,,,,,,,,,,,,,,,,,,,,,,,,,,,,,,,,,,,,,20,5,78,56,,,6,,0,3,3,,1,0,,,,,"Hamburg Laufen",,"Polar BEAT",,0,,0,168070,250480,30378,,,,,,,,,,,,,,,,,,,,,,,,,,,,,,,,,,,,,,,,,,,
5962392,9617e18c-6bca-4686-98b6-a3b275689171,1472586937,120,1548677533,,0,0,3.82,1060,1160,54,38,,,1,0.8,0.47,,,,264,,,,,,,41.28,,1,,,,,,,,,,,,,,22,81,13.29,13.46,13.95,,,,,,,,,,,,,,,,,"10,3,2,5,21,36,22,0,0",,,,,,,133,,,,,,,,,,,,,,,,,,,,,,,,,,,,,,,,,,,,,21,3,53,55,,1024,0,,0,3,3,,1,0,,,,,"Aachen Laufen",,"Polar BEAT",,0,,0,168070,250480,30378,,,,,,,,,,,,,,,,,,,,,,,,,,,,,,,,,,,,,,,,,,,
5962393,0a88f388-b93a-49b8-84ea-a1d3dd310614,1449602481,60,1548677533,,0,0,2.32,765,765,19,28,,,1,0.9,0.61,,,,155,,,,,,,32.45,,1,,,,,,,,,,,,,,15,81,10.91,11.04,11.19,,,,,,,,,,,,,,,,,"9,5,25,53,8,0,0,0,0",,,,,,,112,,,,,,,,,,,,,,,,,,,,,,,,,,,,,,,,,,,,,10,16,197,89,,1028,,,1,6,3,,1,0,,,,,"Aachen Laufen",,"Polar BEAT",,0,,0,168070,250480,30378,,,,,,,,,,,,,,,,,,,,,,,,,,,,,,,,,,,,,,,,,,,
5962394,cf2db61a-7f59-4209-820f-35cfefc7a926,1479039257,60,1548677534,,0,0,18.04,4946,4946,197,263,,,1,1.6,0.44,,,397,1215,,,,,,,46.49,,1,,,,,,,,,,,,,,102,83,13.26,13.41,13.64,,,,,,,,,,,,,,,,,"3,3,6,13,22,38,14,0,0",,,,,,,132,,,,,,,,,,,,,,,,,,,,,,,,,,,,,,,,,,,,,5,3,137,90,,1025,1,,0,6,3,,1,0,,,,,"Stolberg (Rheinland) Laufen",,"Polar BEAT",,0,,0,168070,250480,30378,,,,,,,,,,,,,,,,,,,,,,,,,,,,,,,,,,,,,,,,,,5,
5962395,6ec03743-889e-46e5-80e8-8a2d34906bd6,1503425522,120,1548677534,,0,0,3.36,1071,1071,69,69,,,1,1.7,0.64,1.15,1.06,397,219,138,160,,,,58.83,34.77,60.33,1,,,,,,,,,,,,,,20,78,11.67,11.46,12.25,-3.8,,,,,,,,,,,,,,,,"6,11,22,29,23,9,0,0,0","3,49,48,0,0",,,,,,121,,,,,,,,,,,,,,,,,,,,,,,,,,,,,,,,,,,,21.7,22,3,61,56,,1018,1,,0,5,3,,1,0,I1.000|5:42-I1.000|5:27-I1.000|5:05-I0.370|1:38,,Running,,,,"Polar M430",43,0,,0,168070,250480,30378,,,,,,,,,,,,,,,,,,,,,,,,,,,,,,,,,,,,,,,,,,4,
5962396,549d0435-d059-4323-9986-d0bd7847d4e0,1462050588,120,1548677535,,0,0,9.83,2067,2067,0,0,,,1,0,0,,,,693,,,,,,,60.57,,1,,,,,,,,,,,,,,42,87,17.13,17.19,17.2,,,,,,,,,,,,,,,,,"0,0,0,0,0,0,46,54,0",,,,,,,164,,,,,,,,,,,,,,,,,,,,,,,,,,,,,,,,,,,,,7,4,1,87,,1022,0,,1,6,3,,1,0,,,,,"Aachen Laufen",,"Polar BEAT",,0,,0,168070,250480,30378,,,,,,,,,,,,,,,,,,,,,,,,,,,,,,,,,,,,,,,,,,,
5962397,984d4ce7-2d58-4195-88e9-ffdc8f388794,1479158711,60,1548677535,,0,0,7,2323,2325,65,65,,,1,0.7,0.42,,,,476,,,,,,,34.68,,1,,,,,,,,,,,,,,48,78,10.96,10.9,11.03,,,,,,,,,,,,,,,,,"0,13,41,40,5,0,0,0,0",,,,,,,116,,,,,,,,,,,,,,,,,,,,,,,,,,,,,,,,,,,,,4,7,192,94,,1032,0,,1,6,3,,1,0,,,,,"Aachen Laufen",,"Polar BEAT",,0,,0,168070,250480,30378,,,,,,,,,,,,,,,,,,,,,,,,,,,,,,,,,,,,,,,,,,,
5962398,a9343830-bd6f-4dfd-9119-76e241ac47aa,1418152408,60,1548677536,,0,0,15.65,4615,4818,159,161,,,1,1.4,0.51,,,,1038,,,,,,,42.24,,1,,,,,,,,,,,,,,95,82,12.24,13.51,13.89,,,,,,,,,,,,,,,,,"11,7,9,18,18,7,22,6,1",,,,,,,124,,,,,,,,,,,,,,,,,,,,,,,,,,,,,,,,,,,,,3,6,209,95,,1029,0,,1,5,3,,1,0,,,,,"5x ( hoch schnell ,trab,sprint trab)",,"Polar BEAT",,0,,0,168070,250480,30378,,,,,,,,,,,,,,,,,,,,,,,,,,,,,,,,,,,,,,,,,,,
5962399,00c021aa-9c9e-4dba-8c0e-210906b0dca9,1397671759,120,1548677536,,0,0,1.9,913,1119,12,12,,,1,0,0,,,,213,150,179,,,,31.77,20.35,32.02,1,,,,,,,,,,,,,,24,75,7.51,12.53,12.56,6.9,,,,,,,,,,,,,,,,"67,1,1,1,1,2,4,17,7","0,42,21,37,0",,,,,,83,,,,,,,,,,,,,,,,,,,,,,,,,,,,,,,,,,,,45.7,12,4,285,63,,1028,1,,0,3,3,,1,0,,,,,"Texel Staffel 3x 600m",,"Polar BEAT",,0,,0,168070,250480,30378,,,,,,,,,,,,,,,,,,,,,,,,,,,,,,,,,,,,,,,,,,,
5962400,b9ba62f3-1097-42f6-9dce-b2c163c5bf74,1454525956,60,1548677537,,0,0,10.39,2925,3548,159,155,,,1,2,0.56,,,406,722,,,,,,,43.22,,1,,,,,,,,,,,,,,60,80,13.09,12.93,13.3,,,,,,,,,,,,,,,,,"3,4,5,10,41,38,1,0,0",,,,,,,133,,,,,,,,,,,,,,,,,,,,,,,,,,,,,,,,,,,,,3,15,262,91,,1024,,,1,5,3,,1,0,,,,,"Aachen Laufen",,"Polar BEAT",,0,,0,168070,250480,30378,,,,,,,,,,,,,,,,,,,,,,,,,,,,,,,,,,,,,,,,,,4,
5962401,c509f43b-e2a5-4fe7-8ad2-fbdc9bc3a026,1337790847,120,1548677537,,0,0,10.71,3240,3292,147,148,,,1,1.6,0.49,,,407,754,,,,,,,39.82,,1,,,,,,,,,,,,,,67,,12.25,12.56,12.93,,,,,,,,,,,,,,,,,"13,5,9,17,24,19,10,1,1",,,,,,,,,,,,,,,,,,,,,,,,,,,,,,,,,,,,,,,,,,,,25,2,321,61,,1021,4,,0,5,3,,1,0,,,,,,,"Polar BEAT",,0,,0,168070,250480,30378,,,,,,,,,,,,,,,,,,,,,,,,,,,,,,,,,,,,,,,,,,4,
5962402,140533c4-cb35-436a-a13d-71d27cec3924,1546698510,60,1548677538,,0,0,10.4,3105,3109,53,48,,,1,0,0.12,1.16,0.94,,710,142,155,,,,61.54,40.35,61.96,1,,,,,,,,,,,,,,64,80,12.12,12.16,12.27,6.2,,,,,,,,,,,,,,,,"2,2,6,39,39,10,1,0,0","0,35,65,0,0",,,,,,126,,,,,,,,,,,,,,,,,,,,,,,,,,,,,,,,,,,,26.2,2,15,219,98,,1031,0,262,0,6,3,,1,0,I1.000|4:46-I1.000|4:44-I1.000|4:36-I1.000|4:47-I1.000|4:56-I1.000|5:13-I1.000|5:03-I1.000|5:11-I1.000|5:13-I1.000|5:08-I0.406|2:13,,Running,,,,"Polar M430",43,0,,0,168070,250480,30378,,,,,,,,,,,,,,,,,,,,,,,,,,,,,,,,,,,,,,,,,,,
5962403,bdfe8cc4-5fb7-4500-8d54-8249aafede69,1475834794,120,1548677539,,0,0,13,3849,3878,184,185,,,1,2.5,0.66,,,386,885,,,,,,,41.43,,1,,,,,,,,,,,,,,79,81,12.42,12.31,12.6,,,,,,,,,,,,,,,,,"3,6,5,20,55,11,0,0,0",,,,,,,125,,,,,,,,,,,,,,,,,,,,,,,,,,,,,,,,,,,,,10,7,50,93,,1021,1,,0,5,3,,1,0,,,,,"Aachen Laufen",,"Polar BEAT",,0,,0,168070,250480,30378,,,,,,,,,,,,,,,,,,,,,,,,,,,,,,,,,,,,,,,,,,4,
5962404,c323d650-9520-46a6-b50b-bd13d89e80e3,1422722922,60,1548677539,,0,0,5.19,1118,1118,0,0,,,1,0,0,,,,344,,,,,,,56.64,,1,,,,,,,,,,,,,,23,90,16.71,16.79,16.82,,,,,,,,,,,,,,,,,"0,0,0,0,0,0,73,27,0",,,,,,,155,,,,,,,,,,,,,,,,,,,,,,,,,,,,,,,,,,,,,3,12,231,80,,984,,,0,5,3,,1,0,,,,,"Neukirchen Cross",,"Polar BEAT",,0,,0,168070,250480,30378,,,,,,,,,,,,,,,,,,,,,,,,,,,,,,,,,,,,,,,,,,,
5962405,2d70fde6-07ae-444e-8a14-83f4344fdae5,1496349482,120,1548677539,,0,0,4.15,1529,1540,50,51,,,1,0,0.03,,,,220,,,,,,,29.65,,1,,,,,,,,,,,,,,31,77,9.91,12.06,12.09,,,,,,,,,,,,,,,,,"54,4,3,4,4,6,9,16,1",,,,,,,106,,,,,,,,,,,,,,,,,,,,,,,,,,,,,,,,,,,,,21,6,51,56,,1019,,,0,3,3,,1,0,,,,,"Aachen Laufen",,"Polar BEAT",,0,,0,168070,250480,30378,,,,,,,,,,,,,,,,,,,,,,,,,,,,,,,,,,,,,,,,,,,
5962406,e8969d35-23ba-4aed-bcde-bda50c05a6f0,1414096823,120,1548677539,,0,0,2.88,781,803,29,31,,,1,0,0.02,,,,164,,,,,,,41.46,,1,,,,,,,,,,,,,,16,82,13.26,15.36,15.42,,,,,,,,,,,,,,,,,"29,5,3,3,4,6,9,29,13",,,,,,,135,,,,,,,,,,,,,,,,,,,,,,,,,,,,,,,,,,,,,11,9,184,88,,1024,,,1,5,3,,1,0,,,,,"2x (300,500,300)",,"Polar BEAT",,0,,0,168070,250480,30378,,,,,,,,,,,,,,,,,,,,,,,,,,,,,,,,,,,,,,,,,,,
5962407,a40aee2a-9cac-4a25-addb-05fc65b13adf,1513969424,60,1548677539,,0,0,2.33,609,609,32,33,,,1,0.2,0.26,1.21,0.85,,147,154,176,,,,65.11,42.36,66.19,1,,,,,,,,,,,,,,17,83,13.94,14,14.33,-8.9,,,,,,,,,,,,,,,,"3,0,0,4,37,27,23,4,0","4,5,68,23,0",,,,,,138,,,,,,,,,,,,,,,,,,,,,,,,,,,,,,,,,,,,40.7,7,5,289,94,,1035,,,1,4,3,,1,0,I1.000|4:51-I1.000|4:08-I0.331|1:11,,Running,,,,"Polar M430",43,0,,0,168070,250480,30378,,,,,,,,,,,,,,,,,,,,,,,,,,,,,,,,,,,,,,,,,,,
5962408,1184841f-5f50-4a38-9d0e-a017d6dbd253,1545239830,60,1548677539,,0,0,,326,326,,,,,0,,,,,,61,128,152,,,,,,,1,,,,,,,,,,,,,,4,,,,,,,,,,,,,,,,,,,,,,"8,69,23,0,0",,,,,,,,,,,,,,,,,,,,,,,,,,,,,,,,,,,,,,,,,,9,,,,,,,,,,1,,,1,0,,,"Other indoor",,,,"Polar M430",43,0,,0,168075,,30378,,,,,,,,,,,,,,,,,,,,,,,,,,,,,,,,,,,,,,,,,,,
5962409,bca96369-2e98-4e03-80ad-d636cd7c34f9,1406232838,120,1548677541,,0,0,3.36,952,952,68,68,,,1,1.7,0.64,1.11,1.02,462,165,138,157,,,,68.06,39.91,69.77,1,,,,,,,,,,,,,,17,80,13.14,12.79,13.67,-0.1,,,,,,,,,,,,,,,,"0,0,7,29,33,25,6,0,0","1,56,43,0,0",,,,,,132,,,,,,,,,,,,,,,,,,,,,,,,,,,,,,,,,,,,18.1,19,4,68,80,,1014,0,,0,6,3,,1,0,,,,,Einlaufen,,"Polar BEAT",,0,,0,168070,250480,30378,,,,,,,,,,,,,,,,,,,,,,,,,,,,,,,,,,,,,,,,,,4,
5962410,4ceb8ab7-7676-40ed-93f9-35310fac1b56,1400270642,120,1548677542,,0,0,10.53,3311,3403,178,167,,,1,2.4,0.62,,,,710,,,,,,,38.01,,1,,,,,,,,,,,,,,68,80,11.72,11.69,12.23,,,,,,,,,,,,,,,,,"6,3,13,44,26,8,0,0,0",,,,,,,119,,,,,,,,,,,,,,,,,,,,,,,,,,,,,,,,,,,,,16,7,26,54,,1028,0,,0,3,3,,1,0,,,,,"Regenerativer DL + Fitness + Sprints",,"Polar BEAT",,0,,0,168070,250480,30378,,,,,,,,,,,,,,,,,,,,,,,,,,,,,,,,,,,,,,,,,,,
5962411,a0a8d771-a9a0-4c5b-88f6-49cb9f8f904a,1409863698,120,1548677542,,0,0,4.3,1256,1288,59,91,,,1,1.5,0.53,,,473,281,,,,,,,39.18,,1,,,,,,,,,,,,,,26,82,12.52,12.58,12.9,,,,,,,,,,,,,,,,,"7,4,7,13,39,23,7,0,0",,,,,,,125,,,,,,,,,,,,,,,,,,,,,,,,,,,,,,,,,,,,,18,3,120,80,,1017,0,,1,5,3,,1,0,,,,,Auslaufen,,"Polar BEAT",,0,,0,168070,250480,30378,,,,,,,,,,,,,,,,,,,,,,,,,,,,,,,,,,,,,,,,,,5,
5962412,db91b012-8c73-4457-b9d9-b1e52b8e8b40,1469869912,120,1548677543,,0,0,0.09,29,35,0,0,,,1,0,0,,,,5,,,,,,,26.13,,1,,,,,,,,,,,,,,0,67,10.68,10.02,10.02,,,,,,,,,,,,,,,,,"34,10,41,7,7,0,0,0,0",,,,,,,139,,,,,,,,,,,,,,,,,,,,,,,,,,,,,,,,,,,,,16,8,250,85,,1014,1,,0,5,3,,1,0,,,,,"Aachen Laufen",,"Polar BEAT",,0,,0,168070,250480,30378,,,,,,,,,,,,,,,,,,,,,,,,,,,,,,,,,,,,,,,,,,,
5962413,d43404f8-e7f2-467f-8ae5-de0921ede46e,1392897107,60,1548677543,,0,0,5.48,1580,1671,80,80,,,1,1,0.41,1.13,0.93,2855,281,138,161,,,,66.6,40.37,67.81,1,,,,,,,,,,,,,,30,83,12.7,12.71,12.96,6.1,,,,,,,,,,,,,,,,"9,2,6,12,33,37,1,0,1","2,52,45,0,0",,,,,,125,,,,,,,,,,,,,,,,,,,,,,,,,,,,,,,,,,,,23.5,10,15,202,75,,1010,2,,0,5,3,,1,0,,,,,Regeneration,,"Polar BEAT",,0,,0,168070,250480,30378,,,,,,,,,,,,,,,,,,,,,,,,,,,,,,,,,,,,,,,,,,5,
5962414,b09115fb-d8e0-40da-bc8e-9bee29b76170,1482512307,60,1548677544,,0,0,4.9,1410,1410,67,69,,,1,1.2,0.49,,,253,334,,,,,,,40.19,,1,,,,,,,,,,,,,,29,79,12.76,12.66,12.91,,,,,,,,,,,,,,,,,"1,3,1,35,32,24,2,0,0",,,,,,,132,,,,,,,,,,,,,,,,,,,,,,,,,,,,,,,,,,,,,5,3,216,94,,,0,,1,3,3,,1,0,,,,,"Balve Laufen",,"Polar BEAT",,0,,0,168070,250480,30378,,,,,,,,,,,,,,,,,,,,,,,,,,,,,,,,,,,,,,,,,,5,
5962415,76084844-9bf4-4e99-a130-4dbcaea65529,1481406708,60,1548677544,,0,0,1.03,335,345,29,26,,,1,1.2,0.61,,,,73,,,,,,,30.2,,1,,,,,,,,,,,,,,6,79,11.68,11.23,11.78,,,,,,,,,,,,,,,,,"10,11,19,43,11,6,0,0,0",,,,,,,117,,,,,,,,,,,,,,,,,,,,,,,,,,,,,,,,,,,,,9,9,220,82,,1022,0,,1,4,3,,1,0,,,,,"Aachen Laufen",,"Polar BEAT",,0,,0,168070,250480,30378,,,,,,,,,,,,,,,,,,,,,,,,,,,,,,,,,,,,,,,,,,,
5962416,6475c5fe-4eca-499b-b03d-567f9437d7df,1426015973,60,1548677545,,0,0,12.9,3739,4233,20,48,,,1,0,0.12,,,,850,,,,,,,42.45,,1,,,,,,,,,,,,,,77,80,12.37,14.28,14.32,,,,,,,,,,,,,,,,,"22,3,7,10,8,1,32,16,0",,,,,,,129,,,,,,,,,,,,,,,,,,,,,,,,,,,,,,,,,,,,,8,4,345,72,,1030,0,,1,5,3,,1,0,,,,,"Aachen Laufen",,"Polar BEAT",,0,,0,168070,250480,30378,,,,,,,,,,,,,,,,,,,,,,,,,,,,,,,,,,,,,,,,,,,
5962417,ccf0972b-9366-4e56-8a5b-2569ef1cb32f,1548180616,60,1548677545,,0,0,18.01,4654,4681,66,68,,,1,0,0.09,,0.86,,1231,157,185,,,,64.28,49.78,64.56,1,,,,,,,,,,,,,,137,84,13.96,14.55,14.63,16.8,,,,,,,,,,,,,,,,"3,10,11,4,7,22,34,9,0","0,4,54,41,0",,,,,,138,,,,,,,,,,,,,,,,,,,,,,,,,,,,,,,,,,,,72.4,0,5,38,79,,1007,0,362,1,5,3,,1,0,I2.258|10:17-I0.299|1:01-I0.237|1:01-I0.306|1:02-I0.225|0:58-I0.295|1:00-I0.229|0:59-I0.281|1:00-I0.233|1:00-I0.281|1:00-I0.243|1:02-I0.550|2:02-I0.246|1:00-I0.565|2:00-I0.233|1:01-I0.585|2:02-I0.239|1:03-I0.552|2:01-I0.263|1:06-I0.568|2:01-I0.227|1:01-I0.565|2:01-I0.249|1:06-I0.560|2:01-I0.225|1:02-I0.550|2:03-I0.233|1:01-I0.572|2:02-I0.223|1:00-I0.553|2:02-I0.217|1:01-I0.274|1:00-I0.213|1:02-I0.274|1:02-I0.216|1:02-I0.264|1:02-I0.213|1:03-I0.273|1:00-I0.193|1:03-I0.282|1:03-I2.926|17:55,,Running,,,,"Polar M430",43,0,,0,168070,250480,30378,,,,,,,,,,,,,,,,,,,,,,,,,,,,,,,,,,,,,,,,,,,
5962418,444173d9-73d6-4487-a364-efda18ddf18e,1349292018,120,1548677546,,0,0,18.36,6000,6148,88,85,,,1,0,0.12,0.93,0.78,,1272,143,210,,,,54.55,37.95,54.88,1,,,,,,,,,,,,,,137,,11.1,11.8,11.9,7.9,,,,,,,,,,,,,,,,"15,4,9,23,35,12,1,0,1","4,22,71,1,3",,,,,,,,,,,,,,,,,,,,,,,,,,,,,,,,,,,,,,,,,,67.1,16,3,256,71,,1016,0,,1,5,3,,1,0,,,,,,,"Polar BEAT",,0,,0,168070,250480,30378,,,,,,,,,,,,,,,,,,,,,,,,,,,,,,,,,,,,,,,,,,,
5962419,ac9c0100-72ba-4c42-997d-f2acb8fc7a51,1429958700,120,1548677547,,0,0,2.44,1025,1027,18,20,,,1,0.4,0.33,,,,171,,,,,,,24.45,,1,,,,,,,,,,,,,,21,73,8.64,11.43,11.68,,,,,,,,,,,,,,,,,"37,2,3,18,28,2,3,7,0",,,,,,,98,,,,,,,,,,,,,,,,,,,,,,,,,,,,,,,,,,,,,13,11,227,80,,1008,,,0,5,3,,1,0,,,,,"Balve Laufen",,"Polar BEAT",,0,,0,168070,250480,30378,,,,,,,,,,,,,,,,,,,,,,,,,,,,,,,,,,,,,,,,,,,
5962420,f01a4652-13de-4a80-b123-7fcf927792e2,1496955324,120,1548677547,,0,0,4.54,1418,1418,77,131,,,1,1.9,0.78,,,449,304,,,,,,,36.31,,1,,,,,,,,,,,,,,29,79,11.72,11.78,11.88,,,,,,,,,,,,,,,,,"13,11,14,19,26,15,2,0,0",,,,,,,122,,,,,,,,,,,,,,,,,,,,,,,,,,,,,,,,,,,,,22,7,228,57,,1013,0,,0,5,3,,1,0,,,,,"Aachen Laufen",,"Polar BEAT",,0,,0,168070,250480,30378,,,,,,,,,,,,,,,,,,,,,,,,,,,,,,,,,,,,,,,,,,5,
5962421,7825825a-5e71-4c13-8613-dd8f9c84836a,1412108206,120,1548677547,,0,0,3.35,985,985,68,67,,,1,1.7,0.64,,,431,221,,,,,,,38.22,,1,,,,,,,,,,,,,,20,82,12.66,12.34,13.14,,,,,,,,,,,,,,,,,"2,3,15,21,39,16,3,0,0",,,,,,,124,,,,,,,,,,,,,,,,,,,,,,,,,,,,,,,,,,,,,15,1,165,89,,1026,0,,1,3,3,,1,0,,,,,Einlaufen,,"Polar BEAT",,0,,0,168070,250480,30378,,,,,,,,,,,,,,,,,,,,,,,,,,,,,,,,,,,,,,,,,,5,
5962422,d2a0d225-b637-4100-9b25-998e994c13ad,1518512447,60,1548677548,,0,0,11.04,1601,1601,46,55,,,1,0,0.11,,0.6,,356,148,176,,,,,,,1,,,,,,,,,,,,,,40,,,26.37,,0.9,-23.2,143,119,,1,162,145,,,,,,,,,"9,6,12,65,8,0,0","1,27,39,33,0","66,23,0,1,10",,,,,,,,,,,,,,,,,,,,,,,,,,,,,,,,,,,,,,,,,53.6,-1,1,174,83,,,,,0,3,3,,1,0,,,Cycling,,,,"Polar M430",43,0,,0,168072,,30378,,,,,,,,,,,,,,,,,,,,,,,,,,,,,,,,,,,,,,,,,,,
5962423,78d531f4-f596-4e9a-bd6b-dc3a7a9fdfef,1526320430,120,1548677548,,0,0,8.94,3064,3074,24,24,,,1,0,0.11,1.1,0.92,,598,132,143,,,,56.77,33.93,56.96,1,,,,,,,,,,,,,,48,80,10.55,10.55,10.64,0.1,,,,,,,,,,,,,,,,"8,20,39,30,2,0,0,0,0","1,98,1,0,0",,,,,,109,,,,,,,,,,,,,,,,,,,,,,,,,,,,,,,,,,,,15,17,3,207,86,,,2,,0,6,3,,1,0,I1.000|5:37-I1.000|5:55-I1.000|5:40-I1.000|5:38-I1.000|5:56-I1.000|5:33-I1.000|5:41-I1.000|5:40-I0.947|5:34,,Running,,,,"Polar M430",43,0,,0,168070,250480,30378,,,,,,,,,,,,,,,,,,,,,,,,,,,,,,,,,,,,,,,,,,,
5962424,50eb2340-7be7-4193-9cc1-df09f134e838,1430673613,120,1548677549,,0,0,4.06,1095,1095,23,26,,,1,0,0.11,1.1,0.86,,199,152,166,,,,63.77,42.86,64.16,1,,,,,,,,,,,,,,28,81,13.47,13.49,13.63,-5.6,,,,,,,,,,,,,,,,"1,1,3,10,29,48,8,0,0","1,4,91,5,0",,,,,,137,,,,,,,,,,,,,,,,,,,,,,,,,,,,,,,,,,,,37.7,14,14,169,92,,1001,,,0,6,3,,1,0,,,,,"Menden Laufen",,"Polar BEAT",,0,,0,168070,250480,30378,,,,,,,,,,,,,,,,,,,,,,,,,,,,,,,,,,,,,,,,,,,
5962425,1042fe8d-1206-4eb4-8fea-d41f91bba1ff,1483643664,60,1548677549,,0,0,5.57,2274,2275,68,69,,,1,1.3,0.64,,,,382,,,,,,,26.64,,1,,,,,,,,,,,,,,47,73,8.89,10.92,11.03,,,,,,,,,,,,,,,,,"27,3,13,24,27,4,0,0,0",,,,,,,101,,,,,,,,,,,,,,,,,,,,,,,,,,,,,,,,,,,,,-3,3,31,82,,1037,0,,1,5,3,,1,0,,,,,"Aachen Laufen",,"Polar BEAT",,0,,0,168070,250480,30378,,,,,,,,,,,,,,,,,,,,,,,,,,,,,,,,,,,,,,,,,,,
5962426,32dfa5e5-c63a-4ef5-9fda-e5d9ebaaeecf,1455823679,60,1548677549,,0,0,8.8,2097,2097,327,303,,,1,4.9,0.79,,,1015,568,,,,,,,51.96,,1,,,,,,,,,,,,,,43,86,16.17,15.27,17.2,,,,,,,,,,,,,,,,,"0,0,1,10,13,20,39,17,0",,,,,,,146,,,,,,,,,,,,,,,,,,,,,,,,,,,,,,,,,,,,,1,5,184,72,,1017,,,1,3,3,,1,0,,,,,"Aachen Laufen",,"Polar BEAT",,0,,0,168070,250480,30378,,,,,,,,,,,,,,,,,,,,,,,,,,,,,,,,,,,,,,,,,,"5,5,5,5,5,5,5,5,5,5,5,5,5",
5962427,f1366383-dc68-4c17-aa60-15e0d2d0461b,1433753033,120,1548677550,,0,0,14,3804,3815,272,272,,,1,3.1,0.64,,,585,949,,,,,,,46.05,,1,,,,,,,,,,,,,,79,82,13.72,13.46,13.93,,,,,,,,,,,,,,,,,"0,0,4,19,27,36,14,0,0",,,,,,,135,,,,,,,,,,,,,,,,,,,,,,,,,,,,,,,,,,,,,11,18,26,76,,1030,,,0,5,3,,1,0,,,,,"Voeren Sint-Martens-Voeren Laufen",,"Polar BEAT",,0,,0,168070,250480,30378,,,,,,,,,,,,,,,,,,,,,,,,,,,,,,,,,,,,,,,,,,"4,4,5",
5962428,0a55ae31-45d6-4213-8518-4a486fcc5762,1413373105,120,1548677550,,0,0,8.74,2868,3226,106,131,,,1,1.2,0.53,1.04,1,,447,129,149,,,,61.54,35.66,62.25,1,,,,,,,,,,,,,,42,82,11.08,11.04,11.24,-1.2,,,,,,,,,,,,,,,,"5,12,29,43,8,3,0,0,0","0,91,9,0,0",,,,,,111,,,,,,,,,,,,,,,,,,,,,,,,,,,,,,,,,,,,16.5,14,7,242,78,,1008,2,,0,5,3,,1,0,,,,,"Langsamer DL",,"Polar BEAT",,0,,0,168070,250480,30378,,,,,,,,,,,,,,,,,,,,,,,,,,,,,,,,,,,,,,,,,,,
5962429,37edcb6d-c5af-4b30-ac0c-114de0378f91,1410009031,120,1548677551,,0,0,3.38,1033,1033,67,68,,,1,1.7,0.58,,,396,219,,,,,,,36.55,,1,,,,,,,,,,,,,,21,82,12.19,12.13,12.8,,,,,,,,,,,,,,,,,"6,13,16,33,15,9,4,2,1",,,,,,,120,,,,,,,,,,,,,,,,,,,,,,,,,,,,,,,,,,,,,20,3,235,82,,1014,4,,0,5,3,,1,0,,,,,"Einlaufen + Lauf ABC",,"Polar BEAT",,0,,0,168070,250480,30378,,,,,,,,,,,,,,,,,,,,,,,,,,,,,,,,,,,,,,,,,,4,
5962430,f3038a8c-f5a7-4d53-afa3-2ba15692e400,1527064946,120,1548677551,,0,0,7.57,1357,1393,25,33,,,1,0,0.08,,0.44,,194,113,130,,,,,,,1,,,,,,,,,,,,,,12,,,22.89,,23,-39.6,105,85,,1,129,117,,,,,,,,,"19,7,49,24,2,0,0","16,84,0,0,0","87,5,0,0,8",,,,,,,,,,,,,,,,,,,,,,,,,,,,,,,,,,,,,,,,,7.2,15,2,198,96,,,2,,0,5,3,,1,0,,,Cycling,,,,"Polar M430",43,0,,0,168072,,30378,,,,,,,,,,,,,,,,,,,,,,,,,,,,,,,,,,,,,,,,,,,
5962431,976f2477-40c1-40e6-ad6f-4027b6a51db2,1514880000,60,1548677552,,0,0,11.35,2756,2756,20,32,,,1,0,0.09,,,,281,98,125,,,,,,,1,,,,,,,,,,,,,,15,,,16.22,,-6.5,-44.8,58,47,,1,73,66,,,,,,,,,"22,74,3,1,0,0,0","69,31,0,0,0","90,1,9,0,0",,,,,,,,,,,,,,,,,,,,,,,,,,,,,,,,,,,,,,,,,3.9,6,5,239,82,,,0,,0,4,3,,1,0,,,Cycling,,,,"Polar M430",43,0,,0,168072,,30378,,,,,,,,,,,,,,,,,,,,,,,,,,,,,,,,,,,,,,,,,,,
5962432,4fbcd67b-1e87-4843-847e-bb3fa5c1f0bc,1499854743,120,1548677552,,0,0,2.54,821,830,55,54,,,1,1.5,0.6,,,399,172,,,,,,,33.47,,1,,,,,,,,,,,,,,17,78,11.5,11.23,11.83,,,,,,,,,,,,,,,,,"0,17,24,41,18,0,0,0,0",,,,,,,119,,,,,,,,,,,,,,,,,,,,,,,,,,,,,,,,,,,,,27,8,283,56,,1016,,,0,3,3,,1,0,,,,,"Aix-en-Provence Laufen",,"Polar BEAT",,0,,0,168070,250480,30378,,,,,,,,,,,,,,,,,,,,,,,,,,,,,,,,,,,,,,,,,,5,
5962433,cdb80da5-63b2-4bb9-a5fe-8f159ffb55af,1420451278,60,1548677553,,0,0,13.18,3594,3605,169,169,,,1,1.8,0.6,,,397,883,,,,,,,45.64,,1,,,,,,,,,,,,,,74,84,13.41,13.33,13.52,,,,,,,,,,,,,,,,,"1,0,2,18,26,49,4,0,0",,,,,,,131,,,,,,,,,,,,,,,,,,,,,,,,,,,,,,,,,,,,,-1,6,214,93,,1035,0,,0,3,3,,1,0,,,,,"Langsamer DL",,"Polar BEAT",,0,,0,168070,250480,30378,,,,,,,,,,,,,,,,,,,,,,,,,,,,,,,,,,,,,,,,,,5,
5962434,36560f7f-6668-45ab-b37c-fa8994493a48,1545990151,60,1548677555,,0,0,10.81,3106,3107,331,334,,,1,4.1,0.74,1.1,1.11,479,840,159,178,,,,55.38,42.32,57.46,1,,,,,,,,,,,,,,96,84,13.58,14,14.42,-26.5,,,,,,,,,,,,,,,,"14,13,25,14,4,1,10,18,2","0,6,52,42,0",,,,,,124,,,,,,,,,,,,,,,,,,,,,,,,,,,,,,,,,,,,77.2,-2,9,193,100,,,,,0,3,3,,1,0,I1.000|5:20-I1.000|6:25-I1.000|6:15-I1.000|5:35-I1.000|5:53-I1.000|5:41-I1.000|3:11-I1.000|3:19-I1.000|3:24-I1.000|3:30-I0.808|3:15,,Running,,,,"Polar M430",43,0,,0,168070,250480,30378,,,,,,,,,,,,,,,,,,,,,,,,,,,,,,,,,,,,,,,,,,3,
5962435,2d0daf56-401e-433e-b21d-bed90193238f,1475496115,120,1548677555,,0,0,6.84,2064,2500,91,91,,,1,1.3,0.53,,,,463,,,,,,,38.76,,1,,,,,,,,,,,,,,42,80,12.1,12.54,12.73,,,,,,,,,,,,,,,,,"9,3,9,16,31,28,3,0,0",,,,,,,124,,,,,,,,,,,,,,,,,,,,,,,,,,,,,,,,,,,,,13,11,293,85,,1026,,,0,5,3,,1,0,,,,,"Aachen Laufen",,"Polar BEAT",,0,,0,168070,250480,30378,,,,,,,,,,,,,,,,,,,,,,,,,,,,,,,,,,,,,,,,,,,
5962436,6436e874-f504-4662-a49a-20a05b62f5db,1522143132,120,1548677556,,0,0,10.32,3114,3119,62,61,,,1,0,0.26,1.09,0.92,,711,147,158,,,,58.07,39.83,58.5,1,,,,,,,,,,,,,,72,82,12.01,12,12.16,4.2,,,,,,,,,,,,,,,,"1,3,12,39,38,7,0,0,0","0,16,84,0,0",,,,,,121,,,,,,,,,,,,,,,,,,,,,,,,,,,,,,,,,,,,33.2,6,5,198,90,,1018,1,,0,5,3,,1,0,I1.000|4:54-I1.000|4:50-I1.000|4:41-I1.000|5:05-I1.000|5:09-I1.000|5:05-I1.000|5:15-I1.000|5:11-I1.000|5:05-I1.000|5:02-I0.323|1:42,,Running,,,,"Polar M430",43,0,,0,168070,250480,30378,,,,,,,,,,,,,,,,,,,,,,,,,,,,,,,,,,,,,,,,,,,
5962437,79365b5d-774c-401f-963d-73afe92a25f4,1400789414,120,1548677556,,0,0,3.29,926,926,65,64,,,1,1.7,0.63,,,487,217,,,,,,,40.16,,1,,,,,,,,,,,,,,19,82,13.19,12.93,13.95,,,,,,,,,,,,,,,,,"0,2,14,27,17,26,14,0,0",,,,,,,130,,,,,,,,,,,,,,,,,,,,,,,,,,,,,,,,,,,,,15,16,148,81,,1009,,,0,5,3,,1,0,,,,,Einlaufen,,"Polar BEAT",,0,,0,168070,250480,30378,,,,,,,,,,,,,,,,,,,,,,,,,,,,,,,,,,,,,,,,,,4,
5962438,075840b2-2442-4a88-a0f2-a31e97ef6e1c,1393874803,60,1548677557,,0,0,8.04,2089,2207,142,125,,,1,1.7,0.45,,,287,529,,,,,,,46.68,,1,,,,,,,,,,,,,,43,85,14.32,14.07,14.6,,,,,,,,,,,,,,,,,"0,2,2,6,28,41,17,3,0",,,,,,,136,,,,,,,,,,,,,,,,,,,,,,,,,,,,,,,,,,,,,6,4,149,71,,994,0,,1,5,3,,1,0,,,,,"Züggiger DL   Lauf ABC",,"Polar BEAT",,0,,0,168070,250480,30378,,,,,,,,,,,,,,,,,,,,,,,,,,,,,,,,,,,,,,,,,,4,
5962439,bc0f03ce-4e55-4079-bdee-3ad8c4ee6514,1471215610,120,1548677557,,0,0,0.55,161,165,0,1,,,1,0,0,,,,38,,,,,,,31.98,,1,,,,,,,,,,,,,,3,78,12.23,12.35,12.29,,,,,,,,,,,,,,,,,"0,0,3,42,43,12,0,0,0",,,,,,,131,,,,,,,,,,,,,,,,,,,,,,,,,,,,,,,,,,,,,26,4,331,65,,1018,0,,1,3,3,,1,0,,,,,"Naujac-sur-Mer Laufen",,"Polar BEAT",,0,,0,168070,250480,30378,,,,,,,,,,,,,,,,,,,,,,,,,,,,,,,,,,,,,,,,,,,
5962440,eedb15cb-0047-4fa7-8e91-b45ae19be1fa,1408822799,120,1548677558,,0,0,3.01,596,596,30,24,,,1,0.8,0.54,,,,203,,,,,,,59.54,,1,,,,,,,,,,,,,,12,88,18.41,18.25,18.61,,,,,,,,,,,,,,,,,"0,0,0,0,0,0,16,84,0",,,,,,,172,,,,,,,,,,,,,,,,,,,,,,,,,,,,,,,,,,,,,13,4,244,85,,1015,0,,0,6,3,,1,0,,,,,Einlaufen,,"Polar BEAT",,0,,0,168070,250480,30378,,,,,,,,,,,,,,,,,,,,,,,,,,,,,,,,,,,,,,,,,,,
5962441,e2f02e34-bc96-4f73-b6a8-fb919bbc3bfb,1400109313,120,1548677558,,0,0,2.97,553,553,11,8,,,1,0,0,,,,191,,,,,,,63.73,,1,,,,,,,,,,,,,,11,91,19.42,19.46,19.6,,,,,,,,,,,,,,,,,"0,0,0,0,0,0,4,67,30",,,,,,,177,,,,,,,,,,,,,,,,,,,,,,,,,,,,,,,,,,,,,9,0,293,80,,,0,,1,3,3,,1,0,,,,,"WK 3.000m Dortmund  Rote Erde",,"Polar BEAT",,0,,0,168070,250480,30378,,,,,,,,,,,,,,,,,,,,,,,,,,,,,,,,,,,,,,,,,,,
5962442,ddd9ba23-44cc-423a-a3c6-34cd5b6739a3,1349263381,120,1548677559,,0,0,30.84,4204,4231,203,202,,,1,0.2,0.2,1.23,1.54,496,1080,127,210,,,,,,,1,,,,,,,,,,,,,,63,,,32.06,,14.2,-46,356,241,,1,609,523,,,,,,,,,"19,6,12,23,18,8,13","4,83,11,0,1","57,13,9,5,16",,,,,,,,,,,,,,,,,,,,,,,,,,,,,,,,,,,,,,,,,38.1,14,3,242,72,,1018,3,,0,5,3,,1,0,,,,,,,"Polar BEAT",,0,,0,168072,,30378,,,,,,,,,,,,,,,,,,,,,,,,,,,,,,,,,,,,,,,,,,5,
5962443,4583cf33-5da2-4e5d-bf39-203362b0eeaf,1446579005,60,1548677559,,0,0,12.58,3024,3221,124,124,,,1,1,0.42,,,,844,,,,,,,52.66,,1,,,,,,,,,,,,,,62,85,15.08,15.97,16.17,,,,,,,,,,,,,,,,,"11,0,0,0,1,13,43,29,2",,,,,,,147,,,,,,,,,,,,,,,,,,,,,,,,,,,,,,,,,,,,,10,6,121,79,,1019,,,1,5,3,,1,0,,,,,"Aachen Laufen",,"Polar BEAT",,0,,0,168070,250480,30378,,,,,,,,,,,,,,,,,,,,,,,,,,,,,,,,,,,,,,,,,,,
5962444,1bce4e2e-b9e9-4b8f-aa70-d65927c18b17,1499006182,120,1548677560,,0,0,0.01,11,12,0,1,,,1,1.2,1,,,,3,,,,,,,,,1,,,,,,,,,,,,,,0,61,3.92,3.92,3.92,,,,,,,,,,,,,,,,,"100,0,0,0,0,0,0,0,0",,,,,,,45,,,,,,,,,,,,,,,,,,,,,,,,,,,,,,,,,,,,,25,31,325,45,,1017,9,,0,3,3,,1,0,,,,,"Saint-Marc-Jaumegarde Laufen",,"Polar BEAT",,0,,0,168070,250480,30378,,,,,,,,,,,,,,,,,,,,,,,,,,,,,,,,,,,,,,,,,,,
5962445,30bd5087-bf9f-43a6-87e5-5ff8d7be7e47,1407704554,120,1548677560,,0,0,5,1017,1017,46,46,,,1,0.7,0.44,1.02,0.97,,250,170,182,,,,76.92,60.4,77.81,1,,,,,,,,,,,,,,40,89,17.84,17.75,17.9,3.1,,,,,,,,,,,,,,,,"0,0,0,0,0,0,29,71,0","0,2,9,86,4",,,,,,166,,,,,,,,,,,,,,,,,,,,,,,,,,,,,,,,,,,,87.2,19,12,247,86,,1004,0,,1,6,3,,1,0,,,,,TDL,,"Polar BEAT",,0,,0,168070,250480,30378,,,,,,,,,,,,,,,,,,,,,,,,,,,,,,,,,,,,,,,,,,,
5962446,8fe8b857-8bab-490e-a2cd-089e211ebfc2,1507024898,120,1548677561,,0,0,15,3908,3908,403,402,,,1,4,0.69,1.24,0.9,543,1094,165,176,,,,59.22,48.6,61.19,1,,,,,,,,,,,,,,137,82,14.34,13.86,15.02,3.3,,,,,,,,,,,,,,,,"0,0,0,1,23,68,8,0,0","1,1,19,79,0",,,,,,140,,,,,,,,,,,,,,,,,,,,,,,,,,,,,,,,,,,,79.7,11,11,252,99,,,1,,0,5,3,,1,0,I1.000|4:25-I1.000|4:14-I1.000|4:22-I1.000|4:26-I1.000|4:21-I1.000|4:19-I1.000|4:18-I1.000|4:19-I1.000|4:13-I1.000|4:05-I1.000|4:19-I1.000|4:26-I1.000|4:29-I1.000|4:23-I1.000|4:31,,Running,,,,"Polar M430",43,0,,0,168070,250480,30378,,,,,,,,,,,,,,,,,,,,,,,,,,,,,,,,,,,,,,,,,,"4,5,5,5,5,5",
5962447,387f6a98-6dea-4b04-8b7d-3375119e2db8,1468873980,120,1548677561,,0,0,19.84,5204,5501,296,296,,,1,2.7,0.57,,,379,1355,,,,,,,49.31,,1,,,,,,,,,,,,,,108,83,14.08,14.11,14.44,,,,,,,,,,,,,,,,,"4,1,3,9,21,31,27,3,0",,,,,,,138,,,,,,,,,,,,,,,,,,,,,,,,,,,,,,,,,,,,,26,1,326,54,,1021,0,,0,3,3,,1,0,,,,,"Aachen Laufen",,"Polar BEAT",,0,,0,168070,250480,30378,,,,,,,,,,,,,,,,,,,,,,,,,,,,,,,,,,,,,,,,,,"4,5,5,5",
5962448,95a38b41-4e20-4d96-8352-98d78905646a,1409862876,120,1548677562,,0,0,2.46,543,543,20,21,,,1,0,0.01,,,,137,,,,,,,51.55,,1,,,,,,,,,,,,,,11,87,16.35,16.95,17.01,,,,,,,,,,,,,,,,,"7,2,5,7,4,4,6,48,16",,,,,,,156,,,,,,,,,,,,,,,,,,,,,,,,,,,,,,,,,,,,,18,3,120,80,,1017,0,,1,5,3,,1,0,,,,,"1000,500,300,200",,"Polar BEAT",,0,,0,168070,250480,30378,,,,,,,,,,,,,,,,,,,,,,,,,,,,,,,,,,,,,,,,,,,
5962449,3a2dca9b-0c69-4e2b-9b31-208d5b4b484d,1350215477,120,1548677563,,0,0,19.8,5979,6123,79,78,,,1,0,0.17,,,,1380,,,,,,,41.87,,1,,,,,,,,,,,,,,124,,11.97,12.38,12.48,,,,,,,,,,,,,,,,,"7,5,12,23,29,16,6,1,1",,,,,,,,,,,,,,,,,,,,,,,,,,,,,,,,,,,,,,,,,,,,11,3,226,77,,1006,2,,0,5,3,,1,0,,,,,,,"Polar BEAT",,0,,0,168070,250480,30378,,,,,,,,,,,,,,,,,,,,,,,,,,,,,,,,,,,,,,,,,,,
5962450,05077d7e-9992-4c3d-92cf-5a5bdff7d896,1544119670,60,1548677563,,0,0,13.6,3663,3663,62,62,,,1,0,0.09,1.11,0.9,,936,153,178,,,,63.31,46.41,63.66,1,,,,,,,,,,,,,,99,82,13.42,13.64,13.73,5.7,,,,,,,,,,,,,,,,"0,1,4,28,18,27,22,1,0","0,22,45,33,0",,,,,,136,,,,,,,,,,,,,,,,,,,,,,,,,,,,,,,,,,,,73.3,12,13,220,85,,1022,0,281,1,5,3,,1,0,I1.000|4:37-I1.000|4:38-I1.000|4:21-I1.000|4:14-I1.000|3:56-I1.000|4:03-I1.000|3:54-I1.000|3:50-I1.000|4:10-I1.000|4:51-I1.000|5:06-I1.000|5:09-I1.000|5:07-I0.606|3:06,,Running,,,,"Polar M430",43,0,,0,168070,250480,30378,,,,,,,,,,,,,,,,,,,,,,,,,,,,,,,,,,,,,,,,,,,
5962451,d247cdf8-6b1c-4655-9c39-9138683b7968,1466434102,120,1548677564,,0,0,10.01,2429,2462,138,152,,,1,1.8,0.57,,,592,684,,,,,,,51.28,,1,,,,,,,,,,,,,,50,84,15.1,15.09,15.34,,,,,,,,,,,,,,,,,"2,0,1,3,13,25,52,5,0",,,,,,,147,,,,,,,,,,,,,,,,,,,,,,,,,,,,,,,,,,,,,19,13,202,67,,1018,5,,0,5,3,,1,0,,,,,"Voeren Sint-Martens-Voeren Laufen",,"Polar BEAT",,0,,0,168070,250480,30378,,,,,,,,,,,,,,,,,,,,,,,,,,,,,,,,,,,,,,,,,,4,
5962452,,1414270260,120,1548677564,,0,0,3,0,0,,,,,0,,,,,,203,,,,,,,,,1,,,,,,,,,,,,,,0,,,,,,,,,,,,,,,,,,,,,,,,,,,,,,,,,,,,,,,,,,,,,,,,,,,,,,,,,,,,,,,,,,,,,,,,,,1,,,0,0,,,,,Auslaufen,,"Polar BEAT",,0,,0,168070,250480,30378,,,,,,,,,,,,,,,,,,,,,,,,,,,,,,,,,,,,,,,,,,,
5962453,629f5d1d-9c08-4d3b-8ded-bbad6974ec60,1395688098,60,1548677564,,0,0,5.08,1397,1397,106,111,,,1,1.7,0.68,1.21,0.9,,272,145,157,,,,66.31,42.49,67.94,1,,,,,,,,,,,,,,30,82,13.43,13.16,13.81,-4.9,,,,,,,,,,,,,,,,"0,0,3,6,52,39,0,0,0","0,7,93,0,0",,,,,,133,,,,,,,,,,,,,,,,,,,,,,,,,,,,,,,,,,,,30.3,5,1,27,84,,1014,0,,1,5,3,,1,0,,,,,Auslaufen,,"Polar BEAT",,0,,0,168070,250480,30378,,,,,,,,,,,,,,,,,,,,,,,,,,,,,,,,,,,,,,,,,,,
5962454,0d1ba00a-2fb1-4f5c-8a42-7c6a86ba33d4,1393528391,60,1548677565,,0,0,3.05,940,940,26,36,,,1,0.4,0.41,1.07,1.07,,182,153,173,,,,53.6,35.92,53.95,1,,,,,,,,,,,,,,25,81,11.7,11.76,11.77,-6.2,,,,,,,,,,,,,,,,"4,2,7,48,36,3,0,0,0","0,9,65,26,0",,,,,,120,,,,,,,,,,,,,,,,,,,,,,,,,,,,,,,,,,,,33.6,4,12,208,90,,1010,0,,1,5,3,,1,0,,,,,Einlaufen,,"Polar BEAT",,0,,0,168070,250480,30378,,,,,,,,,,,,,,,,,,,,,,,,,,,,,,,,,,,,,,,,,,,
5962455,5b2da339-e726-4e4c-a5da-44b6427b93ac,1393501273,60,1548677565,,0,0,1.11,342,342,4,30,,,1,0.8,0.55,1.17,1,,63,140,154,,,,60.26,32.39,58.79,1,,,,,,,,,,,,,,6,84,11.15,11.66,11.3,-16,,,,,,,,,,,,,,,,"19,6,6,30,17,13,8,0,0","0,51,49,0,0",,,,,,116,,,,,,,,,,,,,,,,,,,,,,,,,,,,,,,,,,,,12.4,8,14,185,75,,1014,2,,0,5,3,,1,0,,,,,Auslaufen,,"Polar BEAT",,0,,0,168070,250480,30378,,,,,,,,,,,,,,,,,,,,,,,,,,,,,,,,,,,,,,,,,,,
5962456,6b269cd1-9cf4-4808-8369-8130a4f3e627,1452276477,60,1548677565,,0,0,10.01,2263,2263,77,87,,,1,0.5,0.34,,,,677,,,,,,,55.71,,1,,,,,,,,,,,,,,47,85,15.98,16.03,16.11,,,,,,,,,,,,,,,,,"0,0,1,0,2,14,69,14,0",,,,,,,156,,,,,,,,,,,,,,,,,,,,,,,,,,,,,,,,,,,,,3,10,165,84,,1004,,,1,3,3,,1,0,,,,,"Aachen Laufen",,"Polar BEAT",,0,,0,168070,250480,30378,,,,,,,,,,,,,,,,,,,,,,,,,,,,,,,,,,,,,,,,,,,
5962457,5f0b452d-d3f9-4099-a3a6-d8fe78fea6d1,1411154175,120,1548677565,,0,0,6.42,1567,1591,62,69,,,1,1.1,0.59,,,,416,,,,,,,49.58,,1,,,,,,,,,,,,,,32,82,14.86,15.89,16.04,,,,,,,,,,,,,,,,,"13,1,1,2,1,6,52,21,3",,,,,,,150,,,,,,,,,,,,,,,,,,,,,,,,,,,,,,,,,,,,,19,0,270,86,,,0,,0,5,3,,1,0,,,,,"3000, 2000, 1000",,"Polar BEAT",,0,,0,168070,250480,30378,,,,,,,,,,,,,,,,,,,,,,,,,,,,,,,,,,,,,,,,,,,
5962458,75f71aa9-809c-46ad-be03-88b7ae65389a,1349209830,120,1548677566,,0,0,10.18,3142,3682,66,64,,,1,0,0.2,1.06,0.94,,700,141,210,,,,59.59,38.75,60.09,1,,,,,,,,,,,,,,64,,11.82,12.08,12.23,8.2,,,,,,,,,,,,,,,,"11,5,10,18,37,14,3,1,0","1,45,53,0,1",,,,,,,,,,,,,,,,,,,,,,,,,,,,,,,,,,,,,,,,,,48.4,11,1,182,82,,1019,0,,1,3,3,,1,0,,,,,,,"Polar BEAT",,0,,0,168070,250480,30378,,,,,,,,,,,,,,,,,,,,,,,,,,,,,,,,,,,,,,,,,,,
5962459,,1448314260,60,1548677568,,0,0,5,0,0,,,,,0,,,,,,336,,,,,,,,,1,,,,,,,,,,,,,,0,,,,,,,,,,,,,,,,,,,,,,,,,,,,,,,,,,,,,,,,,,,,,,,,,,,,,,,,,,,,,,,,,,,,,,,,,,1,,,0,0,,,,,"Laufen Mailand",,"Polar BEAT",,0,,0,168070,250480,30378,,,,,,,,,,,,,,,,,,,,,,,,,,,,,,,,,,,,,,,,,,,
5962460,de3f8f9b-17ed-4d09-9708-b4b5cf625e4f,1399323926,120,1548677569,,0,0,7.37,2333,2360,101,69,,,1,1,0.43,1.04,1,,370,141,161,,,,57.76,36.79,59.05,1,,,,,,,,,,,,,,46,80,11.66,11.49,11.89,3.4,,,,,,,,,,,,,,,,"4,3,22,51,16,4,1,0,0","0,52,48,0,0",,,,,,118,,,,,,,,,,,,,,,,,,,,,,,,,,,,,,,,,,,,25.2,16,2,142,56,,1013,0,,1,5,3,,1,0,,,,,"Regenerativer DL + Steigerungen",,"Polar BEAT",,0,,0,168070,250480,30378,,,,,,,,,,,,,,,,,,,,,,,,,,,,,,,,,,,,,,,,,,,
5962461,933f81e1-3034-4fb5-9f93-5ae6c30ba8f1,1530038501,120,1548677569,,0,0,3.16,721,728,14,16,,,1,0,0,,,,195,158,183,,,,74.33,50.94,74.68,1,,,,,,,,,,,,,,25,83,15.89,16.4,16.39,33.5,,,,,,,,,,,,,,,,"6,0,0,0,0,2,71,19,0","2,32,4,25,37",,,,,,158,,,,,,,,,,,,,,,,,,,,,,,,,,,,,,,,,,,,85.8,25,12,35,47,,1022,,,0,5,3,,1,0,I2.071|7:24-I1.027|3:48-I0.064|0:57,,Running,,,,"Polar M430",43,0,,0,168070,250480,30378,,,,,,,,,,,,,,,,,,,,,,,,,,,,,,,,,,,,,,,,,,,
5962462,04fc676c-603d-4a4f-94d1-3007f97511e5,1406892186,120,1548677569,,0,0,8.01,2460,2674,91,80,,,1,1.1,0.42,,,,524,,,,,,,38.34,,1,,,,,,,,,,,,,,51,81,11.91,12.08,12.31,,,,,,,,,,,,,,,,,"5,7,27,29,15,9,7,0,0",,,,,,,121,,,,,,,,,,,,,,,,,,,,,,,,,,,,,,,,,,,,,23,3,217,64,,1011,4,,0,5,3,,1,0,,,,,"Regenerativer DL",,"Polar BEAT",,0,,0,168070,250480,30378,,,,,,,,,,,,,,,,,,,,,,,,,,,,,,,,,,,,,,,,,,,
5962463,f2499096-6928-4dad-997a-ae90fe607d41,1403354428,120,1548677570,,0,0,6.46,1833,2961,65,68,,,1,1,0.34,,,410,431,,,,,,,41.54,,1,,,,,,,,,,,,,,38,82,12.94,13.08,13.41,,,,,,,,,,,,,,,,,"4,6,15,18,12,32,13,0,0",,,,,,,129,,,,,,,,,,,,,,,,,,,,,,,,,,,,,,,,,,,,,18,4,338,60,,1020,6,,0,5,3,,1,0,,,,,"Einlaufen + Lauf ABC",,"Polar BEAT",,0,,0,168070,250480,30378,,,,,,,,,,,,,,,,,,,,,,,,,,,,,,,,,,,,,,,,,,5,
5962464,6471d28b-0149-4143-8974-60a364b1bfed,1503599452,120,1548677571,,0,0,16.8,4816,4817,267,267,,,1,2.8,0.58,1.06,1.06,407,1099,147,166,,,,61.86,43.9,63.08,1,,,,,,,,,,,,,,113,80,12.91,12.74,13.17,-1.7,,,,,,,,,,,,,,,,"1,3,10,26,34,19,7,1,0","0,19,78,3,0",,,,,,131,,,,,,,,,,,,,,,,,,,,,,,,,,,,,,,,,,,,38.1,21,8,246,59,,1018,1,,0,5,3,,1,0,I1.000|5:33-I1.000|5:16-I1.000|4:59-I1.000|4:36-I1.000|4:52-I1.000|4:41-I1.000|4:50-I1.000|4:46-I1.000|4:31-I1.000|5:07-I1.000|4:48-I1.000|4:33-I1.000|4:42-I1.000|5:26-I1.000|4:02-I1.000|4:21-I0.808|3:14,,Running,,,,"Polar M430",43,0,,0,168070,250480,30378,,,,,,,,,,,,,,,,,,,,,,,,,,,,,,,,,,,,,,,,,,"4,5,5,5",
5962465,f2b37ac1-9c42-46b9-b2c4-5cee673fff14,1505842813,120,1548677571,,0,0,3.91,774,775,59,40,,,1,1,0.53,1.33,1.11,,51,87,96,,,,,,,1,,,,,,,,,,,,,,2,,,21.37,,-18.3,-36.6,159,122,,1,172,152,,,,,,,,,"36,23,16,15,8,1,2","100,0,0,0,0","76,12,2,2,8",,,,,,,,,,,,,,,,,,,,,,,,,,,,,,,,,,,,,,,,,1.1,14,10,325,74,,1018,,,0,5,3,,1,0,,,Cycling,,,,"Polar M430",43,0,,0,168072,,30378,,,,,,,,,,,,,,,,,,,,,,,,,,,,,,,,,,,,,,,,,,,
5962466,8c95a1b0-4fc1-4257-b36b-7aa28db97d51,1436389383,120,1548677571,,0,0,5.48,1122,1122,94,97,,,1,1.6,0.41,,,363,368,,,,,,,60.32,,1,,,,,,,,,,,,,,23,89,17.89,17.64,18.15,,,,,,,,,,,,,,,,,"0,0,0,0,1,6,35,54,5",,,,,,,165,,,,,,,,,,,,,,,,,,,,,,,,,,,,,,,,,,,,,15,22,247,81,,1014,,,0,5,3,,1,0,,,,,"Aachen Laufen",,"Polar BEAT",,0,,0,168070,250480,30378,,,,,,,,,,,,,,,,,,,,,,,,5.56,1122,,,0,Lousberglauf,,,,,,,0,0,30378,5962466,12902,,4,
5962467,085fa811-fb8c-482f-907c-76684d1c223c,1494614841,120,1548677572,,0,0,15.01,4230,4268,209,199,,,1,2.4,0.64,,,485,1039,,,,,,,44.38,,1,,,,,,,,,,,,,,87,79,13.07,13.17,13.43,,,,,,,,,,,,,,,,,"5,1,4,12,30,40,7,0,0",,,,,,,135,,,,,,,,,,,,,,,,,,,,,,,,,,,,,,,,,,,,,20,5,208,54,,1002,1,,0,5,3,,1,0,,,,,"Aachen Laufen",,"Polar BEAT",,0,,0,168070,250480,30378,,,,,,,,,,,,,,,,,,,,,,,,,,,,,,,,,,,,,,,,,,"5,5",
5962468,5a65d4dd-cbed-4a65-a01e-601fab4d396d,1407705775,120,1548677572,,0,0,2.37,801,817,17,41,,,1,0.7,0.51,1.02,1.03,,138,125,135,,,,61.51,31.59,61.29,1,,,,,,,,,,,,,,10,82,10.55,10.75,10.68,-6.4,,,,,,,,,,,,,,,,"7,15,38,33,7,0,0,0,0","0,100,0,0,0",,,,,,108,,,,,,,,,,,,,,,,,,,,,,,,,,,,,,,,,,,,8.8,19,12,247,86,,1004,0,,1,6,3,,1,0,,,,,Auslaufen,,"Polar BEAT",,0,,0,168070,250480,30378,,,,,,,,,,,,,,,,,,,,,,,,,,,,,,,,,,,,,,,,,,,
5962469,cf452325-484a-4da7-bd7b-64a4a88bcfd9,1504089195,120,1548677573,,0,0,14.5,5330,5338,1322,198,,,1,8.4,0.92,1.25,0.93,771,1579,174,186,,,,35.69,32.43,43.29,1,,,,,,,,,,,,,,231,82,13.11,9.9,14.48,8.7,,,,,,,,,,,,,,,,"29,38,22,8,2,0,0,0,0","0,2,6,82,9",,,,,,100,,,,,,,,,,,,,,,,,,,,,,,,,,,,,,,,,,,,128.2,24,1,90,63,,1013,,,0,3,3,,1,0,I1.000|5:17-I1.000|6:20-I1.000|6:22-I1.000|6:04-I1.000|6:03-I1.000|6:02-I1.000|6:13-I1.000|6:16-I1.000|5:51-I1.000|5:57-I1.000|6:26-I1.000|6:49-I1.000|6:36-I1.000|5:48-I0.505|2:54,,Running,,,,"Polar M430",43,0,,0,168070,250480,30378,,,,,,,,,,,,,,,,,,,,,,,,,,,,,,,,,,,,,,,,,,0,
5962470,b266edfd-66aa-4844-9002-f33c2ca84ebc,1481814481,60,1548677573,,0,0,1.41,462,765,34,36,,,1,1.6,0.85,,,,103,,,,,,,31.04,,1,,,,,,,,,,,,,,9,79,11.47,11.25,11.92,,,,,,,,,,,,,,,,,"13,19,16,16,23,13,0,0,0",,,,,,,116,,,,,,,,,,,,,,,,,,,,,,,,,,,,,,,,,,,,,8,6,129,83,,1024,0,,0,5,3,,1,0,,,,,"Aachen Laufen",,"Polar BEAT",,0,,0,168070,250480,30378,,,,,,,,,,,,,,,,,,,,,,,,,,,,,,,,,,,,,,,,,,,
5962471,889e38a4-2912-48fb-9fed-b15581a51e15,1439839649,120,1548677573,,0,0,3.71,1137,1137,48,46,,,1,1.2,0.51,,,,252,,,,,,,36.67,,1,,,,,,,,,,,,,,23,80,12.2,12.5,12.62,,,,,,,,,,,,,,,,,"13,1,3,14,40,29,0,0,0",,,,,,,122,,,,,,,,,,,,,,,,,,,,,,,,,,,,,,,,,,,,,13,12,269,93,,1014,,,0,4,3,,1,0,,,,,"Aachen Laufen",,"Polar BEAT",,0,,0,168070,250480,30378,,,,,,,,,,,,,,,,,,,,,,,,,,,,,,,,,,,,,,,,,,,
5962472,f8039833-7979-4cc2-bde9-ebf8c5ef9e5c,1446896002,60,1548677574,,0,0,8.41,2055,2057,175,187,,,1,2.5,0.76,,,,536,,,,,,,50.31,,1,,,,,,,,,,,,,,42,83,15.06,15.82,16.27,,,,,,,,,,,,,,,,,"16,0,1,1,1,1,56,24,0",,,,,,,148,,,,,,,,,,,,,,,,,,,,,,,,,,,,,,,,,,,,,17,16,203,89,,1024,,,0,4,3,,1,0,,,,,"Aachen Laufen",,"Polar BEAT",,0,,0,168070,250480,30378,,,,,,,,,,,,,,,,,,,,,,,,,,,,,,,,,,,,,,,,,,,
5962473,0cdca557-d404-4fe8-ab46-e94f5226f680,1404043471,120,1548677574,,0,0,15,4141,4191,417,424,,,1,4,0.73,,,488,1004,,,,,,,45.45,,1,,,,,,,,,,,,,,86,82,13.58,13.12,14.27,,,,,,,,,,,,,,,,,"2,1,3,9,43,38,5,0,0",,,,,,,133,,,,,,,,,,,,,,,,,,,,,,,,,,,,,,,,,,,,,14,5,250,90,,,5,,0,6,3,,1,0,,,,,"Langsamer DL ",,"Polar BEAT",,0,,0,168070,250480,30378,,,,,,,,,,,,,,,,,,,,,,,,,,,,,,,,,,,,,,,,,,"4,5,5,5,5,5",
5962474,b09f0cc7-73d7-4a4d-a28c-b12881e1920f,1537466796,120,1548677575,,0,0,10.86,2761,2762,33,33,,,1,0,0.06,1.13,0.92,,766,161,177,,,,63.27,48.83,63.51,1,,,,,,,,,,,,,,90,83,14.2,14.23,14.3,8.5,,,,,,,,,,,,,,,,"0,0,1,3,14,62,21,0,0","1,9,29,61,0",,,,,,142,,,,,,,,,,,,,,,,,,,,,,,,,,,,,,,,,,,,85.9,29,5,270,29,,1017,,,0,3,3,,1,0,I1.000|4:47-I1.000|4:27-I1.000|4:16-I1.000|4:07-I1.000|4:09-I1.000|4:01-I1.000|4:12-I1.000|4:05-I1.000|4:13-I1.000|4:10-I0.867|3:36,,Running,,,,"Polar M430",43,0,,0,168070,250480,30378,,,,,,,,,,,,,,,,,,,,,,,,,,,,,,,,,,,,,,,,,,,
5962475,65a282d1-208e-416c-b43a-7a48b6bb1ded,1473191322,120,1548677575,,0,0,5.71,1794,1996,68,56,,,1,0.9,0.47,,,,395,,,,,,,36.55,,1,,,,,,,,,,,,,,37,79,11.65,12.44,12.83,,,,,,,,,,,,,,,,,"17,2,6,10,29,31,5,0,0",,,,,,,121,,,,,,,,,,,,,,,,,,,,,,,,,,,,,,,,,,,,,22,1,110,62,,1025,0,,0,3,3,,1,0,,,,,"Aachen Laufen",,"Polar BEAT",,0,,0,168070,250480,30378,,,,,,,,,,,,,,,,,,,,,,,,,,,,,,,,,,,,,,,,,,,
5962476,da033751-cdae-45df-be1c-9c2454cf5467,1397501666,120,1548677576,,0,0,5,1429,1444,18,20,,,1,0,0.16,1.12,0.95,,271,145,162,,,,63.22,40.57,63.47,1,,,,,,,,,,,,,,31,83,12.62,12.77,12.86,-5.3,,,,,,,,,,,,,,,,"2,1,8,24,35,20,9,1,0","0,19,79,2,0",,,,,,126,,,,,,,,,,,,,,,,,,,,,,,,,,,,,,,,,,,,31,9,29,322,72,,1022,0,,0,5,3,,1,0,,,,,Auslaufen,,"Polar BEAT",,0,,0,168070,250480,30378,,,,,,,,,,,,,,,,,,,,,,,,,,,,,,,,,,,,,,,,,,,
5962477,f410d4be-0197-4210-adae-77a0e280d5f0,1458845697,60,1548677576,,0,0,4.74,1696,1757,72,36,,,1,0.7,0.4,,,,327,,,,,,,30.95,,1,,,,,,,,,,,,,,35,77,10.42,11.72,12.19,,,,,,,,,,,,,,,,,"22,1,5,19,38,13,2,0,0",,,,,,,109,,,,,,,,,,,,,,,,,,,,,,,,,,,,,,,,,,,,,7,11,222,70,,1015,,,1,5,3,,1,0,,,,,"Aachen Laufen",,"Polar BEAT",,0,,0,168070,250480,30378,,,,,,,,,,,,,,,,,,,,,,,,,,,,,,,,,,,,,,,,,,,
5962478,267f4bdb-f335-4437-bafc-d58d495b15c7,1503772075,120,1548677576,,0,0,0.62,191,192,15,12,,,1,0.3,0.32,1.27,1.19,,41,144,157,,,,58.14,30.47,60.24,1,,,,,,,,,,,,,,4,81,12.15,11.81,12.42,9,,,,,,,,,,,,,,,,"1,8,15,30,43,3,0,0,0","0,28,72,0,0",,,,,,120,,,,,,,,,,,,,,,,,,,,,,,,,,,,,,,,,,,,11.2,24,4,307,62,,1015,1,,0,5,3,,1,0,,,Running,,,,"Polar M430",43,0,,0,168070,250480,30378,,,,,,,,,,,,,,,,,,,,,,,,,,,,,,,,,,,,,,,,,,,
5962479,b84e2d4b-e3cf-4600-8d40-3f69b103612d,1448909319,60,1548677577,,0,0,14.92,4703,4847,160,161,,,1,1.1,0.43,,,,1019,,,,,,,38.94,,1,,,,,,,,,,,,,,97,80,11.53,11.8,12,,,,,,,,,,,,,,,,,"9,4,14,27,35,11,0,0,0",,,,,,,119,,,,,,,,,,,,,,,,,,,,,,,,,,,,,,,,,,,,,9,37,239,91,,1015,,,1,6,3,,1,0,,,,,"Aachen Laufen",,"Polar BEAT",,0,,0,168070,250480,30378,,,,,,,,,,,,,,,,,,,,,,,,,,,,,,,,,,,,,,,,,,,
5962480,,1432990543,120,1548677577,,0,0,5,0,0,,,,,0,,,,,,305,,,,,,,,,1,,,,,,,,,,,,,,0,,,,,,,,,,,,,,,,,,,,,,,,,,,,,,,,,,,,,,,,,,,,,,,,,,,,,,,,,,,,,,,,,,,,,,,,,,1,,,0,0,,,,,Laufen,,"Polar BEAT",,0,,0,168070,250480,30378,,,,,,,,,,,,,,,,,,,,,,,,,,,,,,,,,,,,,,,,,,,
5962481,1218ad32-0413-45cf-bec2-3bf690a84ff2,1468008393,120,1548677577,,0,0,8.6,2462,2517,122,124,,,1,1.9,0.53,,,285,591,,,,,,,41.84,,1,,,,,,,,,,,,,,51,80,12.75,12.94,13.46,,,,,,,,,,,,,,,,,"7,2,4,15,29,35,7,0,0",,,,,,,131,,,,,,,,,,,,,,,,,,,,,,,,,,,,,,,,,,,,,21,16,277,60,,1017,,,0,5,3,,1,0,,,,,"Aachen Laufen",,"Polar BEAT",,0,,0,168070,250480,30378,,,,,,,,,,,,,,,,,,,,,,,,10,2462,,,0,"Aachener Nachtlauf",,,,,,,0,0,30378,5962481,8534,,4,
5962482,3a8b4baf-0d14-4e03-a400-84663297c148,1526912406,120,1548677578,,0,0,10.38,2771,2774,162,164,,,1,2.3,0.51,1.11,0.98,627,736,160,176,,,,60.1,45.98,61.25,1,,,,,,,,,,,,,,88,82,13.86,13.71,14.27,1.3,,,,,,,,,,,,,,,,"1,2,5,13,21,38,19,1,0","1,5,37,57,0",,,,,,137,,,,,,,,,,,,,,,,,,,,,,,,,,,,,,,,,,,,67.9,23,22,89,43,,,6,,0,5,3,,1,0,I1.000|4:58-I1.000|5:05-I1.000|4:48-I1.000|4:40-I1.000|4:22-I1.000|4:15-I1.000|4:05-I1.000|4:08-I1.000|3:57-I1.000|4:08-I0.381|1:50,,Running,,,,"Polar M430",43,0,,0,168070,250480,30378,,,,,,,,,,,,,,,,,,,,,,,,,,,,,,,,,,,,,,,,,,"4,4",
5962483,a401d291-cb69-4a31-a804-8e1c774cc7bf,1505499777,120,1548677578,,0,0,4.5,1688,1690,48,52,,,1,0.7,0.42,1.13,0.88,,333,133,161,,,,50.34,29.15,50.94,1,,,,,,,,,,,,,,28,80,9.7,9.68,9.81,17.1,,,,,,,,,,,,,,,,"35,30,31,4,0,0,0,0,0","1,56,42,0,0",,,,,,100,,,,,,,,,,,,,,,,,,,,,,,,,,,,,,,,,,,,27.8,12,5,257,81,,1012,0,,0,5,3,,1,0,I1.000|6:19-I1.000|6:37-I1.000|5:57-I1.000|6:08-I0.510|3:09,,Running,,,,"Polar M430",43,0,,0,168070,250480,30378,,,,,,,,,,,,,,,,,,,,,,,,,,,,,,,,,,,,,,,,,,,
5962484,3c46c664-2eac-4933-b10b-d2a1f9d11d9b,1511338026,60,1548677581,,0,0,13.68,1924,1943,33,34,,,1,0,0.04,,,,421,143,170,,,,,,,1,,,,,,,,,,,,,,41,,,26.5,,-5.5,-33.9,130,116,,1,149,136,,,,,,,,,"2,8,28,41,21,0,0","0,42,47,11,0","67,23,0,1,10",,,,,,,,,,,,,,,,,,,,,,,,,,,,,,,,,,,,,,,,,40.4,5,0,208,90,,,,,0,3,3,,1,0,,,Cycling,,,,"Polar M430",43,0,,0,168072,,30378,,,,,,,,,,,,,,,,,,,,,,,,,,,,,,,,,,,,,,,,,,,
5962485,1c7a9ece-a684-4f85-949f-b052bec2d8bc,1478630570,60,1548677582,,0,0,15,4357,5059,229,228,,,1,2.4,0.66,,,390,1031,,,,,,,42.84,,1,,,,,,,,,,,,,,90,80,12.63,12.61,12.98,,,,,,,,,,,,,,,,,"5,2,5,14,48,23,2,1,0",,,,,,,129,,,,,,,,,,,,,,,,,,,,,,,,,,,,,,,,,,,,,2,3,196,89,,1010,0,,1,5,3,,1,0,,,,,"Aachen Laufen",,"Polar BEAT",,0,,0,168070,250480,30378,,,,,,,,,,,,,,,,,,,,,,,,,,,,,,,,,,,,,,,,,,4,
5962486,18d5530f-ebcc-4a06-a21b-1230813466d3,1465653856,120,1548677582,,0,0,2.74,722,722,32,32,,,1,0,0.11,,,,169,,,,,,,42.65,,1,,,,,,,,,,,,,,14,84,13.67,14.01,14.1,,,,,,,,,,,,,,,,,"18,5,5,5,13,16,11,23,4",,,,,,,136,,,,,,,,,,,,,,,,,,,,,,,,,,,,,,,,,,,,,21,3,95,60,,1010,7,,0,5,3,,1,0,,,,,"Aachen Laufen",,"Polar BEAT",,0,,0,168070,250480,30378,,,,,,,,,,,,,,,,,,,,,,,,,,,,,,,,,,,,,,,,,,,
5962487,1dd88c75-3755-4a81-8136-2a352c8f4d75,1448386852,60,1548677582,,0,0,7.15,1984,1984,102,102,,,1,1.3,0.42,,,254,488,,,,,,,42.9,,1,,,,,,,,,,,,,,41,81,13.32,13.31,13.67,,,,,,,,,,,,,,,,,"1,1,3,29,30,17,18,0,0",,,,,,,133,,,,,,,,,,,,,,,,,,,,,,,,,,,,,,,,,,,,,1,22,186,89,,1010,,,1,6,3,,1,0,,,,,"Balve Laufen",,"Polar BEAT",,0,,0,168070,250480,30378,,,,,,,,,,,,,,,,,,,,,,,,,,,,,,,,,,,,,,,,,,4,
5962488,5eb68fb3-db17-4a2c-a554-1b7e8af5b7ed,1521969717,120,1548677583,,0,0,16.63,5164,5165,67,68,,,1,0,0.05,1.09,0.93,,1325,156,172,,,,51.7,39.97,51.95,1,,,,,,,,,,,,,,148,82,11.63,11.61,11.68,2.5,,,,,,,,,,,,,,,,"0,1,10,71,17,0,0,0,0","0,2,77,21,0",,,,,,118,,,,,,,,,,,,,,,,,,,,,,,,,,,,,,,,,,,,52.2,1,0,,86,,1016,,,0,5,3,,1,0,I1.000|5:02-I1.000|5:11-I1.000|5:09-I1.000|5:04-I1.000|5:07-I1.000|5:09-I1.000|5:11-I1.000|5:11-I1.000|5:09-I1.000|5:09-I1.000|5:22-I1.000|5:06-I1.000|5:08-I1.000|5:13-I1.000|5:16-I1.000|5:14-I0.631|3:27,,Running,,,,"Polar M430",43,0,,0,168070,250480,30378,,,,,,,,,,,,,,,,,,,,,,,,,,,,,,,,,,,,,,,,,,,
5962489,1a7b069b-ff54-4941-af63-59eb0340438a,1454576205,60,1548677583,,0,0,0.99,340,340,20,11,,,1,1.2,0.6,,,,78,,,,,,,28.26,,1,,,,,,,,,,,,,,7,81,11.02,10.57,11.47,,,,,,,,,,,,,,,,,"14,17,34,30,6,0,0,0,0",,,,,,,108,,,,,,,,,,,,,,,,,,,,,,,,,,,,,,,,,,,,,3,19,220,88,,1025,,,0,5,3,,1,0,,,,,"Aachen Laufen",,"Polar BEAT",,0,,0,168070,250480,30378,,,,,,,,,,,,,,,,,,,,,,,,,,,,,,,,,,,,,,,,,,,
5962490,5b35524d-ea55-4899-bb94-0c2570aefd7f,1409256767,120,1548677584,,0,0,3.36,1080,1080,73,73,,,1,1.7,0.64,,,408,224,,,,,,,34.43,,1,,,,,,,,,,,,,,22,81,11.56,11.29,12.08,,,,,,,,,,,,,,,,,"5,6,31,37,13,8,0,0,0",,,,,,,115,,,,,,,,,,,,,,,,,,,,,,,,,,,,,,,,,,,,,19,4,173,83,,1014,0,,0,5,3,,1,0,,,,,Einlaufen,,"Polar BEAT",,0,,0,168070,250480,30378,,,,,,,,,,,,,,,,,,,,,,,,,,,,,,,,,,,,,,,,,,4,
5962491,03ee3335-5485-4b3c-85ee-e327ce5afefc,1413542336,120,1548677584,,0,0,7.39,2475,2480,97,98,,,1,1.2,0.54,,,,493,,,,,,,34.42,,1,,,,,,,,,,,,,,51,82,10.93,10.86,11.12,,,,,,,,,,,,,,,,,"5,10,38,41,6,0,0,0,0",,,,,,,109,,,,,,,,,,,,,,,,,,,,,,,,,,,,,,,,,,,,,14,7,235,95,,1014,1,,0,5,3,,1,0,,,,,"Regenerativer DL",,"Polar BEAT",,0,,0,168070,250480,30378,,,,,,,,,,,,,,,,,,,,,,,,,,,,,,,,,,,,,,,,,,,
5962492,508ced7f-42f3-467a-8ba1-096c51658c2f,1516645585,60,1548677585,,0,0,11.37,2266,2308,43,29,,,1,0,0.07,2.08,,,296,108,128,,,,,,,1,,,,,,,,,,,,,,18,,,21.39,,26.2,-43.5,99,73,,1,123,105,,,,,,,,,"23,13,47,17,0,0,0","23,77,0,0,0","87,1,4,6,2",,,,,,,,,,,,,,,,,,,,,,,,,,,,,,,,,,,,,,,,,6.5,8,0,299,95,,,0,,1,6,3,,1,0,,,Cycling,,,,"Polar M430",43,0,,0,168072,,30378,,,,,,,,,,,,,,,,,,,,,,,,,,,,,,,,,,,,,,,,,,,
5962493,ada3545d-08fe-4d8d-a288-eaf2f1e2c21a,1515831664,60,1548677585,,0,0,9.56,2219,2238,32,39,,,1,0,0.09,1.7,0.29,,275,107,135,,,,,,,1,,,,,,,,,,,,,,17,,,17.85,,14.3,-89.7,73,54,,1,93,80,,,,,,,,,"30,48,18,4,0,0,0","33,67,0,0,0","89,1,7,1,1",,,,,,,,,,,,,,,,,,,,,,,,,,,,,,,,,,,,,,,,,8.1,4,2,98,79,,,0,,0,5,3,,1,0,,,Cycling,,,,"Polar M430",43,0,,0,168072,,30378,,,,,,,,,,,,,,,,,,,,,,,,,,,,,,,,,,,,,,,,,,,
5962494,101fcb16-e7a4-4fdd-9f4c-5f707ad0da9f,1349981179,120,1548677587,,0,0,47.37,5843,6072,268,270,,,1,0,0.17,1.62,0.73,602,1648,128,158,,,,,,,1,,,,,,,,,,,,,,86,,,31.16,,-12,-63,241,192,,1,302,254,,,,,,,,,"7,6,13,23,31,11,9","2,76,22,0,0","46,19,12,7,16",,,,,,,,,,,,,,,,,,,,,,,,,,,,,,,,,,,,,,,,,22.1,11,6,79,72,,1011,0,,1,5,3,,1,0,,,,,,,"Polar BEAT",,0,,0,168072,,30378,,,,,,,,,,,,,,,,,,,,,,,,,,,,,,,,,,,,,,,,,,5,
5962495,8fdf1dfd-ac1b-45cf-8bf8-05871344ab83,1416563082,60,1548677587,,0,0,4.5,1356,1356,45,25,,,1,0.3,0.28,,,,315,,,,,,,37.87,,1,,,,,,,,,,,,,,28,83,12.25,12.08,12.36,,,,,,,,,,,,,,,,,"3,2,12,29,47,7,0,0,0",,,,,,,120,,,,,,,,,,,,,,,,,,,,,,,,,,,,,,,,,,,,,3,4,89,97,,1022,0,,0,3,3,,1,0,,,,,Auslaufen,,"Polar BEAT",,0,,0,168070,250480,30378,,,,,,,,,,,,,,,,,,,,,,,,,,,,,,,,,,,,,,,,,,,
5962496,c78d6589-be93-4f1a-b9d6-795e45dec8ed,1434220603,120,1548677588,,0,0,12.24,3336,3336,173,171,,,1,2,0.51,,,311,835,,,,,,,45.42,,1,,,,,,,,,,,,,,69,82,13.53,13.37,13.74,,,,,,,,,,,,,,,,,"3,1,4,8,28,50,6,0,0",,,,,,,134,,,,,,,,,,,,,,,,,,,,,,,,,,,,,,,,,,,,,21,20,251,46,,1010,,,0,3,3,,1,0,,,,,"Aachen Laufen",,"Polar BEAT",,0,,0,168070,250480,30378,,,,,,,,,,,,,,,,,,,,,,,,,,,,,,,,,,,,,,,,,,4,
5962497,a519dead-2df2-4945-baee-9f8e96fc290b,1515746355,60,1548677588,,0,0,9.98,1221,1221,28,33,,,1,0,0.02,,,,310,157,176,,,,,,,1,,,,,,,,,,,,,,37,,,29.51,,10.4,1.3,163,144,,1,172,156,,,,,,,,,"0,0,2,57,42,0,0","0,18,10,73,0","34,55,0,0,11",,,,,,,,,,,,,,,,,,,,,,,,,,,,,,,,,,,,,,,,,64.5,4,1,66,89,,,0,,0,4,3,,1,0,,,Cycling,,,,"Polar M430",43,0,,0,168072,,30378,,,,,,,,,,,,,,,,,,,,,,,,,,,,,,,,,,,,,,,,,,,
5962499,69a4e6ec-589b-4b88-ae1d-8b81257f0056,1528302973,120,1548677588,,0,0,7.43,2052,2052,25,24,,,1,0,0.05,1.12,0.95,,505,153,165,,,,61.38,43.24,61.64,1,,,,,,,,,,,,,,54,82,13.07,13.11,13.2,4.4,,,,,,,,,,,,,,,,"1,0,1,10,49,36,2,0,0","1,4,88,6,0",,,,,,132,,,,,,,,,,,,,,,,,,,,,,,,,,,,,,,,,,,,43.4,28,11,346,48,,,5,,0,3,3,,1,0,I1.000|4:38-I1.000|4:36-I1.000|4:20-I1.000|4:21-I1.000|4:43-I1.000|4:46-I1.000|4:43-I0.427|2:06,,Running,,,,"Polar M430",43,0,,0,168070,250480,30378,,,,,,,,,,,,,,,,,,,,,,,,,,,,,,,,,,,,,,,,,,,
5962500,2fe0bc38-a3ca-42e1-95c3-eab448c3bed5,1546262938,60,1548677589,,0,0,15.04,3282,3282,24,18,,,1,0,0,,,,871,156,185,,,,80.01,59.69,80.2,1,,,,,,,,,,,,,,112,87,16.53,16.53,16.58,30.8,,,,,,,,,,,,,,,,"0,0,0,0,0,3,85,12,0","2,34,1,29,34",,,,,,158,,,,,,,,,,,,,,,,,,,,,,,,,,,,,,,,,,,,124.7,9,8,281,93,,1033,0,296,0,4,3,,1,0,I9.976|35:51-I5.063|18:54,,Running,,,,"Polar M430",43,0,,0,168070,250480,30378,,,,,,,,,,,,,,,,,,,,,,,,15,3282,,,0,"37. Internationaler Silvesterlauf Werl Soest",,,,,,,0,0,30378,5962500,246,,,
5962501,7dd2ddd2-d23c-4b46-95b9-fb9ef9bc4009,1414524597,60,1548677589,,0,0,13.21,3375,3411,120,120,,,1,1.1,0.46,,,,865,,,,,,,49.24,,1,,,,,,,,,,,,,,70,84,14.14,15.32,15.52,,,,,,,,,,,,,,,,,"14,3,2,1,1,12,49,17,0",,,,,,,140,,,,,,,,,,,,,,,,,,,,,,,,,,,,,,,,,,,,,7,7,194,88,,1018,0,,1,5,3,,1,0,,,,,"Doppel, Doppel, Einzel, Viertel",,"Polar BEAT",,0,,0,168070,250480,30378,,,,,,,,,,,,,,,,,,,,,,,,,,,,,,,,,,,,,,,,,,,
5962502,80840c94-d0ae-49f5-8bba-8e23e31c2222,1367618261,120,1548677590,,0,0,5.1,2243,2457,81,84,,,1,1,0.41,,,,347,,,,,,,24.19,,1,,,,,,,,,,,,,,46,,8.4,10.71,11.1,,,,,,,,,,,,,,,,,"45,4,4,14,25,5,2,1,1",,,,,,,,,,,,,,,,,,,,,,,,,,,,,,,,,,,,,,,,,,,,13,1,355,66,,1017,0,,1,3,3,,1,0,,,,,,,"Polar BEAT",,0,,0,168070,250480,30378,,,,,,,,,,,,,,,,,,,,,,,,,,,,,,,,,,,,,,,,,,,
5962503,69783639-00cf-4407-af0e-f78a1fe6b66f,1407065303,120,1548677591,,0,0,16.85,4817,4845,230,230,,,1,2.2,0.56,,,430,1134,,,,,,,44.05,,1,,,,,,,,,,,,,,100,82,12.82,12.73,13.13,,,,,,,,,,,,,,,,,"3,2,5,13,53,21,1,1,0",,,,,,,128,,,,,,,,,,,,,,,,,,,,,,,,,,,,,,,,,,,,,21,2,239,72,,1011,5,,0,5,3,,1,0,,,,,"Regenerativer DL ",,"Polar BEAT",,0,,0,168070,250480,30378,,,,,,,,,,,,,,,,,,,,,,,,,,,,,,,,,,,,,,,,,,"4,5",
5962504,b89f3fcc-ec40-43a5-b7a4-6ecd245b2021,1412628714,120,1548677591,,0,0,2.86,991,1000,20,38,,,1,0.5,0.44,1.03,1.02,,174,133,154,,,,55.51,31.15,55.56,1,,,,,,,,,,,,,,15,82,10.34,10.6,10.59,-1,,,,,,,,,,,,,,,,"14,15,30,36,5,0,0,0,0","0,85,15,0,0",,,,,,106,,,,,,,,,,,,,,,,,,,,,,,,,,,,,,,,,,,,14.2,14,4,157,84,,1007,0,,1,5,3,,1,0,,,,,Auslaufen,,"Polar BEAT",,0,,0,168070,250480,30378,,,,,,,,,,,,,,,,,,,,,,,,,,,,,,,,,,,,,,,,,,,
5962505,fe6ef7c5-8398-4261-aeec-1cc31dfac517,1427795361,120,1548677591,,0,0,6.42,1923,1923,111,110,,,1,1.8,0.53,,,254,438,,,,,,,38.95,,1,,,,,,,,,,,,,,39,84,12.28,12.13,12.57,,,,,,,,,,,,,,,,,"3,3,14,26,40,14,0,0,0",,,,,,,119,,,,,,,,,,,,,,,,,,,,,,,,,,,,,,,,,,,,,9,40,267,79,,999,,,0,11,3,,1,0,,,,,"Aachen Laufen",,"Polar BEAT",,0,,0,168070,250480,30378,,,,,,,,,,,,,,,,,,,,,,,,,,,,,,,,,,,,,,,,,,4,
5962506,8f10eda4-fb65-4bf2-8372-fad59b2653f3,1498772708,120,1548677591,,0,0,1.87,619,627,9,12,,,1,0,0.24,,,,127,,,,,,,31.64,,1,,,,,,,,,,,,,,12,79,10.88,10.93,10.91,,,,,,,,,,,,,,,,,"5,19,33,29,14,1,0,0,0",,,,,,,115,,,,,,,,,,,,,,,,,,,,,,,,,,,,,,,,,,,,,19,9,237,64,,1009,0,,1,5,3,,1,0,,,,,"Aix-en-Provence Laufen",,"Polar BEAT",,0,,0,168070,250480,30378,,,,,,,,,,,,,,,,,,,,,,,,,,,,,,,,,,,,,,,,,,,
5962507,13ab8e43-6fdb-4781-b1ed-2b57f3de7f64,1538144170,120,1548677592,,0,0,9.88,1795,1796,44,46,,,1,0,0.16,,0.48,,209,103,117,,,,,,,1,,,,,,,,,,,,,,11,,,20.89,,6.9,-45.1,92,79,,1,115,105,,,,,,,,,"10,15,75,0,0,0,0","31,69,0,0,0","91,0,0,1,8",,,,,,,,,,,,,,,,,,,,,,,,,,,,,,,,,,,,,,,,,4.6,21,12,338,41,,,,,0,3,3,,1,0,,,Cycling,,,,"Polar M430",43,0,,0,168072,,30378,,,,,,,,,,,,,,,,,,,,,,,,,,,,,,,,,,,,,,,,,,,
5962508,6dafba2b-41d6-494b-ada4-54196349d54f,1411910890,120,1548677593,,0,0,28.07,7539,8489,332,332,,,1,2.5,0.46,1.04,1,420,1314,153,178,,,,63.53,49.29,64.46,1,,,,,,,,,,,,,,202,82,13.62,13.58,13.86,1.8,,,,,,,,,,,,,,,,"2,1,1,7,29,50,10,0,0","0,10,67,23,0",,,,,,136,,,,,,,,,,,,,,,,,,,,,,,,,,,,,,,,,,,,67,20,2,137,73,,1023,3,,0,5,3,,1,0,,,,,"Langer DL",,"Polar BEAT",,0,,0,168070,250480,30378,,,,,,,,,,,,,,,,,,,,,,,,,,,,,,,,,,,,,,,,,,"4,5,5",
5962509,1a124aed-20c2-4f48-a79c-6845155bb13f,1417014592,60,1548677594,,0,0,11.01,3215,3389,222,221,,,1,2.8,0.69,,,811,723,,,,,,,41.58,,1,,,,,,,,,,,,,,66,82,12.83,12.98,13.65,,,,,,,,,,,,,,,,,"9,3,5,12,30,30,10,1,0",,,,,,,125,,,,,,,,,,,,,,,,,,,,,,,,,,,,,,,,,,,,,6,5,96,95,,1013,0,,0,5,3,,1,0,,,,,"Lockerer DL",,"Polar BEAT",,0,,0,168070,250480,30378,,,,,,,,,,,,,,,,,,,,,,,,,,,,,,,,,,,,,,,,,,4,
5962510,123ed77c-07db-445d-8dfc-a2527584da06,1449603616,60,1548677596,,0,0,4.63,1323,1345,47,41,,,1,0.7,0.48,,,,309,,,,,,,40.39,,1,,,,,,,,,,,,,,27,80,12.77,14.32,14.44,,,,,,,,,,,,,,,,,"17,3,5,8,19,8,23,17,0",,,,,,,131,,,,,,,,,,,,,,,,,,,,,,,,,,,,,,,,,,,,,10,16,197,89,,1028,,,1,6,3,,1,0,,,,,"Aachen Laufen",,"Polar BEAT",,0,,0,168070,250480,30378,,,,,,,,,,,,,,,,,,,,,,,,,,,,,,,,,,,,,,,,,,,
5962511,a10a5a34-e086-4d4a-bd04-184184f1819e,1502994915,120,1548677596,,0,0,2.87,1155,1181,43,41,,,1,0,0.01,1.11,0.64,,252,145,172,,,,41.43,26.05,42.24,1,,,,,,,,,,,,,,26,81,9.01,9.72,9.92,30.5,,,,,,,,,,,,,,,,"48,9,10,14,12,6,1,0,0","0,31,62,7,0",,,,,,92,,,,,,,,,,,,,,,,,,,,,,,,,,,,,,,,,,,,30,20,21,210,82,,1015,,,0,5,1,,1,0,I0.072|0:21-I0.116|0:45-I0.083|0:23-I0.116|0:46-I0.073|0:22-I0.116|0:44-I0.071|0:22-I0.124|0:47-I0.076|0:22-I0.118|0:45-I0.063|0:22-I0.117|0:45-I0.062|0:21-I0.122|0:47-I0.072|0:21-I0.110|0:47-I0.061|0:21-I0.115|0:49-I0.060|0:21-I0.131|0:48-I0.068|0:21-I0.114|0:47-I0.070|0:21-I0.156|2:07-I0.079|0:19-I0.149|1:53-I0.078|0:19-I0.145|1:40-I0.067|0:19-I0.048|0:19,,Running,,,,"Polar M430",43,0,,0,168070,250480,30378,,,,,,,,,,,,,,,,,,,,,,,,,,,,,,,,,,,,,,,,,,,
5962512,7383e9e7-c637-478c-8c67-52b1bb321b15,1415909310,60,1548677596,,0,0,2.21,762,762,28,28,,,1,1,0.54,,,,148,,,,,,,30.67,,1,,,,,,,,,,,,,,15,83,10.59,10.54,10.85,,,,,,,,,,,,,,,,,"5,20,47,28,0,0,0,0,0",,,,,,,105,,,,,,,,,,,,,,,,,,,,,,,,,,,,,,,,,,,,,7,4,150,92,,1013,0,,1,5,3,,1,0,,,,,Auslaufen,,"Polar BEAT",,0,,0,168070,250480,30378,,,,,,,,,,,,,,,,,,,,,,,,,,,,,,,,,,,,,,,,,,,
5962513,e1044d55-3107-427e-b362-f4ea22c2f39c,1370081193,120,1548677598,,0,0,29.86,9036,9056,419,420,,,1,2.4,0.49,,,289,2099,,,,,,,43.04,,1,,,,,,,,,,,,,,187,,12.21,12.12,12.57,,,,,,,,,,,,,,,,,"4,4,10,36,35,8,3,0,0",,,,,,,,,,,,,,,,,,,,,,,,,,,,,,,,,,,,,,,,,,,,10,10,305,92,,1017,3,,0,5,3,,1,0,,,,,,,"Polar BEAT",,0,,0,168070,250480,30378,,,,,,,,,,,,,,,,,,,,,,,,,,,,,,,,,,,,,,,,,,"4,5,5",
5962514,88abe960-84e9-4a5b-ae2d-268a67ac3ba5,1401827807,120,1548677598,,0,0,2.45,760,770,21,24,,,1,0,0.16,,,,125,,,,,,,35,,1,,,,,,,,,,,,,,15,79,11.74,14.47,14.43,,,,,,,,,,,,,,,,,"53,1,2,2,2,3,4,6,27",,,,,,,122,,,,,,,,,,,,,,,,,,,,,,,,,,,,,,,,,,,,,15,6,235,81,,1013,,,0,5,3,,1,0,,,,,"500, 300, 500, 300, 200",,"Polar BEAT",,0,,0,168070,250480,30378,,,,,,,,,,,,,,,,,,,,,,,,,,,,,,,,,,,,,,,,,,,
5962515,95851ab2-b542-49f4-a017-cb8984e5f5e9,1539192587,120,1548677598,,0,0,10.54,3156,3157,36,36,,,1,0,0.13,1.14,0.92,,661,135,148,,,,65.3,40.25,65.58,1,,,,,,,,,,,,,,53,80,12.06,12.06,12.15,-0.4,,,,,,,,,,,,,,,,"0,1,5,41,49,3,0,0,0","0,96,4,0,0",,,,,,125,,,,,,,,,,,,,,,,,,,,,,,,,,,,,,,,,,,,17.7,22,5,28,58,,1014,0,288,0,3,3,,1,0,I1.000|5:06-I1.000|5:06-I1.000|5:02-I1.000|5:07-I1.000|4:56-I1.000|4:53-I1.000|4:51-I1.000|4:46-I1.000|4:58-I1.000|5:09-I0.539|2:45,,Running,,,,"Polar M430",43,0,,0,168070,250480,30378,,,,,,,,,,,,,,,,,,,,,,,,,,,,,,,,,,,,,,,,,,,
5962516,2060b67d-b0f6-44df-8dfe-7a94643594e1,1392830244,60,1548677599,,0,0,13.02,3888,3920,175,176,,,1,1.6,0.46,1.04,1.03,304,646,142,158,,,,61.52,41.03,62.54,1,,,,,,,,,,,,,,80,82,12.34,12.11,12.49,5.3,,,,,,,,,,,,,,,,"2,2,8,37,45,5,1,0,0","0,31,69,0,0",,,,,,123,,,,,,,,,,,,,,,,,,,,,,,,,,,,,,,,,,,,29.4,8,8,250,84,,1014,0,,0,5,3,,1,0,,,,,"Sehr lockerer DL ",,"Polar BEAT",,0,,0,168070,250480,30378,,,,,,,,,,,,,,,,,,,,,,,,,,,,,,,,,,,,,,,,,,5,
5962517,,1463703507,120,1548677599,,0,0,11,0,0,,,,,0,,,,,,,,,,,,,,,1,,,,,,,,,,,,,,0,,,,,,,,,,,,,,,,,,,,,,,,,,,,,,,,,,,,,,,,,,,,,,,,,,,,,,,,,,,,,,,,,,,,,,,,,,1,,,0,0,,,,,"laufen ",,"Polar BEAT",,0,,0,168070,250480,30378,,,,,,,,,,,,,,,,,,,,,,,,,,,,,,,,,,,,,,,,,,,
5962518,,1413750120,120,1548677599,,0,0,4,0,0,,,,,0,,,,,,256,,,,,,,,,1,,,,,,,,,,,,,,0,,,,,,,,,,,,,,,,,,,,,,,,,,,,,,,,,,,,,,,,,,,,,,,,,,,,,,,,,,,,,,,,,,,,,,,,,,1,,,0,0,,,,,Einlaufen,,"Polar BEAT",,0,,0,168070,250480,30378,,,,,,,,,,,,,,,,,,,,,,,,,,,,,,,,,,,,,,,,,,,
5962519,24504b8a-2715-4d50-866b-240d40d5bcb8,1531518274,120,1548677599,,0,0,4.59,1492,1493,19,20,,,1,0,0.12,1.11,0.92,,313,135,147,,,,59,34.65,59.28,1,,,,,,,,,,,,,,25,79,11.13,11.13,11.21,3.7,,,,,,,,,,,,,,,,"4,5,27,55,9,0,0,0,0","1,82,17,0,0",,,,,,117,,,,,,,,,,,,,,,,,,,,,,,,,,,,,,,,,,,,17.6,25,7,21,52,,,0,,1,3,3,,1,0,I1.000|5:19-I1.000|5:15-I1.000|5:37-I1.000|5:34-I0.598|3:10,,Running,,,,"Polar M430",43,0,,0,168070,250480,30378,,,,,,,,,,,,,,,,,,,,,,,,,,,,,,,,,,,,,,,,,,,
5962520,04f56e8b-6922-4181-9aab-b9a11fd82cce,1403785671,120,1548677600,,0,0,13.15,3948,3988,157,157,,,1,1.7,0.55,,,371,892,,,,,,,40.8,,1,,,,,,,,,,,,,,81,81,12.17,12.09,12.3,,,,,,,,,,,,,,,,,"2,6,11,25,48,7,0,0,0",,,,,,,123,,,,,,,,,,,,,,,,,,,,,,,,,,,,,,,,,,,,,19,3,10,50,,1016,6,,0,5,3,,1,0,,,,,Auslaufen,,"Polar BEAT",,0,,0,168070,250480,30378,,,,,,,,,,,,,,,,,,,,,,,,,,,,,,,,,,,,,,,,,,5,
5962521,180dab79-3620-42fe-b7ef-8ee2fccd70a9,1534672214,120,1548677601,,0,0,15.73,4207,4207,52,52,,,1,0,0.01,1.1,0.92,,1062,151,167,,,,65.02,47.33,65.29,1,,,,,,,,,,,,,,107,82,13.5,13.49,13.56,5,,,,,,,,,,,,,,,,"0,0,0,4,41,54,2,0,0","0,7,91,2,0",,,,,,137,,,,,,,,,,,,,,,,,,,,,,,,,,,,,,,,,,,,47.3,21,3,348,58,,1022,,,0,5,3,,1,0,I1.000|4:51-I1.000|4:40-I1.000|4:32-I1.000|4:24-I1.000|4:29-I1.000|4:25-I1.000|4:18-I1.000|4:24-I1.000|4:22-I1.000|4:26-I1.000|4:21-I1.000|4:23-I1.000|4:19-I1.000|4:31-I1.000|4:21-I0.732|3:21,,Running,,,,"Polar M430",43,0,,0,168070,250480,30378,,,,,,,,,,,,,,,,,,,,,,,,,,,,,,,,,,,,,,,,,,,
5962522,291ad192-8f50-4c02-ae01-f6774e96921f,1433186836,120,1548677601,,0,0,12.69,3572,3982,135,135,,,1,1.5,0.49,,,,864,,,,,,,43.86,,1,,,,,,,,,,,,,,74,82,12.96,12.94,13.18,,,,,,,,,,,,,,,,,"5,1,3,12,42,33,4,0,0",,,,,,,130,,,,,,,,,,,,,,,,,,,,,,,,,,,,,,,,,,,,,15,11,221,49,,1016,,,0,5,3,,1,0,,,,,"Aachen Laufen",,"Polar BEAT",,0,,0,168070,250480,30378,,,,,,,,,,,,,,,,,,,,,,,,,,,,,,,,,,,,,,,,,,,
5962523,0f005caa-2648-40f0-b31b-3ff768200b65,1482691290,60,1548677602,,0,0,0.75,241,241,8,8,,,1,0,0,,,,53,,,,,,,29.58,,1,,,,,,,,,,,,,,5,79,11.25,11.52,11.54,,,,,,,,,,,,,,,,,"11,6,7,40,35,0,0,0,0",,,,,,,118,,,,,,,,,,,,,,,,,,,,,,,,,,,,,,,,,,,,,8,14,227,98,,,0,,1,4,3,,1,0,,,,,"Balve Laufen",,"Polar BEAT",,0,,0,168070,250480,30378,,,,,,,,,,,,,,,,,,,,,,,,,,,,,,,,,,,,,,,,,,,
5962525,65e8a0f3-70a0-4d93-8e5c-2ecab8c5f238,1430334622,120,1548677602,,0,0,10.52,2842,2842,152,150,,,1,2,0.56,,,311,716,,,,,,,45.39,,1,,,,,,,,,,,,,,59,84,13.69,13.5,13.92,,,,,,,,,,,,,,,,,"2,2,3,11,28,44,11,0,0",,,,,,,132,,,,,,,,,,,,,,,,,,,,,,,,,,,,,,,,,,,,,12,14,208,49,,1015,,,0,5,3,,1,0,,,,,"Aachen Laufen",,"Polar BEAT",,0,,0,168070,250480,30378,,,,,,,,,,,,,,,,,,,,,,,,,,,,,,,,,,,,,,,,,,4,
5962526,511321f6-e4b9-4f61-b9ad-7fba566b5945,1405111094,120,1548677603,,0,0,7.37,2455,2455,104,101,,,1,1.5,0.59,,,,498,,,,,,,34.64,,1,,,,,,,,,,,,,,50,80,11.01,10.85,11.16,,,,,,,,,,,,,,,,,"3,6,46,42,2,0,0,0,0",,,,,,,113,,,,,,,,,,,,,,,,,,,,,,,,,,,,,,,,,,,,,18,10,285,86,,1015,,,0,4,3,,1,0,,,,,"Regenerativer DL",,"Polar BEAT",,0,,0,168070,250480,30378,,,,,,,,,,,,,,,,,,,,,,,,,,,,,,,,,,,,,,,,,,,
5962527,9f2b5e36-70d5-4c2a-a3cc-e8ceb653934f,1457724342,60,1548677603,,0,0,1.12,305,305,19,4,,,1,1.1,0.64,,,,80,,,,,,,37.27,,1,,,,,,,,,,,,,,6,82,13.76,13.85,14.68,,,,,,,,,,,,,,,,,"12,1,1,8,14,29,32,2,0",,,,,,,134,,,,,,,,,,,,,,,,,,,,,,,,,,,,,,,,,,,,,5,11,45,73,,1028,,,1,5,3,,1,0,,,,,"Aachen Laufen",,"Polar BEAT",,0,,0,168070,250480,30378,,,,,,,,,,,,,,,,,,,,,,,,,,,,,,,,,,,,,,,,,,,
5962528,094d3274-6ab0-446c-bb0b-21ca1f19fb37,1504173175,120,1548677604,,0,0,7.36,7436,7542,1438,1623,,,1,5.6,0.52,,,1865,925,102,142,,,,,,,1,,,,,,,,,,,,,,52,,,8.84,,-73.8,,,,,,,,,,,,,,,,"77,12,5,6,0,0","46,53,0,0,0",,,,,,,,,,,,,,,,,,,,,,,,,,,,,,,,,,,,,,,,,,11.1,13,0,250,99,,,2,,0,6,3,,1,0,I0.350|3:59-I7.008|2:01:45,,Hiking,,,,"Polar M430",43,0,,0,168075,,30378,,,,,,,,,,,,,,,,,,,,,,,,,,,,,,,,,,,,,,,,,,"1,3,5",
5962529,7c603b64-2d45-4b34-81d7-9c4dc2630e61,1498766616,120,1548677605,,0,0,7.33,2302,2678,50,63,,,1,0,0.17,,,,508,,,,,,,37.13,,1,,,,,,,,,,,,,,47,81,11.45,12.09,12.13,,,,,,,,,,,,,,,,,"8,3,14,22,38,13,2,0,0",,,,,,,118,,,,,,,,,,,,,,,,,,,,,,,,,,,,,,,,,,,,,22,15,228,51,,1007,0,,0,5,3,,1,0,,,,,"Aix-en-Provence Laufen",,"Polar BEAT",,0,,0,168070,250480,30378,,,,,,,,,,,,,,,,,,,,,,,,,,,,,,,,,,,,,,,,,,,
5962530,1b651eb3-1f61-4ca1-aa51-ee941b16ea92,1421180476,60,1548677605,,0,0,0.45,174,174,10,0,,,1,1.2,1,,,,30,,,,,,,22.71,,1,,,,,,,,,,,,,,3,82,10,9.43,10.24,,,,,,,,,,,,,,,,,"43,14,43,0,0,0,0,0,0",,,,,,,95,,,,,,,,,,,,,,,,,,,,,,,,,,,,,,,,,,,,,7,20,235,84,,1008,,,1,5,3,,1,0,,,,,Auslaufen,,"Polar BEAT",,0,,0,168070,250480,30378,,,,,,,,,,,,,,,,,,,,,,,,,,,,,,,,,,,,,,,,,,,
5962532,383036e3-417b-432e-90b0-16e71134519d,1543997778,60,1548677606,,0,0,10.92,1981,1981,36,44,,,1,0,0.11,2.29,0.62,,296,114,139,,,,,,,1,,,,,,,,,,,,,,19,,,20.67,,-10,-52.3,96,80,,1,112,102,,,,,,,,,"10,17,67,5,2,0,0","6,94,0,0,0","88,3,0,1,8",,,,,,,,,,,,,,,,,,,,,,,,,,,,,,,,,,,,,,,,,7.2,3,7,36,100,,,0,,0,9,3,,1,0,,,Cycling,,,,"Polar M430",43,0,,0,168072,,30378,,,,,,,,,,,,,,,,,,,,,,,,,,,,,,,,,,,,,,,,,,,
5962533,2fa77d8f-3871-408f-9d7a-b5a0385741f3,1367750145,120,1548677607,,0,0,86.23,11921,11993,1158,1182,,,1,3.5,0.46,,,688,2850,,,,,,,,,1,,,,,,,,,,,,,,133,,,31.96,,,,261,188,,1,347,289,,,,,,,,,"18,16,15,14,12,9,17",,"49,17,12,7,15",,,,,,,,,,,,,,,,,,,,,,,,,,,,,,,,,,,,,,,,,,14,6,228,61,,1024,4,,0,3,3,,1,0,,,,,,,"Polar BEAT",,0,,0,168072,,30378,,,,,,,,,,,,,,,,,,,,,,,,,,,,,,,,,,,,,,,,,,"4,4,4,4,4,4",
5962534,9ca80215-5429-4fae-9706-7ec5ca6b7faa,1397762043,120,1548677608,,0,0,2.35,726,726,0,1,,,1,0,0,,,,136,139,148,,,,60.6,35.03,60.57,1,,,,,,,,,,,,,,13,83,11.63,11.72,11.74,-1.2,,,,,,,,,,,,,,,,"4,6,4,40,47,0,0,0,0","1,45,54,0,0",,,,,,117,,,,,,,,,,,,,,,,,,,,,,,,,,,,,,,,,,,,19.1,11,21,264,84,,1014,0,,0,5,3,,1,0,,,,,Auslaufen,,"Polar BEAT",,0,,0,168070,250480,30378,,,,,,,,,,,,,,,,,,,,,,,,,,,,,,,,,,,,,,,,,,,
5962536,4584fe85-d947-4716-9504-6a3e66af4a7c,1464809483,120,1548677608,,0,0,7.67,2337,2338,121,119,,,1,1.8,0.58,,,461,535,,,,,,,38.59,,1,,,,,,,,,,,,,,48,79,12.1,12.31,12.62,,,,,,,,,,,,,,,,,"7,3,5,28,34,20,2,0,0",,,,,,,125,,,,,,,,,,,,,,,,,,,,,,,,,,,,,,,,,,,,,16,6,260,98,,1013,1,,0,6,3,,1,0,,,,,"Aachen Laufen",,"Polar BEAT",,0,,0,168070,250480,30378,,,,,,,,,,,,,,,,,,,,,,,,,,,,,,,,,,,,,,,,,,5,
5962537,57c828eb-94a4-48f1-8ac8-c6928a302c77,1547976469,60,1548677610,,0,0,28.43,8945,8989,717,716,,,1,5.2,0.78,1.2,0.95,509,2022,142,172,,,,57.68,40.98,59.48,1,,,,,,,,,,,,,,187,83,12.16,11.9,12.62,16.5,,,,,,,,,,,,,,,,"16,4,12,25,25,18,1,0,0","0,47,45,8,0",,,,,,115,,,,,,,,,,,,,,,,,,,,,,,,,,,,,,,,,,,,52.2,-5,11,69,80,,1017,0,369,0,3,3,,1,0,,,Running,,,,"Polar M430",43,0,,0,168070,250480,30378,,,,,,,,,,,,,,,,,,,,,,,,,,,,,,,,,,,,,,,,,,"3,3,5,5",
5962538,f38645a3-7116-4ccc-93cf-19c06591b793,1423319549,60,1548677611,,0,0,6.78,1575,1575,72,72,,,1,0.8,0.45,,,,450,,,,,,,52.72,,1,,,,,,,,,,,,,,32,90,15.67,15.58,15.74,,,,,,,,,,,,,,,,,"0,0,0,0,6,23,62,8,0",,,,,,,143,,,,,,,,,,,,,,,,,,,,,,,,,,,,,,,,,,,,,3,10,10,58,,1032,,,0,5,3,,1,0,,,,,"Nobis Cross",,"Polar BEAT",,0,,0,168070,250480,30378,,,,,,,,,,,,,,,,,,,,,,,,,,,,,,,,,,,,,,,,,,,
5962539,be82ab10-2c21-4c33-a866-4ff0da9b90cf,1450006892,60,1548677612,,0,0,10.32,3101,3320,344,346,,,1,4.4,0.8,,,571,704,,,,,,,40.03,,1,,,,,,,,,,,,,,64,81,12.94,12.36,13.54,,,,,,,,,,,,,,,,,"5,9,19,22,16,23,6,0,0",,,,,,,123,,,,,,,,,,,,,,,,,,,,,,,,,,,,,,,,,,,,,7,7,298,87,,1021,,,0,3,3,,1,0,,,,,"Balve Laufen",,"Polar BEAT",,0,,0,168070,250480,30378,,,,,,,,,,,,,,,,,,,,,,,,,,,,,,,,,,,,,,,,,,3,
5962540,649d361a-3bc8-422c-b946-6d53fcb22b34,1404732309,120,1548677612,,0,0,3.09,892,914,33,42,,,1,0.9,0.52,,,,208,,,,,,,38.8,,1,,,,,,,,,,,,,,18,84,12.58,12.57,12.74,,,,,,,,,,,,,,,,,"0,2,9,18,55,16,0,0,0",,,,,,,124,,,,,,,,,,,,,,,,,,,,,,,,,,,,,,,,,,,,,18,4,249,67,,1018,5,,0,5,3,,1,0,,,,,Auslaufen,,"Polar BEAT",,0,,0,168070,250480,30378,,,,,,,,,,,,,,,,,,,,,,,,,,,,,,,,,,,,,,,,,,,
5962541,e3675b3f-5b3e-4e40-8148-fae5735504ce,1394650897,60,1548677613,,0,0,5,1234,1234,49,29,,,1,0,0.19,1.13,1.01,,273,153,168,,,,70.54,48.2,71.75,1,,,,,,,,,,,,,,33,86,14.85,14.64,14.98,4.9,,,,,,,,,,,,,,,,"1,0,0,3,9,37,49,0,0","3,6,65,27,0",,,,,,141,,,,,,,,,,,,,,,,,,,,,,,,,,,,,,,,,,,,44.8,13,2,64,55,,1030,0,,1,3,3,,1,0,,,,,"Zügiger DL Teil 1",,"Polar BEAT",,0,,0,168070,250480,30378,,,,,,,,,,,,,,,,,,,,,,,,,,,,,,,,,,,,,,,,,,,
5962542,e13f8412-5f98-4468-9979-ce6b0b4011fc,1362759765,60,1548677614,,0,0,11.94,3254,3289,9,8,,,1,0,0,,,,831,173,186,,,,52.14,45.34,52.19,1,,,,,,,,,,,,,,135,,13.22,13.39,13.41,5.2,,,,,,,,,,,,,,,,"3,2,4,10,35,34,8,4,0","0,1,3,95,1",,,,,,,,,,,,,,,,,,,,,,,,,,,,,,,,,,,,,,,,,,102.3,16,8,84,51,,998,1,,0,5,3,,1,0,,,,,,,"Polar BEAT",,0,,0,168070,250480,30378,,,,,,,,,,,,,,,,,,,,,,,,,,,,,,,,,,,,,,,,,,,
5962543,b2824a69-737f-4f22-b84c-75bc5ea16883,1511982337,60,1548677614,,0,0,14.69,2888,2888,52,50,,,1,0,0.08,2.66,,,361,106,124,,,,,,,1,,,,,,,,,,,,,,21,,,19.94,,13.5,-8,92,71,,1,108,91,,,,,,,,,"20,20,58,2,0,0,0","20,80,0,0,0","87,0,7,5,1",,,,,,,,,,,,,,,,,,,,,,,,,,,,,,,,,,,,,,,,,5,1,1,202,84,,,0,,1,3,3,,1,0,,,Cycling,,,,"Polar M430",43,0,,0,168072,,30378,,,,,,,,,,,,,,,,,,,,,,,,,,,,,,,,,,,,,,,,,,,
5962544,0fb16878-91ad-4481-a53f-f5e1f078553d,1449403518,60,1548677615,,0,0,18.05,3788,3788,195,275,,,1,1.5,0.42,,,490,1215,,,,,,,63.32,,1,,,,,,,,,,,,,,78,87,17.25,17.29,17.38,,,,,,,,,,,,,,,,,"0,0,0,0,2,7,40,49,3",,,,,,,164,,,,,,,,,,,,,,,,,,,,,,,,,,,,,,,,,,,,,9,23,206,75,,1024,,,0,5,3,,1,0,,,,,"Stolberg (Rheinland) Laufen",,"Polar BEAT",,0,,0,168070,250480,30378,,,,,,,,,,,,,,,,,,,,,,,,18,3788,,,0,"53. Aachener Winterlauf",,,,,,,0,0,30378,5962544,6533,,5,
5962545,ec6bf5fe-4eb1-4e8e-a501-0d3f687335f2,1394737817,60,1548677615,,0,0,3.35,947,947,67,67,,,1,1.6,0.58,1.13,0.99,450,191,145,159,,,,64.08,40.01,65.67,1,,,,,,,,,,,,,,21,82,13.12,12.76,13.62,3.3,,,,,,,,,,,,,,,,"0,0,3,30,37,28,2,0,0","0,22,78,0,0",,,,,,129,,,,,,,,,,,,,,,,,,,,,,,,,,,,,,,,,,,,25.1,11,5,359,52,,1028,,,1,3,3,,1,0,,,,,Einlaufen,,"Polar BEAT",,0,,0,168070,250480,30378,,,,,,,,,,,,,,,,,,,,,,,,,,,,,,,,,,,,,,,,,,5,
5962546,0fc3f71e-ab46-4335-85cb-ce0e1c7deb3b,1400188196,120,1548677615,,0,0,2.51,779,779,21,20,,,1,0,0.28,,,,166,,,,,,,35.05,,1,,,,,,,,,,,,,,16,82,11.76,11.79,11.97,,,,,,,,,,,,,,,,,"8,8,22,22,26,10,4,0,0",,,,,,,118,,,,,,,,,,,,,,,,,,,,,,,,,,,,,,,,,,,,,9,5,2,77,,1036,,,0,5,3,,1,0,,,,,Auslaufen,,"Polar BEAT",,0,,0,168070,250480,30378,,,,,,,,,,,,,,,,,,,,,,,,,,,,,,,,,,,,,,,,,,,
5962547,7f532f98-f6ca-465d-b7f9-1d0e7e67247d,1407015059,120,1548677615,,0,0,10.24,2143,2143,28,30,,,1,0,0,,,,684,,,,,,,61.07,,1,,,,,,,,,,,,,,44,87,17.21,17.67,17.69,,,,,,,,,,,,,,,,,"3,0,0,0,0,1,29,67,1",,,,,,,165,,,,,,,,,,,,,,,,,,,,,,,,,,,,,,,,,,,,,20,6,174,77,,1007,,,1,5,3,,1,0,,,,,"WK 10k Dürwiss",,"Polar BEAT",,0,,0,168070,250480,30378,,,,,,,,,,,,,,,,,,,,,,,,10,2143,,,0,"31. Die 10 km von Dürwiß 2014",,,,,,,0,0,30378,5962547,9345,,,
5962548,80a6db0c-c6c4-462b-b9c8-1d3e1a9f6b7b,1533840025,120,1548677616,,0,0,23.13,6815,6821,90,96,,,1,0,0.12,1.09,0.9,,1629,147,162,,,,59.8,43.61,60.07,1,,,,,,,,,,,,,,157,81,12.25,12.31,12.38,3.7,,,,,,,,,,,,,,,,"0,2,10,26,53,9,0,0,0","1,23,76,1,0",,,,,,126,,,,,,,,,,,,,,,,,,,,,,,,,,,,,,,,,,,,40.4,24,16,257,64,,1014,,,0,6,3,,1,0,I1.000|5:11-I1.000|4:36-I1.000|4:40-I1.000|4:44-I1.000|4:42-I1.000|4:47-I1.000|4:49-I1.000|4:37-I1.000|4:30-I1.000|4:36-I1.000|4:52-I1.000|4:40-I1.000|4:42-I1.000|4:46-I1.000|5:03-I1.000|4:58-I1.000|4:48-I1.000|4:55-I1.000|5:09-I1.000|5:14-I1.000|5:23-I1.000|5:39-I1.000|5:36-I0.132|0:46,,Running,,,,"Polar M430",43,0,,0,168070,250480,30378,,,,,,,,,,,,,,,,,,,,,,,,,,,,,,,,,,,,,,,,,,,
5962549,c13b206e-29a5-430b-bcfe-8c5a63f3d2ce,1493475766,120,1548677617,,0,0,3.31,1009,1009,61,60,,,1,1.5,0.57,,,417,230,,,,,,,36.6,,1,,,,,,,,,,,,,,20,83,12.18,11.92,12.74,,,,,,,,,,,,,,,,,"3,2,20,31,32,10,2,0,0",,,,,,,119,,,,,,,,,,,,,,,,,,,,,,,,,,,,,,,,,,,,,11,6,16,46,,1018,,,0,5,3,,1,0,,,,,"Aachen Laufen",,"Polar BEAT",,0,,0,168070,250480,30378,,,,,,,,,,,,,,,,,,,,,,,,,,,,,,,,,,,,,,,,,,5,
5962550,7089e5a6-aefd-4b7e-bf55-9b6785d3277c,1529603565,120,1548677617,,0,0,6.75,1793,1830,40,41,,,1,0,0.25,1.14,0.81,,332,125,161,,,,82.95,45.01,83.54,1,,,,,,,,,,,,,,24,84,13.6,14.88,15.02,18.8,,,,,,,,,,,,,,,,"20,1,1,2,2,15,41,17,0","1,88,9,2,0",,,,,,134,,,,,,,,,,,,,,,,,,,,,,,,,,,,,,,,,,,,21,20,21,7,41,,1016,,,0,3,3,,1,0,I1.106|4:46-I1.008|3:35-I0.093|0:55-I1.010|3:55-I0.106|0:55-I1.003|3:39-I0.081|1:05-I1.014|3:57-I0.252|3:26-I1.012|3:21-I0.055|1:00,,Running,,,,"Polar M430",43,0,,0,168070,250480,30378,,,,,,,,,,,,,,,,,,,,,,,,,,,,,,,,,,,,,,,,,,,
5962551,e378e1cb-69a5-416e-9043-79e84d738ee7,1367438590,120,1548677617,,0,0,10.22,3660,3731,127,126,,,1,1.1,0.38,,,530,710,,,,,,,32.53,,1,,,,,,,,,,,,,,76,,10.23,10.72,11.29,,,,,,,,,,,,,,,,,"27,14,28,17,8,4,3,1,1",,,,,,,,,,,,,,,,,,,,,,,,,,,,,,,,,,,,,,,,,,,,16,5,72,58,,1019,0,,0,5,3,,1,0,,,,,,,"Polar BEAT",,0,,0,168070,250480,30378,,,,,,,,,,,,,,,,,,,,,,,,,,,,,,,,,,,,,,,,,,4,
5962552,2cf0d0c0-e94b-49bc-9fc3-83882726dc53,1486210473,60,1548677618,,0,0,6.64,2071,2071,151,150,,,1,2.8,0.82,,,425,451,,,,,,,37.2,,1,,,,,,,,,,,,,,43,78,12.06,11.6,12.61,,,,,,,,,,,,,,,,,"2,6,19,43,26,4,0,0,0",,,,,,,123,,,,,,,,,,,,,,,,,,,,,,,,,,,,,,,,,,,,,5,7,117,86,,998,1,,0,5,3,,1,0,,,,,"Aachen Laufen",,"Polar BEAT",,0,,0,168070,250480,30378,,,,,,,,,,,,,,,,,,,,,,,,,,,,,,,,,,,,,,,,,,4,
5962553,8222b4e6-25ec-4b79-88a2-367a93537614,1410462808,120,1548677619,,0,0,13.61,3335,3337,158,159,,,1,1.5,0.59,,,479,909,,,,,,,51.8,,1,,,,,,,,,,,,,,69,84,14.94,15.13,15.3,,,,,,,,,,,,,,,,,"1,0,3,8,19,24,30,15,0",,,,,,,146,,,,,,,,,,,,,,,,,,,,,,,,,,,,,,,,,,,,,17,6,32,67,,1019,0,,0,5,3,,1,0,,,,,"Tempowechsel Lauf",,"Polar BEAT",,0,,0,168070,250480,30378,,,,,,,,,,,,,,,,,,,,,,,,,,,,,,,,,,,,,,,,,,5,
5962554,c27b7eb6-209c-4025-ba80-eb766e40dc9c,1428840003,120,1548677619,,0,0,29.94,6617,6617,96,104,,,1,0,0.09,,,,2021,,,,,,,62.09,,1,,,,,,,,,,,,,,137,87,16.33,16.39,16.44,,,,,,,,,,,,,,,,,"0,0,0,1,2,8,71,17,1",,,,,,,156,,,,,,,,,,,,,,,,,,,,,,,,,,,,,,,,,,,,,12,25,218,65,,1028,,,0,5,3,,1,0,,,,,"Rotterdam Laufen",,"Polar BEAT",,0,,0,168070,250480,30378,,,,,,,,,,,,,,,,,,,,,,,,,,,,,,,,,,,,,,,,,,,
5962555,c649b41b-e98e-488d-96a8-3789c373997b,1439406304,120,1548677620,,0,0,12.74,3492,3837,177,194,,,1,2.2,0.54,,,416,870,,,,,,,45.25,,1,,,,,,,,,,,,,,72,84,13.41,13.23,13.65,,,,,,,,,,,,,,,,,"2,1,2,9,41,41,4,0,0",,,,,,,130,,,,,,,,,,,,,,,,,,,,,,,,,,,,,,,,,,,,,24,13,36,68,,1020,,,0,3,3,,1,0,,,,,"Aachen Laufen",,"Polar BEAT",,0,,0,168070,250480,30378,,,,,,,,,,,,,,,,,,,,,,,,,,,,,,,,,,,,,,,,,,4,
5962556,9c810773-1896-4212-bb64-b13add4699fb,1408138697,120,1548677620,,0,0,2.65,765,1047,14,16,,,1,0,0.08,,,,185,,,,,,,38.29,,1,,,,,,,,,,,,,,15,80,12.52,12.81,12.89,,,,,,,,,,,,,,,,,"6,10,8,12,34,18,10,4,0",,,,,,,130,,,,,,,,,,,,,,,,,,,,,,,,,,,,,,,,,,,,,14,4,271,92,,1017,0,,1,6,3,,1,0,,,,,Einlaufen,,"Polar BEAT",,0,,0,168070,250480,30378,,,,,,,,,,,,,,,,,,,,,,,,,,,,,,,,,,,,,,,,,,,
5962557,4c9f64f6-4396-4632-9869-52881952a7c3,1540031602,120,1548677621,,0,0,21.12,5626,5627,90,92,,,1,0,0.13,1.09,0.95,,1462,154,165,,,,63.6,48.68,63.93,1,,,,,,,,,,,,,,153,82,13.56,13.55,13.63,2.9,,,,,,,,,,,,,,,,"0,0,0,3,31,65,2,0,0","0,6,85,9,0",,,,,,137,,,,,,,,,,,,,,,,,,,,,,,,,,,,,,,,,,,,50.1,8,6,52,100,,1029,1,267,0,9,3,,1,0,I1.000|4:56-I1.000|4:26-I1.000|4:23-I1.000|4:29-I1.000|4:29-I1.000|4:19-I1.000|4:27-I1.000|4:21-I1.000|4:22-I1.000|4:28-I1.000|4:22-I1.000|4:26-I1.000|4:20-I1.000|4:21-I1.000|4:22-I1.000|4:19-I1.000|4:23-I1.000|4:24-I1.000|4:24-I1.000|4:32-I1.000|4:34-I0.133|0:40,,Running,,,,"Polar M430",43,0,,0,168070,250480,30378,,,,,,,,,,,,,,,,,,,,,,,,,,,,,,,,,,,,,,,,,,,
5962558,c18ca09a-b8e7-470a-844e-e4caae8c4e01,1523786839,120,1548677621,,0,0,2.3,793,793,28,24,,,1,0.7,0.52,1.12,0.95,,170,141,162,,,,51.98,30.78,52.88,1,,,,,,,,,,,,,,16,81,10.67,10.49,10.88,9.5,,,,,,,,,,,,,,,,"6,16,50,28,1,0,0,0,0","3,35,60,2,0",,,,,,107,,,,,,,,,,,,,,,,,,,,,,,,,,,,,,,,,,,,22.9,11,2,118,99,,,2,,0,6,3,,1,0,I1.000|5:46-I1.000|5:47-I0.308|1:40,,Running,,,,"Polar M430",43,0,,0,168070,250480,30378,,,,,,,,,,,,,,,,,,,,,,,,,,,,,,,,,,,,,,,,,,,
5962559,53c88621-e64b-451a-8d48-fe08e1d2a5bc,1462826493,120,1548677622,,0,0,14.01,3864,4514,213,215,,,1,1.8,0.45,,,666,965,,,,,,,45.26,,1,,,,,,,,,,,,,,80,82,13.27,13.18,13.52,,,,,,,,,,,,,,,,,"1,0,5,16,36,36,5,1,0",,,,,,,133,,,,,,,,,,,,,,,,,,,,,,,,,,,,,,,,,,,,,22,5,121,48,,1011,0,,1,5,3,,1,0,,,,,"Aachen Laufen",,"Polar BEAT",,0,,0,168070,250480,30378,,,,,,,,,,,,,,,,,,,,,,,,,,,,,,,,,,,,,,,,,,5,
5962560,f7b6350b-94c3-4593-8254-6c2a881855fa,1503225065,120,1548677623,,0,0,20.42,6252,6261,380,378,,,1,3.5,0.49,1.04,0.99,596,1330,142,169,,,,59.65,41.3,61.03,1,,,,,,,,,,,,,,130,82,12.21,11.98,12.67,3.9,,,,,,,,,,,,,,,,"8,6,15,26,29,15,1,0,0","1,38,56,5,0",,,,,,119,,,,,,,,,,,,,,,,,,,,,,,,,,,,,,,,,,,,42.4,15,18,230,82,,1023,,,0,5,1,,1,0,I16.087|1:23:58-I4.333|20:23,,Running,,,,"Polar M430",43,0,,0,168070,250480,30378,,,,,,,,,,,,,,,,,,,,,,,,,,,,,,,,,,,,,,,,,,"4,5,5",
5962561,b7813e68-4eda-410b-bc34-e9e6d171c496,1414753692,60,1548677624,,0,0,25.51,7008,7010,167,166,,,1,0.3,0.22,,,,1715,,,,,,,47.67,,1,,,,,,,,,,,,,,145,83,13.21,13.25,13.39,,,,,,,,,,,,,,,,,"2,0,1,6,37,52,1,0,0",,,,,,,132,,,,,,,,,,,,,,,,,,,,,,,,,,,,,,,,,,,,,16,2,188,79,,,,,0,3,3,,1,0,,,,,"Langer DL",,"Polar BEAT",,0,,0,168070,250480,30378,,,,,,,,,,,,,,,,,,,,,,,,,,,,,,,,,,,,,,,,,,,
5962562,0164f184-a1fb-48e7-afec-a9f008f8ce9a,1425320875,60,1548677624,,0,0,7.13,2010,2153,82,81,,,1,0.9,0.34,,,,487,,,,,,,42.1,,1,,,,,,,,,,,,,,41,83,13.01,12.91,13.15,,,,,,,,,,,,,,,,,"2,0,6,19,35,35,2,0,0",,,,,,,128,,,,,,,,,,,,,,,,,,,,,,,,,,,,,,,,,,,,,4,12,260,79,,1012,0,,1,6,3,,1,0,,,,,"Aachen Laufen",,"Polar BEAT",,0,,0,168070,250480,30378,,,,,,,,,,,,,,,,,,,,,,,,,,,,,,,,,,,,,,,,,,,
5962563,6aba154b-92b1-4615-85cf-176723b2d54b,1543940762,60,1548677626,,0,0,13.27,3424,3441,68,68,,,1,0,0.02,,,,866,153,180,,,,66.76,48.69,67.18,1,,,,,,,,,,,,,,94,83,13.97,14.79,14.82,-3.8,,,,,,,,,,,,,,,,"13,3,4,12,11,2,44,12,0","0,29,28,43,0",,,,,,140,,,,,,,,,,,,,,,,,,,,,,,,,,,,,,,,,,,,68.6,9,7,49,82,,1025,0,299,1,5,3,,1,0,I3.161|16:31-I1.022|3:44-I1.023|3:44-I1.026|3:45-I0.393|2:57-I1.018|3:38-I1.019|3:41-I0.213|1:55-I1.026|3:42-I1.003|3:42-I0.198|2:00-I1.013|3:31-I0.091|0:59-I1.029|3:30-I0.033|0:09,,Running,,,,"Polar M430",43,0,,0,168070,250480,30378,,,,,,,,,,,,,,,,,,,,,,,,,,,,,,,,,,,,,,,,,,,
5962564,51455f0e-3ef5-4377-8342-e71152cad915,1482841448,60,1548677627,,0,0,15.1,4199,4205,377,379,,,1,4.5,0.71,,,653,1026,,,,,,,45.09,,1,,,,,,,,,,,,,,87,81,13.6,13.36,14.24,,,,,,,,,,,,,,,,,"3,2,9,17,22,32,14,1,0",,,,,,,133,,,,,,,,,,,,,,,,,,,,,,,,,,,,,,,,,,,,,5,13,274,90,,,1,,0,3,3,,1,0,,,,,"Balve Laufen",,"Polar BEAT",,0,,0,168070,250480,30378,,,,,,,,,,,,,,,,,,,,,,,,,,,,,,,,,,,,,,,,,,"4,4,5",
5962565,0fdce476-abd0-4784-8ffb-faee86d39391,1476018111,120,1548677628,,0,0,25.56,7138,7202,421,427,,,1,3.1,0.52,,,475,1732,,,,,,,46.78,,1,,,,,,,,,,,,,,148,82,13.22,13.17,13.66,,,,,,,,,,,,,,,,,"3,2,5,12,30,41,7,0,0",,,,,,,131,,,,,,,,,,,,,,,,,,,,,,,,,,,,,,,,,,,,,11,4,11,74,,1026,2,,0,5,3,,1,0,,,,,"Aachen Laufen",,"Polar BEAT",,0,,0,168070,250480,30378,,,,,,,,,,,,,,,,,,,,,,,,,,,,,,,,,,,,,,,,,,"4,5,5,5,5",
5962566,da745be1-6331-4a40-a6d3-90cf50d3f29e,1395411680,60,1548677629,,0,0,8.52,2466,2467,144,144,,,1,1.3,0.4,1.06,1.02,346,459,145,160,,,,62.24,41.28,63.54,1,,,,,,,,,,,,,,54,83,12.78,12.56,12.97,-5.2,,,,,,,,,,,,,,,,"4,2,5,17,48,24,0,0,0","0,31,69,0,0",,,,,,125,,,,,,,,,,,,,,,,,,,,,,,,,,,,,,,,,,,,34.5,8,13,266,86,,1011,3,,0,6,3,,1,0,,,,,"Regenerativer DL ",,"Polar BEAT",,0,,0,168070,250480,30378,,,,,,,,,,,,,,,,,,,,,,,,,,,,,,,,,,,,,,,,,,4,
5962567,f2c1694e-82f6-4b06-aa9e-42225d1a15f0,1473885217,120,1548677629,,0,0,3.7,532,1072,8,40,,,1,0.2,0.33,,,,136,,,,,,,,,1,,,,,,,,,,,,,,5,,,29.28,,,,137,128,,1,167,154,,,,,,,,,"18,14,13,16,14,22,3",,"55,29,11,1,4",,,,,,,,,,,,,,,,,,,,,,,,,,,,,,,,,,,,,,,,,,25,3,88,52,,1012,0,,1,5,3,,1,0,,,,,"Aachen Radfahren",,"Polar BEAT",,0,,0,168072,,30378,,,,,,,,,,,,,,,,,,,,,,,,,,,,,,,,,,,,,,,,,,,
5962568,cb90fc44-6a4d-4799-b67d-fb73391477f2,1461095787,120,1548677630,,0,0,17.17,4914,6547,107,114,,,1,0.4,0.27,,,,1167,,,,,,,44.06,,1,,,,,,,,,,,,,,102,81,12.73,13.92,14.07,,,,,,,,,,,,,,,,,"17,3,4,14,22,11,9,19,0",,,,,,,129,,,,,,,,,,,,,,,,,,,,,,,,,,,,,,,,,,,,,10,10,343,56,,1027,,,0,5,3,,1,0,,,,,"Aachen Laufen",,"Polar BEAT",,0,,0,168070,250480,30378,,,,,,,,,,,,,,,,,,,,,,,,,,,,,,,,,,,,,,,,,,,
5962569,eb934634-2fa2-4087-9033-d942bb3db0e1,1505040579,120,1548677631,,0,0,21.25,6156,6159,404,400,,,1,3.7,0.67,1.06,1.04,367,1528,153,172,,,,57.86,44.19,59.23,1,,,,,,,,,,,,,,166,82,12.92,12.67,13.17,0.7,,,,,,,,,,,,,,,,"3,3,13,21,27,28,4,0,0","0,6,77,17,0",,,,,,126,,,,,,,,,,,,,,,,,,,,,,,,,,,,,,,,,,,,57.6,13,15,220,93,,1006,,,0,2,1,,1,0,I1.000|4:46-I1.000|5:14-I1.000|4:31-I1.000|5:03-I1.000|5:18-I1.000|4:25-I1.000|4:44-I1.000|4:47-I1.000|5:07-I1.000|4:35-I1.000|4:17-I1.000|4:22-I1.000|4:18-I1.000|4:43-I1.000|4:28-I1.000|6:03-I1.000|5:24-I1.000|5:38-I1.000|4:50-I1.000|4:26-I1.000|4:35-I0.251|1:05,,Running,,,,"Polar M430",43,0,,0,168070,250480,30378,,,,,,,,,,,,,,,,,,,,,,,,,,,,,,,,,,,,,,,,,,"4,4,4",
5962570,963e59b9-deac-4ea3-b9b7-a8607e48d1a0,1397242893,120,1548677631,,0,0,1.7,625,626,8,9,,,1,0,0.24,1.02,0.87,,93,134,143,,,,51.14,27.75,51.4,1,,,,,,,,,,,,,,10,78,9.78,9.93,9.96,-1.5,,,,,,,,,,,,,,,,"19,33,44,4,0,0,0,0,0","0,99,1,0,0",,,,,,105,,,,,,,,,,,,,,,,,,,,,,,,,,,,,,,,,,,,12.8,11,14,332,83,,1021,0,,0,5,3,,1,0,,,,,Einlaufen,,"Polar BEAT",,0,,0,168070,250480,30378,,,,,,,,,,,,,,,,,,,,,,,,,,,,,,,,,,,,,,,,,,,
5962571,128cada4-dc2e-4e5c-b1e7-53f1737c1a94,1503647218,120,1548677632,,0,0,10.01,2977,2979,167,175,,,1,2.5,0.58,1.09,0.98,440,689,149,171,,,,58.06,40.42,59.2,1,,,,,,,,,,,,,,72,81,12.42,12.21,12.74,4.8,,,,,,,,,,,,,,,,"2,3,10,29,42,13,0,0,0","0,17,69,13,0",,,,,,125,,,,,,,,,,,,,,,,,,,,,,,,,,,,,,,,,,,,47.7,13,2,113,91,,1019,0,,0,5,3,,1,0,I1.000|4:59-I1.000|4:52-I1.000|4:46-I1.000|4:58-I1.000|5:23-I1.000|5:18-I1.000|4:49-I1.000|4:48-I1.000|4:40-I1.000|5:04-I0.011|0:03,,Running,,,,"Polar M430",43,0,,0,168070,250480,30378,,,,,,,,,,,,,,,,,,,,,,,,,,,,,,,,,,,,,,,,,,4,
5962572,8968c7ef-33e3-4cae-be55-e05ccdef1a99,1472989109,120,1548677633,,0,0,34.01,8486,8487,234,233,,,1,0,0.23,,,173,2300,,,,,,,54.43,,1,,,,,,,,,,,,,,176,84,14.52,14.53,14.65,,,,,,,,,,,,,,,,,"1,0,0,0,8,63,26,1,0",,,,,,,143,,,,,,,,,,,,,,,,,,,,,,,,,,,,,,,,,,,,,19,9,228,86,,1011,3,,0,6,3,,1,0,,,,,"Aachen Laufen",,"Polar BEAT",,0,,0,168070,250480,30378,,,,,,,,,,,,,,,,,,,,,,,,,,,,,,,,,,,,,,,,,,5,
5962573,5839749c-6b44-4a09-b755-5f76ed24f265,1531246184,120,1548677634,,0,0,14.75,4126,4127,54,54,,,1,0,0.07,1.1,0.9,,980,146,168,,,,64.34,44.7,64.63,1,,,,,,,,,,,,,,95,83,12.91,13.21,13.29,2.3,,,,,,,,,,,,,,,,"2,3,10,17,32,22,14,0,0","0,34,46,19,0",,,,,,129,,,,,,,,,,,,,,,,,,,,,,,,,,,,,,,,,,,,52.2,23,14,298,38,,1015,,,0,3,3,,1,0,I1.000|4:37-I1.000|4:42-I1.000|4:42-I1.000|4:39-I1.000|4:01-I1.000|3:53-I1.000|4:15-I1.000|3:59-I1.000|4:04-I1.000|4:48-I1.000|4:37-I1.000|4:59-I1.000|5:19-I1.000|5:51-I0.749|4:21,,Running,,,,"Polar M430",43,0,,0,168070,250480,30378,,,,,,,,,,,,,,,,,,,,,,,,,,,,,,,,,,,,,,,,,,,
5962575,dc69ce80-c412-4879-981d-10c260016b97,1418202103,60,1548677634,,0,0,9.98,2684,2792,84,109,,,1,0.4,0.4,,,228,666,,,,,,,45.46,,1,,,,,,,,,,,,,,55,86,13.49,13.55,13.64,,,,,,,,,,,,,,,,,"1,1,4,12,19,56,6,1,0",,,,,,,130,,,,,,,,,,,,,,,,,,,,,,,,,,,,,,,,,,,,,4,14,215,95,,1018,0,,0,6,3,,1,0,,,,,"Lockerer DL",,"Polar BEAT",,0,,0,168070,250480,30378,,,,,,,,,,,,,,,,,,,,,,,,,,,,,,,,,,,,,,,,,,5,
5962576,69532e9b-44da-413e-9142-ccfa1121e7c6,1475927221,120,1548677634,,0,0,1.08,222,222,24,4,,,1,0.5,0.37,,,,57,,,,,,,50.99,,1,,,,,,,,,,,,,,4,83,18.69,27.36,29.38,,,,,,,,,,,,,,,,,"27,11,16,5,15,2,0,2,22",,,,,,,176,,,,,,,,,,,,,,,,,,,,,,,,,,,,,,,,,,,,,11,7,42,76,,1023,2,,0,5,3,,1,0,,,,,"Aachen Laufen",,"Polar BEAT",,0,,0,168070,250480,30378,,,,,,,,,,,,,,,,,,,,,,,,,,,,,,,,,,,,,,,,,,,
5962577,92f1afd3-d392-4068-88b9-ec1a5a705623,1416946912,60,1548677635,,0,0,1.44,510,518,12,27,,,1,0.9,0.56,,,,94,,,,,,,28.47,,1,,,,,,,,,,,,,,10,80,10.01,10.28,10.46,,,,,,,,,,,,,,,,,"12,12,44,30,2,0,0,0,0",,,,,,,106,,,,,,,,,,,,,,,,,,,,,,,,,,,,,,,,,,,,,5,8,97,84,,1020,0,,1,5,3,,1,0,,,,,Auslaufen,,"Polar BEAT",,0,,0,168070,250480,30378,,,,,,,,,,,,,,,,,,,,,,,,,,,,,,,,,,,,,,,,,,,
5962578,28c4a1d6-2349-410b-8c64-eca4e9e005fd,1464034470,120,1548677635,,0,0,9.82,2846,3063,174,174,,,1,2.3,0.55,,,338,672,,,,,,,41.61,,1,,,,,,,,,,,,,,59,82,12.76,12.65,13.34,,,,,,,,,,,,,,,,,"7,2,5,17,34,31,3,0,0",,,,,,,126,,,,,,,,,,,,,,,,,,,,,,,,,,,,,,,,,,,,,10,9,307,95,,1016,0,,0,6,3,,1,0,,,,,"Aachen Laufen",,"Polar BEAT",,0,,0,168070,250480,30378,,,,,,,,,,,,,,,,,,,,,,,,,,,,,,,,,,,,,,,,,,"4,5",
5962579,a16f5c24-7ef9-49ec-802b-5d3a7c60160e,1414404341,60,1548677636,,0,0,13.58,4237,4255,161,160,,,1,1.3,0.42,,,397,923,,,,,,,39.11,,1,,,,,,,,,,,,,,88,79,11.71,12.46,12.63,,,,,,,,,,,,,,,,,"10,2,8,21,30,26,3,0,0",,,,,,,122,,,,,,,,,,,,,,,,,,,,,,,,,,,,,,,,,,,,,13,4,180,86,,1026,1,,0,5,3,,1,0,,,,,"Regenerativer DL",,"Polar BEAT",,0,,0,168070,250480,30378,,,,,,,,,,,,,,,,,,,,,,,,,,,,,,,,,,,,,,,,,,5,
5962580,63b86842-5623-4515-be5a-39b3e96b7aee,1449082433,60,1548677636,,0,0,1.12,370,370,17,13,,,1,1.1,0.64,,,,75,,,,,,,29.96,,1,,,,,,,,,,,,,,7,81,11.22,10.85,11.36,,,,,,,,,,,,,,,,,"13,19,20,25,18,4,0,0,0",,,,,,,112,,,,,,,,,,,,,,,,,,,,,,,,,,,,,,,,,,,,,8,13,197,77,,1029,,,1,5,3,,1,0,,,,,"Aachen Laufen",,"Polar BEAT",,0,,0,168070,250480,30378,,,,,,,,,,,,,,,,,,,,,,,,,,,,,,,,,,,,,,,,,,,
5962581,66035e5a-d9f2-44b9-8004-adbcc068a313,1392663778,60,1548677637,,0,0,4.38,1319,1320,70,73,,,1,0.6,0.45,,,,294,,,,,,,37.83,,1,,,,,,,,,,,,,,27,83,12.17,12.05,12.39,,,,,,,,,,,,,,,,,"3,3,11,30,45,8,0,0,0",,,,,,,120,,,,,,,,,,,,,,,,,,,,,,,,,,,,,,,,,,,,,6,3,176,79,,1016,0,,1,5,3,,1,0,,,,,Auslaufen,,"Polar BEAT",,0,,0,168070,250480,30378,,,,,,,,,,,,,,,,,,,,,,,,,,,,,,,,,,,,,,,,,,,
5962582,bc796a58-7e2a-4192-8dc6-0bdf134a9122,1398697999,120,1548677637,,0,0,4.2,1326,1397,38,38,,,1,0.5,0.34,1.07,1.06,,235,144,162,,,,56.41,35.68,57.04,1,,,,,,,,,,,,,,29,82,11.57,11.8,12,-6.6,,,,,,,,,,,,,,,,"20,6,12,22,24,11,2,3,1","0,33,61,5,0",,,,,,116,,,,,,,,,,,,,,,,,,,,,,,,,,,,,,,,,,,,29.8,16,2,62,63,,1011,4,,0,5,3,,1,0,,,,,"Auslaufen - Abgebrochen, Schmerzen im rechten Fuß an der Ferse",,"Polar BEAT",,0,,0,168070,250480,30378,,,,,,,,,,,,,,,,,,,,,,,,,,,,,,,,,,,,,,,,,,,
5962583,2ea8f004-a7b5-4020-aa6e-6d174f1ef1f7,1408021424,120,1548677638,,0,0,8.43,2680,2715,68,93,,,1,0.8,0.38,,,,563,,,,,,,36.93,,1,,,,,,,,,,,,,,55,81,11.35,11.39,11.47,,,,,,,,,,,,,,,,,"0,5,28,55,8,2,1,0,0",,,,,,,117,,,,,,,,,,,,,,,,,,,,,,,,,,,,,,,,,,,,,17,8,227,84,,1011,5,,0,5,3,,1,0,,,,,"Regenerativer DL",,"Polar BEAT",,0,,0,168070,250480,30378,,,,,,,,,,,,,,,,,,,,,,,,,,,,,,,,,,,,,,,,,,,
5962584,9939e887-23a5-4f86-897b-17e320ebdf1d,1453367305,60,1548677638,,0,0,6.42,2132,2298,101,99,,,1,1.8,0.53,,,218,448,,,,,,,34.46,,1,,,,,,,,,,,,,,44,80,11.13,11.01,11.46,,,,,,,,,,,,,,,,,"10,16,26,26,19,3,0,0,0",,,,,,,113,,,,,,,,,,,,,,,,,,,,,,,,,,,,,,,,,,,,,0,5,139,94,,1026,,,0,5,3,,1,0,,,,,"Aachen Laufen",,"Polar BEAT",,0,,0,168070,250480,30378,,,,,,,,,,,,,,,,,,,,,,,,,,,,,,,,,,,,,,,,,,4,
5962585,99046f88-4e2a-42af-9df1-0382dae33707,1479754665,60,1548677638,,0,0,13,3383,3387,194,197,,,1,2.2,0.56,,,429,881,,,,,,,48.14,,1,,,,,,,,,,,,,,70,82,14.13,14.05,14.33,,,,,,,,,,,,,,,,,"2,1,3,4,21,47,22,0,0",,,,,,,141,,,,,,,,,,,,,,,,,,,,,,,,,,,,,,,,,,,,,12,17,181,84,,1000,,,1,6,3,,1,0,,,,,"Aachen Laufen",,"Polar BEAT",,0,,0,168070,250480,30378,,,,,,,,,,,,,,,,,,,,,,,,,,,,,,,,,,,,,,,,,,4,
5962586,a39fbdf7-1583-43c1-bbb0-68b65777e1ac,1392559199,60,1548677639,,0,0,5.07,1015,1015,14,12,,,1,0,0.04,,0.96,,247,174,184,,,,75.67,61.58,75.97,1,,,,,,,,,,,,,,44,91,18.05,18.01,18.08,6.1,,,,,,,,,,,,,,,,"0,0,0,0,0,0,21,75,4","0,3,3,70,24",,,,,,165,,,,,,,,,,,,,,,,,,,,,,,,,,,,,,,,,,,,106.7,8,24,255,62,,1008,,,0,5,3,,1,0,,,,,"WK 5k",,"Polar BEAT",,0,,0,168070,250480,30378,,,,,,,,,,,,,,,,,,,,,,,,5,1015,,,0,"Bertlicher Straßenlauf",,,,,,,0,0,30378,5962586,4666,,,
5962587,2f6248ce-4e7f-40ac-b9cc-457c45d9197e,1393499932,60,1548677639,,0,0,3.07,951,956,64,66,,,1,1.7,0.93,1.06,1.14,,183,153,182,,,,53.27,35.72,54.6,1,,,,,,,,,,,,,,28,76,12.25,14.82,15.1,28.2,,,,,,,,,,,,,,,,"44,1,1,1,1,2,6,39,5","0,37,11,46,5",,,,,,127,,,,,,,,,,,,,,,,,,,,,,,,,,,,,,,,,,,,61.9,8,14,185,75,,1014,2,,0,5,3,,1,0,,,,,"2x 1000m + 400m ",,"Polar BEAT",,0,,0,168070,250480,30378,,,,,,,,,,,,,,,,,,,,,,,,,,,,,,,,,,,,,,,,,,,
5962588,f4d5dd2e-12ed-4f2e-80e4-13ce799b6c3f,1521484434,60,1548677639,,0,0,11.02,1782,1782,49,36,,,1,0,0.13,,,,103,80,105,,,,,,,1,,,,,,,,,,,,,,4,,,22.95,,6.9,-19.7,111,98,,1,132,122,,,,,,,,,"4,13,73,8,2,0,0","97,3,0,0,0","87,3,0,1,10",,,,,,,,,,,,,,,,,,,,,,,,,,,,,,,,,,,,,,,,,0.9,1,2,57,63,,,0,,1,5,3,,1,0,,,Cycling,,,,"Polar M430",43,0,,0,168072,,30378,,,,,,,,,,,,,,,,,,,,,,,,,,,,,,,,,,,,,,,,,,,
5962589,df2afb91-b5de-4f0c-aa8b-6698cac18e7f,1466810028,120,1548677641,,0,0,1.06,351,937,16,35,,,1,0.8,0.43,,,,73,,,,,,,29.69,,1,,,,,,,,,,,,,,7,79,11.23,12.07,11.98,,,,,,,,,,,,,,,,,"21,1,1,6,44,23,5,0,0",,,,,,,115,,,,,,,,,,,,,,,,,,,,,,,,,,,,,,,,,,,,,18,1,319,87,,1019,0,,1,5,3,,1,0,,,,,"Aachen Laufen",,"Polar BEAT",,0,,0,168070,250480,30378,,,,,,,,,,,,,,,,,,,,,,,,,,,,,,,,,,,,,,,,,,,
5962590,3db8148e-fc28-4f50-a206-0b14a6b547bb,1394481850,60,1548677642,,0,0,10.11,2278,2278,215,217,,,1,0,0,1.2,0.91,,530,169,175,,,,68.36,55.96,70.15,1,,,,,,,,,,,,,,86,86,16.3,16,16.56,3.2,,,,,,,,,,,,,,,,"0,0,0,0,0,1,98,1,0","0,1,3,97,0",,,,,,155,,,,,,,,,,,,,,,,,,,,,,,,,,,,,,,,,,,,78.9,11,3,20,57,,1026,0,,1,3,3,,1,0,,,,,"TDL 10.000m in 38:00",,"Polar BEAT",,0,,0,168070,250480,30378,,,,,,,,,,,,,,,,,,,,,,,,,,,,,,,,,,,,,,,,,,,
5962591,e29f07c0-c5f6-4122-b10c-070d80abf06d,1496780056,120,1548677642,,0,0,3.35,961,961,66,66,,,1,1.7,0.64,,,439,219,,,,,,,39.33,,1,,,,,,,,,,,,,,19,79,12.96,12.64,13.42,,,,,,,,,,,,,,,,,"0,3,12,24,35,19,7,0,0",,,,,,,132,,,,,,,,,,,,,,,,,,,,,,,,,,,,,,,,,,,,,14,15,233,62,,1006,0,,0,5,3,,1,0,,,,,"Aachen Laufen",,"Polar BEAT",,0,,0,168070,250480,30378,,,,,,,,,,,,,,,,,,,,,,,,,,,,,,,,,,,,,,,,,,5,
5962592,ca6bd142-ef35-4929-a667-07df03609c98,1481967630,60,1548677642,,0,0,0.71,226,230,15,13,,,1,1.2,0.71,,,,52,,,,,,,29.74,,1,,,,,,,,,,,,,,4,81,11.96,12.37,12.95,,,,,,,,,,,,,,,,,"15,2,4,17,34,28,0,0,0",,,,,,,116,,,,,,,,,,,,,,,,,,,,,,,,,,,,,,,,,,,,,2,2,204,93,,1038,0,,0,5,3,,1,0,,,,,"Aachen Laufen",,"Polar BEAT",,0,,0,168070,250480,30378,,,,,,,,,,,,,,,,,,,,,,,,,,,,,,,,,,,,,,,,,,,
5962593,,1408652364,120,1548677642,,0,0,3,0,0,,,,,0,,,,,,,,,,,,,,,1,,,,,,,,,,,,,,0,,,,,,,,,,,,,,,,,,,,,,,,,,,,,,,,,,,,,,,,,,,,,,,,,,,,,,,,,,,,,,,,,,,,,,,,,,1,,,0,0,,,,,Einlaufen,,"Polar BEAT",,0,,0,168070,250480,30378,,,,,,,,,,,,,,,,,,,,,,,,,,,,,,,,,,,,,,,,,,,
5962594,fa9302cd-7021-44d1-9c31-b00e0b04e993,1493383623,120,1548677644,,0,0,13.74,3847,4323,199,196,,,1,2.3,0.57,,,416,977,,,,,,,44.41,,1,,,,,,,,,,,,,,79,82,13.12,13,13.33,,,,,,,,,,,,,,,,,"2,2,4,11,44,33,4,0,0",,,,,,,131,,,,,,,,,,,,,,,,,,,,,,,,,,,,,,,,,,,,,9,6,242,74,,1015,5,,0,5,3,,1,0,,,,,"Aachen Laufen",,"Polar BEAT",,0,,0,168070,250480,30378,,,,,,,,,,,,,,,,,,,,,,,,,,,,,,,,,,,,,,,,,,4,
5962595,477deb41-ff81-481a-8c8d-4f386b1ba742,1407269518,120,1548677644,,0,0,3.33,973,973,66,65,,,1,1.7,0.64,,,440,220,,,,,,,38.48,,1,,,,,,,,,,,,,,20,81,12.73,12.44,13.24,,,,,,,,,,,,,,,,,"1,6,10,28,30,18,7,0,0",,,,,,,127,,,,,,,,,,,,,,,,,,,,,,,,,,,,,,,,,,,,,21,1,256,61,,1019,0,,0,3,3,,1,0,,,,,Einlaufen,,"Polar BEAT",,0,,0,168070,250480,30378,,,,,,,,,,,,,,,,,,,,,,,,,,,,,,,,,,,,,,,,,,5,
5962597,8a7772de-0136-47df-b4d5-5fee23c79754,1443030299,120,1548677644,,0,0,10.71,3722,4448,28,28,,,1,0,0.04,,,,728,,,,,,,33.83,,1,,,,,,,,,,,,,,77,82,10.38,10.49,10.54,,,,,,,,,,,,,,,,,"12,23,44,14,5,2,0,0,0",,,,,,,105,,,,,,,,,,,,,,,,,,,,,,,,,,,,,,,,,,,,,16,8,259,74,,1010,,,0,4,3,,1,0,,,,,"Münster Laufen",,"Polar BEAT",,0,,0,168070,250480,30378,,,,,,,,,,,,,,,,,,,,,,,,,,,,,,,,,,,,,,,,,,,
5962598,82bad39c-d497-44ff-9fa5-247a3b5eb894,1411309037,120,1548677645,,0,0,4.96,1172,1172,79,78,,,1,1.4,0.45,,,436,326,,,,,,,50.69,,1,,,,,,,,,,,,,,24,84,15.73,15.47,16.02,,,,,,,,,,,,,,,,,"0,0,2,3,9,29,40,17,0",,,,,,,151,,,,,,,,,,,,,,,,,,,,,,,,,,,,,,,,,,,,,15,3,308,90,,,3,,0,6,3,,1,0,,,,,"WK 5k Panoramalauf",,"Polar BEAT",,0,,0,168070,250480,30378,,,,,,,,,,,,,,,,,,,,,,,,,,,,,,,,,,,,,,,,,,4,
5962599,8170835b-87b6-4ed5-8730-ac9f8953e0ce,1439139911,120,1548677645,,0,0,14.35,4304,4304,314,316,,,1,4.1,0.65,,,579,982,,,,,,,41.13,,1,,,,,,,,,,,,,,89,84,12.48,12.19,13.08,,,,,,,,,,,,,,,,,"4,7,11,24,40,12,1,0,0",,,,,,,119,,,,,,,,,,,,,,,,,,,,,,,,,,,,,,,,,,,,,24,8,353,60,,1020,,,0,5,3,,1,0,,,,,"Balve Laufen",,"Polar BEAT",,0,,0,168070,250480,30378,,,,,,,,,,,,,,,,,,,,,,,,,,,,,,,,,,,,,,,,,,"4,4",
5962600,158ececd-0942-491c-8fd4-d3aa5847c2e1,1395169799,60,1548677646,,0,0,2.29,695,706,25,22,,,1,0.4,0.35,1.13,0.89,,143,146,159,,,,58.17,35.67,59.05,1,,,,,,,,,,,,,,15,81,11.98,12.16,12.54,8.8,,,,,,,,,,,,,,,,"8,3,2,25,52,10,0,0,0","1,18,82,0,0",,,,,,122,,,,,,,,,,,,,,,,,,,,,,,,,,,,,,,,,,,,25.3,8,12,243,82,,1016,0,,1,5,3,,1,0,,,,,Einlaufen,,"Polar BEAT",,0,,0,168070,250480,30378,,,,,,,,,,,,,,,,,,,,,,,,,,,,,,,,,,,,,,,,,,,
5962601,26cc7b3d-4816-441d-9790-ee72cc51c148,1530207875,120,1548677646,,0,0,1.41,398,398,2,8,,,1,0,0.14,,0.74,,73,125,136,,,,76.9,36.74,76.62,1,,,,,,,,,,,,,,5,82,12.57,12.76,12.66,-10.5,,,,,,,,,,,,,,,,"3,1,2,17,37,40,0,0,0","2,98,0,0,0",,,,,,130,,,,,,,,,,,,,,,,,,,,,,,,,,,,,,,,,,,,7,24,14,80,47,,1017,,,0,4,3,,1,0,I1.000|4:50-I0.409|1:49,,Running,,,,"Polar M430",43,0,,0,168070,250480,30378,,,,,,,,,,,,,,,,,,,,,,,,,,,,,,,,,,,,,,,,,,,
5962602,fc1ae17a-04b9-44e6-af1f-090e545d0e79,1468180837,120,1548677646,,0,0,5.46,1386,1386,93,93,,,1,1.2,0.33,,,300,374,,,,,,,46.89,,1,,,,,,,,,,,,,,28,81,14.43,14.28,14.85,,,,,,,,,,,,,,,,,"0,0,1,3,23,44,28,0,0",,,,,,,146,,,,,,,,,,,,,,,,,,,,,,,,,,,,,,,,,,,,,27,6,235,53,,1009,0,,0,5,3,,1,0,,,,,"Aachen Laufen",,"Polar BEAT",,0,,0,168070,250480,30378,,,,,,,,,,,,,,,,,,,,,,,,,,,,,,,,,,,,,,,,,,4,
5962603,c269e262-bfd8-402f-8c88-cf4c67b27f29,1403216644,120,1548677647,,0,0,4.39,1277,1277,49,32,,,1,0.8,0.4,,,,302,,,,,,,39.42,,1,,,,,,,,,,,,,,26,82,12.65,12.47,12.78,,,,,,,,,,,,,,,,,"0,2,6,29,53,9,1,1,0",,,,,,,126,,,,,,,,,,,,,,,,,,,,,,,,,,,,,,,,,,,,,13,10,313,91,,1020,,,1,4,3,,1,0,,,,,"Lauf ABC + Sprints",,"Polar BEAT",,0,,0,168070,250480,30378,,,,,,,,,,,,,,,,,,,,,,,,,,,,,,,,,,,,,,,,,,,
5962604,193e18ad-9c9a-4da6-8296-6d4b8cc3ef1f,1458848357,60,1548677647,,0,0,7.77,2090,2091,62,61,,,1,0,0.01,,,,486,,,,,,,44.73,,1,,,,,,,,,,,,,,43,83,13.45,15.28,15.35,,,,,,,,,,,,,,,,,"34,2,2,3,4,4,6,39,6",,,,,,,134,,,,,,,,,,,,,,,,,,,,,,,,,,,,,,,,,,,,,7,11,223,72,,1015,,,1,5,3,,1,0,,,,,"Aachen Laufen",,"Polar BEAT",,0,,0,168070,250480,30378,,,,,,,,,,,,,,,,,,,,,,,,,,,,,,,,,,,,,,,,,,,
5962605,4d7fe041-57aa-4e38-92ca-18f861b5194e,1469737973,120,1548677647,,0,0,5.8,2142,2550,24,26,,,1,0,0,,,,314,,,,,,,30.16,,1,,,,,,,,,,,,,,44,77,9.8,11.74,11.81,,,,,,,,,,,,,,,,,"53,4,5,7,6,3,9,8,4",,,,,,,105,,,,,,,,,,,,,,,,,,,,,,,,,,,,,,,,,,,,,20,5,257,69,,1014,0,,0,5,3,,1,0,,,,,"Aachen Laufen",,"Polar BEAT",,0,,0,168070,250480,30378,,,,,,,,,,,,,,,,,,,,,,,,,,,,,,,,,,,,,,,,,,,
5962606,00fc8b34-268a-415e-a6ac-f2e48f429183,1546770581,60,1548677648,,0,0,20.87,8493,8578,834,684,,,1,6.5,0.74,1.28,0.95,400,1913,143,173,,,,41.61,29.52,44.05,1,,,,,,,,,,,,,,186,79,10.02,10.07,12.07,26.6,,,,,,,,,,,,,,,,"40,8,16,22,12,2,0,0,0","1,38,47,15,0",,,,,,93,,,,,,,,,,,,,,,,,,,,,,,,,,,,,,,,,,,,52.2,4,17,200,95,,1033,0,292,0,6,3,,1,0,I1.000|5:22-I1.000|5:22-I1.000|6:19-I1.000|5:17-I1.000|5:34-I1.000|5:17-I1.000|5:16-I1.000|6:20-I1.000|5:47-I1.000|5:37-I1.000|9:39-I1.000|8:21-I1.000|8:58-I1.000|8:41-I1.000|18:13-I1.000|6:12-I1.000|6:07-I1.000|4:59-I1.000|5:04-I1.000|5:06-I0.872|5:27,,Running,,"Ice snow slippery ",,"Polar M430",43,0,,0,168070,250480,30378,,,,,,,,,,,,,,,,,,,,,,,,,,,,,,,,,,,,,,,,,,"2,2,4",
5962607,81b09db3-2c79-4224-a8b4-e64209c976c2,1422040139,60,1548677649,,0,0,10.79,3536,3584,130,132,,,1,0.9,0.37,,,268,729,,,,,,,36.27,,1,,,,,,,,,,,,,,73,81,11.22,11.04,11.35,,,,,,,,,,,,,,,,,"5,7,32,46,10,0,0,0,0",,,,,,,113,,,,,,,,,,,,,,,,,,,,,,,,,,,,,,,,,,,,,-1,3,195,94,,1027,0,,1,4,3,,1,0,,,,,"Langsamer DL",,"Polar BEAT",,0,,0,168070,250480,30378,,,,,,,,,,,,,,,,,,,,,,,,,,,,,,,,,,,,,,,,,,5,
5962608,0a13f78e-b4aa-4682-a8a1-6585e4f8c14f,1509987640,60,1548677650,,0,0,11.9,3468,3471,50,49,,,1,0,0.08,1.13,0.93,,754,141,154,,,,63.97,41.92,64.31,1,,,,,,,,,,,,,,69,81,12.4,12.39,12.49,0.2,,,,,,,,,,,,,,,,"0,0,3,32,58,8,0,0,0","1,37,62,0,0",,,,,,127,,,,,,,,,,,,,,,,,,,,,,,,,,,,,,,,,,,,25.3,8,3,39,76,,1017,0,,1,5,3,,1,0,I1.000|4:49-I1.000|4:43-I1.000|4:39-I1.000|4:51-I1.000|4:50-I1.000|4:44-I1.000|4:50-I1.000|4:54-I1.000|4:50-I1.000|5:01-I1.000|5:03-I0.901|4:39,,Running,,,,"Polar M430",43,0,,0,168070,250480,30378,,,,,,,,,,,,,,,,,,,,,,,,,,,,,,,,,,,,,,,,,,,
5962609,4c8021fb-799a-4e89-895b-112c3125d996,1414008594,120,1548677650,,0,0,15.01,3783,3784,190,197,,,1,2,0.53,,,437,997,,,,,,,50.51,,1,,,,,,,,,,,,,,78,83,14.49,14.49,14.89,,,,,,,,,,,,,,,,,"1,0,1,5,16,50,23,4,0",,,,,,,143,,,,,,,,,,,,,,,,,,,,,,,,,,,,,,,,,,,,,8,5,276,91,,1023,0,,1,5,3,,1,0,,,,,"Gesteigerter DL",,"Polar BEAT",,0,,0,168070,250480,30378,,,,,,,,,,,,,,,,,,,,,,,,,,,,,,,,,,,,,,,,,,4,
5962610,8c5c3a27-198a-4e7a-9018-a2713ea898ba,1407012421,120,1548677651,,0,0,2.7,795,795,10,4,,,1,0,0.03,,,,184,,,,,,,37.49,,1,,,,,,,,,,,,,,16,79,12.34,12.31,12.41,,,,,,,,,,,,,,,,,"0,0,5,40,44,11,0,0,0",,,,,,,129,,,,,,,,,,,,,,,,,,,,,,,,,,,,,,,,,,,,,23,3,207,70,,1007,0,,0,3,3,,1,0,,,,,Einlaufen,,"Polar BEAT",,0,,0,168070,250480,30378,,,,,,,,,,,,,,,,,,,,,,,,,,,,,,,,,,,,,,,,,,,
5962611,f3d48ad6-7e1c-48ea-85f8-d90b1636f6d8,1501094056,120,1548677651,,0,0,2.53,736,739,81,37,,,1,1.9,0.6,0.96,1.17,527,146,151,174,,,,58.6,37.8,62.2,1,,,,,,,,,,,,,,20,81,13.48,12.82,14.24,24.6,,,,,,,,,,,,,,,,"12,4,11,11,25,26,12,0,0","4,22,34,41,0",,,,,,127,,,,,,,,,,,,,,,,,,,,,,,,,,,,,,,,,,,,48.8,23,17,240,53,,1009,,,0,3,1,,1,0,I1.000|4:18-I1.000|4:52-I0.540|3:10,,Running,,,,"Polar M430",43,0,,0,168070,250480,30378,,,,,,,,,,,,,,,,,,,,,,,,,,,,,,,,,,,,,,,,,,4,
5962612,3ecd0b1e-ab1c-45f2-b7ed-bc52059c6e23,1482258551,60,1548677651,,0,0,2.87,943,1362,55,50,,,1,0.9,0.44,,,,199,,,,,,,33.17,,1,,,,,,,,,,,,,,19,81,11.35,11.17,11.7,,,,,,,,,,,,,,,,,"12,10,19,33,18,6,2,0,0",,,,,,,113,,,,,,,,,,,,,,,,,,,,,,,,,,,,,,,,,,,,,0,6,175,87,,1023,,,1,3,3,,1,0,,,,,"Aachen Laufen",,"Polar BEAT",,0,,0,168070,250480,30378,,,,,,,,,,,,,,,,,,,,,,,,,,,,,,,,,,,,,,,,,,,
5962613,a36d8e85-d5de-4bb4-a8d0-b5ec6b663441,1363629898,60,1548677651,,0,0,2.1,662,662,0,4,,,1,0,0,,,,150,158,166,,,,49.84,33.86,49.73,1,,,,,,,,,,,,,,20,,11.39,12.06,11.99,13.6,,,,,,,,,,,,,,,,"8,0,6,27,54,5,0,0,0","0,3,40,56,0",,,,,,,,,,,,,,,,,,,,,,,,,,,,,,,,,,,,,,,,,,43.2,1,6,275,99,,993,0,,0,5,3,,1,0,,,,,,,"Polar BEAT",,0,,0,168070,250480,30378,,,,,,,,,,,,,,,,,,,,,,,,,,,,,,,,,,,,,,,,,,,
5962614,2f5d353f-7eaa-4c10-96cf-c5ac3cac0ea6,1536485038,120,1548677652,,0,0,24.13,7190,7191,85,89,,,1,0,0.08,1.09,0.93,,1808,151,162,,,,56.89,43.18,57.13,1,,,,,,,,,,,,,,182,82,12.12,12.17,12.24,3.4,,,,,,,,,,,,,,,,"1,1,6,40,45,7,0,0,0","0,3,96,1,0",,,,,,123,,,,,,,,,,,,,,,,,,,,,,,,,,,,,,,,,,,,40.4,13,3,209,96,,1022,,,0,5,3,,1,0,I1.000|5:24-I1.000|5:10-I1.000|4:46-I1.000|4:36-I1.000|4:44-I1.000|4:36-I1.000|4:52-I1.000|5:05-I1.000|4:50-I1.000|4:49-I1.000|4:55-I1.000|4:58-I1.000|4:48-I1.000|4:45-I1.000|4:58-I1.000|4:45-I1.000|4:57-I1.000|4:55-I1.000|5:02-I1.000|5:04-I1.000|5:08-I1.000|5:09-I1.000|5:14-I1.000|5:09-I0.136|1:12,,Running,,,,"Polar M430",43,0,,0,168070,250480,30378,,,,,,,,,,,,,,,,,,,,,,,,,,,,,,,,,,,,,,,,,,,
5962615,7f6baab6-6c5f-4a87-8167-e0da81f91908,1367780477,120,1548677655,,0,0,10.08,3233,3275,137,147,,,1,1.5,0.48,,,263,699,,,,,,,37.01,,1,,,,,,,,,,,,,,67,,11.43,11.41,11.77,,,,,,,,,,,,,,,,,"9,8,17,36,25,5,0,0,0",,,,,,,,,,,,,,,,,,,,,,,,,,,,,,,,,,,,,,,,,,,,19,2,355,44,,1022,1,,0,5,3,,1,0,,,,,,,"Polar BEAT",,0,,0,168070,250480,30378,,,,,,,,,,,,,,,,,,,,,,,,,,,,,,,,,,,,,,,,,,5,
5962616,75836109-e66d-4bc1-b11b-7d8cd68e26e0,1408281807,120,1548677655,,0,0,23.21,5956,6093,381,379,,,1,3.2,0.54,,,565,1541,,,,,,,51.21,,1,,,,,,,,,,,,,,123,84,14.45,14.34,14.91,,,,,,,,,,,,,,,,,"3,2,4,7,16,33,31,4,1",,,,,,,139,,,,,,,,,,,,,,,,,,,,,,,,,,,,,,,,,,,,,16,12,236,72,,1013,4,,0,5,3,,1,0,,,,,"Zügiger Langer DL",,"Polar BEAT",,0,,0,168070,250480,30378,,,,,,,,,,,,,,,,,,,,,,,,,,,,,,,,,,,,,,,,,,"4,5,5,5,5",
5962617,5668838a-4abe-4a1b-8012-ca716b813e0b,1501699974,120,1548677656,,0,0,16.01,4680,4680,184,214,,,1,2,0.53,1.03,1.01,454,1036,146,172,,,,60.93,42.75,61.66,1,,,,,,,,,,,,,,106,80,12.47,12.45,12.61,0.9,,,,,,,,,,,,,,,,"2,3,8,21,50,16,0,0,0","0,28,61,11,0",,,,,,128,,,,,,,,,,,,,,,,,,,,,,,,,,,,,,,,,,,,50.7,21,1,340,73,,1016,,,0,5,3,,1,0,I4.339|22:19-I11.667|55:41,,Running,,,,"Polar M430",43,0,,0,168070,250480,30378,,,,,,,,,,,,,,,,,,,,,,,,,,,,,,,,,,,,,,,,,,5,
5962618,67c05722-5930-44b8-8d81-b7278bef4c56,1492584303,120,1548677657,,0,0,5.77,5012,5067,841,10,,,2,8,1,,,597,241,,,,,,,,,1,,,,,,,,,,,,,,104,53,5.83,5.03,8.4,,,,,,,,,,,,,,,,,"99,0,0,0,1,0,0,0,0",,,,,,,65,,,,,,,,,,,,,,,,,,,,,,,,,,,,,,,,,,,,,9,15,300,66,,1014,,,0,3,3,,1,0,,,,,Laufen,,"Polar BEAT",,0,,0,168070,250480,30378,,,,,,,,,,,,,,,,,,,,,,,,,,,,,,,,,,,,,,,,,,0,
5962619,23126f36-a318-4092-beca-d804a5945ce1,1443730053,120,1548677657,,0,0,3.36,1017,1017,65,64,,,1,1.6,0.58,,,444,228,,,,,,,36.95,,1,,,,,,,,,,,,,,21,83,12.28,11.98,12.94,,,,,,,,,,,,,,,,,"3,2,15,37,29,13,1,0,0",,,,,,,119,,,,,,,,,,,,,,,,,,,,,,,,,,,,,,,,,,,,,10,9,75,68,,1029,,,1,3,3,,1,0,,,,,"Aachen Laufen",,"Polar BEAT",,0,,0,168070,250480,30378,,,,,,,,,,,,,,,,,,,,,,,,,,,,,,,,,,,,,,,,,,4,
5962620,10121fe9-c6fa-4d34-a65a-42ed52fedd4f,1502463692,120,1548677658,,0,0,8.32,2482,2486,0,1,,,1,0,0,,,,494,137,149,,,,64.43,39.77,64.42,1,,,,,,,,,,,,,,44,80,12.07,12.24,12.25,-1.6,,,,,,,,,,,,,,,,"2,2,10,38,33,10,2,1,0","1,64,35,0,0",,,,,,126,,,,,,,,,,,,,,,,,,,,,,,,,,,,,,,,,,,,21,19,6,305,68,,1017,4,,0,5,3,,1,0,I2.393|12:55-I5.933|28:31,,Running,,,,"Polar M430",43,0,,0,168070,250480,30378,,,,,,,,,,,,,,,,,,,,,,,,,,,,,,,,,,,,,,,,,,,
5962621,ef489c4f-0a1a-4616-ab06-cfcbb9df4e45,1468443651,120,1548677658,,0,0,5.41,1126,1126,95,98,,,1,1.9,0.51,,,385,366,,,,,,,59.12,,1,,,,,,,,,,,,,,23,87,17.69,17.35,17.96,,,,,,,,,,,,,,,,,"0,0,0,0,3,10,28,57,2",,,,,,,166,,,,,,,,,,,,,,,,,,,,,,,,,,,,,,,,,,,,,14,3,306,89,,1017,0,,0,5,3,,1,0,,,,,"Aachen Laufen",,"Polar BEAT",,0,,0,168070,250480,30378,,,,,,,,,,,,,,,,,,,,,,,,5.56,1126,,,0,Lousberglauf,,,,,,,0,0,30378,5962621,3406,,4,
5962622,95ca0632-8f3e-468f-ba12-e89b2fc5aca6,1457181104,60,1548677658,,0,0,3.37,1014,1102,35,40,,,1,0.8,0.52,,,,235,,,,,,,37.22,,1,,,,,,,,,,,,,,21,83,12.02,12.16,12.24,,,,,,,,,,,,,,,,,"4,5,10,27,40,11,3,0,0",,,,,,,120,,,,,,,,,,,,,,,,,,,,,,,,,,,,,,,,,,,,,4,3,49,88,,996,,,0,4,3,,1,0,,,,,"Herten Laufen",,"Polar BEAT",,0,,0,168070,250480,30378,,,,,,,,,,,,,,,,,,,,,,,,,,,,,,,,,,,,,,,,,,,
5962623,2dee0ec3-2a78-4aee-9c59-ffe0fc7b5798,1529082839,120,1548677658,,0,0,1.23,514,519,4,12,,,1,0,0.16,1.29,0.97,,126,153,197,,,,36.79,23.09,36.64,1,,,,,,,,,,,,,,15,84,8.5,8.81,8.78,6.2,,,,,,,,,,,,,,,,"65,23,12,0,0,0,0,0,0","6,18,30,31,14",,,,,,85,,,,,,,,,,,,,,,,,,,,,,,,,,,,,,,,,,,,62.6,23,10,14,49,,1016,,,0,5,3,,1,0,I1.000|7:02-I0.234|1:39,,Running,,,,"Polar M430",43,0,,0,168070,250480,30378,,,,,,,,,,,,,,,,,,,,,,,,,,,,,,,,,,,,,,,,,,,
5962624,ff4cac22-1d22-4f74-9a19-4584901ff5fd,1475093529,120,1548677659,,0,0,15.01,4178,4353,198,207,,,1,2.1,0.61,,,410,1015,,,,,,,45.02,,1,,,,,,,,,,,,,,86,80,13.15,13.07,13.36,,,,,,,,,,,,,,,,,"2,1,5,10,41,39,2,0,0",,,,,,,135,,,,,,,,,,,,,,,,,,,,,,,,,,,,,,,,,,,,,19,8,226,70,,1026,0,,1,5,3,,1,0,,,,,"Aachen Laufen",,"Polar BEAT",,0,,0,168070,250480,30378,,,,,,,,,,,,,,,,,,,,,,,,,,,,,,,,,,,,,,,,,,4,
5962625,386376f7-9f58-44bd-8d40-3e62609d3796,1523705827,120,1548677660,,0,0,10.52,3398,3398,336,339,,,1,4.2,0.77,1.07,1.07,576,854,156,174,,,,49.25,36.82,51.17,1,,,,,,,,,,,,,,97,81,12.19,11.64,12.64,-10,,,,,,,,,,,,,,,,"24,12,11,15,20,18,0,0,0","0,5,64,30,0",,,,,,115,,,,,,,,,,,,,,,,,,,,,,,,,,,,,,,,,,,,69.6,13,5,255,80,,,3,,0,5,3,,1,0,I1.000|5:27-I1.000|6:14-I1.000|6:35-I1.000|6:50-I1.000|6:07-I1.000|4:59-I1.000|4:35-I1.000|4:44-I1.000|4:32-I1.000|4:14-I0.525|2:22,,Running,,,,"Polar M430",43,0,,0,168070,250480,30378,,,,,,,,,,,,,,,,,,,,,,,,,,,,,,,,,,,,,,,,,,3,
5962626,47a871ac-5e34-4c93-ad47-97d5299aade8,1392923617,60,1548677660,,0,0,2.2,669,669,58,46,,,1,1.6,0.63,1.16,1,427,143,153,166,,,,54.5,35.45,56.64,1,,,,,,,,,,,,,,17,81,12.6,11.87,13.14,-7.9,,,,,,,,,,,,,,,,"1,1,10,54,28,7,0,0,0","0,10,69,21,0",,,,,,122,,,,,,,,,,,,,,,,,,,,,,,,,,,,,,,,,,,,35.9,9,13,199,86,,1006,0,,1,5,3,,1,0,,,,,Einlaufen,,"Polar BEAT",,0,,0,168070,250480,30378,,,,,,,,,,,,,,,,,,,,,,,,,,,,,,,,,,,,,,,,,,5,
5962627,d38d6a3b-7637-4cf4-b186-01efd96cf90c,1457636960,60,1548677660,,0,0,3.32,964,964,64,64,,,1,1.6,0.58,,,466,225,,,,,,,38.75,,1,,,,,,,,,,,,,,20,83,12.8,12.51,13.33,,,,,,,,,,,,,,,,,"2,2,15,20,40,16,6,0,0",,,,,,,124,,,,,,,,,,,,,,,,,,,,,,,,,,,,,,,,,,,,,4,9,45,73,,1022,,,1,5,3,,1,0,,,,,"Aachen Laufen",,"Polar BEAT",,0,,0,168070,250480,30378,,,,,,,,,,,,,,,,,,,,,,,,,,,,,,,,,,,,,,,,,,4,
5962628,a37059a1-c283-4181-b60d-77e63a88025a,1465247072,120,1548677661,,0,0,12,2890,2893,110,105,,,1,0.7,0.36,,,,822,,,,,,,52.37,,1,,,,,,,,,,,,,,60,82,15.09,15.02,15.22,,,,,,,,,,,,,,,,,"0,0,0,2,6,41,52,1,0",,,,,,,152,,,,,,,,,,,,,,,,,,,,,,,,,,,,,,,,,,,,,20,1,120,84,,1021,0,,0,5,3,,1,0,,,,,"Aachen Laufen",,"Polar BEAT",,0,,0,168070,250480,30378,,,,,,,,,,,,,,,,,,,,,,,,,,,,,,,,,,,,,,,,,,,
5962629,8002599d-3e70-4f43-a6d1-1381a2036c38,1416065487,60,1548677661,,0,0,15.01,3153,3153,32,32,,,1,0,0,,,,1000,,,,,,,62.38,,1,,,,,,,,,,,,,,65,89,17.15,17.16,17.18,,,,,,,,,,,,,,,,,"0,0,0,0,0,1,54,45,0",,,,,,,160,,,,,,,,,,,,,,,,,,,,,,,,,,,,,,,,,,,,,11,10,198,88,,1001,,,0,5,3,,1,0,,,,,"WK 15k Erftlauf",,"Polar BEAT",,0,,0,168070,250480,30378,,,,,,,,,,,,,,,,,,,,,,,,,,,,,,,,,,,,,,,,,,,
5962630,30b964f8-53d9-41ac-9327-e237bc02eeec,1503832088,120,1548677661,,0,0,1.86,556,556,28,28,,,1,0.8,0.56,1.02,1.07,,120,143,158,,,,60.89,35.53,62.03,1,,,,,,,,,,,,,,12,81,12.22,12.12,12.32,-0.7,,,,,,,,,,,,,,,,"3,0,15,29,38,14,1,0,0","3,29,68,0,0",,,,,,124,,,,,,,,,,,,,,,,,,,,,,,,,,,,,,,,,,,,20.9,19,3,42,79,,1018,4,,0,5,3,,1,0,I1.000|5:10-I0.862|4:07,,Running,,,,"Polar M430",43,0,,0,168070,250480,30378,,,,,,,,,,,,,,,,,,,,,,,,,,,,,,,,,,,,,,,,,,,
5962631,2a846061-8e14-425e-8078-53035f568541,1458241943,60,1548677661,,0,0,3.33,901,901,63,62,,,1,1.7,0.64,,,475,231,,,,,,,42.07,,1,,,,,,,,,,,,,,18,84,13.72,13.39,14.22,,,,,,,,,,,,,,,,,"0,0,2,17,37,27,17,0,0",,,,,,,132,,,,,,,,,,,,,,,,,,,,,,,,,,,,,,,,,,,,,6,6,20,61,,1026,,,1,3,3,,1,0,,,,,"Aachen Laufen",,"Polar BEAT",,0,,0,168070,250480,30378,,,,,,,,,,,,,,,,,,,,,,,,,,,,,,,,,,,,,,,,,,5,
5962632,1c597205-3cf0-4752-94ce-d8e075bf339e,1546971270,60,1548677662,,0,0,12.23,3215,3215,24,17,,,1,0,0.02,,,,806,152,176,,,,65.83,47.36,66.03,1,,,,,,,,,,,,,,85,83,13.73,14.05,14.09,14.2,,,,,,,,,,,,,,,,"0,2,11,12,19,18,37,0,0","0,20,50,30,0",,,,,,137,,,,,,,,,,,,,,,,,,,,,,,,,,,,,,,,,,,,55.5,6,18,261,81,,1017,0,336,1,6,3,,1,0,I2.136|10:09-I0.258|1:01-I0.216|1:00-I0.518|2:00-I0.219|1:01-I0.796|3:01-I0.223|1:01-I1.067|4:03-I0.216|1:01-I1.262|4:59-I0.252|1:01-I1.034|4:01-I0.219|1:00-I0.788|3:01-I0.175|1:00-I0.503|1:59-I0.199|1:01-I0.278|1:03-I1.860|10:16,,Running,,,,"Polar M430",43,0,,0,168070,250480,30378,,,,,,,,,,,,,,,,,,,,,,,,,,,,,,,,,,,,,,,,,,,
5962633,6b12c36a-ad82-43a0-a71c-fef0ce513a11,1467926753,120,1548677662,,0,0,1.86,648,648,19,20,,,1,0.3,0.35,,,,127,,,,,,,29.81,,1,,,,,,,,,,,,,,13,81,10.47,10.53,10.6,,,,,,,,,,,,,,,,,"15,17,30,35,4,0,0,0,0",,,,,,,106,,,,,,,,,,,,,,,,,,,,,,,,,,,,,,,,,,,,,19,1,72,72,,1019,0,,0,5,3,,1,0,,,,,"Aachen Laufen",,"Polar BEAT",,0,,0,168070,250480,30378,,,,,,,,,,,,,,,,,,,,,,,,,,,,,,,,,,,,,,,,,,,
5962634,fde0d4c9-ccb6-4c87-8b8f-61512004b745,1486412220,60,1548677663,,0,0,4.71,1826,1922,30,31,,,1,0.6,0.38,,,,319,,,,,,,28.08,,1,,,,,,,,,,,,,,37,76,9.39,9.73,9.87,,,,,,,,,,,,,,,,,"34,33,25,5,1,3,0,0,0",,,,,,,102,,,,,,,,,,,,,,,,,,,,,,,,,,,,,,,,,,,,,3,5,104,86,,1020,,,1,5,3,,1,0,,,,,"Aachen Laufen",,"Polar BEAT",,0,,0,168070,250480,30378,,,,,,,,,,,,,,,,,,,,,,,,,,,,,,,,,,,,,,,,,,,
5962635,6ac29ec3-5d0a-4529-91ad-992da6486711,1510075976,60,1548677663,,0,0,11.97,2023,2032,45,40,,,1,0,0.09,,,,350,125,139,,,,,,,1,,,,,,,,,,,,,,26,,,23.42,,20.8,-20.6,114,91,,1,138,120,,,,,,,,,"15,15,19,51,0,0,0","4,96,0,0,0","83,2,3,9,3",,,,,,,,,,,,,,,,,,,,,,,,,,,,,,,,,,,,,,,,,13.7,8,1,354,85,,,0,,1,5,3,,1,0,,,Cycling,,,,"Polar M430",43,0,,0,168072,,30378,,,,,,,,,,,,,,,,,,,,,,,,,,,,,,,,,,,,,,,,,,,
5962636,d2da93f4-871a-4e25-aedd-02f72ebc4577,1417194108,60,1548677664,,0,0,17.45,4514,4549,245,245,,,1,2.6,0.5,,,689,1160,,,,,,,49.59,,1,,,,,,,,,,,,,,93,84,14.17,14.1,14.56,,,,,,,,,,,,,,,,,"1,1,3,8,22,36,27,2,0",,,,,,,138,,,,,,,,,,,,,,,,,,,,,,,,,,,,,,,,,,,,,6,9,86,87,,1008,0,,1,5,3,,1,0,,,,,"Zügiger DL",,"Polar BEAT",,0,,0,168070,250480,30378,,,,,,,,,,,,,,,,,,,,,,,,,,,,,,,,,,,,,,,,,,"4,5",
5962637,fa861e6b-63e0-4238-a376-e4ca97fab0a2,1511285843,60,1548677664,,0,0,11.7,2070,2070,41,35,,,1,0,0.12,,,,309,115,139,,,,,,,1,,,,,,,,,,,,,,20,,,23.12,,23.4,-19.4,113,87,,1,137,120,,,,,,,,,"16,19,20,45,0,0,0","20,80,0,0,0","84,2,4,8,2",,,,,,,,,,,,,,,,,,,,,,,,,,,,,,,,,,,,,,,,,9.4,8,6,245,86,,,0,,1,5,3,,1,0,,,Cycling,,,,"Polar M430",43,0,,0,168072,,30378,,,,,,,,,,,,,,,,,,,,,,,,,,,,,,,,,,,,,,,,,,,
5962638,3a214d8e-1e7d-4c71-901b-b9e9f6d3f958,1429864014,120,1548677665,,0,0,5.91,1863,1972,105,88,,,1,2,0.62,,,241,404,,,,,,,36.48,,1,,,,,,,,,,,,,,38,82,11.75,11.5,12.16,,,,,,,,,,,,,,,,,"2,8,20,44,23,4,0,0,0",,,,,,,116,,,,,,,,,,,,,,,,,,,,,,,,,,,,,,,,,,,,,9,8,186,73,,1015,,,0,3,3,,1,0,,,,,"Aachen Laufen",,"Polar BEAT",,0,,0,168070,250480,30378,,,,,,,,,,,,,,,,,,,,,,,,,,,,,,,,,,,,,,,,,,4,
5962639,6f1ff901-9274-4633-b0fd-fe8839ce55cb,1401136709,120,1548677665,,0,0,1.91,551,566,20,25,,,1,0,0.21,,,,130,,,,,,,37.09,,1,,,,,,,,,,,,,,11,82,12.54,12.78,13.09,,,,,,,,,,,,,,,,,"6,15,8,11,22,23,12,2,0",,,,,,,127,,,,,,,,,,,,,,,,,,,,,,,,,,,,,,,,,,,,,17,1,103,85,,1012,0,,0,5,3,,1,0,,,,,Einlaufen,,"Polar BEAT",,0,,0,168070,250480,30378,,,,,,,,,,,,,,,,,,,,,,,,,,,,,,,,,,,,,,,,,,,
5962640,6deeb9fb-eba4-458e-983e-7ca21c0e166f,1451312797,60,1548677666,,0,0,3.8,1216,1217,0,0,,,1,0,0,,,,237,,,,,,,34.9,,1,,,,,,,,,,,,,,25,79,11.27,14.09,14.09,,,,,,,,,,,,,,,,,"53,4,3,1,2,2,3,28,5",,,,,,,119,,,,,,,,,,,,,,,,,,,,,,,,,,,,,,,,,,,,,11,15,125,64,,1025,,,0,3,3,,1,0,,,,,"Balve Laufen",,"Polar BEAT",,0,,0,168070,250480,30378,,,,,,,,,,,,,,,,,,,,,,,,,,,,,,,,,,,,,,,,,,,
5962641,632687d6-c2ea-430e-86f6-d93085ddef14,1475612577,120,1548677667,,0,0,4.31,1578,2293,54,55,,,1,0.9,0.47,,,,286,,,,,,,29.94,,1,,,,,,,,,,,,,,32,73,10.13,11.29,11.44,,,,,,,,,,,,,,,,,"28,6,9,20,24,14,0,0,0",,,,,,,112,,,,,,,,,,,,,,,,,,,,,,,,,,,,,,,,,,,,,11,4,59,80,,1033,0,,1,5,3,,1,0,,,,,"Aachen Laufen",,"Polar BEAT",,0,,0,168070,250480,30378,,,,,,,,,,,,,,,,,,,,,,,,,,,,,,,,,,,,,,,,,,,
5962642,44e5c26b-febc-4d15-b923-a5a1bfca4496,1421177359,60,1548677668,,0,0,11.18,2909,3017,105,116,,,1,0.7,0.39,,,,722,,,,,,,47.62,,1,,,,,,,,,,,,,,60,84,13.88,15.19,15.27,,,,,,,,,,,,,,,,,"16,2,6,6,2,11,30,26,1",,,,,,,137,,,,,,,,,,,,,,,,,,,,,,,,,,,,,,,,,,,,,7,21,236,86,,1008,,,1,5,3,,1,0,,,,,"3x Einzel + 2 Sprint runden",,"Polar BEAT",,0,,0,168070,250480,30378,,,,,,,,,,,,,,,,,,,,,,,,,,,,,,,,,,,,,,,,,,,
5962643,2ceaa5f5-2c5f-46d4-9612-7d58ed86d342,1546878253,60,1548677668,,0,0,17.13,4640,4645,60,60,,,1,0,0.11,1.09,0.92,,1118,148,159,,,,65.76,46.95,66.04,1,,,,,,,,,,,,,,109,81,13.33,13.33,13.4,-0.5,,,,,,,,,,,,,,,,"0,0,0,5,49,46,0,0,0","1,7,92,0,0",,,,,,137,,,,,,,,,,,,,,,,,,,,,,,,,,,,,,,,,,,,37.7,5,10,222,86,,1033,0,292,1,5,3,,1,0,I1.000|4:35-I1.000|4:36-I1.000|4:26-I1.000|4:25-I1.000|4:35-I1.000|4:43-I1.000|4:35-I1.000|4:43-I1.000|4:38-I1.000|4:30-I1.000|4:38-I1.000|4:28-I1.000|4:13-I1.000|4:12-I1.000|4:22-I1.000|4:31-I1.000|4:36-I0.136|0:39,,Running,,,,"Polar M430",43,0,,0,168070,250480,30378,,,,,,,,,,,,,,,,,,,,,,,,,,,,,,,,,,,,,,,,,,,
5962644,7a9b49b8-f709-44ef-a00c-8c5046fd8488,1411727323,120,1548677669,,0,0,9.86,3045,3051,94,94,,,1,0.7,0.41,1.07,1.01,,571,149,170,,,,55.42,38.63,56.08,1,,,,,,,,,,,,,,73,81,11.78,11.71,11.92,-1.1,,,,,,,,,,,,,,,,"1,6,11,51,29,3,0,0,0","0,16,75,8,0",,,,,,120,,,,,,,,,,,,,,,,,,,,,,,,,,,,,,,,,,,,44.8,14,9,227,88,,1025,1,,0,5,3,,1,0,,,,,"Sehr langsamer DL ",,"Polar BEAT",,0,,0,168070,250480,30378,,,,,,,,,,,,,,,,,,,,,,,,,,,,,,,,,,,,,,,,,,,
5962645,dc29295a-3f32-4ddf-9536-1942639fdf9b,1459799810,120,1548677670,,0,0,16.86,4747,5563,254,262,,,1,2.5,0.51,,,393,1154,,,,,,,44.84,,1,,,,,,,,,,,,,,98,82,13.11,13.03,13.33,,,,,,,,,,,,,,,,,"5,2,4,17,33,31,7,1,0",,,,,,,130,,,,,,,,,,,,,,,,,,,,,,,,,,,,,,,,,,,,,13,5,154,62,,1007,,,1,5,3,,1,0,,,,,"Aachen Laufen",,"Polar BEAT",,0,,0,168070,250480,30378,,,,,,,,,,,,,,,,,,,,,,,,,,,,,,,,,,,,,,,,,,"4,5",
5962646,954c57f0-7486-4a25-bc69-4cd7e38cb5f8,1477599126,120,1548677670,,0,0,3.33,1018,1018,67,66,,,1,1.6,0.58,,,443,221,,,,,,,36.5,,1,,,,,,,,,,,,,,21,79,12.13,11.84,12.76,,,,,,,,,,,,,,,,,"5,4,10,37,31,12,0,0,0",,,,,,,124,,,,,,,,,,,,,,,,,,,,,,,,,,,,,,,,,,,,,10,4,217,92,,1034,0,,1,5,3,,1,0,,,,,"Aachen Laufen",,"Polar BEAT",,0,,0,168070,250480,30378,,,,,,,,,,,,,,,,,,,,,,,,,,,,,,,,,,,,,,,,,,4,
5962647,45a422d0-54af-4cda-88b9-7392e91f9245,1468180401,120,1548677670,,0,0,1.28,352,352,20,0,,,1,0,0.21,,,,86,,,,,,,37.42,,1,,,,,,,,,,,,,,7,81,13.77,13.09,13.78,,,,,,,,,,,,,,,,,"0,0,9,2,39,50,0,0,0",,,,,,,135,,,,,,,,,,,,,,,,,,,,,,,,,,,,,,,,,,,,,27,6,235,53,,1009,0,,0,5,3,,1,0,,,,,"Aachen Laufen",,"Polar BEAT",,0,,0,168070,250480,30378,,,,,,,,,,,,,,,,,,,,,,,,,,,,,,,,,,,,,,,,,,,
5962648,d2dae0c9-8c43-4166-a094-a1c7a47e416f,1428436497,120,1548677671,,0,0,15.8,4652,5916,137,137,,,1,0.9,0.33,,,,1057,,,,,,,42.35,,1,,,,,,,,,,,,,,96,81,12.38,13.05,13.3,,,,,,,,,,,,,,,,,"14,4,5,10,30,22,8,7,0",,,,,,,126,,,,,,,,,,,,,,,,,,,,,,,,,,,,,,,,,,,,,10,5,314,56,,1035,,,1,5,3,,1,0,,,,,"Aachen Laufen",,"Polar BEAT",,0,,0,168070,250480,30378,,,,,,,,,,,,,,,,,,,,,,,,,,,,,,,,,,,,,,,,,,,
5962649,0e1fcc9e-6f74-404d-8800-82933428bc32,1402692256,120,1548677671,,0,0,3.28,1007,1603,0,0,,,1,0,0.01,,,,217,,,,,,,36.28,,1,,,,,,,,,,,,,,20,81,11.71,11.85,11.87,,,,,,,,,,,,,,,,,"4,4,15,28,42,7,0,0,0",,,,,,,121,,,,,,,,,,,,,,,,,,,,,,,,,,,,,,,,,,,,,19,5,349,63,,1021,0,,0,5,3,,1,0,,,,,Einlaufen,,"Polar BEAT",,0,,0,168070,250480,30378,,,,,,,,,,,,,,,,,,,,,,,,,,,,,,,,,,,,,,,,,,,
5962650,,1368307061,120,1548677671,,0,0,,49183,49183,,,,,0,,,,,,12023,,,,,,,,,1,,,,,,,,,,,,,,1021,,,,,,,,,,,,,,,,,,,,,,,,,,,,,,,,,,,,,,,,,,,,,,,,,,,,,,,,,,,,,,,,,,,,,,,,,,1,,,0,0,,,,,,,"Polar BEAT",,0,,0,168070,250480,30378,,,,,,,,,,,,,,,,,,,,,,,,,,,,,,,,,,,,,,,,,,,
5962651,a07cef42-2681-47c0-9dae-ad77908ebebe,1520496764,60,1548677672,,0,0,21.73,3536,3551,77,77,,,1,0,0.11,,0.52,,577,121,148,,,,,,,1,,,,,,,,,,,,,,42,,,23.54,,7.2,-33.5,123,91,,1,142,117,,,,,,,,,"10,9,40,40,0,0,0","4,92,4,0,0","78,2,17,0,3",,,,,,,,,,,,,,,,,,,,,,,,,,,,,,,,,,,,,,,,,12.8,5,21,210,86,,1007,,,0,8,1,,1,0,,,Cycling,,,,"Polar M430",43,0,,0,168072,,30378,,,,,,,,,,,,,,,,,,,,,,,,,,,,,,,,,,,,,,,,,,,
5962652,,1418468100,60,1548677672,,0,0,3,0,0,,,,,0,,,,,,199,,,,,,,,,1,,,,,,,,,,,,,,0,,,,,,,,,,,,,,,,,,,,,,,,,,,,,,,,,,,,,,,,,,,,,,,,,,,,,,,,,,,,,,,,,,,,,,,,,,1,,,0,0,,,,,Steigerungen,,"Polar BEAT",,0,,0,168070,250480,30378,,,,,,,,,,,,,,,,,,,,,,,,,,,,,,,,,,,,,,,,,,,
5962653,1e8e098e-47e6-40e5-b2aa-e7a2280ad3af,1472769151,120,1548677672,,0,0,0.69,246,266,4,9,,,1,0,0,,,,42,,,,,,,26.02,,1,,,,,,,,,,,,,,5,81,10.28,10.08,10.29,,,,,,,,,,,,,,,,,"29,25,20,9,13,4,0,0,0",,,,,,,104,,,,,,,,,,,,,,,,,,,,,,,,,,,,,,,,,,,,,17,0,293,84,,1023,0,,1,5,3,,1,0,,,,,"Aachen Laufen",,"Polar BEAT",,0,,0,168070,250480,30378,,,,,,,,,,,,,,,,,,,,,,,,,,,,,,,,,,,,,,,,,,,
5962655,5209779d-8790-4dc1-aeb2-5c5b7d0101c6,1346776740,120,1548677674,,0,0,41.25,5696,5818,977,977,,,1,5.5,0.62,,,944,1516,,,,,,,,,1,,,,,,,,,,,,,,63,,,32.65,,,,410,287,,1,641,524,,,,,,,,,"20,18,16,14,10,7,15",,"48,13,9,7,23",,,,,,,,,,,,,,,,,,,,,,,,,,,,,,,,,,,,,,,,,,24,5,285,51,,1021,2,,0,3,3,,1,0,,,,,,,"Polar BEAT",,0,,0,168072,,30378,,,,,,,,,,,,,,,,,,,,,,,,,,,,,,,,,,,,,,,,,,"3,4,4,4,4,4,5",
5962656,fef01f42-6d38-4f02-a91d-567a908bf15e,1393074718,60,1548677674,,0,0,3.55,1128,1156,12,90,,,1,0.3,0.37,1.02,0.97,,200,140,156,,,,58.01,35.03,56.68,1,,,,,,,,,,,,,,22,81,10.92,11.51,11.16,-5.6,,,,,,,,,,,,,,,,"5,6,17,44,20,7,0,0,0","0,47,53,0,0",,,,,,117,,,,,,,,,,,,,,,,,,,,,,,,,,,,,,,,,,,,21,6,12,233,88,,1015,2,,0,4,3,,1,0,,,,,Auslaufen,,"Polar BEAT",,0,,0,168070,250480,30378,,,,,,,,,,,,,,,,,,,,,,,,,,,,,,,,,,,,,,,,,,,
5962657,3c3325ff-8778-44b9-9b6d-4df3f0136311,1534440024,120,1548677675,,0,0,15.26,4132,4132,50,49,,,1,0,0.04,1.09,0.87,,1152,161,172,,,,58.53,46.54,58.77,1,,,,,,,,,,,,,,133,82,13.32,13.36,13.42,8.9,,,,,,,,,,,,,,,,"0,0,1,7,42,47,3,0,0","0,1,29,70,0",,,,,,135,,,,,,,,,,,,,,,,,,,,,,,,,,,,,,,,,,,,63.5,31,6,305,29,,1014,,,0,3,3,,1,0,I1.000|4:38-I1.000|4:22-I1.000|4:19-I1.000|4:23-I1.000|4:17-I1.000|4:26-I1.000|4:24-I1.000|4:20-I1.000|4:29-I1.000|4:29-I1.000|4:35-I1.000|4:40-I1.000|4:39-I1.000|4:49-I1.000|4:43-I0.259|1:20,,Running,,,,"Polar M430",43,0,,0,168070,250480,30378,,,,,,,,,,,,,,,,,,,,,,,,,,,,,,,,,,,,,,,,,,,
5962658,3bb8101e-db6f-43e5-9d71-f44a9648c84e,1401828753,120,1548677675,,0,0,3.53,1098,1098,61,63,,,1,1.6,0.6,,,433,233,,,,,,,35.91,,1,,,,,,,,,,,,,,22,82,11.93,11.68,12.48,,,,,,,,,,,,,,,,,"4,8,18,34,27,9,0,0,0",,,,,,,118,,,,,,,,,,,,,,,,,,,,,,,,,,,,,,,,,,,,,15,6,235,81,,1013,,,0,5,3,,1,0,,,,,Auslaufen,,"Polar BEAT",,0,,0,168070,250480,30378,,,,,,,,,,,,,,,,,,,,,,,,,,,,,,,,,,,,,,,,,,4,
5962659,c85dc98b-d7f8-4a86-8be0-0122469df036,1473719879,120,1548677675,,0,0,3.69,1180,1180,55,25,,,1,0.2,0.34,,,,255,,,,,,,34.86,,1,,,,,,,,,,,,,,24,83,11.65,11.38,11.77,,,,,,,,,,,,,,,,,"6,10,24,37,18,3,2,0,0",,,,,,,113,,,,,,,,,,,,,,,,,,,,,,,,,,,,,,,,,,,,,21,2,124,76,,1016,0,,1,3,3,,1,0,,,,,"Aachen Laufen",,"Polar BEAT",,0,,0,168070,250480,30378,,,,,,,,,,,,,,,,,,,,,,,,,,,,,,,,,,,,,,,,,,,
5962660,55dac8df-d249-4443-893e-6c1681b7067c,1446752104,60,1548677676,,0,0,8.33,2190,2237,42,44,,,1,0,0,,,,484,,,,,,,46.14,,1,,,,,,,,,,,,,,45,86,13.7,15.05,15.08,,,,,,,,,,,,,,,,,"28,5,4,4,4,5,8,32,10",,,,,,,133,,,,,,,,,,,,,,,,,,,,,,,,,,,,,,,,,,,,,15,14,171,79,,1019,,,1,5,3,,1,0,,,,,"Aachen Laufen",,"Polar BEAT",,0,,0,168070,250480,30378,,,,,,,,,,,,,,,,,,,,,,,,,,,,,,,,,,,,,,,,,,,
5962661,d222adba-54ac-4aee-9efa-0436c821e37e,1364406755,60,1548677676,,0,0,7.54,2972,3353,226,250,,,1,1.7,0.73,,,109,492,,,,,,,28.37,,1,,,,,,,,,,,,,,61,,9.49,13.2,13.56,,,,,,,,,,,,,,,,,"47,3,3,5,7,8,9,11,7",,,,,,,,,,,,,,,,,,,,,,,,,,,,,,,,,,,,,,,,,,,,4,9,74,45,,1009,0,,0,5,3,,1,0,,,,,,,"Polar BEAT",,0,,0,168070,250480,30378,,,,,,,,,,,,,,,,,,,,,,,,,,,,,,,,,,,,,,,,,,5,
5962662,55a738ce-ac2a-452d-81db-ce44fff6678d,1481467929,60,1548677677,,0,0,1.71,455,490,16,32,,,1,1,0.59,,,,116,,,,,,,40.14,,1,,,,,,,,,,,,,,9,82,13.47,14.04,14.02,,,,,,,,,,,,,,,,,"5,0,3,11,14,39,28,0,0",,,,,,,137,,,,,,,,,,,,,,,,,,,,,,,,,,,,,,,,,,,,,7,9,256,78,,1024,0,,0,5,3,,1,0,,,,,"Aachen Laufen",,"Polar BEAT",,0,,0,168070,250480,30378,,,,,,,,,,,,,,,,,,,,,,,,,,,,,,,,,,,,,,,,,,,
5962663,84531f9c-1de9-45d6-be23-2e3f29879e13,1491343541,120,1548677677,,0,0,18.72,3522,3680,243,260,,,1,2.8,0.51,,,629,731,,,,,,,,,1,,,,,,,,,,,,,,39,,,23.65,,,,124,95,,1,161,145,,,,,,,,,"37,19,15,15,8,3,3",,"65,13,16,5,1",,,,,,,,,,,,,,,,,,,,,,,,,,,,,,,,,,,,,,,,,,9,1,19,70,,1025,0,,1,5,3,,1,0,,,,,"Aachen Radfahren",,"Polar BEAT",,0,,0,168072,,30378,,,,,,,,,,,,,,,,,,,,,,,,,,,,,,,,,,,,,,,,,,4,
5962664,e7031b4f-b6ec-49ee-a594-d9f6a6ad1c52,1403979606,120,1548677678,,0,0,10.88,3060,3064,328,330,,,1,4.2,0.69,,,466,737,,,,,,,43.41,,1,,,,,,,,,,,,,,63,82,13.61,13.11,14.43,,,,,,,,,,,,,,,,,"4,4,9,14,26,36,8,0,0",,,,,,,130,,,,,,,,,,,,,,,,,,,,,,,,,,,,,,,,,,,,,16,3,243,86,,,2,,0,5,3,,1,0,,,,,"Regenerativer DL",,"Polar BEAT",,0,,0,168070,250480,30378,,,,,,,,,,,,,,,,,,,,,,,,,,,,,,,,,,,,,,,,,,3,
5962665,410765ee-daa3-4038-a6d6-08010456f0c4,1344598028,120,1548677680,,0,0,91.59,11196,11439,2528,2526,,,1,5.7,0.71,,,947,3357,,,,,,,,,1,,,,,,,,,,,,,,125,,,31.32,,,,441,263,,1,577,382,,,,,,,,,"6,4,11,18,45,10,6",,"53,9,7,6,25",,,,,,,,,,,,,,,,,,,,,,,,,,,,,,,,,,,,,,,,,,17,9,15,62,,1027,4,,0,5,3,,1,0,,,,,,,"Polar BEAT",,0,,0,168072,,30378,,,,,,,,,,,,,,,,,,,,,,,,,,,,,,,,,,,,,,,,,,"4,4,4,4,4,4,4,4,4,4,4,4,4,4,4,4,5,5,5,5,5,5,5,5,5,5,5,5,5",
5962666,40b52334-1117-409a-b26e-39769a06b030,1519805511,60,1548677682,,0,0,10.68,1975,1989,38,48,,,1,0,0.11,,0.55,,358,131,171,,,,,,,1,,,,,,,,,,,,,,34,,,22.72,,18.1,-16.2,109,83,,1,132,117,,,,,,,,,"23,7,43,26,0,0,0","12,45,38,5,0","90,2,0,0,8",,,,,,,,,,,,,,,,,,,,,,,,,,,,,,,,,,,,,,,,,34.7,-10,18,30,78,,1017,,,0,2,1,,1,0,,,Cycling,,,,"Polar M430",43,0,,0,168072,,30378,,,,,,,,,,,,,,,,,,,,,,,,,,,,,,,,,,,,,,,,,,,
5962667,e1d112fb-e620-4161-acd6-4134e78bc554,1447584969,60,1548677682,,0,0,18.52,5810,5811,425,425,,,1,4.6,0.72,,,637,1265,,,,,,,39.84,,1,,,,,,,,,,,,,,120,83,12,11.62,12.55,,,,,,,,,,,,,,,,,"5,9,16,34,30,4,1,0,0",,,,,,,115,,,,,,,,,,,,,,,,,,,,,,,,,,,,,,,,,,,,,14,38,246,80,,1007,,,0,11,3,,1,0,,,,,"Balve Laufen",,"Polar BEAT",,0,,0,168070,250480,30378,,,,,,,,,,,,,,,,,,,,,,,,,,,,,,,,,,,,,,,,,,"4,4,4,4",
5962668,f8fe969d-b7dc-4583-80ca-5283e5fcfe79,1425488377,60,1548677684,,0,0,26.52,7661,8363,379,378,,,1,2.3,0.53,,,466,1808,,,,,,,45.09,,1,,,,,,,,,,,,,,159,83,12.71,12.58,12.93,,,,,,,,,,,,,,,,,"2,2,5,22,46,23,1,0,0",,,,,,,125,,,,,,,,,,,,,,,,,,,,,,,,,,,,,,,,,,,,,5,12,278,80,,1028,0,,0,5,3,,1,0,,,,,"Langer DL",,"Polar BEAT",,0,,0,168070,250480,30378,,,,,,,,,,,,,,,,,,,,,,,,,,,,,,,,,,,,,,,,,,"5,5,5",
5962669,,1396725300,120,1548677684,,0,0,4,0,0,,,,,0,,,,,,,,,,,,,,,1,,,,,,,,,,,,,,0,,,,,,,,,,,,,,,,,,,,,,,,,,,,,,,,,,,,,,,,,,,,,,,,,,,,,,,,,,,,,,,,,,,,,,,,,,1,,,0,0,,,,,Auslaufen,,"Polar BEAT",,0,,0,168070,250480,30378,,,,,,,,,,,,,,,,,,,,,,,,,,,,,,,,,,,,,,,,,,,
5962670,751f9213-cfef-4fa7-b894-2baaf9c7f044,1538822151,120,1548677685,,0,0,16.67,4569,4569,55,52,,,1,0,0.06,1.16,0.93,,1298,164,176,,,,56.13,46.22,56.37,1,,,,,,,,,,,,,,160,82,13.17,13.22,13.29,7.2,,,,,,,,,,,,,,,,"0,1,3,9,43,41,3,0,0","0,7,20,72,0",,,,,,133,,,,,,,,,,,,,,,,,,,,,,,,,,,,,,,,,,,,88.5,15,0,,84,,,,,0,3,3,,1,0,I1.000|4:53-I1.000|4:46-I1.000|4:29-I1.000|4:22-I1.000|4:28-I1.000|4:18-I1.000|4:36-I1.000|4:24-I1.000|4:15-I1.000|4:22-I1.000|4:35-I1.000|4:26-I1.000|4:32-I1.000|4:32-I1.000|4:43-I1.000|5:00-I0.671|3:27,,Running,,,,"Polar M430",43,0,,0,168070,250480,30378,,,,,,,,,,,,,,,,,,,,,,,,,,,,,,,,,,,,,,,,,,,
5962671,878de185-6ac0-4b9c-84b0-20a56e4bb44c,1463918458,120,1548677685,,0,0,20.84,4657,4657,59,60,,,1,0,0.03,,,,1418,,,,,,,59.56,,1,,,,,,,,,,,,,,96,85,16.14,16.17,16.21,,,,,,,,,,,,,,,,,"0,0,0,0,1,13,69,17,0",,,,,,,158,,,,,,,,,,,,,,,,,,,,,,,,,,,,,,,,,,,,,23,8,225,54,,,6,,0,5,3,,1,0,,,,,"Menden Laufen",,"Polar BEAT",,0,,0,168070,250480,30378,,,,,,,,,,,,,,,,,,,,,,,,21.1,4657,,,0,"32. Menden Marathon und 6. Halbmarathon",,,,,,,0,0,30378,5962671,14615,,,
5962672,da743d3d-f77d-4487-aedb-39a7824e04da,1480850389,60,1548677686,,0,0,3.36,1034,1101,45,40,,,1,0.4,0.42,,,153,228,,,,,,,36.24,,1,,,,,,,,,,,,,,21,79,12.09,12.09,12.66,,,,,,,,,,,,,,,,,"9,2,2,22,59,7,0,0,0",,,,,,,123,,,,,,,,,,,,,,,,,,,,,,,,,,,,,,,,,,,,,1,13,115,64,,1026,,,0,3,3,,1,0,,,,,"Stolberg (Rheinland) Laufen",,"Polar BEAT",,0,,0,168070,250480,30378,,,,,,,,,,,,,,,,,,,,,,,,,,,,,,,,,,,,,,,,,,5,
5962673,d0176f86-c1c4-4886-8e4f-fe9a30d14c12,1511166382,60,1548677686,,0,0,12.06,2426,2455,45,45,,,1,0,0.1,1.73,0.7,,332,112,130,,,,,,,1,,,,,,,,,,,,,,21,,,19.45,,-13.1,-27.3,85,67,,1,100,87,,,,,,,,,"17,37,42,3,0,0,0","9,91,0,0,0","87,0,9,3,1",,,,,,,,,,,,,,,,,,,,,,,,,,,,,,,,,,,,,,,,,6.2,3,4,221,87,,,0,,0,5,3,,1,0,,,Cycling,,,,"Polar M430",43,0,,0,168072,,30378,,,,,,,,,,,,,,,,,,,,,,,,,,,,,,,,,,,,,,,,,,,
5962675,6d2e6860-e97b-459a-9243-b7f23b9e22b9,1471363429,120,1548677687,,0,0,14.3,3164,3928,33,30,,,1,0,0.04,,,,416,,,,,,,,,1,,,,,,,,,,,,,,35,,,17.46,,,,57,49,,1,75,66,,,,,,,,,"20,63,16,1,0,0,0",,"88,1,11,0,0",,,,,,,,,,,,,,,,,,,,,,,,,,,,,,,,,,,,,,,,,,28,12,248,64,,1013,,,0,3,3,,1,0,,,,,"Vendays-Montalivet Radfahren",,"Polar BEAT",,0,,0,168072,,30378,,,,,,,,,,,,,,,,,,,,,,,,,,,,,,,,,,,,,,,,,,,
5962676,864fc761-f7c7-46a9-98bb-edaf1d1906d6,1430161377,120,1548677687,,0,0,11.81,3312,4015,141,146,,,1,0.8,0.42,,,167,799,,,,,,,43.82,,1,,,,,,,,,,,,,,68,82,13.05,13.27,13.48,,,,,,,,,,,,,,,,,"4,3,6,13,38,24,7,3,1",,,,,,,130,,,,,,,,,,,,,,,,,,,,,,,,,,,,,,,,,,,,,9,11,27,66,,1009,,,0,5,3,,1,0,,,,,"Aachen Laufen",,"Polar BEAT",,0,,0,168070,250480,30378,,,,,,,,,,,,,,,,,,,,,,,,,,,,,,,,,,,,,,,,,,5,
5962677,2cb231b8-71b7-4ce6-b0ec-45010c5d025d,1399730823,120,1548677688,,0,0,1.05,243,243,14,14,,,1,0.4,0.39,,,,63,,,,,,,44.46,,1,,,,,,,,,,,,,,5,84,15.67,17.26,17.47,,,,,,,,,,,,,,,,,"13,1,3,5,5,11,10,26,26",,,,,,,154,,,,,,,,,,,,,,,,,,,,,,,,,,,,,,,,,,,,,12,11,200,91,,1010,5,,0,6,3,,1,0,,,,,"3x 300m",,"Polar BEAT",,0,,0,168070,250480,30378,,,,,,,,,,,,,,,,,,,,,,,,,,,,,,,,,,,,,,,,,,,
5962678,638ff9bc-c560-4a2a-9819-2ef919efe35e,1485005117,60,1548677688,,0,0,4.45,995,1254,45,63,,,1,0.8,0.5,,,,232,,,,,,,,,1,,,,,,,,,,,,,,11,,,19.4,,,,87,79,,1,114,109,,,,,,,,,"43,26,15,14,2,0,0",,"88,7,0,0,6",,,,,,,,,,,,,,,,,,,,,,,,,,,,,,,,,,,,,,,,,,3,5,108,60,,1029,1,,0,3,3,,1,0,,,,,Radfahren,,"Polar BEAT",,0,,0,168072,,30378,,,,,,,,,,,,,,,,,,,,,,,,,,,,,,,,,,,,,,,,,,,
5962679,04844da0-a95b-4580-bdd5-b3f56e1f13be,1498769728,120,1548677688,,0,0,3.94,946,946,28,29,,,1,0,0.15,,,,285,,,,,,,48.95,,1,,,,,,,,,,,,,,19,84,15.06,15.16,15.21,,,,,,,,,,,,,,,,,"0,1,1,2,16,29,35,16,0",,,,,,,149,,,,,,,,,,,,,,,,,,,,,,,,,,,,,,,,,,,,,20,12,227,59,,1008,0,,0,5,3,,1,0,,,,,"Aix-en-Provence Laufen",,"Polar BEAT",,0,,0,168070,250480,30378,,,,,,,,,,,,,,,,,,,,,,,,,,,,,,,,,,,,,,,,,,,
5962680,ea3a0ecd-712f-4fe7-84f2-d06ba9364993,1411827681,120,1548677688,,0,0,3.13,990,990,28,56,,,1,1,0.55,0.96,0.94,,165,134,150,,,,61.57,34.91,61.57,1,,,,,,,,,,,,,,16,81,11.32,11.57,11.53,0.3,,,,,,,,,,,,,,,,"7,6,13,38,30,6,0,0,0","1,75,24,0,0",,,,,,117,,,,,,,,,,,,,,,,,,,,,,,,,,,,,,,,,,,,15.9,20,4,50,67,,1028,3,,0,5,3,,1,0,,,,,Auslaufen,,"Polar BEAT",,0,,0,168070,250480,30378,,,,,,,,,,,,,,,,,,,,,,,,,,,,,,,,,,,,,,,,,,,
5962681,beb68b2f-31af-4cc1-bf8d-d13eb3cb9e46,1473356955,120,1548677689,,0,0,10.33,2900,2984,133,139,,,1,1.5,0.53,,,418,699,,,,,,,43.34,,1,,,,,,,,,,,,,,60,82,13.09,13.04,13.32,,,,,,,,,,,,,,,,,"4,2,4,16,28,41,4,0,0",,,,,,,130,,,,,,,,,,,,,,,,,,,,,,,,,,,,,,,,,,,,,27,7,254,47,,1012,1,,0,3,3,,1,0,,,,,"Aachen Laufen",,"Polar BEAT",,0,,0,168070,250480,30378,,,,,,,,,,,,,,,,,,,,,,,,,,,,,,,,,,,,,,,,,,4,
5962682,651a5068-81c7-4464-bcc5-02f90e5de9d5,1473194382,120,1548677689,,0,0,9.09,2428,2514,89,89,,,1,0,0,,,,592,,,,,,,45.55,,1,,,,,,,,,,,,,,50,80,13.54,15.53,15.6,,,,,,,,,,,,,,,,,"27,1,1,1,1,2,23,44,0",,,,,,,140,,,,,,,,,,,,,,,,,,,,,,,,,,,,,,,,,,,,,20,1,99,70,,1025,0,,1,3,3,,1,0,,,,,"Aachen Laufen",,"Polar BEAT",,0,,0,168070,250480,30378,,,,,,,,,,,,,,,,,,,,,,,,,,,,,,,,,,,,,,,,,,,
5962683,0ece7c0c-b649-417f-8ac3-3fa02bb8fd05,1368226879,120,1548677690,,0,0,0.22,79,80,11,45,,,1,0,0.07,,,,9,,,,,,,23.61,,1,,,,,,,,,,,,,,1,,15.68,16.42,18.39,,,,,,,,,,,,,,,,,"56,1,1,1,3,3,3,4,29",,,,,,,,,,,,,,,,,,,,,,,,,,,,,,,,,,,,,,,,,,,,10,8,232,83,,1018,0,,1,5,3,,1,0,,,,,,,"Polar BEAT",,0,,0,168070,250480,30378,,,,,,,,,,,,,,,,,,,,,,,,,,,,,,,,,,,,,,,,,,,
5962684,65b8caf6-37e8-4599-83e4-c461c483e6fa,1490539870,120,1548677690,,0,0,18.2,5346,5776,295,296,,,1,2.7,0.58,,,391,1289,,,,,,,42.95,,1,,,,,,,,,,,,,,111,81,12.59,12.56,13,,,,,,,,,,,,,,,,,"8,5,8,18,31,27,3,1,0",,,,,,,126,,,,,,,,,,,,,,,,,,,,,,,,,,,,,,,,,,,,,14,6,55,45,,1022,4,,0,5,3,,1,0,,,,,"Aachen Laufen",,"Polar BEAT",,0,,0,168070,250480,30378,,,,,,,,,,,,,,,,,,,,,,,,,,,,,,,,,,,,,,,,,,"4,5",
5962685,1b479b17-5992-413d-ac0f-d7c0a99de2d1,1369929606,120,1548677691,,0,0,10.94,3983,4578,212,245,,,1,2.7,0.61,,,365,766,,,,,,,32.07,,1,,,,,,,,,,,,,,82,,10.14,11.17,11.71,,,,,,,,,,,,,,,,,"25,6,16,25,17,7,2,1,0",,,,,,,,,,,,,,,,,,,,,,,,,,,,,,,,,,,,,,,,,,,,13,3,193,67,,1009,4,,0,5,3,,1,0,,,,,,,"Polar BEAT",,0,,0,168070,250480,30378,,,,,,,,,,,,,,,,,,,,,,,,,,,,,,,,,,,,,,,,,,4,
5962686,2ebf32d0-ced6-4a93-afdb-6039ced7f446,1483519887,60,1548677691,,0,0,0.41,183,184,0,4,,,1,0,0,,,,27,,,,,,,18.97,,1,,,,,,,,,,,,,,3,71,8,9.81,9.45,,,,,,,,,,,,,,,,,"51,10,16,8,14,0,0,0,0",,,,,,,95,,,,,,,,,,,,,,,,,,,,,,,,,,,,,,,,,,,,,2,13,276,98,,1017,0,,0,6,3,,1,0,,,,,"Aachen Laufen",,"Polar BEAT",,0,,0,168070,250480,30378,,,,,,,,,,,,,,,,,,,,,,,,,,,,,,,,,,,,,,,,,,,
5962687,d3b7bbf5-8cc0-4c9b-9340-563eaba7231b,1490647315,120,1548677692,,0,0,0.59,172,172,12,8,,,1,0.3,0.34,,,,42,,,,,,,32.32,,1,,,,,,,,,,,,,,3,81,12.8,12.41,12.96,,,,,,,,,,,,,,,,,"5,6,5,27,35,21,0,0,0",,,,,,,127,,,,,,,,,,,,,,,,,,,,,,,,,,,,,,,,,,,,,13,4,123,41,,1021,0,,1,3,3,,1,0,,,,,"Aachen Laufen",,"Polar BEAT",,0,,0,168070,250480,30378,,,,,,,,,,,,,,,,,,,,,,,,,,,,,,,,,,,,,,,,,,,
5962688,e98e5f32-e861-4a23-a166-a68baa526232,1478260288,60,1548677692,,0,0,5.31,1458,1482,57,58,,,1,0.9,0.51,,,,360,,,,,,,42.68,,1,,,,,,,,,,,,,,30,82,13.32,13.29,13.37,,,,,,,,,,,,,,,,,"1,1,5,18,30,34,12,0,0",,,,,,,133,,,,,,,,,,,,,,,,,,,,,,,,,,,,,,,,,,,,,8,5,204,76,,1014,1,,0,5,3,,1,0,,,,,"Aachen Laufen",,"Polar BEAT",,0,,0,168070,250480,30378,,,,,,,,,,,,,,,,,,,,,,,,,,,,,,,,,,,,,,,,,,,
5962689,d492bfd0-1902-46f3-8ff7-c88dc46c6184,1518465299,60,1548677692,,0,0,11.78,2161,2205,61,47,,,1,0,0.12,1.77,0.54,,341,118,144,,,,,,,1,,,,,,,,,,,,,,23,,,22.44,,29.1,-0.5,108,85,,1,135,118,,,,,,,,,"19,11,43,27,0,0,0","9,91,1,0,0","83,3,4,7,2",,,,,,,,,,,,,,,,,,,,,,,,,,,,,,,,,,,,,,,,,11.8,0,2,232,72,,,0,,1,5,3,,1,0,,,Cycling,,,,"Polar M430",43,0,,0,168072,,30378,,,,,,,,,,,,,,,,,,,,,,,,,,,,,,,,,,,,,,,,,,,
5962690,9adc4e47-47b5-495e-8745-62b98348d07f,1521360381,60,1548677694,,0,0,15.89,13273,13587,864,827,,,1,7.1,0.8,,,329,2054,114,163,,,,,,,1,,,,,,,,,,,,,,136,,,5.04,,-26.5,,,,,,,,,,,,,,,,"60,39,1,0,0,0","17,73,9,0,0",,,,,,,,,,,,,,,,,,,,,,,,,,,,,,,,,,,,,,,,,,32.8,-5,7,67,99,,,0,,0,4,3,,1,0,I1.000|11:56-I1.000|11:36-I1.000|17:35-I1.000|13:30-I1.000|13:54-I1.000|17:14-I1.000|13:36-I1.000|18:16-I1.000|13:08-I1.000|14:10-I1.000|13:51-I1.000|15:02-I1.000|13:31-I1.000|12:17-I1.000|14:56-I1.000|11:58,,Hiking,,,,"Polar M430",43,0,,0,168075,,30378,,,,,,,,,,,,,,,,,,,,,,,,,,,,,,,,,,,,,,,,,,"2,2,4,5",
5962691,0bfaf262-589c-40e8-8cb6-68d764ff11d0,1491168228,120,1548677695,,0,0,16.97,2650,2727,178,201,,,1,1.6,0.46,,,438,642,,,,,,,,,1,,,,,,,,,,,,,,29,,,27.53,,,,144,121,,1,177,153,,,,,,,,,"22,22,12,16,16,5,7",,"60,13,17,6,4",,,,,,,,,,,,,,,,,,,,,,,,,,,,,,,,,,,,,,,,,,12,3,343,69,,1024,0,,1,5,3,,1,0,,,,,"Aachen Radfahren",,"Polar BEAT",,0,,0,168072,,30378,,,,,,,,,,,,,,,,,,,,,,,,,,,,,,,,,,,,,,,,,,4,
5962692,9657fe41-69af-4588-9534-d01be8d31dd0,1405247716,120,1548677697,,0,0,17.73,4855,4855,213,213,,,1,1.6,0.48,,,744,1202,,,,,,,46.49,,1,,,,,,,,,,,,,,100,82,13.35,13.26,13.52,,,,,,,,,,,,,,,,,"0,1,4,10,37,48,1,0,0",,,,,,,134,,,,,,,,,,,,,,,,,,,,,,,,,,,,,,,,,,,,,16,15,238,89,,,,,0,3,3,,1,0,,,,,"Lockerer DL",,"Polar BEAT",,0,,0,168070,250480,30378,,,,,,,,,,,,,,,,,,,,,,,,,,,,,,,,,,,,,,,,,,4,
5962693,cab0016d-b9e4-4836-b616-0987a7a9d36c,1404337557,120,1548677698,,0,0,1.24,498,500,38,37,,,1,1.5,0.68,,,743,78,,,,,,,24.21,,1,,,,,,,,,,,,,,10,80,9.56,9.14,9.95,,,,,,,,,,,,,,,,,"60,19,8,13,0,0,0,0,0",,,,,,,93,,,,,,,,,,,,,,,,,,,,,,,,,,,,,,,,,,,,,17,1,69,60,,1023,0,,0,5,3,,1,0,,,,,Auslaufen,,"Polar BEAT",,0,,0,168070,250480,30378,,,,,,,,,,,,,,,,,,,,,,,,,,,,,,,,,,,,,,,,,,5,
5962694,fbd91f44-901b-4847-b727-547d31649aca,1412711118,120,1548677698,,0,0,6.77,2071,2409,85,49,,,1,0.7,0.36,0.99,0.95,,362,138,153,,,,61.9,38.11,63.27,1,,,,,,,,,,,,,,38,82,12.11,11.9,12.29,-0.6,,,,,,,,,,,,,,,,"5,3,10,39,39,5,0,0,0","0,59,41,0,0",,,,,,120,,,,,,,,,,,,,,,,,,,,,,,,,,,,,,,,,,,,21.4,12,8,220,81,,1005,0,,1,5,3,,1,0,,,,,Einlaufen,,"Polar BEAT",,0,,0,168070,250480,30378,,,,,,,,,,,,,,,,,,,,,,,,,,,,,,,,,,,,,,,,,,,
5962695,,1415135880,60,1548677698,,0,0,4,0,0,,,,,0,,,,,,253,,,,,,,,,1,,,,,,,,,,,,,,0,,,,,,,,,,,,,,,,,,,,,,,,,,,,,,,,,,,,,,,,,,,,,,,,,,,,,,,,,,,,,,,,,,,,,,,,,,1,,,0,0,,,,,Auslaufen,,"Polar BEAT",,0,,0,168070,250480,30378,,,,,,,,,,,,,,,,,,,,,,,,,,,,,,,,,,,,,,,,,,,
5962696,e631fb96-d871-4e41-86e8-5159dff2f7c2,1347803945,120,1548677700,,0,0,27.09,8217,8358,784,785,,,1,4.9,0.68,1.27,0.97,604,1883,159,210,,,,51.8,42.65,53.66,1,,,,,,,,,,,,,,263,,12.48,12.61,13.72,10.3,,,,,,,,,,,,,,,,"12,4,8,16,28,23,7,1,1","2,8,34,54,2",,,,,,,,,,,,,,,,,,,,,,,,,,,,,,,,,,,,,,,,,,89.4,20,11,223,60,,1016,3,,0,5,3,,1,0,,,,,,,"Polar BEAT",,0,,0,168070,250480,30378,,,,,,,,,,,,,,,,,,,,,,,,,,,,,,,,,,,,,,,,,,"4,4,4,4,4,5,5,5,5,5",
5962697,3c29399a-ce1c-4cad-8745-74ebd07a96bc,1397073512,120,1548677700,,0,0,16.33,4286,4347,266,276,,,1,2.1,0.52,,,408,1089,,,,,,,48.51,,1,,,,,,,,,,,,,,89,83,14.07,13.94,14.39,,,,,,,,,,,,,,,,,"1,2,4,9,20,44,17,3,1",,,,,,,138,,,,,,,,,,,,,,,,,,,,,,,,,,,,,,,,,,,,,12,6,268,59,,1025,0,,1,3,3,,1,0,,,,,"Zügiger DL",,"Polar BEAT",,0,,0,168070,250480,30378,,,,,,,,,,,,,,,,,,,,,,,,,,,,,,,,,,,,,,,,,,"4,5,5",
5962698,0c15e8fb-d7cb-4fdd-9572-47ebe16c8fc2,1417951541,60,1548677701,,0,0,21.1,5289,5289,511,513,,,1,3.7,0.72,,,382,1418,,,,,,,52.22,,1,,,,,,,,,,,,,,109,85,14.8,14.4,15.3,,,,,,,,,,,,,,,,,"0,0,0,1,9,68,22,0,0",,,,,,,141,,,,,,,,,,,,,,,,,,,,,,,,,,,,,,,,,,,,,4,7,213,90,,,0,,0,5,3,,1,0,,,,,"Zügiger DL",,"Polar BEAT",,0,,0,168070,250480,30378,,,,,,,,,,,,,,,,,,,,,,,,,,,,,,,,,,,,,,,,,,"4,4,5,5,5,5,5",
5962699,ef0e87b2-0f8e-4249-8005-2b7c353c752c,1439724237,120,1548677702,,0,0,27.64,7591,7760,684,684,,,1,4.8,0.67,,,504,1886,,,,,,,47.97,,1,,,,,,,,,,,,,,157,85,13.69,13.28,14.33,,,,,,,,,,,,,,,,,"2,2,3,15,30,42,7,0,0",,,,,,,129,,,,,,,,,,,,,,,,,,,,,,,,,,,,,,,,,,,,,16,14,296,94,,1014,,,0,4,3,,1,0,,,,,"Balve Laufen",,"Polar BEAT",,0,,0,168070,250480,30378,,,,,,,,,,,,,,,,,,,,,,,,,,,,,,,,,,,,,,,,,,"4,4,4,4,5,5,5,5,5,5,5",
5962700,64ddab3d-8860-4e0c-bec6-6000d310c336,1506881903,120,1548677703,,0,0,9.19,2311,2312,37,36,,,1,0,0.07,1.12,0.92,,623,161,178,,,,64.13,48.92,64.46,1,,,,,,,,,,,,,,75,81,14.37,14.42,14.52,0.2,,,,,,,,,,,,,,,,"1,0,1,3,10,54,30,0,0","1,1,34,64,0",,,,,,147,,,,,,,,,,,,,,,,,,,,,,,,,,,,,,,,,,,,68.1,17,0,82,62,,,,,0,3,3,,1,0,I1.000|4:44-I1.000|4:16-I1.000|3:58-I1.000|4:06-I1.000|4:17-I1.000|4:13-I1.000|4:12-I1.000|4:01-I1.000|3:58-I0.195|0:47,,Running,,,,"Polar M430",43,0,,0,168070,250480,30378,,,,,,,,,,,,,,,,,,,,,,,,,,,,,,,,,,,,,,,,,,,
5962701,0ad28814-7093-4280-9a46-30a44b850633,1494885668,120,1548677704,,0,0,1.44,577,604,20,5,,,1,0,0.16,,,,99,,,,,,,24.67,,1,,,,,,,,,,,,,,11,77,9.36,10.4,10.82,,,,,,,,,,,,,,,,,"38,7,20,9,16,8,0,0,0",,,,,,,97,,,,,,,,,,,,,,,,,,,,,,,,,,,,,,,,,,,,,17,1,198,59,,1029,0,,1,5,3,,1,0,,,,,"Aachen Laufen",,"Polar BEAT",,0,,0,168070,250480,30378,,,,,,,,,,,,,,,,,,,,,,,,,,,,,,,,,,,,,,,,,,,
5962702,2c88446c-888b-4867-a025-22248731deb0,1463925319,120,1548677704,,0,0,2.33,807,807,4,5,,,1,0,0,,,,160,,,,,,,30.65,,1,,,,,,,,,,,,,,16,81,10.41,10.49,10.49,,,,,,,,,,,,,,,,,"7,21,46,24,2,0,0,0,0",,,,,,,107,,,,,,,,,,,,,,,,,,,,,,,,,,,,,,,,,,,,,23,13,232,58,,,6,,0,5,3,,1,0,,,,,"Menden Laufen",,"Polar BEAT",,0,,0,168070,250480,30378,,,,,,,,,,,,,,,,,,,,,,,,,,,,,,,,,,,,,,,,,,,
5962703,2f980cdd-7cfc-4ccf-84f1-98fd91e27a35,1449757673,60,1548677705,,0,0,20.01,5983,6165,297,294,,,1,2.3,0.44,,,340,1365,,,,,,,42.39,,1,,,,,,,,,,,,,,124,83,12.39,12.19,12.58,,,,,,,,,,,,,,,,,"3,4,13,24,42,14,1,0,0",,,,,,,121,,,,,,,,,,,,,,,,,,,,,,,,,,,,,,,,,,,,,6,18,196,71,,1032,,,0,5,3,,1,0,,,,,"Aachen Laufen",,"Polar BEAT",,0,,0,168070,250480,30378,,,,,,,,,,,,,,,,,,,,,,,,,,,,,,,,,,,,,,,,,,"5,5,5",
5962704,6b994cc4-38ca-4f66-a3c7-2590cb5e9dcd,1529339410,120,1548677705,,0,0,9.16,2900,2906,56,59,,,1,0,0.2,1.12,0.91,,559,129,146,,,,64.33,37.33,64.79,1,,,,,,,,,,,,,,42,80,11.41,11.51,11.61,5.7,,,,,,,,,,,,,,,,"6,6,19,42,23,5,0,0,0","1,91,8,0,0",,,,,,118,,,,,,,,,,,,,,,,,,,,,,,,,,,,,,,,,,,,16.8,23,16,275,59,,,4,,0,5,3,,1,0,I8.247|43:23-I0.914|5:03,,Running,,,,"Polar M430",43,0,,0,168070,250480,30378,,,,,,,,,,,,,,,,,,,,,,,,,,,,,,,,,,,,,,,,,,,
5962705,858c0b82-4db5-4f45-a41b-82d64c8ee10a,1467552852,120,1548677706,,0,0,2.71,859,859,32,33,,,1,0.3,0.37,,,,184,,,,,,,34.43,,1,,,,,,,,,,,,,,17,80,11.52,11.45,11.72,,,,,,,,,,,,,,,,,"2,7,21,46,24,0,0,0,0",,,,,,,118,,,,,,,,,,,,,,,,,,,,,,,,,,,,,,,,,,,,,17,6,241,69,,,6,,0,5,3,,1,0,,,,,"Balve Laufen",,"Polar BEAT",,0,,0,168070,250480,30378,,,,,,,,,,,,,,,,,,,,,,,,,,,,,,,,,,,,,,,,,,,
5962706,d2cf6e45-80ef-496d-814c-a733162dff18,1470267989,120,1548677707,,0,0,1.98,613,613,28,28,,,1,1.3,0.69,,,,138,,,,,,,34.36,,1,,,,,,,,,,,,,,12,79,11.88,11.81,11.94,,,,,,,,,,,,,,,,,"11,10,5,19,52,3,0,0,0",,,,,,,123,,,,,,,,,,,,,,,,,,,,,,,,,,,,,,,,,,,,,17,10,234,95,,1012,0,,1,6,3,,1,0,,,,,"Aachen Laufen",,"Polar BEAT",,0,,0,168070,250480,30378,,,,,,,,,,,,,,,,,,,,,,,,,,,,,,,,,,,,,,,,,,,
5962707,,1465245249,120,1548677707,,0,0,,0,0,,,,,0,,,,,,,,,,,,,,,1,,,,,,,,,,,,,,0,,,,,,,,,,,,,,,,,,,,,,,,,,,,,,,,,,,,,,,,,,,,,,,,,,,,,,,,,,,,,,,,,,,,,,,,,,1,,,0,0,,,,,"Gym ",,"Polar BEAT",,0,,0,168075,,30378,,,,,,,,,,,,,,,,,,,,,,,,,,,,,,,,,,,,,,,,,,,
5962708,da5ee411-e8e1-438f-a2e8-970b4c800be6,1431374421,120,1548677707,,0,0,15.64,4405,4732,318,322,,,1,2.9,0.57,,,425,1066,,,,,,,44.55,,1,,,,,,,,,,,,,,91,83,13.27,13.22,13.99,,,,,,,,,,,,,,,,,"6,2,3,15,28,30,14,1,0",,,,,,,128,,,,,,,,,,,,,,,,,,,,,,,,,,,,,,,,,,,,,23,3,245,45,,1019,0,,0,5,3,,1,0,,,,,"Aachen Laufen",,"Polar BEAT",,0,,0,168070,250480,30378,,,,,,,,,,,,,,,,,,,,,,,,,,,,,,,,,,,,,,,,,,"4,4,5",
5962709,,1431694447,120,1548677707,,0,0,5,0,0,,,,,0,,,,,,331,,,,,,,,,1,,,,,,,,,,,,,,0,,,,,,,,,,,,,,,,,,,,,,,,,,,,,,,,,,,,,,,,,,,,,,,,,,,,,,,,,,,,,,,,,,,,,,,,,,1,,,0,0,,,,,Laufen,,"Polar BEAT",,0,,0,168070,250480,30378,,,,,,,,,,,,,,,,,,,,,,,,,,,,,,,,,,,,,,,,,,,
5962710,1fcbf68f-1db0-4119-bd90-25fab80cae1b,1364820607,120,1548677708,,0,0,14.6,3973,4026,312,312,,,1,4.2,0.67,,,633,1005,,,,,,,46.12,,1,,,,,,,,,,,,,,82,,13.81,13.76,14.58,,,,,,,,,,,,,,,,,"7,5,7,15,16,20,22,7,0",,,,,,,,,,,,,,,,,,,,,,,,,,,,,,,,,,,,,,,,,,,,3,14,81,56,,,,,0,3,3,,1,0,,,,,,,"Polar BEAT",,0,,0,168070,250480,30378,,,,,,,,,,,,,,,,,,,,,,,,,,,,,,,,,,,,,,,,,,"4,4",
5962711,a84bd8b5-6899-467e-a869-2db201e8fc7c,1548353403,60,1548677709,,0,0,15.62,3980,3984,59,58,,,1,0,0.16,1.1,0.97,,1060,158,178,,,,64.82,50.03,65.13,1,,,,,,,,,,,,,,120,84,14.18,14.45,14.55,-4.1,,,,,,,,,,,,,,,,"2,0,1,2,30,33,25,6,0","0,4,57,39,0",,,,,,140,,,,,,,,,,,,,,,,,,,,,,,,,,,,,,,,,,,,73,-2,12,181,85,,1013,0,408,1,4,3,,1,0,I12.144|52:19-I0.011|0:12-I1.926|7:49-I0.998|3:26-I0.546|2:41,,Running,,,,"Polar M430",43,0,,0,168070,250480,30378,,,,,,,,,,,,,,,,,,,,,,,,,,,,,,,,,,,,,,,,,,,
5962712,a4040ded-7cac-4afc-96c4-41081b4b502c,1450284135,60,1548677709,,0,0,15.24,4511,4740,186,190,,,1,1.9,0.51,,,443,1043,,,,,,,41.97,,1,,,,,,,,,,,,,,93,81,12.35,12.47,12.75,,,,,,,,,,,,,,,,,"6,2,6,22,40,23,1,0,0",,,,,,,125,,,,,,,,,,,,,,,,,,,,,,,,,,,,,,,,,,,,,11,15,225,96,,1024,,,1,4,3,,1,0,,,,,"Aachen Laufen",,"Polar BEAT",,0,,0,168070,250480,30378,,,,,,,,,,,,,,,,,,,,,,,,,,,,,,,,,,,,,,,,,,5,
5962713,73c54020-1395-4a4c-a6f2-10dbae654056,1540381408,120,1548677710,,0,0,10.37,1250,1251,36,43,,,1,0,0.1,,,,279,142,175,,,,,,,1,,,,,,,,,,,,,,29,,,30.43,,20.3,5.7,180,159,,1,199,181,,,,,,,,,"0,5,9,14,70,2,0","16,18,25,41,0","27,59,1,0,12",,,,,,,,,,,,,,,,,,,,,,,,,,,,,,,,,,,,,,,,,55.2,12,22,200,71,,1025,2,281,0,4,3,,1,0,I0.713|2:11-I9.652|18:37-I0.009|0:05,,Cycling,,,,"Polar M430",43,0,,0,168072,,30378,,,,,,,,,,,,,,,,,,,,,,,,,,,,,,,,,,,,,,,,,,,
5962714,e987a11c-4691-4452-a4b4-4f6a036f440b,1421781175,60,1548677710,,0,0,3.71,1356,1357,40,47,,,1,0.8,0.49,,,,250,,,,,,,29.74,,1,,,,,,,,,,,,,,28,75,9.86,12.34,12.65,,,,,,,,,,,,,,,,,"26,2,3,17,27,10,11,3,0",,,,,,,109,,,,,,,,,,,,,,,,,,,,,,,,,,,,,,,,,,,,,-1,4,144,80,,1014,,,1,5,3,,1,0,,,,,Einlaufen,,"Polar BEAT",,0,,0,168070,250480,30378,,,,,,,,,,,,,,,,,,,,,,,,,,,,,,,,,,,,,,,,,,,
5962715,df3058ad-d396-4560-a1b9-8d3f8c479890,1398370509,120,1548677710,,0,0,2.17,689,690,55,43,,,1,1.5,0.63,1.1,0.96,449,139,148,163,,,,54.04,33.69,56.11,1,,,,,,,,,,,,,,16,80,12.08,11.37,12.46,-2.4,,,,,,,,,,,,,,,,"6,3,14,54,23,0,0,0,0","0,19,75,6,0",,,,,,118,,,,,,,,,,,,,,,,,,,,,,,,,,,,,,,,,,,,27.8,15,0,106,83,,1016,0,,0,5,3,,1,0,,,,,Einlaufen,,"Polar BEAT",,0,,0,168070,250480,30378,,,,,,,,,,,,,,,,,,,,,,,,,,,,,,,,,,,,,,,,,,5,
5962716,6d6d8669-0366-404a-858b-6f89a9774131,1490311581,60,1548677711,,0,0,7.48,1308,1316,128,129,,,1,1.9,0.51,,,404,341,,,,,,,,,1,,,,,,,,,,,,,,14,,,24.68,,,,181,149,,1,222,196,,,,,,,,,"26,25,21,13,11,2,3",,"71,11,2,4,12",,,,,,,,,,,,,,,,,,,,,,,,,,,,,,,,,,,,,,,,,,8,8,59,81,,1020,0,,1,5,3,,1,0,,,,,"Aachen Radfahren",,"Polar BEAT",,0,,0,168072,,30378,,,,,,,,,,,,,,,,,,,,,,,,,,,,,,,,,,,,,,,,,,4,
5962718,ceadb348-26b4-4274-9148-3503e06b698c,1445708686,120,1548677713,,0,0,21.06,4841,4841,149,153,,,1,0.2,0.27,,,,1431,,,,,,,57.7,,1,,,,,,,,,,,,,,100,86,15.78,15.83,15.96,,,,,,,,,,,,,,,,,"0,0,0,0,4,32,45,20,0",,,,,,,152,,,,,,,,,,,,,,,,,,,,,,,,,,,,,,,,,,,,,12,5,175,77,,1016,,,0,5,3,,1,0,,,,,"Herzogenrath Laufen",,"Polar BEAT",,0,,0,168070,250480,30378,,,,,,,,,,,,,,,,,,,,,,,,,,,,,,,,,,,,,,,,,,,
5962719,8d46b73f-62f9-46b7-8802-72ec32475091,1455357659,60,1548677714,,0,0,20.02,5984,6153,562,564,,,1,5.2,0.7,,,577,1381,,,,,,,42.41,,1,,,,,,,,,,,,,,124,83,12.82,12.37,13.4,,,,,,,,,,,,,,,,,"6,9,15,19,22,25,4,0,0",,,,,,,121,,,,,,,,,,,,,,,,,,,,,,,,,,,,,,,,,,,,,1,10,100,84,,994,,,0,5,3,,1,0,,,,,"Balve Laufen",,"Polar BEAT",,0,,0,168070,250480,30378,,,,,,,,,,,,,,,,,,,,,,,,,,,,,,,,,,,,,,,,,,"3,4,5",
5962720,2987903b-3aff-4aa5-9896-bad041c9036a,1395342521,60,1548677714,,0,0,3.31,926,926,64,64,,,1,1.7,0.63,1.15,0.99,466,195,150,172,,,,62.06,40.46,63.54,1,,,,,,,,,,,,,,23,81,13.24,12.91,13.9,0,,,,,,,,,,,,,,,,"0,1,6,17,40,34,2,0,0","0,23,59,18,0",,,,,,132,,,,,,,,,,,,,,,,,,,,,,,,,,,,,,,,,,,,32.9,17,11,221,43,,1010,0,,1,3,3,,1,0,,,,,Einlaufen,,"Polar BEAT",,0,,0,168070,250480,30378,,,,,,,,,,,,,,,,,,,,,,,,,,,,,,,,,,,,,,,,,,4,
5962721,ec20ada9-340e-47c0-aef7-c2fbad9c897a,1405455066,120,1548677714,,0,0,2.91,848,848,31,27,,,1,0.4,0.35,1.11,0.83,,161,143,154,,,,62.84,38.19,63.77,1,,,,,,,,,,,,,,17,80,12.5,12.47,12.85,8.4,,,,,,,,,,,,,,,,"3,4,8,15,46,23,0,0,0","1,30,69,0,0",,,,,,129,,,,,,,,,,,,,,,,,,,,,,,,,,,,,,,,,,,,22.3,19,6,237,77,,1021,,,0,5,3,,1,0,,,,,Einlaufen,,"Polar BEAT",,0,,0,168070,250480,30378,,,,,,,,,,,,,,,,,,,,,,,,,,,,,,,,,,,,,,,,,,,
5962722,3e62d8b9-feec-4dd1-b675-76cda16ef4a4,1444853198,120,1548677715,,0,0,13.93,4083,4083,191,197,,,1,2.1,0.55,,,374,955,,,,,,,42.15,,1,,,,,,,,,,,,,,84,84,12.51,12.42,12.67,,,,,,,,,,,,,,,,,"3,4,5,20,54,14,0,0,0",,,,,,,122,,,,,,,,,,,,,,,,,,,,,,,,,,,,,,,,,,,,,2,8,35,97,,1019,,,1,4,3,,1,0,,,,,"Aachen Laufen",,"Polar BEAT",,0,,0,168070,250480,30378,,,,,,,,,,,,,,,,,,,,,,,,,,,,,,,,,,,,,,,,,,4,
5962723,4d2baaba-1e3e-40af-9b43-75634530cba1,1493841434,120,1548677715,,0,0,0.7,227,227,15,12,,,1,1.3,0.71,,,,52,,,,,,,29.07,,1,,,,,,,,,,,,,,4,81,11.65,11.32,11.72,,,,,,,,,,,,,,,,,"13,10,16,24,31,6,0,0,0",,,,,,,114,,,,,,,,,,,,,,,,,,,,,,,,,,,,,,,,,,,,,12,11,81,82,,1019,,,0,4,3,,1,0,,,,,"Aachen Laufen",,"Polar BEAT",,0,,0,168070,250480,30378,,,,,,,,,,,,,,,,,,,,,,,,,,,,,,,,,,,,,,,,,,,
5962724,a21aa250-f823-430a-a1f5-6b6202c90ed7,1453636291,60,1548677715,,0,0,9.34,2946,3065,161,159,,,1,1.7,0.5,,,343,648,,,,,,,37.54,,1,,,,,,,,,,,,,,61,80,11.88,11.61,12.02,,,,,,,,,,,,,,,,,"8,11,12,30,35,4,0,0,0",,,,,,,119,,,,,,,,,,,,,,,,,,,,,,,,,,,,,,,,,,,,,6,14,195,91,,1031,,,0,5,3,,1,0,,,,,"Aachen Laufen",,"Polar BEAT",,0,,0,168070,250480,30378,,,,,,,,,,,,,,,,,,,,,,,,,,,,,,,,,,,,,,,,,,"5,5,5",
5962725,b5281667-1b76-4459-b0f7-31a68bff6292,1473880067,120,1548677716,,0,0,12.97,4008,4008,197,200,,,1,2.4,0.66,,,354,888,,,,,,,39.41,,1,,,,,,,,,,,,,,83,79,11.93,11.81,12.02,,,,,,,,,,,,,,,,,"6,5,16,33,32,6,1,0,0",,,,,,,123,,,,,,,,,,,,,,,,,,,,,,,,,,,,,,,,,,,,,28,4,73,42,,1011,0,,0,3,3,,1,0,,,,,"Aachen Laufen",,"Polar BEAT",,0,,0,168070,250480,30378,,,,,,,,,,,,,,,,,,,,,,,,,,,,,,,,,,,,,,,,,,4,
5962726,f41410b8-1746-4b27-8383-2b31923bd6da,1413282709,120,1548677717,,0,0,7.68,2816,2846,91,97,,,1,1.4,0.55,1.45,1.49,454,397,138,155,,,,49.5,30.98,50.18,1,,,,,,,,,,,,,,52,78,9.93,11.33,11.63,30.2,,,,,,,,,,,,,,,,"23,6,9,23,31,7,2,0,0","1,61,39,0,0",,,,,,105,,,,,,,,,,,,,,,,,,,,,,,,,,,,,,,,,,,,24,12,7,214,81,,1008,1,,0,3,3,,1,0,,,,,"Regenerativer DL",,"Polar BEAT",,0,,0,168070,250480,30378,,,,,,,,,,,,,,,,,,,,,,,,,,,,,,,,,,,,,,,,,,5,
5962727,e8536326-2933-4f99-8552-5e7374a735e5,1543595768,60,1548677717,,0,0,6.31,2017,2021,28,28,,,1,0,0.22,1.09,0.9,,433,137,157,,,,59.16,36.02,59.48,1,,,,,,,,,,,,,,37,79,11.32,11.34,11.49,-1.2,,,,,,,,,,,,,,,,"3,5,21,55,16,0,0,0,0","1,61,38,0,0",,,,,,119,,,,,,,,,,,,,,,,,,,,,,,,,,,,,,,,,,,,24.2,7,15,210,100,,1015,,,1,6,1,,1,0,I1.000|5:13-I1.000|5:26-I1.000|5:14-I1.000|5:07-I1.000|5:24-I1.000|5:31-I0.311|1:47,,Running,,,,"Polar M430",43,0,,0,168070,250480,30378,,,,,,,,,,,,,,,,,,,,,,,,,,,,,,,,,,,,,,,,,,,
5962728,946163fd-85e9-4654-a444-5b78b921399c,1444768193,120,1548677717,,0,0,8.6,2213,2357,0,0,,,1,0,0,,,,538,,,,,,,47.41,,1,,,,,,,,,,,,,,45,82,14.01,15.54,15.6,,,,,,,,,,,,,,,,,"20,1,1,1,1,2,46,27,0",,,,,,,142,,,,,,,,,,,,,,,,,,,,,,,,,,,,,,,,,,,,,3,13,10,86,,1020,,,1,4,3,,1,0,,,,,"Aachen Laufen",,"Polar BEAT",,0,,0,168070,250480,30378,,,,,,,,,,,,,,,,,,,,,,,,,,,,,,,,,,,,,,,,,,,
5962729,c61463b2-2d7a-42f0-9dde-f7426546a7ed,1465654721,120,1548677717,,0,0,1,401,401,1,0,,,1,0,0,,,,72,,,,,,,23.67,,1,,,,,,,,,,,,,,8,81,9,9.04,9.08,,,,,,,,,,,,,,,,,"67,15,16,2,0,0,0,0,0",,,,,,,92,,,,,,,,,,,,,,,,,,,,,,,,,,,,,,,,,,,,,20,2,103,59,,1010,,,0,5,3,,1,0,,,,,"Aachen Laufen",,"Polar BEAT",,0,,0,168070,250480,30378,,,,,,,,,,,,,,,,,,,,,,,,,,,,,,,,,,,,,,,,,,,
5962730,9387f8b6-fb9e-48bd-85f1-202e5d1650e1,1504099263,120,1548677718,,0,0,12.26,3988,3991,126,1180,,,1,1.1,0.89,,1.03,,804,136,165,,,,58.42,36.95,53.01,1,,,,,,,,,,,,,,71,82,10.44,11.12,10.61,-8.8,,,,,,,,,,,,,,,,"2,7,32,49,9,0,0,0,0","0,75,22,3,0",,,,,,112,,,,,,,,,,,,,,,,,,,,,,,,,,,,,,,,,,,,28,23,0,,75,,1011,,,0,3,3,,1,0,I1.000|5:26-I1.000|5:12-I1.000|5:29-I1.000|5:33-I1.000|5:30-I1.000|5:34-I1.000|5:36-I1.000|5:40-I1.000|5:21-I1.000|5:25-I1.000|5:12-I1.000|5:08-I0.263|1:29,,Running,,,,"Polar M430",43,0,,0,168070,250480,30378,,,,,,,,,,,,,,,,,,,,,,,,,,,,,,,,,,,,,,,,,,,
5962731,72145adc-3a54-4c91-bc40-6ddd5fd0244f,1453834843,60,1548677719,,0,0,11.14,3437,3984,137,145,,,1,1.2,0.55,,,,770,,,,,,,39.03,,1,,,,,,,,,,,,,,71,79,11.77,12.81,13.2,,,,,,,,,,,,,,,,,"16,2,5,18,29,14,11,4,0",,,,,,,123,,,,,,,,,,,,,,,,,,,,,,,,,,,,,,,,,,,,,8,24,201,75,,1021,,,1,5,3,,1,0,,,,,"Aachen Laufen",,"Polar BEAT",,0,,0,168070,250480,30378,,,,,,,,,,,,,,,,,,,,,,,,,,,,,,,,,,,,,,,,,,,
5962732,ef106210-e4ec-477d-b1c7-0043e8cc21ec,1502444205,120,1548677719,,0,0,12.89,3748,3754,4,5,,,1,0,0,,,,797,143,166,,,,63.01,42.29,63.03,1,,,,,,,,,,,,,,79,81,12.39,12.51,12.53,8.1,,,,,,,,,,,,,,,,"2,2,8,22,44,22,0,0,0","1,36,60,4,0",,,,,,127,,,,,,,,,,,,,,,,,,,,,,,,,,,,,,,,,,,,41.2,16,1,326,80,,1018,2,,0,5,3,,1,0,I6.028|28:13-I6.861|34:22,,Running,,,,"Polar M430",43,0,,0,168070,250480,30378,,,,,,,,,,,,,,,,,,,,,,,,,,,,,,,,,,,,,,,,,,,
5962733,14d9376e-e457-4634-825b-c9e8a70a1205,1416509264,60,1548677720,,0,0,5.69,1741,2276,86,54,,,1,0.5,0.43,,,,384,,,,,,,37.71,,1,,,,,,,,,,,,,,36,81,12.2,11.96,12.39,,,,,,,,,,,,,,,,,"5,4,13,33,30,15,0,0,0",,,,,,,121,,,,,,,,,,,,,,,,,,,,,,,,,,,,,,,,,,,,,5,11,95,90,,1026,,,1,5,3,,1,0,,,,,Einlaufen,,"Polar BEAT",,0,,0,168070,250480,30378,,,,,,,,,,,,,,,,,,,,,,,,,,,,,,,,,,,,,,,,,,,
5962734,f315afb8-cb62-4458-898f-df9507749f8e,1534873390,120,1548677720,,0,0,13.74,4016,4018,48,49,,,1,0,0.01,1.17,0.9,,843,135,159,,,,67.28,42.24,67.57,1,,,,,,,,,,,,,,72,81,12.34,12.58,12.65,24.5,,,,,,,,,,,,,,,,"3,1,2,22,53,20,0,0,0","1,53,46,0,0",,,,,,127,,,,,,,,,,,,,,,,,,,,,,,,,,,,,,,,,,,,34.5,31,10,0,35,,1017,,,0,3,3,,1,0,I1.000|4:31-I1.000|4:28-I1.000|4:36-I1.000|4:35-I1.000|4:41-I1.000|4:46-I1.000|4:44-I1.000|4:51-I1.000|4:43-I1.000|4:56-I1.000|4:58-I1.000|4:52-I1.000|5:10-I0.741|5:09,,Running,,,,"Polar M430",43,0,,0,168070,250480,30378,,,,,,,,,,,,,,,,,,,,,,,,,,,,,,,,,,,,,,,,,,,
5962735,cc795815-2c30-4ebb-92e8-86f58b1b2934,1461874294,120,1548677721,,0,0,6.84,1948,2499,101,99,,,1,0.8,0.29,,,436,446,,,,,,,41.5,,1,,,,,,,,,,,,,,40,82,12.9,13.92,14.24,,,,,,,,,,,,,,,,,"16,4,8,14,14,18,8,15,4",,,,,,,128,,,,,,,,,,,,,,,,,,,,,,,,,,,,,,,,,,,,,6,3,204,86,,1016,0,,0,6,3,,1,0,,,,,"Aachen Laufen",,"Polar BEAT",,0,,0,168070,250480,30378,,,,,,,,,,,,,,,,,,,,,,,,,,,,,,,,,,,,,,,,,,5,
5962736,2c9c6469-9cd0-476c-919e-6cb23e246096,1537470022,120,1548677721,,0,0,1.61,500,500,15,16,,,1,0,0,,0.66,,113,147,170,,,,56.04,33.49,56.64,1,,,,,,,,,,,,,,12,83,11.54,12.58,12.69,27.7,,,,,,,,,,,,,,,,"28,18,12,9,4,6,7,12,2","3,27,47,22,0",,,,,,116,,,,,,,,,,,,,,,,,,,,,,,,,,,,,,,,,,,,25.8,26,2,261,35,,1016,,,0,3,3,,1,0,I0.165|0:58-I0.213|0:42-I0.202|1:15-I0.203|0:38-I0.216|1:23-I0.200|0:38-I0.413|2:49,,Running,,,,"Polar M430",43,0,,0,168070,250480,30378,,,,,,,,,,,,,,,,,,,,,,,,,,,,,,,,,,,,,,,,,,,
5962737,e6d35cdc-8fbb-4f9a-bfce-87ca7d673b55,1496781902,120,1548677721,,0,0,7.86,2363,2371,56,57,,,1,0,0.05,,,,477,,,,,,,39.27,,1,,,,,,,,,,,,,,49,80,12.09,13.99,14.03,,,,,,,,,,,,,,,,,"41,2,2,2,3,4,16,30,1",,,,,,,125,,,,,,,,,,,,,,,,,,,,,,,,,,,,,,,,,,,,,13,13,233,64,,1006,0,,0,5,3,,1,0,,,,,"Aachen Laufen",,"Polar BEAT",,0,,0,168070,250480,30378,,,,,,,,,,,,,,,,,,,,,,,,,,,,,,,,,,,,,,,,,,,
5962738,5dd2cb3d-b846-490d-b4b7-7d9f88c9d58e,1411210143,120,1548677722,,0,0,6.41,2338,2339,111,112,,,1,1.5,0.47,,,314,432,,,,,,,30.8,,1,,,,,,,,,,,,,,48,75,10.14,11.79,12.18,,,,,,,,,,,,,,,,,"24,6,6,14,29,18,2,0,0",,,,,,,110,,,,,,,,,,,,,,,,,,,,,,,,,,,,,,,,,,,,,16,0,203,89,,,2,,0,5,3,,1,0,,,,,"Regenerativer DL",,"Polar BEAT",,0,,0,168070,250480,30378,,,,,,,,,,,,,,,,,,,,,,,,,,,,,,,,,,,,,,,,,,4,
5962739,7dfab1eb-6145-4fa1-86c5-2f370f001eb2,1542910033,60,1548677722,,0,0,14.86,3704,3706,56,57,,,1,0,0.07,,0.93,,1000,159,177,,,,66.01,51.12,66.31,1,,,,,,,,,,,,,,115,84,14.49,14.71,14.79,5.1,,,,,,,,,,,,,,,,"2,1,3,5,10,34,43,2,0","0,2,50,48,0",,,,,,143,,,,,,,,,,,,,,,,,,,,,,,,,,,,,,,,,,,,71.1,3,3,341,87,,1021,0,317,1,3,3,,1,0,I1.000|4:22-I1.000|4:20-I1.000|4:17-I1.000|4:19-I1.000|4:14-I1.000|4:21-I1.000|3:47-I1.000|3:50-I1.000|3:53-I1.000|3:50-I1.000|3:49-I1.000|3:46-I1.000|3:49-I1.000|4:18-I0.868|4:55,,Running,,,,"Polar M430",43,0,,0,168070,250480,30378,,,,,,,,,,,,,,,,,,,,,,,,,,,,,,,,,,,,,,,,,,,
5962740,d392ceed-d85d-4405-8f37-039e58752ec6,1501243671,120,1548677723,,0,0,11.71,3134,3136,206,208,,,1,2.7,0.55,1.05,0.99,372,784,158,182,,,,61,46.24,62.32,1,,,,,,,,,,,,,,95,83,13.84,13.67,14.14,4.8,,,,,,,,,,,,,,,,"1,1,6,10,28,36,17,0,0","1,7,49,41,2",,,,,,135,,,,,,,,,,,,,,,,,,,,,,,,,,,,,,,,,,,,75.5,19,13,248,68,,1014,5,,0,5,3,,1,0,I1.000|5:05-I1.000|4:32-I1.000|4:19-I1.000|4:39-I1.000|4:45-I1.000|4:39-I1.000|4:16-I1.000|4:00-I1.000|3:55-I1.000|4:01-I1.000|4:39-I0.717|3:26,,Running,,,,"Polar M430",43,0,,0,168070,250480,30378,,,,,,,,,,,,,,,,,,,,,,,,,,,,,,,,,,,,,,,,,,"4,5,5",
5962741,992fe7ae-75fd-4a74-b462-237c44928e61,1402843146,120,1548677723,,0,0,6.33,1712,1725,40,40,,,1,0,0.25,,,,427,,,,,,,43.9,,1,,,,,,,,,,,,,,35,83,13.43,13.47,13.56,,,,,,,,,,,,,,,,,"1,0,4,11,29,45,9,0,0",,,,,,,134,,,,,,,,,,,,,,,,,,,,,,,,,,,,,,,,,,,,,19,4,15,58,,1023,7,,0,5,3,,1,0,,,,,Auslaufen,,"Polar BEAT",,0,,0,168070,250480,30378,,,,,,,,,,,,,,,,,,,,,,,,,,,,,,,,,,,,,,,,,,,
5962742,,1449306900,60,1548677723,,0,0,4,0,0,,,,,0,,,,,,270,,,,,,,,,1,,,,,,,,,,,,,,0,,,,,,,,,,,,,,,,,,,,,,,,,,,,,,,,,,,,,,,,,,,,,,,,,,,,,,,,,,,,,,,,,,,,,,,,,,1,,,0,0,,,,,laufen,,"Polar BEAT",,0,,0,168070,250480,30378,,,,,,,,,,,,,,,,,,,,,,,,,,,,,,,,,,,,,,,,,,,
5962743,4fb4a235-9cb6-4627-8fa2-2fc3a453169e,1504808084,120,1548677725,,0,0,6.87,2657,2678,128,130,,,1,1.4,0.38,1.18,0.83,383,559,140,179,,,,45.52,28.84,46.55,1,,,,,,,,,,,,,,53,79,9.46,9.8,10.3,22.9,,,,,,,,,,,,,,,,"38,22,18,11,7,4,1,0,0","2,51,41,7,0",,,,,,98,,,,,,,,,,,,,,,,,,,,,,,,,,,,,,,,,,,,43.2,17,15,249,71,,1014,,,0,3,3,,1,0,I2.334|14:33-I0.089|0:22-I0.124|0:46-I0.076|0:23-I0.116|0:49-I0.081|0:23-I0.118|0:44-I0.084|0:23-I0.114|0:45-I0.076|0:22-I0.122|0:45-I0.071|0:21-I0.122|0:45-I0.062|0:22-I0.118|0:49-I0.077|0:22-I0.117|0:46-I0.079|0:22-I0.119|0:48-I0.071|0:22-I0.120|0:53-I0.060|0:22-I0.118|0:49-I0.069|0:22-I0.146|1:12-I0.083|0:19-I0.150|1:19-I0.080|0:21-I0.138|1:15-I0.065|0:21-I0.157|2:48-I1.502|9:32,,Running,,,,"Polar M430",43,0,,0,168070,250480,30378,,,,,,,,,,,,,,,,,,,,,,,,,,,,,,,,,,,,,,,,,,5,
5962744,4ac8320b-6120-4033-98c1-425d63a687d3,1474575222,120,1548677726,,0,0,2.99,894,906,89,34,,,1,1.8,0.61,,,438,201,,,,,,,37.15,,1,,,,,,,,,,,,,,18,80,13.11,12.59,14.01,,,,,,,,,,,,,,,,,"13,5,13,15,18,25,11,0,0",,,,,,,125,,,,,,,,,,,,,,,,,,,,,,,,,,,,,,,,,,,,,16,1,208,76,,1022,0,,1,5,3,,1,0,,,,,"Aachen Laufen",,"Polar BEAT",,0,,0,168070,250480,30378,,,,,,,,,,,,,,,,,,,,,,,,,,,,,,,,,,,,,,,,,,5,
5962745,7b872a6c-5073-42b3-a6b7-b97e9b0b52a8,1435402034,120,1548677726,,0,0,6.53,2152,2158,120,117,,,1,2.1,0.59,,,699,439,,,,,,,34.81,,1,,,,,,,,,,,,,,44,82,11.33,11.02,11.67,,,,,,,,,,,,,,,,,"7,14,29,41,5,1,3,0,0",,,,,,,111,,,,,,,,,,,,,,,,,,,,,,,,,,,,,,,,,,,,,18,13,265,81,,1017,,,0,4,3,,1,0,,,,,"Aachen Laufen",,"Polar BEAT",,0,,0,168070,250480,30378,,,,,,,,,,,,,,,,,,,,,,,,,,,,,,,,,,,,,,,,,,"5,5",
5962747,78f3d874-25d9-447f-a0ef-c57dd3ea6a01,1370282506,120,1548677728,,0,0,95.65,13796,13993,1201,1211,,,1,2.9,0.41,,,759,3230,,,,,,,,,1,,,,,,,,,,,,,,154,,,30.26,,,,289,195,,1,384,321,,,,,,,,,"21,15,16,14,12,8,13",,"56,12,8,5,19",,,,,,,,,,,,,,,,,,,,,,,,,,,,,,,,,,,,,,,,,,15,9,2,53,,1027,2,,0,5,3,,1,0,,,,,,,"Polar BEAT",,0,,0,168072,,30378,,,,,,,,,,,,,,,,,,,,,,,,,,,,,,,,,,,,,,,,,,"4,4,4,4,4,4,5,5",
5962748,4bb628fe-5c12-45a0-974d-34b842be1c02,1405363309,120,1548677728,,0,0,9.81,2674,2677,139,123,,,1,1.5,0.42,0.98,1.01,545,492,148,168,,,,65.25,44.7,66.53,1,,,,,,,,,,,,,,64,81,13.53,13.39,13.65,-3.4,,,,,,,,,,,,,,,,"2,1,2,11,31,47,6,0,0","0,23,70,8,0",,,,,,136,,,,,,,,,,,,,,,,,,,,,,,,,,,,,,,,,,,,39.5,21,8,273,63,,1016,2,,0,5,3,,1,0,,,,,"Lockerer DL",,"Polar BEAT",,0,,0,168070,250480,30378,,,,,,,,,,,,,,,,,,,,,,,,,,,,,,,,,,,,,,,,,,5,
5962749,97793ff1-a6df-4135-ab7d-b6e832173ff6,1416656634,60,1548677729,,0,0,6.85,2054,2895,124,92,,,1,1.7,0.59,,,453,460,,,,,,,39.05,,1,,,,,,,,,,,,,,42,83,12.45,12.15,12.85,,,,,,,,,,,,,,,,,"3,4,10,32,37,12,2,0,0",,,,,,,121,,,,,,,,,,,,,,,,,,,,,,,,,,,,,,,,,,,,,10,2,146,93,,1019,1,,0,5,3,,1,0,,,,,Samstagstraining,,"Polar BEAT",,0,,0,168070,250480,30378,,,,,,,,,,,,,,,,,,,,,,,,,,,,,,,,,,,,,,,,,,4,
5962750,aa07ee59-6682-4101-bf93-d5c59e133f60,1520365758,60,1548677730,,0,0,10.76,1937,1968,57,44,,,1,0,0.11,2.02,0.38,,319,121,146,,,,,,,1,,,,,,,,,,,,,,23,,,21.76,,13.6,-32.7,107,89,,1,127,113,,,,,,,,,"11,20,55,14,0,0,0","1,95,4,0,0","90,0,0,1,9",,,,,,,,,,,,,,,,,,,,,,,,,,,,,,,,,,,,,,,,,13.3,8,3,230,75,,,0,,1,5,3,,1,0,,,Cycling,,,,"Polar M430",43,0,,0,168072,,30378,,,,,,,,,,,,,,,,,,,,,,,,,,,,,,,,,,,,,,,,,,,
5962751,eb40607d-18ff-4250-ab73-f3767f938d3b,1400791082,120,1548677730,,0,0,3.65,928,969,0,2,,,1,0,0,,,,204,,,,,,,45.55,,1,,,,,,,,,,,,,,19,84,14.14,15.62,15.67,,,,,,,,,,,,,,,,,"23,7,3,3,5,6,13,18,21",,,,,,,140,,,,,,,,,,,,,,,,,,,,,,,,,,,,,,,,,,,,,15,16,148,81,,1009,,,0,5,3,,1,0,,,,,"Schnelle kurze Intervalle",,"Polar BEAT",,0,,0,168070,250480,30378,,,,,,,,,,,,,,,,,,,,,,,,,,,,,,,,,,,,,,,,,,,
5962752,53da945c-1a0b-4a71-8d58-b7888f6331a1,1447875999,60,1548677730,,0,0,14.72,4072,4086,185,191,,,1,2.1,0.58,,,407,1007,,,,,,,45.27,,1,,,,,,,,,,,,,,84,83,13.24,13.14,13.39,,,,,,,,,,,,,,,,,"1,0,4,12,41,39,3,0,0",,,,,,,131,,,,,,,,,,,,,,,,,,,,,,,,,,,,,,,,,,,,,11,31,216,75,,1015,,,1,11,3,,1,0,,,,,"Aachen Laufen",,"Polar BEAT",,0,,0,168070,250480,30378,,,,,,,,,,,,,,,,,,,,,,,,,,,,,,,,,,,,,,,,,,4,
5962753,894695b6-9a6c-49b3-b6e8-1a1958cbcc9f,1434402385,120,1548677731,,0,0,10.59,2461,2461,116,131,,,1,1.2,0.45,,,,715,,,,,,,54.14,,1,,,,,,,,,,,,,,51,84,15.62,15.58,15.81,,,,,,,,,,,,,,,,,"1,0,0,0,3,24,66,6,0",,,,,,,154,,,,,,,,,,,,,,,,,,,,,,,,,,,,,,,,,,,,,16,12,19,51,,1020,,,0,3,3,,1,0,,,,,"Aachen Laufen",,"Polar BEAT",,0,,0,168070,250480,30378,,,,,,,,,,,,,,,,,,,,,,,,,,,,,,,,,,,,,,,,,,,
5962754,55196cb0-260d-4f67-b358-63feb9c4198a,1465045940,120,1548677731,,0,0,3.34,1057,1057,68,68,,,1,1.6,0.58,,,393,228,,,,,,,35.05,,1,,,,,,,,,,,,,,21,81,11.75,11.58,12.31,,,,,,,,,,,,,,,,,"10,9,22,22,28,10,0,0,0",,,,,,,117,,,,,,,,,,,,,,,,,,,,,,,,,,,,,,,,,,,,,16,2,306,96,,1015,5,,0,9,3,,1,0,,,,,"Aachen Laufen",,"Polar BEAT",,0,,0,168070,250480,30378,,,,,,,,,,,,,,,,,,,,,,,,,,,,,,,,,,,,,,,,,,4,
5962755,122f9331-6591-4fda-b5c4-e0567f35ef17,1525885498,120,1548677732,,0,0,15.5,4311,4313,44,44,,,1,0,0.05,1.04,0.88,,1107,157,178,,,,58.7,45.17,58.9,1,,,,,,,,,,,,,,128,82,12.98,13.33,13.39,7.9,,,,,,,,,,,,,,,,"5,4,7,12,31,22,19,0,0","0,13,47,40,0",,,,,,132,,,,,,,,,,,,,,,,,,,,,,,,,,,,,,,,,,,,72.5,26,2,37,38,,,,,0,3,3,,1,0,I1.000|4:54-I1.000|4:49-I1.000|4:34-I1.000|3:56-I1.000|4:43-I1.000|3:57-I1.000|4:36-I1.000|3:56-I1.000|4:53-I1.000|4:02-I1.000|4:48-I1.000|4:03-I1.000|5:24-I1.000|3:58-I1.000|6:23-I0.505|3:00,,Running,,,,"Polar M430",43,0,,0,168070,250480,30378,,,,,,,,,,,,,,,,,,,,,,,,,,,,,,,,,,,,,,,,,,,
5962756,9c07c31c-8987-4161-b53d-62853e2a6af5,1530561985,120,1548677732,,0,0,0.33,110,111,4,3,,,1,0.3,0.38,1.05,,,18,118,136,,,,66.64,26.43,67.89,1,,,,,,,,,,,,,,1,82,10.85,10.82,11.21,31.4,,,,,,,,,,,,,,,,"0,13,53,35,0,0,0,0,0","24,76,0,0,0",,,,,,110,,,,,,,,,,,,,,,,,,,,,,,,,,,,,,,,,,,,1.9,23,15,60,33,,,,,0,3,3,,1,0,,,Running,,,,"Polar M430",43,0,,0,168070,250480,30378,,,,,,,,,,,,,,,,,,,,,,,,,,,,,,,,,,,,,,,,,,,
5962757,230c32b0-4e7b-4624-b9d6-5ec07ed25370,1533060491,120,1548677733,,0,0,17.33,4642,4643,70,70,,,1,0,0.07,1.14,0.95,,1289,161,173,,,,59.32,47.61,59.61,1,,,,,,,,,,,,,,150,83,13.47,13.5,13.59,7.8,,,,,,,,,,,,,,,,"0,0,1,5,40,49,5,0,0","0,2,30,68,0",,,,,,135,,,,,,,,,,,,,,,,,,,,,,,,,,,,,,,,,,,,70.2,35,9,289,28,,1015,,,0,3,3,,1,0,I1.000|4:42-I1.000|4:32-I1.000|4:23-I1.000|4:21-I1.000|4:34-I1.000|4:02-I1.000|4:13-I1.000|4:27-I1.000|4:36-I1.000|4:29-I1.000|4:31-I1.000|4:32-I1.000|4:22-I1.000|4:27-I1.000|4:26-I1.000|4:31-I1.000|4:45-I0.329|1:32,,Running,,,,"Polar M430",43,0,,0,168070,250480,30378,,,,,,,,,,,,,,,,,,,,,,,,,,,,,,,,,,,,,,,,,,,
5962759,ca7317dd-5dc8-41ab-80ee-0878ffedb961,1421062741,60,1548677733,,0,0,6.37,1946,2064,38,168,,,1,0.8,0.59,0.99,1,,333,137,156,,,,62.56,38.03,61.45,1,,,,,,,,,,,,,,35,,11.51,11.92,11.69,-8.9,,,,,,,,,,,,,,,,"6,3,8,31,44,8,1,0,0","0,68,32,0,0",,,,,,,,,,,,,,,,,,,,,,,,,,,,,,,,,,,,,,,,,,23.1,6,21,220,83,,1020,1,,0,5,3,,1,0,,,,,Auslaufen,,"Polar BEAT",,0,,0,168070,250480,30378,,,,,,,,,,,,,,,,,,,,,,,,,,,,,,,,,,,,,,,,,,,
5962760,7aa7ab66-8ac5-447c-ad47-ad2388e44b48,1336223400,120,1548677734,,0,0,16.17,6369,7308,185,247,,,1,0.4,0.26,,,96,1051,,,,,,,30.13,,1,,,,,,,,,,,,,,132,,9.31,13.72,14.13,,,,,,,,,,,,,,,,,"43,4,6,12,11,9,6,3,6",,,,,,,,,,,,,,,,,,,,,,,,,,,,,,,,,,,,,,,,,,,,8,8,13,95,,1006,5,,0,6,3,,1,0,,,,,,,"Polar BEAT",,0,,0,168070,250480,30378,,,,,,,,,,,,,,,,,,,,,,,,,,,,,,,,,,,,,,,,,,5,
5962761,14b06dc7-9435-43e8-af5a-457b8f3d7fc3,1428239571,120,1548677735,,0,0,15.01,3691,3691,374,376,,,1,3.6,0.65,,,482,1014,,,,,,,51.97,,1,,,,,,,,,,,,,,76,86,15.15,14.8,15.8,,,,,,,,,,,,,,,,,"1,0,0,1,9,49,37,3,0",,,,,,,142,,,,,,,,,,,,,,,,,,,,,,,,,,,,,,,,,,,,,8,12,359,42,,1026,,,0,5,3,,1,0,,,,,"Balve Laufen",,"Polar BEAT",,0,,0,168070,250480,30378,,,,,,,,,,,,,,,,,,,,,,,,,,,,,,,,,,,,,,,,,,"4,5,5,5,5,5",
5962762,6b5edcb1-2a3b-4d77-a552-63330d2555a3,1391886389,60,1548677736,,0,0,3.64,1188,1188,47,74,,,1,0.7,0.39,1.11,0.96,,200,136,153,,,,58.18,34,58.57,1,,,,,,,,,,,,,,20,84,11.04,11.13,11.36,0.2,,,,,,,,,,,,,,,,"8,9,29,38,11,4,0,0,0","0,78,22,0,0",,,,,,109,,,,,,,,,,,,,,,,,,,,,,,,,,,,,,,,,,,,16.8,6,14,202,85,,990,0,,1,5,3,,1,0,,,,,Auslaufen,,"Polar BEAT",,0,,0,168070,250480,30378,,,,,,,,,,,,,,,,,,,,,,,,,,,,,,,,,,,,,,,,,,,
5962763,00581f6c-e424-47ca-81e5-59193d2f629d,1366799561,120,1548677736,,0,0,14.9,4606,4667,254,265,,,1,2.8,0.5,1.2,1.02,465,1038,155,210,,,,52.45,39.83,53.51,1,,,,,,,,,,,,,,131,,11.95,12.46,13.03,6.2,,,,,,,,,,,,,,,,"15,7,13,18,18,17,8,3,2","0,3,64,32,1",,,,,,,,,,,,,,,,,,,,,,,,,,,,,,,,,,,,,,,,,,55.9,15,8,223,66,,1026,4,,0,3,3,,1,0,,,,,,,"Polar BEAT",,0,,0,168070,250480,30378,,,,,,,,,,,,,,,,,,,,,,,,,,,,,,,,,,,,,,,,,,"4,5",
5962764,f864f020-b336-4201-bac9-6c044eb65945,1538071572,120,1548677737,,0,0,15.14,3722,3722,62,62,,,1,0,0.03,1.12,,,1032,161,172,,,,65.95,52.02,66.29,1,,,,,,,,,,,,,,119,84,14.68,14.75,14.81,1.5,,,,,,,,,,,,,,,,"0,0,1,2,11,42,41,3,0","0,1,31,68,0",,,,,,145,,,,,,,,,,,,,,,,,,,,,,,,,,,,,,,,,,,,66.5,24,5,320,34,,1025,,,0,3,3,,1,0,I1.000|4:38-I1.000|4:29-I1.000|4:11-I1.000|4:18-I1.000|3:44-I1.000|3:57-I1.000|4:05-I1.000|4:10-I1.000|3:50-I1.000|4:02-I1.000|4:08-I1.000|3:55-I1.000|4:00-I1.000|4:00-I1.000|3:58-I0.148|0:38,,Running,,,,"Polar M430",43,0,,0,168070,250480,30378,,,,,,,,,,,,,,,,,,,,,,,,,,,,,,,,,,,,,,,,,,,
5962765,8fd161eb-bf10-441f-b534-ad242736ffcf,1398953226,120,1548677737,,0,0,5.87,2034,2185,38,72,,,1,0.5,0.38,1.04,0.9,,356,145,210,,,,49.84,32.58,49.89,1,,,,,,,,,,,,,,44,82,10.3,10.47,10.49,-4.7,,,,,,,,,,,,,,,,"12,16,46,19,7,0,0,0,0","0,33,66,0,1",,,,,,106,,,,,,,,,,,,,,,,,,,,,,,,,,,,,,,,,,,,31.3,17,1,321,58,,1011,5,,0,5,3,,1,0,,,,,Auslaufen,,"Polar BEAT",,0,,0,168070,250480,30378,,,,,,,,,,,,,,,,,,,,,,,,,,,,,,,,,,,,,,,,,,,
5962766,032dcc64-222d-4483-b49a-3f3cc88ca643,1410297750,120,1548677738,,0,0,3.58,1069,1072,20,53,,,1,0.6,0.49,,,,242,,,,,,,37.71,,1,,,,,,,,,,,,,,22,83,11.87,12.31,12.27,,,,,,,,,,,,,,,,,"5,1,6,30,39,20,0,0,0",,,,,,,121,,,,,,,,,,,,,,,,,,,,,,,,,,,,,,,,,,,,,14,3,16,86,,1021,0,,1,5,3,,1,0,,,,,Auslaufen,,"Polar BEAT",,0,,0,168070,250480,30378,,,,,,,,,,,,,,,,,,,,,,,,,,,,,,,,,,,,,,,,,,,
5962767,02e9ffd8-8e9b-48b1-9aca-22524b7e16b4,1541787439,60,1548677738,,0,0,5.95,1875,1878,36,36,,,1,0,0.14,1.06,0.9,,400,138,167,,,,59.67,36.51,60.12,1,,,,,,,,,,,,,,36,80,11.49,11.53,11.69,14,,,,,,,,,,,,,,,,"1,4,22,45,26,2,0,0,0","1,55,41,3,0",,,,,,119,,,,,,,,,,,,,,,,,,,,,,,,,,,,,,,,,,,,39.5,10,1,120,87,,,0,,1,3,3,,1,0,I1.000|5:08-I1.000|5:13-I1.000|5:27-I1.000|5:30-I1.000|5:06-I0.954|4:56,,Running,,,,"Polar M430",43,0,,0,168070,250480,30378,,,,,,,,,,,,,,,,,,,,,,,,,,,,,,,,,,,,,,,,,,,
5962768,63765aa2-bc69-41ad-a537-b0d9ca954abd,1368190272,120,1548677740,,0,0,8.35,2638,3013,112,132,,,1,1,0.39,,,,577,,,,,,,37.18,,1,,,,,,,,,,,,,,54,,11.75,12.18,12.53,,,,,,,,,,,,,,,,,"15,2,7,17,34,22,3,0,0",,,,,,,,,,,,,,,,,,,,,,,,,,,,,,,,,,,,,,,,,,,,13,16,250,68,,1016,5,,0,5,3,,1,0,,,,,,,"Polar BEAT",,0,,0,168070,250480,30378,,,,,,,,,,,,,,,,,,,,,,,,,,,,,,,,,,,,,,,,,,,
5962769,e44059e0-47f6-4a46-8efa-bbd36fab86ae,1446920991,60,1548677740,,0,0,3.89,1270,1509,61,44,,,1,1.2,0.47,,,252,274,,,,,,,34.13,,1,,,,,,,,,,,,,,26,82,11.35,11.49,11.85,,,,,,,,,,,,,,,,,"14,2,14,34,28,7,0,0,0",,,,,,,112,,,,,,,,,,,,,,,,,,,,,,,,,,,,,,,,,,,,,17,19,206,85,,1022,,,1,5,3,,1,0,,,,,"Aachen Laufen",,"Polar BEAT",,0,,0,168070,250480,30378,,,,,,,,,,,,,,,,,,,,,,,,,,,,,,,,,,,,,,,,,,5,
5962770,9d010060-414c-448b-95db-4dd7a11690e9,1517740626,60,1548677743,,0,0,8.34,2367,2373,66,66,,,2,0.1,0.22,1.14,0.94,,532,146,168,,,,63.2,42.18,63.82,1,,,,,,,,,,,,,,54,82,12.83,12.91,13.13,5.1,,,,,,,,,,,,,,,,"7,4,4,11,37,29,6,2,0","0,29,63,8,0",,,,,,129,,,,,,,,,,,,,,,,,,,,,,,,,,,,,,,,,,,,44.6,3,25,266,43,,1017,0,,1,5,3,,1,0,I6.443|30:08-I0.467|2:19-I0.553|3:16-I0.883|3:52,,Running,,,,"Polar M430",43,0,,0,168070,250480,30378,,,,,,,,,,,,,,,,,,,,,,,,,,,,,,,,,,,,,,,,,,,
5962771,ec598901-e746-46a6-81f1-7b7898882e10,1535997944,120,1548677744,,0,0,7.32,2509,2509,20,21,,,1,0,0,1.12,0.89,,501,132,151,,,,56.77,33.46,56.95,1,,,,,,,,,,,,,,39,80,10.54,10.54,10.63,4.3,,,,,,,,,,,,,,,,"3,19,55,21,2,0,0,0,0","1,92,8,0,0",,,,,,109,,,,,,,,,,,,,,,,,,,,,,,,,,,,,,,,,,,,15.2,23,4,133,53,,1016,,,0,5,3,,1,0,I1.000|5:44-I1.000|5:41-I1.000|5:40-I1.000|5:23-I1.000|5:43-I1.000|5:56-I1.000|5:58-I0.323|1:46,,Running,,,,"Polar M430",43,0,,0,168070,250480,30378,,,,,,,,,,,,,,,,,,,,,,,,,,,,,,,,,,,,,,,,,,,
5962772,64bab95f-7bd7-4b98-a8a0-da499ac4ccdb,1516092107,60,1548677744,,0,0,11.17,1891,1893,20,34,,,1,0,0.02,,,,331,129,147,,,,,,,1,,,,,,,,,,,,,,28,,,22.92,,9.3,-17.9,100,85,,1,117,106,,,,,,,,,"10,17,46,25,1,0,0","3,84,13,0,0","89,2,0,1,8",,,,,,,,,,,,,,,,,,,,,,,,,,,,,,,,,,,,,,,,,15.3,8,13,237,85,,,0,,0,6,3,,1,0,,,Cycling,,,,"Polar M430",43,0,,0,168072,,30378,,,,,,,,,,,,,,,,,,,,,,,,,,,,,,,,,,,,,,,,,,,
5962773,73b35289-5d68-400f-97ff-6a196d7dada3,1527695098,120,1548677745,,0,0,10.95,1972,1973,47,41,,,1,0,0.15,2.01,,,296,118,143,,,,,,,1,,,,,,,,,,,,,,21,,,22.23,,15.7,-13.9,111,89,,1,132,118,,,,,,,,,"17,6,70,8,0,0,0","4,95,1,0,0","91,0,0,0,9",,,,,,,,,,,,,,,,,,,,,,,,,,,,,,,,,,,,,,,,,9.8,28,14,358,37,,,5,,0,5,3,,1,0,,,Cycling,,,,"Polar M430",43,0,,0,168072,,30378,,,,,,,,,,,,,,,,,,,,,,,,,,,,,,,,,,,,,,,,,,,
5962774,1984cff1-92c5-4d90-af6b-cf5425ae84ba,1547372844,60,1548677745,,0,0,13.46,3986,3987,304,364,,,1,3.5,0.72,1.06,1.21,381,793,130,159,,,,69.25,41.54,70.81,1,,,,,,,,,,,,,,64,82,12.81,12.8,13.22,-44.5,,,,,,,,,,,,,,,,"8,6,20,19,13,16,17,1,0","12,47,40,0,0",,,,,,124,,,,,,,,,,,,,,,,,,,,,,,,,,,,,,,,,,,,29,5,18,226,100,,1008,0,318,0,6,3,,1,0,I6.306|36:33-I7.153|29:56,,Running,,,,"Polar M430",43,0,,0,168070,250480,30378,,,,,,,,,,,,,,,,,,,,,,,,,,,,,,,,,,,,,,,,,,3,
5962775,81ccc539-784d-4dac-8f57-b2ae13cc912a,1540114072,120,1548677746,,0,0,16.84,4856,4856,54,56,,,1,0,0.08,1.14,0.93,,1152,145,155,,,,62.53,43.61,62.77,1,,,,,,,,,,,,,,107,82,12.51,12.53,12.6,-1.7,,,,,,,,,,,,,,,,"0,0,1,25,64,9,0,0,0","0,5,95,0,0",,,,,,127,,,,,,,,,,,,,,,,,,,,,,,,,,,,,,,,,,,,30.6,8,17,30,93,,1028,,,0,3,1,,1,0,I1.000|5:00-I1.000|4:57-I1.000|4:49-I1.000|5:02-I1.000|4:57-I1.000|4:57-I1.000|4:45-I1.000|4:44-I1.000|4:41-I1.000|4:33-I1.000|4:42-I1.000|4:46-I1.000|4:43-I1.000|4:41-I1.000|4:40-I1.000|4:50-I0.852|4:09,,Running,,,,"Polar M430",43,0,,0,168070,250480,30378,,,,,,,,,,,,,,,,,,,,,,,,,,,,,,,,,,,,,,,,,,,
5962776,53ed37fb-351f-4510-91df-dc7c5da3e8e2,1394822440,60,1548677747,,0,0,14.01,3825,3872,169,168,,,1,1.5,0.46,1.12,0.99,334,726,152,169,,,,62.82,45.79,63.76,1,,,,,,,,,,,,,,102,83,13.42,13.88,14.25,9.7,,,,,,,,,,,,,,,,"7,1,3,5,13,51,21,0,0","1,13,53,33,0",,,,,,132,,,,,,,,,,,,,,,,,,,,,,,,,,,,,,,,,,,,55.4,13,5,268,56,,1024,0,,1,3,3,,1,0,,,,,"Zügiger DL ",,"Polar BEAT",,0,,0,168070,250480,30378,,,,,,,,,,,,,,,,,,,,,,,,,,,,,,,,,,,,,,,,,,5,
5962777,5598d780-dbaf-4878-bd2c-2ddd3e4e9b1b,1545646264,60,1548677748,,0,0,21.11,5421,5423,233,234,,,1,1.8,0.36,1.07,0.97,458,1566,166,182,,,,59.74,50.78,60.55,1,,,,,,,,,,,,,,196,85,14.23,14.16,14.42,-2.9,,,,,,,,,,,,,,,,"0,1,3,8,16,45,27,0,0","0,3,16,81,0",,,,,,137,,,,,,,,,,,,,,,,,,,,,,,,,,,,,,,,,,,,83.9,4,13,330,88,,,0,,0,5,3,,1,0,I1.000|4:43-I1.000|4:52-I1.000|5:05-I1.000|4:41-I1.000|4:12-I1.000|4:26-I1.000|4:17-I1.000|4:10-I1.000|4:21-I1.000|4:24-I1.000|4:03-I1.000|4:03-I1.000|4:05-I1.000|4:03-I1.000|4:01-I1.000|4:05-I1.000|4:05-I1.000|4:04-I1.000|4:01-I1.000|4:00-I1.000|4:09-I0.111|0:33,,Running,,,,"Polar M430",43,0,,0,168070,250480,30378,,,,,,,,,,,,,,,,,,,,,,,,,,,,,,,,,,,,,,,,,,"4,5",
5962778,2c55000e-b7c1-47aa-bb0f-dbfc384973cf,1399583366,120,1548677748,,0,0,3.47,1024,1024,37,29,,,1,0.8,0.42,,,,242,,,,,,,38.15,,1,,,,,,,,,,,,,,21,82,12.38,12.26,12.49,,,,,,,,,,,,,,,,,"0,1,4,41,46,8,0,0,0",,,,,,,124,,,,,,,,,,,,,,,,,,,,,,,,,,,,,,,,,,,,,11,14,224,94,,1010,0,,1,6,3,,1,0,,,,,Auslaufen,,"Polar BEAT",,0,,0,168070,250480,30378,,,,,,,,,,,,,,,,,,,,,,,,,,,,,,,,,,,,,,,,,,,
5962779,dd7cfe0e-932e-459a-914c-8f866b89eead,1421867350,60,1548677749,,0,0,15.01,3707,3712,197,206,,,1,2,0.54,,,446,998,,,,,,,51.71,,1,,,,,,,,,,,,,,76,85,14.82,14.69,15.01,,,,,,,,,,,,,,,,,"0,0,1,3,8,54,31,3,0",,,,,,,143,,,,,,,,,,,,,,,,,,,,,,,,,,,,,,,,,,,,,0,6,101,85,,1012,0,,1,5,3,,1,0,,,,,"Zügiger DL",,"Polar BEAT",,0,,0,168070,250480,30378,,,,,,,,,,,,,,,,,,,,,,,,,,,,,,,,,,,,,,,,,,4,
5962780,f45c0eb9-5d2b-4b72-8538-fb55c59b0034,1368226372,120,1548677749,,0,0,1.26,452,477,37,38,,,1,1.5,0.68,,,,73,,,,,,,27.64,,1,,,,,,,,,,,,,,9,,10.55,15.88,16.22,,,,,,,,,,,,,,,,,"57,0,0,0,0,0,1,25,15",,,,,,,,,,,,,,,,,,,,,,,,,,,,,,,,,,,,,,,,,,,,10,8,232,83,,1018,0,,1,5,3,,1,0,,,,,,,"Polar BEAT",,0,,0,168070,250480,30378,,,,,,,,,,,,,,,,,,,,,,,,,,,,,,,,,,,,,,,,,,,
5962781,652f9a3a-7449-4b0f-8b4a-49b9dc6c102a,1406495301,120,1548677749,,0,0,2.56,772,779,24,43,,,1,0.6,0.47,1.35,0.95,,138,146,180,,,,58.63,36.3,58.77,1,,,,,,,,,,,,,,18,81,11.76,13.13,13.63,23.8,,,,,,,,,,,,,,,,"16,1,4,21,24,11,22,1,0","0,46,28,26,0",,,,,,123,,,,,,,,,,,,,,,,,,,,,,,,,,,,,,,,,,,,42.2,22,1,50,71,,1015,0,,0,5,3,,1,0,,,,,Auslaufen,,"Polar BEAT",,0,,0,168070,250480,30378,,,,,,,,,,,,,,,,,,,,,,,,,,,,,,,,,,,,,,,,,,,
5962782,8800f2e0-3ede-4018-8107-922167f77673,1519112038,60,1548677750,,0,0,10.97,1657,1657,46,53,,,1,0,0.15,1.92,0.76,,310,132,168,,,,,,,1,,,,,,,,,,,,,,28,,,25.45,,6.2,-18.3,133,111,,1,153,137,,,,,,,,,"8,9,18,60,4,0,0","7,44,46,3,0","75,15,0,1,10",,,,,,,,,,,,,,,,,,,,,,,,,,,,,,,,,,,,,,,,,26.2,0,8,30,86,,1016,,,0,4,1,,1,0,,,Cycling,,,,"Polar M430",43,0,,0,168072,,30378,,,,,,,,,,,,,,,,,,,,,,,,,,,,,,,,,,,,,,,,,,,
5962783,afe74b8a-ad45-4a12-9071-2b47521e66ba,1414608344,60,1548677750,,0,0,9.58,2510,2621,0,4,,,1,0,0.02,,,,627,,,,,,,46.75,,1,,,,,,,,,,,,,,52,84,13.73,14.85,14.85,,,,,,,,,,,,,,,,,"16,7,7,9,2,1,44,12,2",,,,,,,136,,,,,,,,,,,,,,,,,,,,,,,,,,,,,,,,,,,,,9,4,208,95,,,0,,1,4,3,,1,0,,,,,"4000,2000,2x400",,"Polar BEAT",,0,,0,168070,250480,30378,,,,,,,,,,,,,,,,,,,,,,,,,,,,,,,,,,,,,,,,,,,
5962784,bfb9f245-538d-4850-aa44-9cc8a03946a5,1349614004,120,1548677755,,0,0,19.56,5736,5780,80,81,,,1,0,0.1,,,,1350,,,,,,,43.28,,1,,,,,,,,,,,,,,119,,12.33,13.3,13.41,,,,,,,,,,,,,,,,,"11,3,6,14,23,24,13,3,2",,,,,,,,,,,,,,,,,,,,,,,,,,,,,,,,,,,,,,,,,,,,13,18,308,88,,1015,3,,0,5,3,,1,0,,,,,,,"Polar BEAT",,0,,0,168070,250480,30378,,,,,,,,,,,,,,,,,,,,,,,,,,,,,,,,,,,,,,,,,,,
5962785,3dcfac24-a875-43c4-af64-66d7014d0956,1368724478,120,1548677755,,0,0,7.14,2078,2099,123,125,,,1,2,0.63,,,384,499,,,,,,,40.55,,1,,,,,,,,,,,,,,43,,12.8,12.58,13.04,,,,,,,,,,,,,,,,,"8,6,7,15,35,23,5,1,0",,,,,,,,,,,,,,,,,,,,,,,,,,,,,,,,,,,,,,,,,,,,11,4,280,95,,997,3,,0,6,3,,1,0,,,,,,,"Polar BEAT",,0,,0,168070,250480,30378,,,,,,,,,,,,,,,,,,,,,,,,,,,,,,,,,,,,,,,,,,5,
5962786,423b64fe-11b2-4bfe-92c2-0a62104d0afc,1537902574,120,1548677755,,0,0,11.36,3144,3146,43,44,,,1,0,0.07,,0.96,,716,142,157,,,,67.59,44.37,67.9,1,,,,,,,,,,,,,,65,79,13.03,13.05,13.11,2.2,,,,,,,,,,,,,,,,"0,0,1,11,54,31,2,0,0","1,36,63,0,0",,,,,,137,,,,,,,,,,,,,,,,,,,,,,,,,,,,,,,,,,,,32.4,15,20,51,36,,1037,,,1,3,3,,1,0,I1.000|4:53-I1.000|4:37-I1.000|4:40-I1.000|4:47-I1.000|4:49-I1.000|4:38-I1.000|4:33-I1.000|4:39-I1.000|4:30-I1.000|4:21-I1.000|4:23-I0.357|1:37,,Running,,,,"Polar M430",43,0,,0,168070,250480,30378,,,,,,,,,,,,,,,,,,,,,,,,,,,,,,,,,,,,,,,,,,,
5962787,2220e225-e519-4212-93ab-87767964e4d7,1475180834,120,1548677756,,0,0,8.9,2217,2217,354,330,,,1,5,0.75,,,1012,562,,,,,,,49.36,,1,,,,,,,,,,,,,,46,84,15.53,14.64,16.73,,,,,,,,,,,,,,,,,"1,0,3,10,21,19,38,8,0",,,,,,,143,,,,,,,,,,,,,,,,,,,,,,,,,,,,,,,,,,,,,17,9,229,75,,1015,0,,1,5,3,,1,0,,,,,"Aachen Laufen",,"Polar BEAT",,0,,0,168070,250480,30378,,,,,,,,,,,,,,,,,,,,,,,,,,,,,,,,,,,,,,,,,,"4,5,5,5,5,5,5,5,5,5,5,5,5",
5962788,6dde59a4-331a-4745-ac26-29186533a2ae,1412680195,120,1548677757,,0,0,19.3,5630,5676,236,235,,,1,1.8,0.42,1.01,0.99,341,910,143,161,,,,62.76,43.5,63.71,1,,,,,,,,,,,,,,118,83,12.53,12.47,12.81,4.6,,,,,,,,,,,,,,,,"3,2,6,23,50,15,2,0,0","0,43,56,1,0",,,,,,124,,,,,,,,,,,,,,,,,,,,,,,,,,,,,,,,,,,,33.3,14,11,206,86,,1001,2,,0,5,3,,1,0,,,,,"Langsamer DL",,"Polar BEAT",,0,,0,168070,250480,30378,,,,,,,,,,,,,,,,,,,,,,,,,,,,,,,,,,,,,,,,,,"4,5",
5962789,3e2bb682-058e-4fb1-8919-18e01f6b3fd4,1366196459,120,1548677758,,0,0,12.27,3830,3875,216,228,,,1,2.5,0.65,,,438,858,,,,,,,38.78,,1,,,,,,,,,,,,,,79,,11.77,12.53,12.9,,,,,,,,,,,,,,,,,"17,6,10,16,21,17,11,2,1",,,,,,,,,,,,,,,,,,,,,,,,,,,,,,,,,,,,,,,,,,,,16,9,203,72,,1022,3,,0,5,3,,1,0,,,,,,,"Polar BEAT",,0,,0,168070,250480,30378,,,,,,,,,,,,,,,,,,,,,,,,,,,,,,,,,,,,,,,,,,"4,5",
5962790,744e6c77-297d-4a9f-90b0-f501cb677897,1440533377,120,1548677758,,0,0,3.37,963,963,62,62,,,1,1.7,0.64,,,433,223,,,,,,,39.53,,1,,,,,,,,,,,,,,20,83,13,12.66,13.39,,,,,,,,,,,,,,,,,"0,0,4,35,42,13,7,0,0",,,,,,,126,,,,,,,,,,,,,,,,,,,,,,,,,,,,,,,,,,,,,16,18,189,67,,1014,,,0,5,3,,1,0,,,,,"Aachen Laufen",,"Polar BEAT",,0,,0,168070,250480,30378,,,,,,,,,,,,,,,,,,,,,,,,,,,,,,,,,,,,,,,,,,5,
5962791,533bceed-8b90-4e15-80cb-1a251b5d831e,1515694091,60,1548677758,,0,0,11.87,3189,3190,33,33,,,1,0,0.09,1.05,0.91,,788,152,167,,,,64.08,46.08,64.3,1,,,,,,,,,,,,,,83,83,13.43,13.46,13.53,2.1,,,,,,,,,,,,,,,,"0,1,1,5,37,53,4,0,0","1,3,93,3,0",,,,,,135,,,,,,,,,,,,,,,,,,,,,,,,,,,,,,,,,,,,43.4,7,4,20,87,,1018,,,1,4,1,,1,0,I1.000|4:59-I1.000|4:35-I1.000|4:19-I1.000|4:19-I1.000|4:27-I1.000|4:28-I1.000|4:16-I1.000|4:30-I1.000|4:27-I1.000|4:27-I1.000|4:30-I0.872|3:54,,Running,,,,"Polar M430",43,0,,0,168070,250480,30378,,,,,,,,,,,,,,,,,,,,,,,,,,,,,,,,,,,,,,,,,,,
5962792,1d71cea8-4c65-4c52-8159-84e4d19a5208,1344972611,120,1548677759,,0,0,14.91,5925,6646,309,247,,,1,1.4,0.27,,,291,1017,,,,,,,29.62,,1,,,,,,,,,,,,,,123,,9.32,13.24,13.42,,,,,,,,,,,,,,,,,"42,2,5,8,11,9,9,8,6",,,,,,,,,,,,,,,,,,,,,,,,,,,,,,,,,,,,,,,,,,,,20,5,84,82,,1013,,,0,5,3,,1,0,,,,,,,"Polar BEAT",,0,,0,168070,250480,30378,,,,,,,,,,,,,,,,,,,,,,,,,,,,,,,,,,,,,,,,,,"4,4,5",
5962793,e19ac261-2c0e-469d-a1c8-f5b316479e96,1517331647,60,1548677759,,0,0,11.3,2080,2098,52,45,,,1,0,0.09,,,,275,109,145,,,,,,,1,,,,,,,,,,,,,,17,,,20.36,,20.1,-24.4,89,75,,1,112,100,,,,,,,,,"9,41,46,3,0,0,0","29,69,2,0,0","86,1,8,4,2",,,,,,,,,,,,,,,,,,,,,,,,,,,,,,,,,,,,,,,,,9.4,9,1,198,87,,1020,0,,0,4,3,,1,0,,,Cycling,,,,"Polar M430",43,0,,0,168072,,30378,,,,,,,,,,,,,,,,,,,,,,,,,,,,,,,,,,,,,,,,,,,
5962794,e0960c2a-f1be-4a5e-89dd-604665f9aa42,1347133420,120,1548677760,,0,0,26.85,3905,4155,663,665,,,1,4.7,0.71,,,825,956,,,,,,,,,1,,,,,,,,,,,,,,43,,,34.3,,,,345,269,,1,557,396,,,,,,,,,"25,26,16,8,5,6,15",,"51,7,13,9,21",,,,,,,,,,,,,,,,,,,,,,,,,,,,,,,,,,,,,,,,,,21,1,294,64,,1019,0,,1,3,3,,1,0,,,,,,,"Polar BEAT",,0,,0,168072,,30378,,,,,,,,,,,,,,,,,,,,,,,,,,,,,,,,,,,,,,,,,,"4,4,5,5",
5962796,c20e5827-41fd-456b-9857-9a84e351c5a8,1536167958,120,1548677762,,0,0,10.81,1645,1707,63,49,,,1,0,0.09,1.9,,,288,121,138,,,,,,,1,,,,,,,,,,,,,,19,,,24.97,,15.5,-13.7,131,112,,1,148,134,,,,,,,,,"8,8,19,65,0,0,0","3,97,0,0,0","83,6,0,0,11",,,,,,,,,,,,,,,,,,,,,,,,,,,,,,,,,,,,,,,,,11.1,29,7,349,38,,1016,2,,0,5,3,,1,0,,,Cycling,,,,"Polar M430",43,0,,0,168072,,30378,,,,,,,,,,,,,,,,,,,,,,,,,,,,,,,,,,,,,,,,,,,
5962797,f88b0f2e-5e9b-4aec-b8b4-46ba30ab89bf,1447791351,60,1548677763,,0,0,3.47,1497,1869,48,45,,,1,0.7,0.41,,,,235,,,,,,,24.21,,1,,,,,,,,,,,,,,31,73,8.64,9.84,9.98,,,,,,,,,,,,,,,,,"46,11,13,19,10,1,0,0,0",,,,,,,95,,,,,,,,,,,,,,,,,,,,,,,,,,,,,,,,,,,,,14,32,227,90,,1007,,,1,6,3,,1,0,,,,,"Aachen Laufen",,"Polar BEAT",,0,,0,168070,250480,30378,,,,,,,,,,,,,,,,,,,,,,,,,,,,,,,,,,,,,,,,,,,
5962798,8e2502d3-28d3-4671-8be9-5452debb6f4f,1392318964,60,1548677763,,0,0,3.17,899,899,27,44,,,1,0.8,0.55,1.04,0.96,,178,145,163,,,,63.83,39.69,64.08,1,,,,,,,,,,,,,,20,81,12.65,12.74,12.79,0.9,,,,,,,,,,,,,,,,"0,0,1,20,57,22,0,0,0","1,31,64,4,0",,,,,,131,,,,,,,,,,,,,,,,,,,,,,,,,,,,,,,,,,,,25.5,4,17,262,92,,997,,,1,5,3,,1,0,,,,,Einlaufen,,"Polar BEAT",,0,,0,168070,250480,30378,,,,,,,,,,,,,,,,,,,,,,,,,,,,,,,,,,,,,,,,,,,
5962799,77e93825-ce6a-4950-9c67-3793e0871b90,1532159549,120,1548677763,,0,0,15.13,4333,4345,58,57,,,1,0,0.12,1.11,0.92,,1010,145,156,,,,63.06,43.58,63.36,1,,,,,,,,,,,,,,95,82,12.61,12.62,12.69,3.5,,,,,,,,,,,,,,,,"1,1,3,14,69,12,1,0,0","1,15,84,0,0",,,,,,128,,,,,,,,,,,,,,,,,,,,,,,,,,,,,,,,,,,,31.1,19,8,67,65,,1013,,,0,5,3,,1,0,I1.000|5:12-I1.000|4:32-I1.000|4:39-I1.000|4:36-I1.000|4:47-I1.000|4:39-I1.000|4:39-I1.000|4:58-I1.000|4:45-I1.000|4:48-I1.000|4:51-I1.000|4:40-I1.000|4:43-I1.000|4:50-I1.000|5:03-I0.140|0:44,,Running,,,,"Polar M430",43,0,,0,168070,250480,30378,,,,,,,,,,,,,,,,,,,,,,,,,,,,,,,,,,,,,,,,,,,
5962801,1efbb0fd-32dd-453e-9edd-2e1f27f3ebe0,1402092504,120,1548677764,,0,0,5.01,1391,1858,72,74,,,1,1.6,0.6,,,317,331,,,,,,,41.98,,1,,,,,,,,,,,,,,28,82,13.16,13.26,13.58,,,,,,,,,,,,,,,,,"2,1,5,23,40,17,4,8,0",,,,,,,132,,,,,,,,,,,,,,,,,,,,,,,,,,,,,,,,,,,,,18,4,79,59,,,0,,1,3,3,,1,0,,,,,"Einlaufen + Lauf ABC ",,"Polar BEAT",,0,,0,168070,250480,30378,,,,,,,,,,,,,,,,,,,,,,,,,,,,,,,,,,,,,,,,,,5,
5962802,ec69f996-4c33-4e3e-a979-7194061ca0c1,1510044724,60,1548677764,,0,0,12.09,2266,2267,47,48,,,1,0,0.08,,0.46,,329,115,141,,,,,,,1,,,,,,,,,,,,,,22,,,19.83,,-2.6,-34.4,87,74,,1,103,93,,,,,,,,,"12,42,42,4,0,0,0","2,98,0,0,0","86,0,11,3,1",,,,,,,,,,,,,,,,,,,,,,,,,,,,,,,,,,,,,,,,,9.7,5,4,31,87,,1021,,,0,5,3,,1,0,,,Cycling,,,,"Polar M430",43,0,,0,168072,,30378,,,,,,,,,,,,,,,,,,,,,,,,,,,,,,,,,,,,,,,,,,,
5962805,0c4e7a78-e5b6-4543-8f13-bd2abca06a8a,1534068826,120,1548677765,,0,0,17.38,5128,5132,64,69,,,1,0,0.11,1.07,0.93,,1196,144,158,,,,61.33,42.57,61.59,1,,,,,,,,,,,,,,112,82,12.24,12.28,12.35,0.6,,,,,,,,,,,,,,,,"1,2,5,32,51,8,1,0,0","0,14,85,0,0",,,,,,124,,,,,,,,,,,,,,,,,,,,,,,,,,,,,,,,,,,,35.2,21,6,98,52,,1018,,,0,5,3,,1,0,I1.000|5:17-I1.000|4:45-I1.000|4:47-I1.000|4:49-I1.000|4:53-I1.000|4:56-I1.000|4:52-I1.000|5:01-I1.000|5:01-I1.000|5:04-I1.000|5:15-I1.000|4:59-I1.000|4:47-I1.000|4:21-I1.000|4:34-I1.000|5:02-I1.000|5:08-I0.387|2:03,,Running,,,,"Polar M430",43,0,,0,168070,250480,30378,,,,,,,,,,,,,,,,,,,,,,,,,,,,,,,,,,,,,,,,,,,
5962806,,1428327900,120,1548677765,,0,0,12,0,0,,,,,0,,,,,,788,,,,,,,,,1,,,,,,,,,,,,,,0,,,,,,,,,,,,,,,,,,,,,,,,,,,,,,,,,,,,,,,,,,,,,,,,,,,,,,,,,,,,,,,,,,,,,,,,,,1,,,0,0,,,,,"Lockerer DL",,"Polar BEAT",,0,,0,168070,250480,30378,,,,,,,,,,,,,,,,,,,,,,,,,,,,,,,,,,,,,,,,,,,
5962807,f3d8c2d8-7edd-423e-ad77-8af7a0462573,1472590074,120,1548677766,,0,0,7.59,2045,2063,81,81,,,1,0,0.01,,,,504,,,,,,,44.58,,1,,,,,,,,,,,,,,42,79,13.45,15.67,15.73,,,,,,,,,,,,,,,,,"28,1,1,1,1,1,20,47,0",,,,,,,141,,,,,,,,,,,,,,,,,,,,,,,,,,,,,,,,,,,,,18,2,62,63,,1024,0,,1,3,3,,1,0,,,,,"Aachen Laufen",,"Polar BEAT",,0,,0,168070,250480,30378,,,,,,,,,,,,,,,,,,,,,,,,,,,,,,,,,,,,,,,,,,,
5962808,f1b7de66-d51d-4eb7-9ed1-c58728f1a8b0,1362667379,60,1548677766,,0,0,,1148,1148,,,,,0,,,,,,281,157,175,,,,,,,1,,,,,,,,,,,,,,33,,,,,,,,,,,,,,,,,,,,,,"1,3,66,30,0",,,,,,,,,,,,,,,,,,,,,,,,,,,,,,,,,,,,,,,,,,48.4,,,,,,,,,,1,,,1,0,,,,,,,"Polar BEAT",,0,,0,168070,250480,30378,,,,,,,,,,,,,,,,,,,,,,,,,,,,,,,,,,,,,,,,,,,
5962809,3c5b1cab-15fc-4dac-b2e9-7fe07b8b9feb,1515228627,60,1548677766,,0,0,16.71,5010,5012,52,53,,,1,0,0.02,1.07,0.93,,1038,151,165,,,,56.46,41.65,56.67,1,,,,,,,,,,,,,,126,82,12.04,12.03,12.09,-1.5,,,,,,,,,,,,,,,,"0,0,3,50,45,1,0,0,0","0,1,99,1,0",,,,,,122,,,,,,,,,,,,,,,,,,,,,,,,,,,,,,,,,,,,38.7,7,0,110,92,,,0,,0,5,3,,1,0,I1.000|5:06-I1.000|5:00-I1.000|5:02-I1.000|4:59-I1.000|5:06-I1.000|4:59-I1.000|4:59-I1.000|5:02-I1.000|4:56-I1.000|4:59-I1.000|5:05-I1.000|4:50-I1.000|4:53-I1.000|5:05-I1.000|5:02-I1.000|4:56-I0.712|3:36,,Running,,,,"Polar M430",43,0,,0,168070,250480,30378,,,,,,,,,,,,,,,,,,,,,,,,,,,,,,,,,,,,,,,,,,,
5962810,1167f0bb-87d8-4b4d-a044-ab943a827e4a,1412967294,120,1548677767,,0,0,13.4,3469,3469,183,185,,,1,1.9,0.52,,,374,896,,,,,,,48.54,,1,,,,,,,,,,,,,,72,83,14.14,14.02,14.34,,,,,,,,,,,,,,,,,"0,0,2,6,16,60,17,0,0",,,,,,,140,,,,,,,,,,,,,,,,,,,,,,,,,,,,,,,,,,,,,14,1,172,83,,1015,0,,1,5,3,,1,0,,,,,"Zügiger DL",,"Polar BEAT",,0,,0,168070,250480,30378,,,,,,,,,,,,,,,,,,,,,,,,,,,,,,,,,,,,,,,,,,4,
5962811,4246dc0c-db97-49ef-9524-1cc436774a07,1451308481,60,1548677767,,0,0,5.87,1820,1820,70,69,,,1,1.2,0.45,,,310,399,,,,,,,37.19,,1,,,,,,,,,,,,,,37,80,11.86,11.78,12.11,,,,,,,,,,,,,,,,,"2,4,12,44,32,6,0,0,0",,,,,,,121,,,,,,,,,,,,,,,,,,,,,,,,,,,,,,,,,,,,,11,15,127,68,,1026,,,0,3,3,,1,0,,,,,"Balve Laufen",,"Polar BEAT",,0,,0,168070,250480,30378,,,,,,,,,,,,,,,,,,,,,,,,,,,,,,,,,,,,,,,,,,5,
5962812,cf038e16-60c4-4b3d-940c-5d21829098b2,1524511657,120,1548677768,,0,0,12.01,3795,3796,36,37,,,1,0,0.03,1.09,0.94,,810,139,155,,,,58.94,38.17,59.15,1,,,,,,,,,,,,,,72,80,11.42,11.45,11.51,1.5,,,,,,,,,,,,,,,,"2,6,17,55,18,1,0,0,0","0,58,42,0,0",,,,,,119,,,,,,,,,,,,,,,,,,,,,,,,,,,,,,,,,,,,21.6,17,15,231,77,,1015,,,0,5,3,,1,0,I1.000|5:27-I1.000|5:13-I1.000|5:05-I1.000|5:14-I1.000|5:20-I1.000|5:17-I1.000|5:13-I1.000|5:10-I1.000|5:21-I1.000|5:11-I1.000|5:11-I1.000|5:31-I0.010|0:04,,Running,,,,"Polar M430",43,0,,0,168070,250480,30378,,,,,,,,,,,,,,,,,,,,,,,,,,,,,,,,,,,,,,,,,,,
5962813,ec1ec8af-590b-4329-9ce2-b218df995a61,1496873185,120,1548677769,,0,0,28.22,5298,5364,509,462,,,1,3.5,0.66,,,570,1133,,,,,,,,,1,,,,,,,,,,,,,,59,,,24.86,,,,145,107,,1,185,165,,,,,,,,,"41,22,13,10,6,3,4",,"51,33,11,3,2",,,,,,,,,,,,,,,,,,,,,,,,,,,,,,,,,,,,,,,,,,15,10,247,58,,1018,0,,1,3,3,,1,0,,,,,"Voeren Sint-Martens-Voeren Radfahren",,"Polar BEAT",,0,,0,168072,,30378,,,,,,,,,,,,,,,,,,,,,,,,,,,,,,,,,,,,,,,,,,"4,4,4,5,5",
5962814,8e232afd-2538-414c-beb8-d4553ba3d664,1497386304,120,1548677769,,0,0,6.97,2462,2651,0,3,,,1,0,0.03,,,,390,,,,,,,32.18,,1,,,,,,,,,,,,,,51,75,10.24,13.45,13.51,,,,,,,,,,,,,,,,,"53,2,2,2,3,3,4,28,3",,,,,,,113,,,,,,,,,,,,,,,,,,,,,,,,,,,,,,,,,,,,,19,9,4,62,,1019,,,0,5,3,,1,0,,,,,"Aachen Laufen",,"Polar BEAT",,0,,0,168070,250480,30378,,,,,,,,,,,,,,,,,,,,,,,,,,,,,,,,,,,,,,,,,,,
5962815,c83ec008-6e6a-4c14-a5aa-f8b501a44273,1461664644,120,1548677769,,0,0,1.28,384,384,,,,,0,,,,,,88,,,,,,,33.93,,1,,,,,,,,,,,,,,7,83,,12.05,,,,,,,,,,,,,,,,,,"0,1,3,45,51,0,0,0,0",,,,,,,120,,,,,,,,,,,,,,,,,,,,,,,,,,,,,,,,,,,,,,,,,,,,,,1,,,1,0,,,,,Laufen,,"Polar BEAT",,0,,0,168070,250480,30378,,,,,,,,,,,,,,,,,,,,,,,,,,,,,,,,,,,,,,,,,,,
5962816,de16730f-9137-4987-8693-c0535b385bbf,1462455981,120,1548677770,,0,0,6.18,1824,1824,107,107,,,1,2,0.59,,,404,424,,,,,,,39.54,,1,,,,,,,,,,,,,,37,80,12.56,12.36,12.98,,,,,,,,,,,,,,,,,"0,6,11,32,28,24,0,0,0",,,,,,,127,,,,,,,,,,,,,,,,,,,,,,,,,,,,,,,,,,,,,16,15,113,36,,1023,,,0,3,3,,1,0,,,,,"Aachen Laufen",,"Polar BEAT",,0,,0,168070,250480,30378,,,,,,,,,,,,,,,,,,,,,,,,,,,,,,,,,,,,,,,,,,4,
5962817,8ad794f4-aaec-49f6-b243-3d391e225fa3,1467061461,120,1548677770,,0,0,13.44,3626,3834,182,187,,,1,2.2,0.59,,,413,925,,,,,,,46.28,,1,,,,,,,,,,,,,,75,82,13.59,13.61,13.98,,,,,,,,,,,,,,,,,"2,1,3,11,30,43,7,3,0",,,,,,,136,,,,,,,,,,,,,,,,,,,,,,,,,,,,,,,,,,,,,16,3,286,91,,1019,0,,0,5,3,,1,0,,,,,"Aachen Laufen",,"Polar BEAT",,0,,0,168070,250480,30378,,,,,,,,,,,,,,,,,,,,,,,,,,,,,,,,,,,,,,,,,,4,
5962818,0fd38810-d833-43fd-8d46-b29b47a105d5,1536667772,120,1548677771,,0,0,7.9,1262,1267,128,181,,,1,2.2,0.61,1.45,0.94,635,160,108,159,,,,,,,1,,,,,,,,,,,,,,11,,,27.79,,6.6,-41.2,204,164,,1,272,234,,,,,,,,,"29,19,13,8,11,17,4","52,35,13,0,0","63,15,6,5,11",,,,,,,,,,,,,,,,,,,,,,,,,,,,,,,,,,,,,,,,,14.6,20,36,240,63,,,4,,0,11,3,,1,0,,,Cycling,,,,"Polar M430",43,0,,0,168072,,30378,,,,,,,,,,,,,,,,,,,,,,,,,,,,,,,,,,,,,,,,,,"5,5",
5962819,2cc639ac-213a-42e1-9a6f-8a4aabc88704,1405174219,120,1548677771,,0,0,2.06,559,738,0,2,,,1,0,0.02,,,,122,,,,,,,40.08,,1,,,,,,,,,,,,,,11,80,13.52,15,15.01,,,,,,,,,,,,,,,,,"22,2,2,7,9,13,17,17,13",,,,,,,138,,,,,,,,,,,,,,,,,,,,,,,,,,,,,,,,,,,,,17,4,266,94,,1014,5,,0,5,3,,1,0,,,,,"Samstagstraining 300er",,"Polar BEAT",,0,,0,168070,250480,30378,,,,,,,,,,,,,,,,,,,,,,,,,,,,,,,,,,,,,,,,,,,
5962820,de7feaeb-b601-4ad8-957c-62b82cefb298,1471032606,120,1548677771,,0,0,2.75,780,908,17,16,,,1,0,0.22,,,,190,,,,,,,39.21,,1,,,,,,,,,,,,,,16,79,12.76,12.76,12.88,,,,,,,,,,,,,,,,,"3,1,4,3,69,21,0,0,0",,,,,,,134,,,,,,,,,,,,,,,,,,,,,,,,,,,,,,,,,,,,,25,0,126,58,,1024,,,0,3,3,,1,0,,,,,"Naujac-sur-Mer Laufen",,"Polar BEAT",,0,,0,168070,250480,30378,,,,,,,,,,,,,,,,,,,,,,,,,,,,,,,,,,,,,,,,,,,
5962821,ff38c76d-06fe-482b-a67b-175c7af325f4,1430946641,120,1548677772,,0,0,14.79,3925,4028,223,208,,,1,2.5,0.66,,,510,1007,,,,,,,47.52,,1,,,,,,,,,,,,,,81,83,13.88,13.77,14.11,,,,,,,,,,,,,,,,,"1,1,2,8,32,42,10,4,0",,,,,,,136,,,,,,,,,,,,,,,,,,,,,,,,,,,,,,,,,,,,,11,11,221,75,,1014,0,,1,5,3,,1,0,,,,,"Aachen Laufen",,"Polar BEAT",,0,,0,168070,250480,30378,,,,,,,,,,,,,,,,,,,,,,,,,,,,,,,,,,,,,,,,,,"5,5",
5962822,cca3678a-5a6d-4336-8502-e650ca11c62b,1395508349,60,1548677773,,0,0,25,6000,6002,90,111,,,1,0,0.09,,0.95,,1271,159,171,,,,69.18,55.66,69.42,1,,,,,,,,,,,,,,184,84,15.01,15.06,15.11,-1.2,,,,,,,,,,,,,,,,"0,0,0,0,6,34,58,1,0","0,1,60,39,0",,,,,,149,,,,,,,,,,,,,,,,,,,,,,,,,,,,,,,,,,,,62,6,9,229,87,,,0,,0,6,3,,1,0,,,,,"Langer TDL",,"Polar BEAT",,0,,0,168070,250480,30378,,,,,,,,,,,,,,,,,,,,,,,,,,,,,,,,,,,,,,,,,,,
5962823,1e01f48a-32e4-440d-8d5c-3a3c6af7e018,1466258445,120,1548677773,,0,0,6.17,1968,1995,142,200,,,1,2.9,0.77,,,531,422,,,,,,,36.06,,1,,,,,,,,,,,,,,40,81,11.63,11.56,12.28,,,,,,,,,,,,,,,,,"15,7,17,22,29,8,2,0,0",,,,,,,116,,,,,,,,,,,,,,,,,,,,,,,,,,,,,,,,,,,,,15,7,243,90,,1017,5,,0,6,3,,1,0,,,,,"Aachen Laufen",,"Polar BEAT",,0,,0,168070,250480,30378,,,,,,,,,,,,,,,,,,,,,,,,,,,,,,,,,,,,,,,,,,"4,4",
5962824,63d90091-3423-4084-bf35-eec09f13ce2e,1496784429,120,1548677776,,0,0,1.8,583,583,25,28,,,1,0.7,0.45,,,,118,,,,,,,32.31,,1,,,,,,,,,,,,,,12,81,11.2,11.27,11.37,,,,,,,,,,,,,,,,,"9,7,16,49,19,0,0,0,0",,,,,,,114,,,,,,,,,,,,,,,,,,,,,,,,,,,,,,,,,,,,,13,11,231,68,,1007,0,,0,5,3,,1,0,,,,,"Aachen Laufen",,"Polar BEAT",,0,,0,168070,250480,30378,,,,,,,,,,,,,,,,,,,,,,,,,,,,,,,,,,,,,,,,,,,
5962825,1745a686-ff7c-4e85-9740-ebd2be5e71f0,1423990643,60,1548677777,,0,0,29.04,8383,8486,453,454,,,1,3.3,0.51,,,542,1985,,,,,,,45.41,,1,,,,,,,,,,,,,,174,84,12.81,12.76,13.26,,,,,,,,,,,,,,,,,"5,2,4,18,43,24,4,0,0",,,,,,,124,,,,,,,,,,,,,,,,,,,,,,,,,,,,,,,,,,,,,2,2,78,93,,1012,0,,0,3,3,,1,0,,,,,"Sehr langer DL",,"Polar BEAT",,0,,0,168070,250480,30378,,,,,,,,,,,,,,,,,,,,,,,,,,,,,,,,,,,,,,,,,,"4,5,5,5,5,5,5",
5962827,9e4a8246-333a-4463-ab38-52455131b20d,1547492625,60,1548677777,,0,0,0.13,32,34,2,0,,,1,0,0,,,,6,90,114,,,,,36.57,,1,,,,,,,,,,,,,,0,83,14.93,14.43,15.22,-0.9,,,,,,,,,,,,,,,,"0,0,0,9,22,25,34,9,0","50,50,0,0,0",,,,,,147,,,,,,,,,,,,,,,,,,,,,,,,,,,,,,,,,,,,0.1,3,5,190,93,,1019,0,315,1,5,3,,1,0,,,Running,,,,"Polar M430",43,0,,0,168070,250480,30378,,,,,,,,,,,,,,,,,,,,,,,,,,,,,,,,,,,,,,,,,,,
5962828,d0772786-737f-426d-97e4-a9936f176589,1534924793,120,1548677778,,0,0,10.03,2576,2579,36,43,,,1,0,0.12,1.13,0.97,,461,123,149,,,,88.1,48,88.42,1,,,,,,,,,,,,,,32,83,14.04,14.08,14.14,-5.4,,,,,,,,,,,,,,,,"0,0,0,3,27,48,22,0,0","2,94,4,0,0",,,,,,141,,,,,,,,,,,,,,,,,,,,,,,,,,,,,,,,,,,,12.3,18,0,,88,,,,,0,3,3,,1,0,I0.479|2:08-I9.555|40:54,,Running,,,,"Polar M430",43,0,,0,168070,250480,30378,,,,,,,,,,,,,,,,,,,,,,,,,,,,,,,,,,,,,,,,,,,
5962829,35d29581-1600-4d86-98eb-5f53aac9f3eb,1413569689,120,1548677778,,0,0,13.86,4128,4155,257,258,,,1,3.1,0.58,,,320,929,,,,,,,41.35,,1,,,,,,,,,,,,,,85,81,12.43,12.88,13.45,,,,,,,,,,,,,,,,,"10,1,6,17,32,21,13,1,0",,,,,,,124,,,,,,,,,,,,,,,,,,,,,,,,,,,,,,,,,,,,,15,5,214,83,,1017,0,,1,5,3,,1,0,,,,,"Lockerer DL",,"Polar BEAT",,0,,0,168070,250480,30378,,,,,,,,,,,,,,,,,,,,,,,,,,,,,,,,,,,,,,,,,,4,
5962830,239523f1-9dd3-488c-8f97-50d56743b6e8,1468068064,120,1548677779,,0,0,8.69,2474,2638,210,209,,,1,3.1,0.67,,,547,592,,,,,,,42.14,,1,,,,,,,,,,,,,,51,81,13.24,13,13.86,,,,,,,,,,,,,,,,,"9,8,8,13,19,29,14,0,0",,,,,,,130,,,,,,,,,,,,,,,,,,,,,,,,,,,,,,,,,,,,,22,8,244,66,,1021,6,,0,5,3,,1,0,,,,,"Aachen Laufen",,"Polar BEAT",,0,,0,168070,250480,30378,,,,,,,,,,,,,,,,,,,,,,,,,,,,,,,,,,,,,,,,,,"4,5",
5962831,0c5e97ef-d05f-4c83-b0f1-6e754fc3f976,1478282783,60,1548677779,,0,0,13.19,3774,3819,192,198,,,1,2.3,0.63,,,391,896,,,,,,,43.16,,1,,,,,,,,,,,,,,78,82,12.81,12.67,13.02,,,,,,,,,,,,,,,,,"1,3,3,17,55,22,0,0,0",,,,,,,128,,,,,,,,,,,,,,,,,,,,,,,,,,,,,,,,,,,,,8,7,191,76,,1010,0,,1,5,3,,1,0,,,,,"Aachen Laufen",,"Polar BEAT",,0,,0,168070,250480,30378,,,,,,,,,,,,,,,,,,,,,,,,,,,,,,,,,,,,,,,,,,4,
5962832,,1548421980,60,1548677779,,0,0,2,600,600,,,,,0,,,,,,147,,,,,,,35.65,,1,,,,,,,,,,,,,,12,,,,,,,,,,,,,,,,,,,,,,,,,,,,,,,,,,,,,,,,,,,,,,,,,,,,,,,,,,,,,,,,,,,,,,,,,,1,,,0,0,,,,,,,"no device name available",,0,,0,168070,250480,30378,,,,,,,,,,,,,,,,,,,,,,,,,,,,,,,,,,,,,,,,,,,
5962833,5a3bf547-e804-40cb-80f0-618ae822c89c,1532243842,120,1548677780,,0,0,3.96,1693,1693,8,9,,,1,0,0.03,,,,278,119,153,,,,48.57,24.67,48.68,1,,,,,,,,,,,,,,18,82,8.44,8.43,8.45,2.8,,,,,,,,,,,,,,,,"95,2,1,1,1,0,0,0,0","2,93,6,0,0",,,,,,86,,,,,,,,,,,,,,,,,,,,,,,,,,,,,,,,,,,,11.2,,,,,,,,,0,1,3,,1,0,I1.000|7:21-I1.000|7:03-I1.000|7:01-I0.966|6:50,,Running,,,,"Polar M430",43,0,,0,168070,250480,30378,,,,,,,,,,,,,,,,,,,,,,,,,,,,,,,,,,,,,,,,,,,
5962834,de996750-ec47-413f-8a3d-fe9cd4a99aa5,1437422714,120,1548677780,,0,0,1.09,374,374,12,18,,,1,0.4,0.37,,,,73,,,,,,,28.6,,1,,,,,,,,,,,,,,7,82,10.54,10.58,10.79,,,,,,,,,,,,,,,,,"3,29,39,27,2,0,0,0,0",,,,,,,107,,,,,,,,,,,,,,,,,,,,,,,,,,,,,,,,,,,,,22,13,225,86,,1013,,,0,5,3,,1,0,,,,,"Aachen Laufen",,"Polar BEAT",,0,,0,168070,250480,30378,,,,,,,,,,,,,,,,,,,,,,,,,,,,,,,,,,,,,,,,,,,
5962835,d95cc82f-33bd-447a-9a55-b628be6265b8,1503427193,120,1548677780,,0,0,9.87,2783,2798,116,119,,,1,0,0.16,0.81,0.67,,593,143,184,,,,65.45,42.98,66.38,1,,,,,,,,,,,,,,62,81,12.86,14.33,14.47,24.9,,,,,,,,,,,,,,,,"23,1,6,18,7,2,16,27,1","1,40,42,15,1",,,,,,131,,,,,,,,,,,,,,,,,,,,,,,,,,,,,,,,,,,,55.7,23,13,40,53,,1018,,,0,5,1,,1,0,I1.017|3:42-I1.031|3:37-I0.198|1:57-I1.019|3:33-I0.217|1:59-I1.021|3:28-I0.221|2:17-I0.526|1:40-I0.091|0:59-I0.519|1:39-I0.098|1:01-I0.517|1:40-I0.104|1:02-I0.522|1:38-I0.161|2:41-I2.602|13:48,,Running,,,,"Polar M430",43,0,,0,168070,250480,30378,,,,,,,,,,,,,,,,,,,,,,,,,,,,,,,,,,,,,,,,,,,
5962836,b1aff012-143b-463a-a743-3a7e38c21205,1533230068,120,1548677781,,0,0,9.4,1166,1167,37,35,,,1,0,0.17,1.84,,,225,134,158,,,,,,,1,,,,,,,,,,,,,,22,,,29.59,,11.7,-5.9,179,155,,1,196,176,,,,,,,,,"1,3,8,36,49,2,2","18,20,62,0,0","41,45,3,0,12",,,,,,,,,,,,,,,,,,,,,,,,,,,,,,,,,,,,,,,,,25.4,32,10,348,38,,,,,0,3,3,,1,0,,,Cycling,,,,"Polar M430",43,0,,0,168072,,30378,,,,,,,,,,,,,,,,,,,,,,,,,,,,,,,,,,,,,,,,,,,
5962837,956220cc-b285-46b4-9cae-82f551eea113,1405686339,120,1548677781,,0,0,13.22,3780,3796,171,172,,,1,1.6,0.54,,,320,894,,,,,,,43.21,,1,,,,,,,,,,,,,,78,81,12.84,13.04,13.2,,,,,,,,,,,,,,,,,"8,2,5,13,23,42,6,0,0",,,,,,,130,,,,,,,,,,,,,,,,,,,,,,,,,,,,,,,,,,,,,30,5,129,47,,1016,5,,0,5,3,,1,0,,,,,"Lockerer DL",,"Polar BEAT",,0,,0,168070,250480,30378,,,,,,,,,,,,,,,,,,,,,,,,,,,,,,,,,,,,,,,,,,"5,5",
5962838,b1c3121c-f2a6-48ef-bc60-baec56dca22b,1524913064,120,1548677782,,0,0,18.57,5404,5404,89,86,,,1,0,0.12,1.11,0.95,,1385,156,171,,,,56.01,43.49,56.35,1,,,,,,,,,,,,,,155,82,12.42,12.49,12.59,1.5,,,,,,,,,,,,,,,,"0,2,8,24,52,10,3,0,0","0,3,71,26,0",,,,,,126,,,,,,,,,,,,,,,,,,,,,,,,,,,,,,,,,,,,59.8,16,3,230,55,,,,,0,3,3,,1,0,I1.000|4:04-I1.000|4:54-I1.000|5:03-I1.000|5:01-I1.000|4:53-I1.000|5:04-I1.000|4:43-I1.000|4:52-I1.000|4:53-I1.000|4:42-I1.000|4:39-I1.000|4:54-I1.000|4:38-I1.000|4:44-I1.000|4:41-I1.000|4:32-I1.000|5:28-I1.000|5:20-I0.573|2:58,,Running,,,,"Polar M430",43,0,,0,168070,250480,30378,,,,,,,,,,,,,,,,,,,,,,,,,,,,,,,,,,,,,,,,,,,
5962839,b0001113-efdc-4ed4-a331-9d9c91be6e7c,1411315944,120,1548677783,,0,0,5,1523,1556,186,186,,,1,3.6,0.8,,,701,331,,,,,,,37.62,,1,,,,,,,,,,,,,,31,81,12.87,12.04,13.78,,,,,,,,,,,,,,,,,"2,7,19,33,23,13,3,0,0",,,,,,,122,,,,,,,,,,,,,,,,,,,,,,,,,,,,,,,,,,,,,16,5,294,76,,,2,,0,5,3,,1,0,,,,,Auslaufen,,"Polar BEAT",,0,,0,168070,250480,30378,,,,,,,,,,,,,,,,,,,,,,,,,,,,,,,,,,,,,,,,,,3,
5962840,29c95536-97bc-4167-9b2c-8344023edfec,1501527331,120,1548677783,,0,0,12.73,3295,3300,192,193,,,1,2.5,0.51,1.03,1.01,439,822,157,175,,,,64.15,48.37,65.34,1,,,,,,,,,,,,,,98,83,14.27,14.18,14.54,-2.1,,,,,,,,,,,,,,,,"0,2,5,13,16,28,36,0,0","0,9,53,37,0",,,,,,140,,,,,,,,,,,,,,,,,,,,,,,,,,,,,,,,,,,,71.3,24,4,240,47,,1013,1,,0,5,3,,1,0,I1.000|4:49-I1.000|4:31-I1.000|4:29-I1.000|5:10-I1.000|4:38-I1.000|4:04-I1.000|4:12-I1.000|3:51-I1.000|3:47-I1.000|3:51-I1.000|3:56-I1.000|4:20-I0.734|3:23,,Running,,,,"Polar M430",43,0,,0,168070,250480,30378,,,,,,,,,,,,,,,,,,,,,,,,,,,,,,,,,,,,,,,,,,4,
5962841,197e9ad5-9952-43c3-9fa2-050470cced98,1508349503,120,1548677784,,0,0,5.28,1700,1709,103,108,,,1,2.2,0.81,1.86,0.8,,408,157,188,,,,49,35.34,50.12,1,,,,,,,,,,,,,,53,82,11.14,13.52,14.4,24.6,,,,,,,,,,,,,,,,"46,3,3,3,4,4,6,27,4","0,18,32,40,10",,,,,,114,,,,,,,,,,,,,,,,,,,,,,,,,,,,,,,,,,,,70.7,19,9,230,68,,1012,,,0,2,1,,1,0,I0.085|0:35-I0.306|0:58-I0.103|0:56-I0.307|0:59-I0.099|0:52-I0.304|0:59-I0.106|0:57-I0.311|0:59-I0.103|0:44-I0.306|0:59-I0.099|0:54-I0.304|0:59-I0.103|0:55-I0.302|0:58-I0.216|1:41-I0.304|0:55-I0.221|1:42-I0.302|0:54-I0.215|1:39-I0.308|0:50-I0.254|4:54-I0.516|1:36-I0.094|1:33,,Running,,,,"Polar M430",43,0,,0,168070,250480,30378,,,,,,,,,,,,,,,,,,,,,,,,,,,,,,,,,,,,,,,,,,,
5962842,d5fea34d-edf3-4cca-be99-d9481f9c0772,1413118085,120,1548677785,,0,0,29,8711,8853,465,461,,,1,3.2,0.58,1.19,1.06,361,1316,147,172,,,,58.39,43.34,59.56,1,,,,,,,,,,,,,,203,82,12.29,12.63,13.06,-11,,,,,,,,,,,,,,,,"11,5,9,18,24,25,8,1,0","0,24,69,7,0",,,,,,122,,,,,,,,,,,,,,,,,,,,,,,,,,,,,,,,,,,,42.4,16,5,96,80,,1014,2,,0,5,3,,1,0,,,,,"Langer langsamer DL",,"Polar BEAT",,0,,0,168070,250480,30378,,,,,,,,,,,,,,,,,,,,,,,,,,,,,,,,,,,,,,,,,,"4,4,4,5",
5962843,09d2b444-d0cc-4254-957a-66b1354ce97d,1336309613,120,1548677788,,0,0,25.03,8778,9180,396,336,,,1,2.6,0.54,,,264,1738,,,,,,,35.73,,1,,,,,,,,,,,,,,182,,10.57,11.7,12.15,,,,,,,,,,,,,,,,,"24,8,13,17,18,12,5,2,1",,,,,,,,,,,,,,,,,,,,,,,,,,,,,,,,,,,,,,,,,,,,7,8,38,93,,1010,4,,0,6,3,,1,0,,,,,,,"Polar BEAT",,0,,0,168070,250480,30378,,,,,,,,,,,,,,,,,,,,,,,,,,,,,,,,,,,,,,,,,,"4,5",
5962844,8e693d41-c836-4f34-964c-0e441d7873fc,1392201455,60,1548677788,,0,0,10,2505,2585,156,139,,,1,1.7,0.46,1.16,0.95,352,526,162,179,,,,63.86,49.41,65.23,1,,,,,,,,,,,,,,82,87,14.7,14.69,15.21,-6.2,,,,,,,,,,,,,,,,"4,1,1,4,12,33,36,8,0","0,5,29,66,0",,,,,,138,,,,,,,,,,,,,,,,,,,,,,,,,,,,,,,,,,,,67,4,22,210,82,,1010,,,0,5,3,,1,0,,,,,"Zügiger DL 10k Lousberg gesteigert",,"Polar BEAT",,0,,0,168070,250480,30378,,,,,,,,,,,,,,,,,,,,,,,,,,,,,,,,,,,,,,,,,,5,
5962845,,1542205560,60,1548677788,,0,0,1.5,3600,3600,,,,,0,,,,,,500,,,,,,,,,1,,,,,,,,,,,,,,40,,,,,,,,,,,,,,,,,,,,,,,,,,,,,,,,,,,,,,,,,,,,,,,,,,,,,,,,,,,,,,,,,,,,,,,,,,1,,,0,0,,,,,,,"no device name available",,0,,0,168075,,30378,,,,,,,,,,,,,,,,,,,,,,,,,,,,,,,,,,,,,,,,,,,
5962846,14d8c9d2-26ef-4e55-ba1f-17421b2afa69,1416427724,60,1548677789,,0,0,15.01,3876,3876,167,183,,,1,1.9,0.51,,,429,1000,,,,,,,49.11,,1,,,,,,,,,,,,,,80,84,14.11,14.15,14.42,,,,,,,,,,,,,,,,,"0,0,1,7,29,45,12,6,0",,,,,,,138,,,,,,,,,,,,,,,,,,,,,,,,,,,,,,,,,,,,,5,1,86,97,,1024,0,,1,5,3,,1,0,,,,,"Gesteigerter DL",,"Polar BEAT",,0,,0,168070,250480,30378,,,,,,,,,,,,,,,,,,,,,,,,,,,,,,,,,,,,,,,,,,4,
5962847,b8612338-67a1-4a24-8e60-1bb0daec29c9,1483394755,60,1548677789,,0,0,4.7,1579,1579,52,52,,,1,0.7,0.51,,,,325,,,,,,,33.36,,1,,,,,,,,,,,,,,32,78,10.86,10.94,11.12,,,,,,,,,,,,,,,,,"13,18,25,25,21,0,0,0,0",,,,,,,114,,,,,,,,,,,,,,,,,,,,,,,,,,,,,,,,,,,,,0,4,252,97,,1027,0,,1,5,3,,1,0,,,,,"Aachen Laufen",,"Polar BEAT",,0,,0,168070,250480,30378,,,,,,,,,,,,,,,,,,,,,,,,,,,,,,,,,,,,,,,,,,,
5962848,265c3c99-dd3b-4cdb-b689-45e3fc3879e4,1363803240,60,1548677799,1606294736,0,0,15.15,4380,86195,20,21,,,1,0,0,,,,1071,,,,,,,43.11,,1,,,,,,,,,,,,,,108,,0.63,5.95,5.96,,,,,,,,,,,,,,,,,"95,0,1,1,2,1,0,0,0",,,,,,,,,,,,,,,,,,,,,,,,,,,,,,,,,,,,,,,,,,,,6,12,242,76,,1008,0,,1,5,3,,1,0,,,,,,,"Polar BEAT",,0,,0,168070,250480,30378,,,,,,,,,,,,,,,,,,,,,,,,,,,,,,,,,,,,,,,,,,,
5962849,00cb4d79-5197-4189-8821-4fdc817c1b1e,1395661373,60,1548677801,,0,0,16.32,4444,4559,174,175,,,1,1.4,0.42,1.03,1.03,379,839,151,170,,,,63.59,46.49,64.42,1,,,,,,,,,,,,,,113,83,13.48,13.29,13.62,0.5,,,,,,,,,,,,,,,,"1,1,2,9,36,48,3,0,0","0,14,71,15,0",,,,,,133,,,,,,,,,,,,,,,,,,,,,,,,,,,,,,,,,,,,43.4,5,2,0,89,,1015,3,,0,5,3,,1,0,,,,,"Lockerer DL ",,"Polar BEAT",,0,,0,168070,250480,30378,,,,,,,,,,,,,,,,,,,,,,,,,,,,,,,,,,,,,,,,,,5,
5962850,c851e8a6-a901-45a3-beb8-32134a8f9608,1370880913,120,1548677803,,0,0,18.18,4833,4911,279,279,,,1,2.3,0.46,,,464,1240,,,,,,,48.21,,1,,,,,,,,,,,,,,100,,13.87,13.72,14.24,,,,,,,,,,,,,,,,,"3,2,6,11,24,29,21,4,0",,,,,,,,,,,,,,,,,,,,,,,,,,,,,,,,,,,,,,,,,,,,17,4,292,63,,1015,4,,0,5,3,,1,0,,,,,,,"Polar BEAT",,0,,0,168070,250480,30378,,,,,,,,,,,,,,,,,,,,,,,,,,,,,,,,,,,,,,,,,,"5,5,5",
5962851,8ac5d476-e4d1-4bdd-9d0e-bff5f3965870,1450604166,60,1548677804,,0,0,7.19,2395,2503,107,107,,,1,1.7,0.5,,,403,489,,,,,,,34.58,,1,,,,,,,,,,,,,,49,81,11.22,10.94,11.35,,,,,,,,,,,,,,,,,"10,10,21,51,8,0,0,0,0",,,,,,,111,,,,,,,,,,,,,,,,,,,,,,,,,,,,,,,,,,,,,10,17,188,81,,1017,,,0,5,3,,1,0,,,,,"Aachen Laufen",,"Polar BEAT",,0,,0,168070,250480,30378,,,,,,,,,,,,,,,,,,,,,,,,,,,,,,,,,,,,,,,,,,"5,5",
5962852,32271573-66f1-4d78-aad7-6bd9574b8af5,1522859275,120,1548677804,,0,0,10.87,1570,1590,46,36,,,1,0,0.08,,,,298,135,169,,,,,,,1,,,,,,,,,,,,,,29,,,26.97,,9.1,-25.5,138,122,,1,170,153,,,,,,,,,"6,13,32,22,25,2,0","1,62,25,12,0","64,25,0,1,10",,,,,,,,,,,,,,,,,,,,,,,,,,,,,,,,,,,,,,,,,41.3,12,8,213,81,,,2,,0,6,3,,1,0,,,Cycling,,,,"Polar M430",43,0,,0,168072,,30378,,,,,,,,,,,,,,,,,,,,,,,,,,,,,,,,,,,,,,,,,,,
5962853,2995c3c0-26ac-4ca9-9d39-22cdea5493bd,1348607617,120,1548677805,,0,0,7.52,2430,2826,40,38,,,1,0,0.11,1.31,0.94,,501,142,210,,,,55.81,35.95,56.19,1,,,,,,,,,,,,,,54,,11.25,13.29,13.65,33.6,,,,,,,,,,,,,,,,"28,7,9,11,12,16,8,5,4","3,33,52,8,4",,,,,,,,,,,,,,,,,,,,,,,,,,,,,,,,,,,,,,,,,,59.8,14,5,347,77,,1004,0,,1,5,3,,1,0,,,,,,,"Polar BEAT",,0,,0,168070,250480,30378,,,,,,,,,,,,,,,,,,,,,,,,,,,,,,,,,,,,,,,,,,,
5962854,9f2e6b87-d657-49a1-9c59-7c0795fb0da1,1393438001,60,1548677805,,0,0,9.84,2939,3028,125,135,,,1,1.5,0.49,1.13,0.99,285,498,146,210,,,,59.33,40.17,60.19,1,,,,,,,,,,,,,,71,80,12.23,12.26,12.6,-12,,,,,,,,,,,,,,,,"4,3,5,23,55,8,2,0,0","0,36,53,6,5",,,,,,126,,,,,,,,,,,,,,,,,,,,,,,,,,,,,,,,,,,,95.6,8,5,263,72,,1019,0,,1,5,3,,1,0,,,,,"Regenerativer DL",,"Polar BEAT",,0,,0,168070,250480,30378,,,,,,,,,,,,,,,,,,,,,,,,,,,,,,,,,,,,,,,,,,4,
5962855,622a491a-a8dd-44f2-91c9-6c4446393732,1467924123,120,1548677806,,0,0,2.95,764,765,0,1,,,1,0,0.07,,,,185,,,,,,,43.8,,1,,,,,,,,,,,,,,15,84,13.99,15.54,15.54,,,,,,,,,,,,,,,,,"26,1,3,7,5,6,8,43,1",,,,,,,138,,,,,,,,,,,,,,,,,,,,,,,,,,,,,,,,,,,,,20,1,14,69,,1019,0,,0,5,3,,1,0,,,,,"Aachen Laufen",,"Polar BEAT",,0,,0,168070,250480,30378,,,,,,,,,,,,,,,,,,,,,,,,,,,,,,,,,,,,,,,,,,,
5962856,bede1bb1-4693-487c-b223-ea1e62d255f5,1445175601,120,1548677806,,0,0,16.3,5462,5515,228,229,,,1,2.4,0.56,,,381,1099,,,,,,,36.51,,1,,,,,,,,,,,,,,113,82,11.05,11.02,11.26,,,,,,,,,,,,,,,,,"14,9,27,35,10,4,1,0,0",,,,,,,109,,,,,,,,,,,,,,,,,,,,,,,,,,,,,,,,,,,,,9,2,325,75,,1020,,,0,5,3,,1,0,,,,,"Aachen Laufen",,"Polar BEAT",,0,,0,168070,250480,30378,,,,,,,,,,,,,,,,,,,,,,,,,,,,,,,,,,,,,,,,,,"4,5",
5962857,92780ef8-9f82-4250-b139-8afe7888c812,1402311477,120,1548677807,,0,0,13.64,3631,3631,164,164,,,1,1.7,0.56,,,434,922,,,,,,,47.06,,1,,,,,,,,,,,,,,75,83,13.72,13.64,13.88,,,,,,,,,,,,,,,,,"1,0,1,7,28,55,7,0,0",,,,,,,136,,,,,,,,,,,,,,,,,,,,,,,,,,,,,,,,,,,,,26,4,131,69,,1016,5,,0,5,3,,1,0,,,,,,,"Polar BEAT",,0,,0,168070,250480,30378,,,,,,,,,,,,,,,,,,,,,,,,,,,,,,,,,,,,,,,,,,5,
5962858,dcacd1c2-cb98-44b1-ae9f-8d504dc2b559,1350432171,120,1548677808,,0,0,,16773,16773,,,,,0,,,,,,3588,53,122,,,,,,,1,,,,,,,,,,,,,,2,,,,,,,,,,,,,,,,,,,,,,"100,0,0,0,0",,,,,,,,,,,,,,,,,,,,,,,,,,,,,,,,,,,,,,,,,,1,,,,,,,,,,1,,,1,0,,,,,,,"Polar BEAT",,0,,0,168072,,30378,,,,,,,,,,,,,,,,,,,,,,,,,,,,,,,,,,,,,,,,,,,
5962859,61919cae-335b-4b61-aea1-af2bd001cd5f,1460491301,120,1548677809,,0,0,15.39,4357,5065,177,184,,,1,1.5,0.53,,,,1033,,,,,,,44.23,,1,,,,,,,,,,,,,,90,81,12.87,14.18,14.45,,,,,,,,,,,,,,,,,"16,2,3,4,19,21,21,14,0",,,,,,,131,,,,,,,,,,,,,,,,,,,,,,,,,,,,,,,,,,,,,9,3,282,92,,1009,0,,1,6,3,,1,0,,,,,"Aachen Laufen",,"Polar BEAT",,0,,0,168070,250480,30378,,,,,,,,,,,,,,,,,,,,,,,,,,,,,,,,,,,,,,,,,,,
5962860,aba0f952-d483-4d39-b69d-1262045afd77,1470562640,120,1548677810,,0,0,13,3974,4107,199,194,,,1,2.3,0.58,,,372,902,,,,,,,39.92,,1,,,,,,,,,,,,,,82,81,12.04,11.89,12.25,,,,,,,,,,,,,,,,,"4,3,8,42,36,5,1,0,0",,,,,,,121,,,,,,,,,,,,,,,,,,,,,,,,,,,,,,,,,,,,,18,8,226,78,,1029,2,,0,3,3,,1,0,,,,,"Aachen Laufen",,"Polar BEAT",,0,,0,168070,250480,30378,,,,,,,,,,,,,,,,,,,,,,,,,,,,,,,,,,,,,,,,,,4,
5962861,e9bd5b21-89d8-4d5d-9c06-7ee867ed0bdf,1397330333,120,1548677810,,0,0,3.3,1197,1205,13,12,,,1,0,0.14,1.37,0.97,,190,142,210,,,,48.39,29.79,48.65,1,,,,,,,,,,,,,,25,84,9.95,10.71,10.84,18.8,,,,,,,,,,,,,,,,"27,7,10,31,24,1,0,0,0","0,48,48,1,4",,,,,,98,,,,,,,,,,,,,,,,,,,,,,,,,,,,,,,,,,,,46.1,11,20,239,85,,1015,0,,0,5,3,,1,0,,,,,Auslaufen,,"Polar BEAT",,0,,0,168070,250480,30378,,,,,,,,,,,,,,,,,,,,,,,,,,,,,,,,,,,,,,,,,,,
5962862,be725534-9eab-432b-835f-4130d3967b0b,1526061959,120,1548677811,,0,0,15.67,4142,4148,49,53,,,1,0,0.03,,,,1055,155,174,,,,63.64,47.96,63.87,1,,,,,,,,,,,,,,117,82,13.64,13.78,13.83,5.3,,,,,,,,,,,,,,,,"0,1,2,9,27,43,17,0,0","1,8,52,39,0",,,,,,138,,,,,,,,,,,,,,,,,,,,,,,,,,,,,,,,,,,,69.3,21,9,14,49,,1016,,,0,3,3,,1,0,I15.362|1:07:40-I0.322|1:28,,Running,,,,"Polar M430",43,0,,0,168070,250480,30378,,,,,,,,,,,,,,,,,,,,,,,,,,,,,,,,,,,,,,,,,,,
5962863,d38c3e0d-ce93-4197-a4ff-6cde2c46c332,1494274081,120,1548677811,,0,0,0.99,286,301,,,,,0,,,,,,69,,,,,,,34.39,,1,,,,,,,,,,,,,,5,79,,12.37,,,,,,,,,,,,,,,,,,"0,5,4,33,49,10,0,0,0",,,,,,,131,,,,,,,,,,,,,,,,,,,,,,,,,,,,,,,,,,,,,,,,,,,,,,1,,,1,0,,,,,Laufen,,"Polar BEAT",,0,,0,168070,250480,30378,,,,,,,,,,,,,,,,,,,,,,,,,,,,,,,,,,,,,,,,,,,
5962864,,1472465496,120,1548677811,,0,0,7.5,0,0,,,,,0,,,,,,,,,,,,,,,1,,,,,,,,,,,,,,0,,,,,,,,,,,,,,,,,,,,,,,,,,,,,,,,,,,,,,,,,,,,,,,,,,,,,,,,,,,,,,,,,,,,,,,,,,1,,,0,0,,,,,"locker DL ",,"Polar BEAT",,0,,0,168070,250480,30378,,,,,,,,,,,,,,,,,,,,,,,,,,,,,,,,,,,,,,,,,,,
5962865,eee70f28-de69-4295-83ff-0a35f4980a0f,1541235382,60,1548677811,,0,0,1.09,401,403,5,8,,,1,0,0.18,1.15,0.89,,86,137,159,,,,49.74,26.41,49.85,1,,,,,,,,,,,,,,7,85,9.79,9.91,9.96,2.7,,,,,,,,,,,,,,,,"15,35,49,1,0,0,0,0,0","6,43,51,0,0",,,,,,96,,,,,,,,,,,,,,,,,,,,,,,,,,,,,,,,,,,,14.9,6,20,20,87,,1028,0,268,0,5,3,,1,0,I1.000|6:03-I0.101|0:40,,Running,,,,"Polar M430",43,0,,0,168070,250480,30378,,,,,,,,,,,,,,,,,,,,,,,,,,,,,,,,,,,,,,,,,,,
5962866,fbaecf7a-1b70-4f91-896b-98e91e256d2b,1466696522,120,1548677811,,0,0,1.46,450,451,15,43,,,1,1.3,0.72,,,,101,,,,,,,33.41,,1,,,,,,,,,,,,,,9,81,11.59,12.28,11.89,,,,,,,,,,,,,,,,,"14,4,3,12,60,7,0,0,0",,,,,,,120,,,,,,,,,,,,,,,,,,,,,,,,,,,,,,,,,,,,,31,7,197,56,,1016,6,,0,3,3,,1,0,,,,,"Voeren Sint-Martens-Voeren Laufen",,"Polar BEAT",,0,,0,168070,250480,30378,,,,,,,,,,,,,,,,,,,,,,,,,,,,,,,,,,,,,,,,,,,
5962867,ddeff1d7-ee7b-484b-b902-79b4001d6718,1461186346,120,1548677812,,0,0,5.19,1723,1887,120,120,,,1,1.8,0.62,,,,332,,,,,,,34.04,,1,,,,,,,,,,,,,,35,76,11.06,13.55,14.21,,,,,,,,,,,,,,,,,"34,0,3,10,14,21,2,10,5",,,,,,,119,,,,,,,,,,,,,,,,,,,,,,,,,,,,,,,,,,,,,11,7,53,54,,1028,0,,1,3,3,,1,0,,,,,"Aachen Laufen",,"Polar BEAT",,0,,0,168070,250480,30378,,,,,,,,,,,,,,,,,,,,,,,,,,,,,,,,,,,,,,,,,,,
5962868,d3865854-92b8-46f8-bdfc-681098884bd1,1439496621,120,1548677812,,0,0,3.34,995,995,63,62,,,1,1.6,0.58,,,430,224,,,,,,,37.63,,1,,,,,,,,,,,,,,20,82,12.47,12.16,12.94,,,,,,,,,,,,,,,,,"0,4,15,32,34,12,4,0,0",,,,,,,123,,,,,,,,,,,,,,,,,,,,,,,,,,,,,,,,,,,,,26,5,67,65,,1009,,,0,5,3,,1,0,,,,,"Aachen Laufen",,"Polar BEAT",,0,,0,168070,250480,30378,,,,,,,,,,,,,,,,,,,,,,,,,,,,,,,,,,,,,,,,,,4,
5962869,26d88c58-dd6e-4ce6-a741-8e16aa4d1b04,1413032906,120,1548677812,,0,0,3.31,1027,1027,68,68,,,1,1.6,0.57,,,406,218,,,,,,,35.85,,1,,,,,,,,,,,,,,21,81,12,11.82,12.45,,,,,,,,,,,,,,,,,"11,12,11,28,22,10,6,0,0",,,,,,,119,,,,,,,,,,,,,,,,,,,,,,,,,,,,,,,,,,,,,17,5,184,83,,1013,2,,0,5,3,,1,0,,,,,Samstagstraining,,"Polar BEAT",,0,,0,168070,250480,30378,,,,,,,,,,,,,,,,,,,,,,,,,,,,,,,,,,,,,,,,,,4,
5962870,b88bd31c-4edb-4c12-87d6-ba0583807474,1444569103,120,1548677813,,0,0,14.51,3990,4084,177,203,,,1,2.1,0.53,,,352,994,,,,,,,45.54,,1,,,,,,,,,,,,,,82,84,13.25,13.24,13.47,,,,,,,,,,,,,,,,,"2,2,3,6,39,46,2,0,0",,,,,,,130,,,,,,,,,,,,,,,,,,,,,,,,,,,,,,,,,,,,,11,12,72,63,,1016,,,0,3,3,,1,0,,,,,"Aachen Laufen",,"Polar BEAT",,0,,0,168070,250480,30378,,,,,,,,,,,,,,,,,,,,,,,,,,,,,,,,,,,,,,,,,,4,
5962871,9200c065-aaf5-499c-ab38-dfbac5724248,1367525423,120,1548677813,,0,0,3.56,1543,1560,83,81,,,1,1.6,0.57,,,459,246,,,,,,,24.11,,1,,,,,,,,,,,,,,32,,8.54,11.44,12.21,,,,,,,,,,,,,,,,,"38,1,3,13,21,24,1,0,0",,,,,,,,,,,,,,,,,,,,,,,,,,,,,,,,,,,,,,,,,,,,15,7,40,65,,1018,0,,0,5,3,,1,0,,,,,,,"Polar BEAT",,0,,0,168070,250480,30378,,,,,,,,,,,,,,,,,,,,,,,,,,,,,,,,,,,,,,,,,,5,
5962872,4e340ad4-acb3-4417-8203-c98dbd8e061d,1534353742,120,1548677813,,0,0,15.11,4193,4200,37,36,,,1,0,0.01,1.18,0.91,,960,143,172,,,,66.76,45.2,66.97,1,,,,,,,,,,,,,,90,81,13.01,13.07,13.14,14.4,,,,,,,,,,,,,,,,"0,0,1,15,54,24,5,1,0","0,36,61,3,0",,,,,,133,,,,,,,,,,,,,,,,,,,,,,,,,,,,,,,,,,,,43.4,26,7,297,47,,1019,,,0,5,3,,1,0,I1.000|4:40-I1.000|4:27-I1.000|4:34-I1.000|4:48-I1.000|4:34-I1.000|4:29-I1.000|4:37-I1.000|4:31-I1.000|4:45-I1.000|4:47-I1.000|4:47-I1.000|4:51-I1.000|4:52-I1.000|3:51-I1.000|4:53-I0.106|0:34,,Running,,,,"Polar M430",43,0,,0,168070,250480,30378,,,,,,,,,,,,,,,,,,,,,,,,,,,,,,,,,,,,,,,,,,,
5962873,2a51f615-3969-4fbb-b0ea-806eaf4a52ac,1453488490,60,1548677814,,0,0,3,915,947,56,59,,,1,0.5,0.34,,,,214,,,,,,,36.31,,1,,,,,,,,,,,,,,19,79,12.13,11.91,12.31,,,,,,,,,,,,,,,,,"3,5,11,30,43,7,0,0,0",,,,,,,125,,,,,,,,,,,,,,,,,,,,,,,,,,,,,,,,,,,,,2,18,174,85,,1023,,,1,5,3,,1,0,,,,,"Aachen Laufen",,"Polar BEAT",,0,,0,168070,250480,30378,,,,,,,,,,,,,,,,,,,,,,,,,,,,,,,,,,,,,,,,,,,
5962874,,1431872940,120,1548677814,,0,0,15.3,0,0,,,,,0,,,,,,515,,,,,,,,,1,,,,,,,,,,,,,,0,,,,,,,,,,,,,,,,,,,,,,,,,,,,,,,,,,,,,,,,,,,,,,,,,,,,,,,,,,,,,,,,,,,,,,,,,,1,,,0,0,,,,,"Sorpe rum",,"Polar BEAT",,0,,0,168070,250480,30378,,,,,,,,,,,,,,,,,,,,,,,,,,,,,,,,,,,,,,,,,,,
5962875,1d3b6be7-7789-42ca-b451-c6270f9f6e8d,1473360120,120,1548677816,,0,0,0.97,306,306,25,23,,,1,1.6,0.79,,,,66,,,,,,,31.06,,1,,,,,,,,,,,,,,6,83,11.78,11.57,12.26,,,,,,,,,,,,,,,,,"2,8,17,48,25,0,0,0,0",,,,,,,115,,,,,,,,,,,,,,,,,,,,,,,,,,,,,,,,,,,,,26,7,260,50,,1012,0,,0,3,3,,1,0,,,,,"Aachen Laufen",,"Polar BEAT",,0,,0,168070,250480,30378,,,,,,,,,,,,,,,,,,,,,,,,,,,,,,,,,,,,,,,,,,,
5962876,2a80395d-24c0-47ff-b147-0b41edafae6b,1435005228,120,1548677816,,0,0,14.41,3777,3820,193,193,,,1,2,0.54,,,377,981,,,,,,,48.11,,1,,,,,,,,,,,,,,78,82,13.96,13.83,14.23,,,,,,,,,,,,,,,,,"1,0,1,4,22,60,11,0,0",,,,,,,140,,,,,,,,,,,,,,,,,,,,,,,,,,,,,,,,,,,,,10,8,281,94,,1007,,,0,4,3,,1,0,,,,,"Aachen Laufen",,"Polar BEAT",,0,,0,168070,250480,30378,,,,,,,,,,,,,,,,,,,,,,,,,,,,,,,,,,,,,,,,,,4,
5962877,26589e21-cfc0-4a33-8901-6bc13a323907,1349118689,120,1548677817,,0,0,19.16,6178,6215,98,97,,,1,0,0.19,,,,1320,,,,,,,38.69,,1,,,,,,,,,,,,,,128,,11.24,11.99,12.09,,,,,,,,,,,,,,,,,"13,4,10,26,29,12,5,2,0",,,,,,,,,,,,,,,,,,,,,,,,,,,,,,,,,,,,,,,,,,,,14,6,256,86,,1018,0,,1,4,3,,1,0,,,,,,,"Polar BEAT",,0,,0,168070,250480,30378,,,,,,,,,,,,,,,,,,,,,,,,,,,,,,,,,,,,,,,,,,,
5962878,f008dd6d-286c-433b-a29e-31e5c8f41dfc,1409492908,120,1548677818,,0,0,2.79,931,931,18,20,,,1,0,0.29,,,,184,,,,,,,32.5,,1,,,,,,,,,,,,,,19,82,10.94,10.93,11.03,,,,,,,,,,,,,,,,,"8,7,45,24,13,3,0,0,0",,,,,,,110,,,,,,,,,,,,,,,,,,,,,,,,,,,,,,,,,,,,,13,3,259,89,,,5,,0,5,3,,1,0,,,,,Auslaufen,,"Polar BEAT",,0,,0,168070,250480,30378,,,,,,,,,,,,,,,,,,,,,,,,,,,,,,,,,,,,,,,,,,,
5962880,4588ed15-ad79-4115-857f-1564146d00fe,1415356551,60,1548677818,,0,0,13.56,4644,4864,152,151,,,1,1.6,0.51,,,366,915,,,,,,,35.06,,1,,,,,,,,,,,,,,96,79,10.67,11.54,11.7,,,,,,,,,,,,,,,,,"16,5,12,23,39,6,0,0,0",,,,,,,111,,,,,,,,,,,,,,,,,,,,,,,,,,,,,,,,,,,,,7,10,165,76,,1004,1,,0,5,3,,1,0,,,,,"Regenerativer DL",,"Polar BEAT",,0,,0,168070,250480,30378,,,,,,,,,,,,,,,,,,,,,,,,,,,,,,,,,,,,,,,,,,5,
5962881,82634a6a-e49a-48f7-b68b-2b0016f63041,1415907247,60,1548677819,,0,0,5.53,1475,1475,0,3,,,1,0,0.01,,,,324,,,,,,,44.27,,1,,,,,,,,,,,,,,30,83,13.56,15.56,15.56,,,,,,,,,,,,,,,,,"26,3,3,5,6,7,8,32,10",,,,,,,136,,,,,,,,,,,,,,,,,,,,,,,,,,,,,,,,,,,,,7,11,152,92,,1013,,,1,5,3,,1,0,,,,,"4x (300,500,300)",,"Polar BEAT",,0,,0,168070,250480,30378,,,,,,,,,,,,,,,,,,,,,,,,,,,,,,,,,,,,,,,,,,,
5962882,d389587d-7e44-47f8-bc96-e7683e00c6ae,1516819816,60,1548677819,,0,0,10.64,1707,1735,43,37,,,1,0,0.06,,,,269,117,136,,,,,,,1,,,,,,,,,,,,,,17,,,22.85,,8.6,-29,102,92,,1,118,111,,,,,,,,,"4,11,69,16,0,0,0","0,100,0,0,0","90,0,0,0,9",,,,,,,,,,,,,,,,,,,,,,,,,,,,,,,,,,,,,,,,,8.1,10,13,230,71,,1018,,,1,2,1,,1,0,,,Cycling,,,,"Polar M430",43,0,,0,168072,,30378,,,,,,,,,,,,,,,,,,,,,,,,,,,,,,,,,,,,,,,,,,,
5962883,3039112b-fdbe-4b19-b24f-1059ca67ce72,1498330760,120,1548677819,,0,0,6.59,2037,2113,77,83,,,1,1.3,0.54,,,399,452,,,,,,,37.58,,1,,,,,,,,,,,,,,42,77,11.83,11.9,12.19,,,,,,,,,,,,,,,,,"11,3,8,22,41,14,0,0,0",,,,,,,126,,,,,,,,,,,,,,,,,,,,,,,,,,,,,,,,,,,,,30,12,232,50,,1015,1,,0,3,3,,1,0,,,,,"Aix-en-Provence Laufen",,"Polar BEAT",,0,,0,168070,250480,30378,,,,,,,,,,,,,,,,,,,,,,,,,,,,,,,,,,,,,,,,,,5,
5962884,0c972078-36f2-4cd3-8c10-23de83073556,1532715816,120,1548677820,,0,0,14.47,4372,4375,59,56,,,1,0,0.04,1.12,0.94,,980,141,156,,,,61.18,40.81,61.51,1,,,,,,,,,,,,,,87,82,11.96,11.95,12.04,9.6,,,,,,,,,,,,,,,,"1,1,6,50,40,2,0,0,0","1,29,71,0,0",,,,,,121,,,,,,,,,,,,,,,,,,,,,,,,,,,,,,,,,,,,28.4,34,8,17,27,,1010,,,0,5,3,,1,0,I1.000|4:50-I1.000|4:47-I1.000|4:48-I1.000|4:54-I1.000|4:55-I1.000|4:59-I1.000|5:04-I1.000|5:08-I1.000|5:11-I1.000|5:01-I1.000|5:09-I1.000|5:11-I1.000|5:11-I1.000|5:18-I0.474|2:28,,Running,,,,"Polar M430",43,0,,0,168070,250480,30378,,,,,,,,,,,,,,,,,,,,,,,,,,,,,,,,,,,,,,,,,,,
5962885,ec9fda09-e057-4c46-86b0-bbb1816a53fd,1505844588,120,1548677820,,0,0,3.36,908,908,68,67,,,1,1.7,0.64,1.15,0.98,463,223,152,166,,,,63.62,42.16,65.24,1,,,,,,,,,,,,,,23,80,13.81,13.42,14.19,4.4,,,,,,,,,,,,,,,,"0,0,1,15,38,31,14,1,0","1,7,76,15,0",,,,,,139,,,,,,,,,,,,,,,,,,,,,,,,,,,,,,,,,,,,36.8,14,9,305,77,,1019,,,0,5,3,,1,0,I1.000|4:52-I1.000|4:32-I1.000|4:20-I0.373|1:25,,Running,,,,"Polar M430",43,0,,0,168070,250480,30378,,,,,,,,,,,,,,,,,,,,,,,,,,,,,,,,,,,,,,,,,,4,
5962886,8b18c36e-6649-4f65-a734-35348cfa7af7,1452891216,60,1548677820,,0,0,1.44,485,486,26,24,,,1,1.4,0.72,,,,89,,,,,,,30.16,,1,,,,,,,,,,,,,,10,78,11.15,11.47,11.85,,,,,,,,,,,,,,,,,"16,1,5,36,29,12,0,0,0",,,,,,,114,,,,,,,,,,,,,,,,,,,,,,,,,,,,,,,,,,,,,1,8,331,92,,1018,,,1,5,3,,1,0,,,,,"Aachen Laufen",,"Polar BEAT",,0,,0,168070,250480,30378,,,,,,,,,,,,,,,,,,,,,,,,,,,,,,,,,,,,,,,,,,,
5962887,7a3d380e-e8e8-4925-b692-98828044475f,1470919688,120,1548677821,,0,0,15.25,3575,4297,21,24,,,1,0,0.03,,,,505,,,,,,,,,1,,,,,,,,,,,,,,39,,,16.93,,,,51,45,,1,66,60,,,,,,,,,"31,57,13,0,0,0,0",,"89,2,9,0,0",,,,,,,,,,,,,,,,,,,,,,,,,,,,,,,,,,,,,,,,,,20,5,340,65,,,,,0,3,3,,1,0,,,,,"Naujac-sur-Mer Radfahren",,"Polar BEAT",,0,,0,168072,,30378,,,,,,,,,,,,,,,,,,,,,,,,,,,,,,,,,,,,,,,,,,,
5962888,db029d5f-76f2-4d65-a050-45b39e76d522,1498248000,120,1548677821,,0,0,2.13,632,880,23,49,,,1,1.3,0.71,,,,145,,,,,,,36.34,,1,,,,,,,,,,,,,,13,77,11.89,12.55,12.13,,,,,,,,,,,,,,,,,"8,3,7,23,32,21,6,0,0",,,,,,,131,,,,,,,,,,,,,,,,,,,,,,,,,,,,,,,,,,,,,23,11,266,51,,1017,0,,0,5,3,,1,0,,,,,"Aachen Laufen",,"Polar BEAT",,0,,0,168070,250480,30378,,,,,,,,,,,,,,,,,,,,,,,,,,,,,,,,,,,,,,,,,,,
5962889,307621af-1b5d-49bf-bdb2-c0912462ad61,1472849367,120,1548677822,,0,0,5.72,1652,1838,56,64,,,1,1,0.58,,,,393,,,,,,,40.39,,1,,,,,,,,,,,,,,34,80,12.54,12.65,12.81,,,,,,,,,,,,,,,,,"3,0,6,18,48,22,2,0,0",,,,,,,130,,,,,,,,,,,,,,,,,,,,,,,,,,,,,,,,,,,,,20,1,256,74,,1020,0,,1,5,3,,1,0,,,,,"Aachen Laufen",,"Polar BEAT",,0,,0,168070,250480,30378,,,,,,,,,,,,,,,,,,,,,,,,,,,,,,,,,,,,,,,,,,,
5962890,,1548280440,60,1548677822,,0,0,10,1800,1800,,,,,0,,,,,,385,,,,,,,,,1,,,,,,,,,,,,,,20,,,,,,,,,,,,,,,,,,,,,,,,,,,,,,,,,,,,,,,,,,,,,,,,,,,,,,,,,,,,,,,,,,,,,,,,,,1,,,0,0,,,,,,,"no device name available",,0,,0,168072,,30378,,,,,,,,,,,,,,,,,,,,,,,,,,,,,,,,,,,,,,,,,,,
5962891,c0578c3d-0523-4ecd-80d2-008156976537,1474320446,120,1548677822,,0,0,5.73,1634,1664,76,69,,,1,1.3,0.54,,,816,391,,,,,,,41,,1,,,,,,,,,,,,,,33,79,12.83,13.09,13.43,,,,,,,,,,,,,,,,,"2,4,10,21,37,20,4,0,2",,,,,,,133,,,,,,,,,,,,,,,,,,,,,,,,,,,,,,,,,,,,,14,1,38,75,,1020,0,,1,5,3,,1,0,,,,,"Aachen Laufen",,"Polar BEAT",,0,,0,168070,250480,30378,,,,,,,,,,,,,,,,,,,,,,,,,,,,,,,,,,,,,,,,,,5,
5962893,dcd3a85d-e786-42c7-a204-246e10474c08,1532332480,120,1548677823,,0,0,11.95,3284,3284,37,37,,,1,0,0.05,1.06,0.91,,843,153,166,,,,61.75,44.9,61.99,1,,,,,,,,,,,,,,88,82,13.13,13.16,13.23,2.2,,,,,,,,,,,,,,,,"0,0,2,12,41,45,1,0,0","1,5,85,9,0",,,,,,133,,,,,,,,,,,,,,,,,,,,,,,,,,,,,,,,,,,,49.6,17,1,350,94,,,1,,0,9,3,,1,0,I1.000|4:55-I1.000|4:49-I1.000|4:44-I1.000|4:43-I1.000|4:26-I1.000|4:29-I1.000|4:29-I1.000|4:27-I1.000|4:23-I1.000|4:32-I1.000|4:26-I0.951|4:22,,Running,,,,"Polar M430",43,0,,0,168070,250480,30378,,,,,,,,,,,,,,,,,,,,,,,,,,,,,,,,,,,,,,,,,,,
5962894,1e0f0300-dc44-459c-8d6c-e15da0a0a0b7,1528222093,120,1548677824,,0,0,15,3851,3854,41,44,,,1,0,0.05,,,,1009,158,177,,,,64.22,49.44,64.42,1,,,,,,,,,,,,,,120,83,14.05,14.08,14.13,10.4,,,,,,,,,,,,,,,,"0,0,0,2,18,67,13,0,0","1,13,28,58,0",,,,,,141,,,,,,,,,,,,,,,,,,,,,,,,,,,,,,,,,,,,80.5,28,13,33,46,,1008,,,0,5,3,,1,0,I1.000|4:33-I1.000|4:21-I1.000|4:21-I1.000|4:20-I1.000|4:05-I1.000|4:17-I1.000|4:18-I1.000|4:09-I1.000|4:15-I1.000|4:20-I1.000|4:11-I1.000|4:10-I1.000|4:10-I1.000|4:18-I1.000|4:23-I0.006|0:03,,Running,,,,"Polar M430",43,0,,0,168070,250480,30378,,,,,,,,,,,,,,,,,,,,,,,,,,,,,,,,,,,,,,,,,,,
5962895,80cc1cb4-00d9-4c03-bfe1-f9886d3faff1,1540227589,120,1548677824,,0,0,11.03,3070,3073,55,59,,,1,0,0.12,1.07,0.93,,692,143,163,,,,66.51,43.98,66.89,1,,,,,,,,,,,,,,65,81,12.98,13,13.09,1.3,,,,,,,,,,,,,,,,"0,0,3,10,58,26,3,0,0","1,22,75,2,0",,,,,,133,,,,,,,,,,,,,,,,,,,,,,,,,,,,,,,,,,,,37.6,16,17,187,46,,1029,0,253,0,4,3,,1,0,I1.000|4:49-I1.000|4:51-I1.000|4:44-I1.000|4:41-I1.000|4:49-I1.000|4:46-I1.000|4:30-I1.000|4:34-I1.000|4:39-I1.000|4:27-I1.000|4:12-I0.035|0:12,,Running,,,,"Polar M430",43,0,,0,168070,250480,30378,,,,,,,,,,,,,,,,,,,,,,,,,,,,,,,,,,,,,,,,,,,
5962896,d9b9cf87-f2ad-4bac-8ec8-dc12b477e7b8,1443960168,120,1548677825,,0,0,42.3,11105,11105,130,116,,,1,0,0.06,,,,2892,,,,,,,51.95,,1,,,,,,,,,,,,,,230,84,13.76,13.82,13.92,,,,,,,,,,,,,,,,,"0,0,1,8,27,49,13,1,0",,,,,,,136,,,,,,,,,,,,,,,,,,,,,,,,,,,,,,,,,,,,,15,9,182,80,,1017,,,0,5,3,,1,0,,,,,"Köln Laufen",,"Polar BEAT",,0,,0,168070,250480,30378,,,,,,,,,,,,,,,,,,,,,,,,42.2,11105,,,0,"RheinEnergieMarathon Köln 2015",,,,,,,0,0,30378,5962896,201,,,
5962897,44ad91b6-40a0-4416-87d6-f25144c49d12,1469650673,120,1548677826,,0,0,1.89,793,794,17,23,,,1,0.5,0.43,,,,131,,,,,,,23.99,,1,,,,,,,,,,,,,,16,71,8.63,10.91,10.99,,,,,,,,,,,,,,,,,"32,2,6,23,31,5,2,0,0",,,,,,,101,,,,,,,,,,,,,,,,,,,,,,,,,,,,,,,,,,,,,20,8,251,68,,1017,0,,0,5,3,,1,0,,,,,"Aachen Laufen",,"Polar BEAT",,0,,0,168070,250480,30378,,,,,,,,,,,,,,,,,,,,,,,,,,,,,,,,,,,,,,,,,,,
5962898,8864fee9-6a22-4d70-b35e-9ba31e91b4e9,1398371463,120,1548677826,,0,0,7.36,2426,2556,277,277,,,1,4.4,0.74,2.42,1.28,875,416,151,188,,,,50.23,35.07,52.57,1,,,,,,,,,,,,,,67,80,11.42,13.07,15.34,33.6,,,,,,,,,,,,,,,,"37,4,4,10,9,6,14,13,3","0,33,26,40,1",,,,,,114,,,,,,,,,,,,,,,,,,,,,,,,,,,,,,,,,,,,65.5,15,0,106,83,,1016,0,,1,5,3,,1,0,,,,,Dreieck,,"Polar BEAT",,0,,0,168070,250480,30378,,,,,,,,,,,,,,,,,,,,,,,,,,,,,,,,,,,,,,,,,,"5,5,5,5,5,5,5,5,5,5",
5962899,854ec359-73c6-4a48-aeea-2f8873e5f8a5,1475261463,120,1548677827,,0,0,10.01,2769,3812,105,109,,,1,1.1,0.44,,,,676,,,,,,,44,,1,,,,,,,,,,,,,,57,80,13.09,14.03,14.15,,,,,,,,,,,,,,,,,"12,2,2,5,13,30,32,4,0",,,,,,,136,,,,,,,,,,,,,,,,,,,,,,,,,,,,,,,,,,,,,16,2,228,68,,1015,0,,0,5,3,,1,0,,,,,"Aachen Laufen",,"Polar BEAT",,0,,0,168070,250480,30378,,,,,,,,,,,,,,,,,,,,,,,,,,,,,,,,,,,,,,,,,,,
5962900,d5ad5d94-25f3-4804-9591-5f9a4b1372bc,1490035945,60,1548677827,,0,0,12.07,3417,3620,199,203,,,1,2,0.47,,,444,850,,,,,,,43.41,,1,,,,,,,,,,,,,,70,81,13.09,13.05,13.61,,,,,,,,,,,,,,,,,"6,3,5,13,28,37,7,0,0",,,,,,,131,,,,,,,,,,,,,,,,,,,,,,,,,,,,,,,,,,,,,10,13,230,81,,1009,0,,1,5,3,,1,0,,,,,"Aachen Laufen",,"Polar BEAT",,0,,0,168070,250480,30378,,,,,,,,,,,,,,,,,,,,,,,,,,,,,,,,,,,,,,,,,,"5,5,5",
5962901,9aabe6de-6d12-44ed-998d-4df0f950f0e2,1395775609,60,1548677828,,0,0,2.3,480,480,0,0,,,1,0,0,,,,120,175,181,,,,71.21,54.5,71.21,1,,,,,,,,,,,,,,21,89,17.31,17.3,17.33,7.4,,,,,,,,,,,,,,,,"0,0,0,0,0,0,46,54,0","0,3,3,93,2",,,,,,162,,,,,,,,,,,,,,,,,,,,,,,,,,,,,,,,,,,,77.4,6,4,74,67,,1011,0,,1,5,3,,1,0,,,,,"1x 4 Außenrunden",,"Polar BEAT",,0,,0,168070,250480,30378,,,,,,,,,,,,,,,,,,,,,,,,,,,,,,,,,,,,,,,,,,,
5962902,b21fb8ba-252c-4667-8edf-770a25bced5c,1465136399,120,1548677830,,0,0,5.38,1631,1631,60,60,,,1,0.7,0.37,,,291,371,,,,,,,38,,1,,,,,,,,,,,,,,33,79,12.1,11.94,12.25,,,,,,,,,,,,,,,,,"0,4,9,48,31,8,0,0,0",,,,,,,125,,,,,,,,,,,,,,,,,,,,,,,,,,,,,,,,,,,,,24,4,9,73,,1017,7,,0,5,3,,1,0,,,,,"Aachen Laufen",,"Polar BEAT",,0,,0,168070,250480,30378,,,,,,,,,,,,,,,,,,,,,,,,,,,,,,,,,,,,,,,,,,5,
5962903,02592aee-fbe6-46e7-9845-8794f0ac977a,1414847449,60,1548677830,,0,0,1.08,355,355,15,8,,,1,0.8,0.56,,,,72,,,,,,,30,,1,,,,,,,,,,,,,,7,80,11.27,11.01,11.45,,,,,,,,,,,,,,,,,"2,3,28,66,0,0,0,0,0",,,,,,,114,,,,,,,,,,,,,,,,,,,,,,,,,,,,,,,,,,,,,20,8,186,58,,1019,1,,0,5,3,,1,0,,,,,Auslaufen,,"Polar BEAT",,0,,0,168070,250480,30378,,,,,,,,,,,,,,,,,,,,,,,,,,,,,,,,,,,,,,,,,,,
5962904,51a7ba48-ebee-44c5-909c-c75dd89a8549,1429995492,120,1548677830,,0,0,2.93,565,565,71,69,,,1,2.2,1,,,,198,,,,,,,61.17,,1,,,,,,,,,,,,,,11,91,18.98,18.73,19.2,,,,,,,,,,,,,,,,,"0,0,0,0,0,0,6,89,4",,,,,,,171,,,,,,,,,,,,,,,,,,,,,,,,,,,,,,,,,,,,,12,7,188,88,,1007,,,1,5,3,,1,0,,,,,"Essen Laufen",,"Polar BEAT",,0,,0,168070,250480,30378,,,,,,,,,,,,,,,,,,,,,,,,,,,,,,,,,,,,,,,,,,,
5962905,f62ce286-7bd3-449c-bc80-2ec6f846bc92,1470268878,120,1548677831,,0,0,2.21,755,755,32,22,,,1,0.7,0.45,,,,150,,,,,,,31,,1,,,,,,,,,,,,,,15,79,10.87,10.55,10.96,,,,,,,,,,,,,,,,,"11,26,35,18,8,2,0,0,0",,,,,,,111,,,,,,,,,,,,,,,,,,,,,,,,,,,,,,,,,,,,,17,10,234,95,,1012,0,,1,6,3,,1,0,,,,,"Aachen Laufen",,"Polar BEAT",,0,,0,168070,250480,30378,,,,,,,,,,,,,,,,,,,,,,,,,,,,,,,,,,,,,,,,,,,
5962906,bb2e4725-445e-42f9-86a9-6477d45ccd0b,1471788136,120,1548677831,,0,0,4.41,1230,1257,21,21,,,1,0,0.14,,,,301,,,,,,,41.43,,1,,,,,,,,,,,,,,25,80,12.96,13.06,13.11,,,,,,,,,,,,,,,,,"3,0,2,5,61,20,8,0,0",,,,,,,134,,,,,,,,,,,,,,,,,,,,,,,,,,,,,,,,,,,,,22,7,239,74,,,,,0,3,3,,1,0,,,,,"Naujac-sur-Mer Laufen",,"Polar BEAT",,0,,0,168070,250480,30378,,,,,,,,,,,,,,,,,,,,,,,,,,,,,,,,,,,,,,,,,,,
5962907,645dd2b7-be31-4eae-9643-32f677a1e86f,1407872602,120,1548677832,,0,0,7.8,2169,2398,157,159,,,1,2.1,0.92,,,,467,,,,,,,43.02,,1,,,,,,,,,,,,,,45,83,13.5,15.44,15.76,,,,,,,,,,,,,,,,,"36,2,2,2,2,3,4,44,6",,,,,,,130,,,,,,,,,,,,,,,,,,,,,,,,,,,,,,,,,,,,,14,8,217,89,,1011,0,,0,6,3,,1,0,,,,,"5x1000m / 200m Traubpause <1:30 , 2x400m, 2x200m lange Pausen",,"Polar BEAT",,0,,0,168070,250480,30378,,,,,,,,,,,,,,,,,,,,,,,,,,,,,,,,,,,,,,,,,,,
5962908,c4bde1fb-0c8c-4937-b7cf-02fd4bf116e0,1500046004,120,1548677832,,0,0,1.19,390,391,23,18,,,1,0,0.15,,,,74,,,,,,,30.44,,1,,,,,,,,,,,,,,8,78,11.19,11.6,11.92,,,,,,,,,,,,,,,,,"33,14,9,6,7,16,12,3,0",,,,,,,117,,,,,,,,,,,,,,,,,,,,,,,,,,,,,,,,,,,,,31,37,322,31,,1014,8,,0,3,3,,1,0,,,,,"Aix-en-Provence Laufen",,"Polar BEAT",,0,,0,168070,250480,30378,,,,,,,,,,,,,,,,,,,,,,,,,,,,,,,,,,,,,,,,,,,
5962909,1388b6ee-a8d9-46ee-802f-dbd0c15ceed6,1465505120,120,1548677832,,0,0,10.94,3460,3460,228,227,,,1,3,0.61,,,456,753,,,,,,,37.86,,1,,,,,,,,,,,,,,71,81,11.81,11.61,12.29,,,,,,,,,,,,,,,,,"10,8,21,32,22,5,1,1,1",,,,,,,117,,,,,,,,,,,,,,,,,,,,,,,,,,,,,,,,,,,,,19,3,351,54,,1017,0,,0,3,3,,1,0,,,,,"Aachen Laufen",,"Polar BEAT",,0,,0,168070,250480,30378,,,,,,,,,,,,,,,,,,,,,,,,,,,,,,,,,,,,,,,,,,"4,5",
5962910,dc2615e9-16a0-4728-aed6-fe3e5b7fb099,1399890913,120,1548677833,,0,0,9.76,2971,2975,186,186,,,1,2.5,0.54,,,312,667,,,,,,,39.26,,1,,,,,,,,,,,,,,61,82,12.06,12.03,12.73,,,,,,,,,,,,,,,,,"6,6,12,24,37,15,0,0,0",,,,,,,120,,,,,,,,,,,,,,,,,,,,,,,,,,,,,,,,,,,,,10,14,236,80,,1011,3,,0,5,3,,1,0,,,,,"Regenerativer DL ",,"Polar BEAT",,0,,0,168070,250480,30378,,,,,,,,,,,,,,,,,,,,,,,,,,,,,,,,,,,,,,,,,,4,
5962911,bf968b25-9d40-4013-903a-9c64c68ad416,1524254018,120,1548677833,,0,0,7.22,2296,2297,34,32,,,1,0.1,0.27,1.16,0.93,,533,147,162,,,,54.42,36.55,54.76,1,,,,,,,,,,,,,,53,81,11.39,11.42,11.55,1.1,,,,,,,,,,,,,,,,"3,7,23,44,20,1,1,0,0","1,4,95,1,0",,,,,,116,,,,,,,,,,,,,,,,,,,,,,,,,,,,,,,,,,,,32.9,22,1,304,39,,1018,,,0,3,3,,1,0,I1.000|5:13-I1.000|5:33-I1.000|5:20-I1.000|5:04-I1.000|5:10-I1.000|5:29-I1.000|5:15-I0.227|1:13,,Running,,,,"Polar M430",43,0,,0,168070,250480,30378,,,,,,,,,,,,,,,,,,,,,,,,,,,,,,,,,,,,,,,,,,,
5962912,ff8b0734-78c6-4ef3-9ab7-2b33f9186924,1461619494,120,1548677834,,0,0,13.64,3976,4181,169,160,,,1,1.4,0.45,,,228,949,,,,,,,42.35,,1,,,,,,,,,,,,,,82,81,12.62,12.54,12.81,,,,,,,,,,,,,,,,,"3,0,2,23,56,15,1,0,0",,,,,,,127,,,,,,,,,,,,,,,,,,,,,,,,,,,,,,,,,,,,,3,6,294,96,,1004,0,,1,6,3,,1,0,,,,,Laufen,,"Polar BEAT",,0,,0,168070,250480,30378,,,,,,,,,,,,,,,,,,,,,,,,,,,,,,,,,,,,,,,,,,"5,5",
5962913,a0f5c1db-b09f-4438-b52c-f5d45ec6132f,1460059283,120,1548677835,,0,0,15.94,4454,6028,195,202,,,1,0.7,0.29,,,,1049,,,,,,,45.03,,1,,,,,,,,,,,,,,92,84,13.03,13.85,14.02,,,,,,,,,,,,,,,,,"15,4,6,17,23,10,7,14,5",,,,,,,128,,,,,,,,,,,,,,,,,,,,,,,,,,,,,,,,,,,,,7,1,232,78,,1012,0,,1,5,3,,1,0,,,,,"Aachen Laufen",,"Polar BEAT",,0,,0,168070,250480,30378,,,,,,,,,,,,,,,,,,,,,,,,,,,,,,,,,,,,,,,,,,,
5962914,,1400625328,120,1548677835,,0,0,2,0,0,,,,,0,,,,,,,,,,,,,,,1,,,,,,,,,,,,,,0,,,,,,,,,,,,,,,,,,,,,,,,,,,,,,,,,,,,,,,,,,,,,,,,,,,,,,,,,,,,,,,,,,,,,,,,,,1,,,0,0,,,,,Auslaufen,,"Polar BEAT",,0,,0,168070,250480,30378,,,,,,,,,,,,,,,,,,,,,,,,,,,,,,,,,,,,,,,,,,,
5962915,c7baeab0-42da-48ff-8701-a61d33a59fb4,1462223039,120,1548677836,,0,0,10,2547,2547,140,148,,,1,1.9,0.54,,,503,685,,,,,,,48.46,,1,,,,,,,,,,,,,,52,82,14.37,14.26,14.54,,,,,,,,,,,,,,,,,"0,0,1,5,17,49,28,0,0",,,,,,,144,,,,,,,,,,,,,,,,,,,,,,,,,,,,,,,,,,,,,14,3,275,62,,1021,0,,1,5,3,,1,0,,,,,"Aachen Laufen",,"Polar BEAT",,0,,0,168070,250480,30378,,,,,,,,,,,,,,,,,,,,,,,,,,,,,,,,,,,,,,,,,,5,
5962916,6f373064-b33d-4297-ad8a-8c8be0d17b1d,1517511448,60,1548677836,,0,0,11.45,1886,1982,37,25,,,1,0,0.09,,,,363,129,148,,,,,,,1,,,,,,,,,,,,,,27,,,23.65,,16,-29.6,114,97,,1,132,121,,,,,,,,,"10,10,38,42,0,0,0","2,89,9,0,0","87,3,0,0,9",,,,,,,,,,,,,,,,,,,,,,,,,,,,,,,,,,,,,,,,,15.1,4,3,205,82,,,0,,1,4,3,,1,0,,,Cycling,,,,"Polar M430",43,0,,0,168072,,30378,,,,,,,,,,,,,,,,,,,,,,,,,,,,,,,,,,,,,,,,,,,
5962917,645fed72-efd2-4206-9561-4512b6409d6c,1396111462,60,1548677836,,0,0,8.06,2255,2261,88,86,,,1,0.9,0.4,1.06,1.04,523,463,148,168,,,,63.18,42.8,64.05,1,,,,,,,,,,,,,,54,82,13.1,13.2,13.47,-7.2,,,,,,,,,,,,,,,,"1,4,8,27,21,20,19,0,0","0,33,48,19,0",,,,,,131,,,,,,,,,,,,,,,,,,,,,,,,,,,,,,,,,,,,49.9,18,8,105,38,,1016,1,,0,5,3,,1,0,,,,,"Auslaufen gesteigert",,"Polar BEAT",,0,,0,168070,250480,30378,,,,,,,,,,,,,,,,,,,,,,,,,,,,,,,,,,,,,,,,,,5,
5962918,5302bf44-3482-4a55-b21b-0ce5c15abd1a,1454930654,60,1548677837,,0,0,12.89,3531,3684,148,150,,,1,1.6,0.44,,,396,912,,,,,,,45.33,,1,,,,,,,,,,,,,,73,82,13.35,13.4,13.62,,,,,,,,,,,,,,,,,"4,3,4,12,31,35,10,2,0",,,,,,,134,,,,,,,,,,,,,,,,,,,,,,,,,,,,,,,,,,,,,7,30,223,80,,993,,,0,6,3,,1,0,,,,,"Aachen Laufen",,"Polar BEAT",,0,,0,168070,250480,30378,,,,,,,,,,,,,,,,,,,,,,,,,,,,,,,,,,,,,,,,,,"5,5",
5962919,44fadbe6-9e16-4a0c-912f-d8cd21d990ec,1509349448,60,1548677838,,0,0,13.99,2709,2710,36,37,,,1,0,0.03,1.76,,,307,103,129,,,,,,,1,,,,,,,,,,,,,,18,,,20.6,,2.4,11.2,87,69,,1,112,96,,,,,,,,,"15,38,39,5,3,0,0","41,59,0,0,0","86,2,9,2,1",,,,,,,,,,,,,,,,,,,,,,,,,,,,,,,,,,,,,,,,,6.2,4,0,279,90,,,,,0,3,3,,1,0,,,Cycling,,,,"Polar M430",43,0,,0,168072,,30378,,,,,,,,,,,,,,,,,,,,,,,,,,,,,,,,,,,,,,,,,,,
5962920,4a861c46-b0a3-487b-b1ff-5a53e230cf76,1368791146,120,1548677839,,0,0,29.86,9916,10353,490,490,,,1,3.1,0.51,,,507,2063,,,,,,,38.55,,1,,,,,,,,,,,,,,205,,11.16,11.66,12.19,,,,,,,,,,,,,,,,,"19,9,14,22,21,9,4,1,1",,,,,,,,,,,,,,,,,,,,,,,,,,,,,,,,,,,,,,,,,,,,8,6,312,96,,1003,5,,0,5,3,,1,0,,,,,,,"Polar BEAT",,0,,0,168070,250480,30378,,,,,,,,,,,,,,,,,,,,,,,,,,,,,,,,,,,,,,,,,,"4,4",
5962922,,1517483220,60,1548677850,,0,0,11,1920,1920,,,,,0,,,,,,411,,,,,,,,,1,,,,,,,,,,,,,,21,,,,,,,,,,,,,,,,,,,,,,,,,,,,,,,,,,,,,,,,,,,,,,,,,,,,,,,,,,,,,,,,,,,,,,,,,,1,,,0,0,,,,,,,"no device name available",,0,,0,168072,,30378,,,,,,,,,,,,,,,,,,,,,,,,,,,,,,,,,,,,,,,,,,,
5962923,601df8bc-ec95-41b3-afb2-8f58247b2265,1514724544,60,1548677850,,0,0,1.19,434,437,4,4,,,1,0,0,,,,94,146,160,,,,46.37,26.94,46.57,1,,,,,,,,,,,,,,10,78,9.94,10.69,10.64,30.7,,,,,,,,,,,,,,,,"18,14,11,38,20,0,0,0,0","0,29,71,0,0",,,,,,105,,,,,,,,,,,,,,,,,,,,,,,,,,,,,,,,,,,,21.9,13,18,214,79,,1002,,,0,5,3,,1,0,I1.000|6:12-I0.196|1:06,,Running,,,,"Polar M430",43,0,,0,168070,250480,30378,,,,,,,,,,,,,,,,,,,,,,,,,,,,,,,,,,,,,,,,,,,
5962924,bb14f447-be79-4ca7-a7e8-cefd3db89d56,1540842247,60,1548677850,,0,0,2.64,924,925,14,16,,,1,0,0.15,1.13,1.01,,176,127,146,,,,57.86,30.59,58.19,1,,,,,,,,,,,,,,13,79,10.34,10.42,10.51,4.7,,,,,,,,,,,,,,,,"18,20,32,25,5,0,0,0,0","4,77,19,0,0",,,,,,108,,,,,,,,,,,,,,,,,,,,,,,,,,,,,,,,,,,,12,6,30,30,93,,,0,,1,11,3,,1,0,I1.000|5:25-I1.000|6:14-I0.641|3:48,,Running,,,,"Polar M430",43,0,,0,168070,250480,30378,,,,,,,,,,,,,,,,,,,,,,,,,,,,,,,,,,,,,,,,,,,
5962925,d2e33474-3eb7-446d-aa6e-547808c5023c,1408804317,120,1548677851,,0,0,3.73,1160,1160,21,56,,,1,0.7,0.51,,,,250,,,,,,,36.05,,1,,,,,,,,,,,,,,24,81,11.41,11.83,11.7,,,,,,,,,,,,,,,,,"5,8,20,28,23,15,0,0,0",,,,,,,119,,,,,,,,,,,,,,,,,,,,,,,,,,,,,,,,,,,,,15,5,281,72,,1015,5,,0,5,3,,1,0,,,,,Auslaufen,,"Polar BEAT",,0,,0,168070,250480,30378,,,,,,,,,,,,,,,,,,,,,,,,,,,,,,,,,,,,,,,,,,,
5962926,592bd4ad-7ecd-4ea6-8d7d-2aeccd415e3d,1511202655,60,1548677851,,0,0,14.85,2540,2541,50,49,,,1,0,0.08,,,,387,116,150,,,,,,,1,,,,,,,,,,,,,,27,,,22.88,,22.9,13.2,107,87,,1,129,112,,,,,,,,,"16,17,38,26,4,0,0","16,79,5,0,0","80,6,5,6,2",,,,,,,,,,,,,,,,,,,,,,,,,,,,,,,,,,,,,,,,,14.5,5,10,211,85,,,0,,1,4,3,,1,0,,,Cycling,,,,"Polar M430",43,0,,0,168072,,30378,,,,,,,,,,,,,,,,,,,,,,,,,,,,,,,,,,,,,,,,,,,
5962928,cfa09ccb-cdbd-4ccb-a20f-f1a279b4f710,1457725006,60,1548677853,,0,0,10.73,3214,4255,138,164,,,1,1.3,0.51,,,471,748,,,,,,,40.29,,1,,,,,,,,,,,,,,66,83,12.2,12.26,12.57,,,,,,,,,,,,,,,,,"5,1,5,20,61,7,0,0,0",,,,,,,121,,,,,,,,,,,,,,,,,,,,,,,,,,,,,,,,,,,,,5,11,45,73,,1028,,,1,5,3,,1,0,,,,,"Aachen Laufen",,"Polar BEAT",,0,,0,168070,250480,30378,,,,,,,,,,,,,,,,,,,,,,,,,,,,,,,,,,,,,,,,,,5,
5962929,13673f93-35b7-4f10-b950-b430fcaf2ea0,1510485301,60,1548677854,,0,0,18.14,4852,4855,210,277,,,1,1.3,0.37,1.06,0.96,403,1244,157,183,,,,61.6,47.86,62.2,1,,,,,,,,,,,,,,148,84,13.63,14.08,14.27,-11.6,,,,,,,,,,,,,,,,"4,4,12,16,12,15,30,6,1","0,16,36,46,1",,,,,,134,,,,,,,,,,,,,,,,,,,,,,,,,,,,,,,,,,,,98.3,5,4,270,96,,1002,,,0,6,3,,1,0,I1.000|5:36-I1.000|6:06-I1.000|5:10-I1.000|4:41-I1.000|5:20-I1.000|5:03-I1.000|5:18-I1.000|4:11-I1.000|4:12-I1.000|4:00-I1.000|3:47-I1.000|3:56-I1.000|3:46-I1.000|3:44-I1.000|4:44-I1.000|3:40-I1.000|3:47-I1.000|3:24-I0.150|0:32,,Running,,,,"Polar M430",43,0,,0,168070,250480,30378,,,,,,,,,,,,,,,,,,,,,,,,,,,,,,,,,,,,,,,,,,5,
5962930,66a2e196-4670-406c-af00-f4b94dd904e5,1427921515,120,1548677854,,0,0,9.58,2237,2237,205,194,,,1,2.6,1,,,,643,,,,,,,53.49,,1,,,,,,,,,,,,,,46,87,15.63,16.13,16.83,,,,,,,,,,,,,,,,,"12,6,3,3,3,3,14,53,3",,,,,,,148,,,,,,,,,,,,,,,,,,,,,,,,,,,,,,,,,,,,,6,21,262,63,,1021,,,1,5,3,,1,0,,,,,"8x 1000m",,"Polar BEAT",,0,,0,168070,250480,30378,,,,,,,,,,,,,,,,,,,,,,,,,,,,,,,,,,,,,,,,,,,
5962931,b4cba269-1240-4c38-ae57-9b7ad7330f34,1393758981,60,1548677855,,0,0,25,5940,5940,699,688,,,1,5.1,0.84,1.25,0.89,474,1370,167,182,,,,65.18,56.31,67.48,1,,,,,,,,,,,,,,218,85,15.7,15.24,16.39,-2.4,,,,,,,,,,,,,,,,"0,0,0,0,5,41,48,6,0","0,0,6,93,1",,,,,,149,,,,,,,,,,,,,,,,,,,,,,,,,,,,,,,,,,,,108.4,5,8,234,79,,,2,,0,5,3,,1,0,,,,,"Langer TDL, gesteigert",,"Polar BEAT",,0,,0,168070,250480,30378,,,,,,,,,,,,,,,,,,,,,,,,,,,,,,,,,,,,,,,,,,"4,4,4,4,5,5,5,5,5,5,5",
5962932,c2b21534-e5ef-4916-a546-db1f614b8805,1414259085,120,1548677856,,0,0,21.11,4501,4501,155,160,,,1,0.1,0.25,,,,1405,,,,,,,62.94,,1,,,,,,,,,,,,,,93,87,16.99,16.99,17.13,,,,,,,,,,,,,,,,,"1,0,0,0,0,3,55,41,0",,,,,,,162,,,,,,,,,,,,,,,,,,,,,,,,,,,,,,,,,,,,,13,3,226,96,,1021,0,,0,6,3,,1,0,,,,,"WK HM Herzogenrath",,"Polar BEAT",,0,,0,168070,250480,30378,,,,,,,,,,,,,,,,,,,,,,,,,,,,,,,,,,,,,,,,,,,
5962933,6969fc3b-dfbd-4abd-a54b-1ac5dc5a1151,1519373663,60,1548677856,,0,0,10.77,1606,1607,37,50,,,1,0,0.13,,0.67,,316,149,173,,,,,,,1,,,,,,,,,,,,,,32,,,25.59,,-14,-34.5,132,110,,1,152,137,,,,,,,,,"12,4,12,65,7,0,0","0,13,75,13,0","75,15,0,0,10",,,,,,,,,,,,,,,,,,,,,,,,,,,,,,,,,,,,,,,,,38.1,-3,5,33,68,,,0,,0,5,3,,1,0,I1.118|4:37-I0.012|0:03-I9.641|22:08,,Cycling,,,,"Polar M430",43,0,,0,168072,,30378,,,,,,,,,,,,,,,,,,,,,,,,,,,,,,,,,,,,,,,,,,,
5962934,9d913955-d76c-4551-9cf7-bd13293c4631,1515999324,60,1548677857,,0,0,14.75,4471,4472,50,52,,,1,0,0.07,1.08,0.95,,1055,149,171,,,,56.71,40.72,56.94,1,,,,,,,,,,,,,,110,82,11.91,11.9,11.95,10.3,,,,,,,,,,,,,,,,"0,0,3,62,34,1,0,0,0","1,21,60,19,0",,,,,,121,,,,,,,,,,,,,,,,,,,,,,,,,,,,,,,,,,,,55.2,-1,1,169,90,,,0,,1,4,3,,1,0,I1.000|5:06-I1.000|5:06-I1.000|5:03-I1.000|5:07-I1.000|4:56-I1.000|4:58-I1.000|5:06-I1.000|5:03-I1.000|5:02-I1.000|5:05-I1.000|5:06-I1.000|5:01-I1.000|5:00-I1.000|5:00-I0.756|3:53,,Running,,,,"Polar M430",43,0,,0,168070,250480,30378,,,,,,,,,,,,,,,,,,,,,,,,,,,,,,,,,,,,,,,,,,,
5962935,18b4bb98-5aa4-45f6-a8dd-d1a493b82c8b,1453971022,60,1548677857,,0,0,1.09,372,372,17,12,,,1,1.1,0.63,,,,83,,,,,,,28.78,,1,,,,,,,,,,,,,,7,80,10.89,10.76,11.34,,,,,,,,,,,,,,,,,"22,15,14,39,10,0,0,0,0",,,,,,,110,,,,,,,,,,,,,,,,,,,,,,,,,,,,,,,,,,,,,5,10,272,89,,1025,,,0,5,3,,1,0,,,,,"Aachen Laufen",,"Polar BEAT",,0,,0,168070,250480,30378,,,,,,,,,,,,,,,,,,,,,,,,,,,,,,,,,,,,,,,,,,,
5962936,2212d965-9664-478c-ad91-d053c4f6571b,1483556583,60,1548677858,,0,0,13,3364,3561,198,198,,,1,2.2,0.58,,,449,876,,,,,,,48.46,,1,,,,,,,,,,,,,,69,82,14.19,14.15,14.55,,,,,,,,,,,,,,,,,"2,1,1,4,18,55,16,2,0",,,,,,,141,,,,,,,,,,,,,,,,,,,,,,,,,,,,,,,,,,,,,2,15,303,90,,1020,,,1,5,3,,1,0,,,,,"Aachen Laufen",,"Polar BEAT",,0,,0,168070,250480,30378,,,,,,,,,,,,,,,,,,,,,,,,,,,,,,,,,,,,,,,,,,4,
5962937,82c741fc-db7d-47fd-a9c0-f12ad51c8f1e,1437309708,120,1548677858,,0,0,5,1285,1285,134,141,,,1,1.1,0.56,,,254,342,,,,,,,45.97,,1,,,,,,,,,,,,,,26,84,14.4,14.21,15.02,,,,,,,,,,,,,,,,,"2,0,1,6,22,37,32,0,0",,,,,,,139,,,,,,,,,,,,,,,,,,,,,,,,,,,,,,,,,,,,,19,10,239,80,,,,,0,3,3,,1,0,,,,,"Balve Laufen",,"Polar BEAT",,0,,0,168070,250480,30378,,,,,,,,,,,,,,,,,,,,,,,,,,,,,,,,,,,,,,,,,,4,
5962938,8bf31ce1-fbd8-41a9-a1b4-a3f808177189,1370525225,120,1548677860,,0,0,101.25,13795,13908,1214,1214,,,1,3,0.42,,,491,3552,,,,,,,,,1,,,,,,,,,,,,,,154,,,33.44,,,,310,206,,1,395,333,,,,,,,,,"21,12,14,14,11,7,21",,"52,12,9,6,20",,,,,,,,,,,,,,,,,,,,,,,,,,,,,,,,,,,,,,,,,,24,6,70,46,,1019,8,,0,3,3,,1,0,,,,,,,"Polar BEAT",,0,,0,168072,,30378,,,,,,,,,,,,,,,,,,,,,,,,,,,,,,,,,,,,,,,,,,"4,4,4,5,5,5",
5962939,ef92cbd8-ad07-4672-8b9f-c8de8e956222,1426187498,60,1548677860,,0,0,3.31,957,957,70,70,,,1,1.6,0.57,,,444,226,,,,,,,38.94,,1,,,,,,,,,,,,,,19,82,12.88,12.57,13.35,,,,,,,,,,,,,,,,,"2,3,7,26,39,18,5,0,0",,,,,,,127,,,,,,,,,,,,,,,,,,,,,,,,,,,,,,,,,,,,,8,4,103,65,,1028,0,,1,3,3,,1,0,,,,,"Aachen Laufen",,"Polar BEAT",,0,,0,168070,250480,30378,,,,,,,,,,,,,,,,,,,,,,,,,,,,,,,,,,,,,,,,,,5,
5962940,c3a6b6f3-73b3-4550-8e4d-626ea1860917,1509695174,60,1548677861,,0,0,11.87,3602,3603,44,44,,,1,0,0.1,1.1,0.96,,840,147,169,,,,57.66,39.98,57.93,1,,,,,,,,,,,,,,85,82,11.91,11.89,11.97,-0.9,,,,,,,,,,,,,,,,"0,0,9,50,38,2,0,0,0","0,17,81,2,0",,,,,,121,,,,,,,,,,,,,,,,,,,,,,,,,,,,,,,,,,,,40.2,10,0,69,91,,,0,,0,5,3,,1,0,I1.000|5:25-I1.000|5:10-I1.000|5:14-I1.000|5:03-I1.000|5:03-I1.000|5:02-I1.000|5:04-I1.000|4:55-I1.000|4:55-I1.000|4:59-I1.000|4:59-I0.874|4:13,,Running,,,,"Polar M430",43,0,,0,168070,250480,30378,,,,,,,,,,,,,,,,,,,,,,,,,,,,,,,,,,,,,,,,,,,
5962941,e0ddfdd3-9be7-46ac-9ff8-c1cc709807e2,1507398174,120,1548677861,,0,0,6.24,1867,1867,87,81,,,1,1.2,0.48,1.06,0.95,,409,142,155,,,,61.37,38.93,62.51,1,,,,,,,,,,,,,,38,80,12.23,12.2,12.49,-2.4,,,,,,,,,,,,,,,,"2,3,10,45,29,6,3,2,0","0,36,64,0,0",,,,,,125,,,,,,,,,,,,,,,,,,,,,,,,,,,,,,,,,,,,26.7,9,15,222,94,,1017,0,,0,6,3,,1,0,I1.000|5:14-I1.000|4:52-I1.000|5:03-I1.000|5:18-I1.000|5:03-I1.000|4:45-I0.246|0:52,,Running,,,,"Polar M430",43,0,,0,168070,250480,30378,,,,,,,,,,,,,,,,,,,,,,,,,,,,,,,,,,,,,,,,,,,
5962942,d131b0ff-c533-4625-a891-70b1d9566ca5,1494067017,120,1548677861,,0,0,2.33,554,554,20,20,,,1,0.9,0.56,,,,161,,,,,,,47.14,,1,,,,,,,,,,,,,,11,84,15.24,15.14,15.41,,,,,,,,,,,,,,,,,"0,0,0,0,4,42,49,5,0",,,,,,,150,,,,,,,,,,,,,,,,,,,,,,,,,,,,,,,,,,,,,14,8,92,76,,1010,4,,0,3,3,,1,0,,,,,"Aachen Laufen",,"Polar BEAT",,0,,0,168070,250480,30378,,,,,,,,,,,,,,,,,,,,,,,,,,,,,,,,,,,,,,,,,,,
5962944,a0619b50-f8c8-4a99-9cf8-1bf8cfb2233f,1468687347,120,1548677862,,0,0,32.31,4453,6420,519,516,,,1,3.3,0.53,,,713,1238,,,,,,,,,1,,,,,,,,,,,,,,49,,,29.83,,,,230,168,,1,282,230,,,,,,,,,"11,15,22,23,11,10,9",,"48,18,11,13,10",,,,,,,,,,,,,,,,,,,,,,,,,,,,,,,,,,,,,,,,,,20,4,259,79,,,4,,0,5,3,,1,0,,,,,"Balve Radfahren",,"Polar BEAT",,0,,0,168072,,30378,,,,,,,,,,,,,,,,,,,,,,,,,,,,,,,,,,,,,,,,,,"4,5,5,5",
5962945,818ca7c6-2d4a-4666-b0ed-31599707932d,1394883303,60,1548677862,,0,0,4,1223,1324,61,25,,,1,0.7,0.35,0.95,0.94,,242,146,158,,,,57.64,36.95,59.37,1,,,,,,,,,,,,,,27,82,12.3,12.04,12.44,1,,,,,,,,,,,,,,,,"8,3,14,27,36,10,3,0,0","1,21,78,0,0",,,,,,120,,,,,,,,,,,,,,,,,,,,,,,,,,,,,,,,,,,,29.9,8,10,303,87,,1024,3,,0,5,3,,1,0,,,,,Einlaufen,,"Polar BEAT",,0,,0,168070,250480,30378,,,,,,,,,,,,,,,,,,,,,,,,,,,,,,,,,,,,,,,,,,,
5962946,f13ae7a5-09f3-4702-a3be-479781f7f473,1393270102,60,1548677863,,0,0,1.28,466,497,29,29,,,1,0,0,,,,63,,,,,,,27.22,,1,,,,,,,,,,,,,,9,82,10.3,14.45,14.61,,,,,,,,,,,,,,,,,"66,1,1,1,1,2,2,3,23",,,,,,,100,,,,,,,,,,,,,,,,,,,,,,,,,,,,,,,,,,,,,10,7,179,65,,1013,0,,1,5,3,,1,0,,,,,"2x 400m",,"Polar BEAT",,0,,0,168070,250480,30378,,,,,,,,,,,,,,,,,,,,,,,,,,,,,,,,,,,,,,,,,,,
5962947,09479030-ca69-4076-b57c-6fbd6dfaab60,1457638475,60,1548677863,,0,0,9.81,2529,2546,4,7,,,1,0,0.05,,,,602,,,,,,,47.72,,1,,,,,,,,,,,,,,52,86,14.01,15.43,15.47,,,,,,,,,,,,,,,,,"22,4,5,7,5,6,7,41,2",,,,,,,135,,,,,,,,,,,,,,,,,,,,,,,,,,,,,,,,,,,,,4,9,45,73,,1022,,,1,5,3,,1,0,,,,,"Aachen Laufen",,"Polar BEAT",,0,,0,168070,250480,30378,,,,,,,,,,,,,,,,,,,,,,,,,,,,,,,,,,,,,,,,,,,
5962948,07c23c50-cd96-403f-9327-d53396058d53,1458474768,60,1548677863,,0,0,3.89,1132,1132,51,50,,,1,1.2,0.59,,,,268,,,,,,,39.09,,1,,,,,,,,,,,,,,23,82,12.59,12.49,12.77,,,,,,,,,,,,,,,,,"0,1,5,35,39,21,0,0,0",,,,,,,126,,,,,,,,,,,,,,,,,,,,,,,,,,,,,,,,,,,,,5,9,342,78,,1022,,,0,5,3,,1,0,,,,,"Eschweiler Laufen",,"Polar BEAT",,0,,0,168070,250480,30378,,,,,,,,,,,,,,,,,,,,,,,,,,,,,,,,,,,,,,,,,,,
5962949,a4c6356f-a7d8-47dd-a9f0-29ad452e16c9,1401913866,120,1548677863,,0,0,9.83,2062,2062,74,73,,,1,0,0.23,,,,668,,,,,,,60.75,,1,,,,,,,,,,,,,,42,88,17.26,17.24,17.31,,,,,,,,,,,,,,,,,"0,0,0,0,0,8,35,55,1",,,,,,,163,,,,,,,,,,,,,,,,,,,,,,,,,,,,,,,,,,,,,15,12,181,79,,1006,,,0,5,3,,1,0,,,,,"WK 10k Köln Unicup",,"Polar BEAT",,0,,0,168070,250480,30378,,,,,,,,,,,,,,,,,,,,,,,,10,2062,,,0,"Unilauf 2014",,,,,,,0,0,30378,5962949,8539,,,
5962950,6b0451cc-d6a6-43c9-82bc-57c458c78426,1516956634,60,1548677864,,0,0,11.29,1986,2022,28,41,,,1,0,0.09,,,,343,126,144,,,,,,,1,,,,,,,,,,,,,,27,,,21.59,,11.8,-9.9,92,78,,1,106,97,,,,,,,,,"9,12,79,0,0,0,0","1,96,3,0,0","92,0,0,1,8",,,,,,,,,,,,,,,,,,,,,,,,,,,,,,,,,,,,,,,,,14.3,7,0,183,90,,,0,,0,6,3,,1,0,,,Cycling,,,,"Polar M430",43,0,,0,168072,,30378,,,,,,,,,,,,,,,,,,,,,,,,,,,,,,,,,,,,,,,,,,,
5962951,2df64749-d00d-44f5-b18b-d146ab09b821,1400366386,120,1548677864,,0,0,8.08,2651,3345,101,100,,,1,1.2,0.52,,,194,531,,,,,,,35.48,,1,,,,,,,,,,,,,,55,79,11.21,11.4,11.69,,,,,,,,,,,,,,,,,"11,11,28,30,7,7,4,1,0",,,,,,,116,,,,,,,,,,,,,,,,,,,,,,,,,,,,,,,,,,,,,13,2,72,77,,1021,0,,1,3,3,,1,0,,,,,"Regenerativer DL",,"Polar BEAT",,0,,0,168070,250480,30378,,,,,,,,,,,,,,,,,,,,,,,,,,,,,,,,,,,,,,,,,,5,
5962952,1c431cfa-aab0-4952-96b0-71595b6bf9d6,1360603264,60,1548677865,,0,0,13.96,4680,4734,59,58,,,1,0,0.17,0.99,0.8,,966,148,210,,,,50.54,36.04,50.81,1,,,,,,,,,,,,,,119,,10.83,11.76,11.86,-2.7,,,,,,,,,,,,,,,,"20,6,14,18,19,14,8,1,0","3,13,64,17,2",,,,,,,,,,,,,,,,,,,,,,,,,,,,,,,,,,,,,,,,,,73.9,-3,12,84,69,,1003,0,,1,5,3,,1,0,,,,,,,"Polar BEAT",,0,,0,168070,250480,30378,,,,,,,,,,,,,,,,,,,,,,,,,,,,,,,,,,,,,,,,,,,
5962953,,1413457860,120,1548677865,,0,0,7,0,0,,,,,0,,,,,,473,,,,,,,,,1,,,,,,,,,,,,,,0,,,,,,,,,,,,,,,,,,,,,,,,,,,,,,,,,,,,,,,,,,,,,,,,,,,,,,,,,,,,,,,,,,,,,,,,,,1,,,0,0,,,,,"Einlaufen + Dehnen",,"Polar BEAT",,0,,0,168070,250480,30378,,,,,,,,,,,,,,,,,,,,,,,,,,,,,,,,,,,,,,,,,,,
5962954,f32855fa-6973-465f-919e-e1f07203a7f6,1410293688,120,1548677867,,0,0,2.25,646,646,29,24,,,1,0.8,0.46,,,,151,,,,,,,37.94,,1,,,,,,,,,,,,,,13,81,12.73,12.59,13.07,,,,,,,,,,,,,,,,,"2,1,2,20,61,14,0,0,0",,,,,,,129,,,,,,,,,,,,,,,,,,,,,,,,,,,,,,,,,,,,,15,3,10,82,,1020,0,,1,5,3,,1,0,,,,,Einlaufen,,"Polar BEAT",,0,,0,168070,250480,30378,,,,,,,,,,,,,,,,,,,,,,,,,,,,,,,,,,,,,,,,,,,
5962955,72f34e08-9cae-4386-b049-67ff8fee8457,1466954138,120,1548677868,,0,0,9.71,2198,2198,214,214,,,1,3,0.62,,,757,664,,,,,,,55.52,,1,,,,,,,,,,,,,,45,86,16.51,16.28,17.29,,,,,,,,,,,,,,,,,"1,2,3,5,8,13,30,32,5",,,,,,,154,,,,,,,,,,,,,,,,,,,,,,,,,,,,,,,,,,,,,17,7,259,71,,1018,5,,0,6,3,,1,0,,,,,"Aachen Laufen",,"Polar BEAT",,0,,0,168070,250480,30378,,,,,,,,,,,,,,,,,,,,,,,,,,,,,,,,,,,,,,,,,,"4,4",
5962956,f6d07d4f-803c-46da-b2a6-7ba0aaee5eac,1511714563,60,1548677868,,0,0,4.91,1187,1187,72,72,,,1,1.7,0.63,1.22,0.94,311,265,145,177,,,,77.8,49.33,79.23,1,,,,,,,,,,,,,,29,84,15.2,15.16,15.35,21.9,,,,,,,,,,,,,,,,"0,1,1,3,17,32,34,13,0","1,50,2,48,0",,,,,,148,,,,,,,,,,,,,,,,,,,,,,,,,,,,,,,,,,,,58,4,24,240,75,,1020,,,1,8,1,,1,0,I1.000|4:18-I1.000|4:17-I1.000|4:22-I1.000|3:27-I0.912|3:24,,Running,,,,"Polar M430",43,0,,0,168070,250480,30378,,,,,,,,,,,,,,,,,,,,,,,,,,,,,,,,,,,,,,,,,,4,
5962957,632918ca-8336-4222-b301-a42a63bbb074,1542456872,60,1548677869,,0,0,12.4,4387,4398,385,381,,,1,4.9,0.63,1.47,0.99,666,927,136,161,,,,52.67,33.51,54.71,1,,,,,,,,,,,,,,78,80,10.82,10.31,12.91,4,,,,,,,,,,,,,,,,"20,18,35,22,4,1,0,0,0","1,56,44,0,0",,,,,,106,,,,,,,,,,,,,,,,,,,,,,,,,,,,,,,,,,,,31.3,6,28,90,64,,1027,1,305,0,11,3,,1,0,I11.168|1:05:37-I0.107|0:25-I0.133|0:54-I0.105|0:27-I0.130|0:55-I0.094|0:28-I0.118|1:03-I0.104|0:29-I0.121|1:02-I0.095|0:28-I0.220|1:33,,Running,,,,"Polar M430",43,0,,0,168070,250480,30378,,,,,,,,,,,,,,,,,,,,,,,,,,,,,,,,,,,,,,,,,,"3,4,4",
5962958,035e2bae-5294-4de4-a398-a788b7801df8,1405168542,120,1548677869,,0,0,6.81,3180,3182,118,87,,,1,1.8,0.53,,,169,459,,,,,,,22.91,,1,,,,,,,,,,,,,,66,76,7.91,10.72,11.24,,,,,,,,,,,,,,,,,"38,3,9,20,20,9,1,0,0",,,,,,,85,,,,,,,,,,,,,,,,,,,,,,,,,,,,,,,,,,,,,17,10,267,93,,1015,,,0,4,3,,1,0,,,,,Einlaufen,,"Polar BEAT",,0,,0,168070,250480,30378,,,,,,,,,,,,,,,,,,,,,,,,,,,,,,,,,,,,,,,,,,4,
5962959,1171f647-43f6-4243-9a2e-e68c3dc758c7,1454149948,60,1548677869,,0,0,9,2630,2654,318,227,,,1,4.1,0.69,,,547,625,,,,,,,40.96,,1,,,,,,,,,,,,,,54,81,13.44,12.51,14.15,,,,,,,,,,,,,,,,,"1,7,13,17,36,24,2,0,0",,,,,,,127,,,,,,,,,,,,,,,,,,,,,,,,,,,,,,,,,,,,,8,33,208,85,,1006,,,0,6,3,,1,0,,,,,"Balve Laufen",,"Polar BEAT",,0,,0,168070,250480,30378,,,,,,,,,,,,,,,,,,,,,,,,,,,,,,,,,,,,,,,,,,3,
5962960,643d62a5-ba86-4b8f-b592-74d45bcbfbfb,1363514750,60,1548677870,,0,0,14,4238,4388,36,36,,,1,0,0.07,1.03,0.73,,973,160,210,,,,51.47,40.61,51.63,1,,,,,,,,,,,,,,138,,11.97,12.54,12.6,6.8,,,,,,,,,,,,,,,,"9,3,8,20,29,24,5,1,1","3,3,44,49,2",,,,,,,,,,,,,,,,,,,,,,,,,,,,,,,,,,,,,,,,,,88.3,2,11,97,58,,1008,2,,0,5,3,,1,0,,,,,,,"Polar BEAT",,0,,0,168070,250480,30378,,,,,,,,,,,,,,,,,,,,,,,,,,,,,,,,,,,,,,,,,,,
5962961,a510af2b-e191-4fa3-b9aa-cc68486c4f8b,1403436812,120,1548677871,,0,0,18.44,5034,5100,247,247,,,1,2.4,0.54,,,791,1238,,,,,,,46.81,,1,,,,,,,,,,,,,,104,83,13.42,13.33,13.68,,,,,,,,,,,,,,,,,"1,1,3,10,35,44,5,1,0",,,,,,,132,,,,,,,,,,,,,,,,,,,,,,,,,,,,,,,,,,,,,18,4,351,60,,1021,6,,0,5,3,,1,0,,,,,"Lockerer DL",,"Polar BEAT",,0,,0,168070,250480,30378,,,,,,,,,,,,,,,,,,,,,,,,,,,,,,,,,,,,,,,,,,"4,5",
5962962,1b7d2321-3de5-4a59-8994-29b9ba4e2868,1436566532,120,1548677871,,0,0,5,977,977,29,29,,,1,0,0.08,,,,332,,,,,,,63.28,,1,,,,,,,,,,,,,,20,89,18.51,18.65,18.68,,,,,,,,,,,,,,,,,"0,0,0,0,0,0,28,48,23",,,,,,,173,,,,,,,,,,,,,,,,,,,,,,,,,,,,,,,,,,,,,17,9,91,51,,1019,,,1,3,3,,1,0,,,,,"Aachen Laufen",,"Polar BEAT",,0,,0,168070,250480,30378,,,,,,,,,,,,,,,,,,,,,,,,,,,,,,,,,,,,,,,,,,,
5962963,fe22a138-a747-4c83-be76-40c0bcfc4f57,1429648579,120,1548677872,,0,0,10.95,3872,4204,0,2,,,1,0,0.02,,,,659,,,,,,,33.2,,1,,,,,,,,,,,,,,80,75,10.22,14.08,14.11,,,,,,,,,,,,,,,,,"53,4,4,2,1,2,2,28,4",,,,,,,113,,,,,,,,,,,,,,,,,,,,,,,,,,,,,,,,,,,,,14,11,350,45,,1030,,,1,3,3,,1,0,,,,,"Aachen Laufen",,"Polar BEAT",,0,,0,168070,250480,30378,,,,,,,,,,,,,,,,,,,,,,,,,,,,,,,,,,,,,,,,,,,
5962964,27bbc141-3daa-41f8-a003-7fe221e0845f,1423515505,60,1548677873,,0,0,11.13,3056,3159,124,127,,,1,0.9,0.47,,,,744,,,,,,,44.72,,1,,,,,,,,,,,,,,63,82,13.24,13.24,13.44,,,,,,,,,,,,,,,,,"2,1,2,12,38,39,6,0,0",,,,,,,133,,,,,,,,,,,,,,,,,,,,,,,,,,,,,,,,,,,,,4,6,295,96,,1032,0,,1,5,3,,1,0,,,,,"Aachen Laufen",,"Polar BEAT",,0,,0,168070,250480,30378,,,,,,,,,,,,,,,,,,,,,,,,,,,,,,,,,,,,,,,,,,,
5962965,86c0f98e-a053-4fcd-b832-8460578bce0f,1428156284,120,1548677873,,0,0,22.01,5720,5733,491,492,,,1,4.6,0.69,,,669,1506,,,,,,,50.26,,1,,,,,,,,,,,,,,118,86,14.41,14.11,14.94,,,,,,,,,,,,,,,,,"1,1,3,8,24,38,23,2,0",,,,,,,134,,,,,,,,,,,,,,,,,,,,,,,,,,,,,,,,,,,,,7,19,1,53,,1020,,,0,4,3,,1,0,,,,,"Balve Laufen",,"Polar BEAT",,0,,0,168070,250480,30378,,,,,,,,,,,,,,,,,,,,,,,,,,,,,,,,,,,,,,,,,,"4,4,4",
5962966,c40fc378-5704-442b-897d-c55e6b85a517,1528219716,120,1548677874,,0,0,2.73,886,886,2,8,,,1,0,0.12,,0.87,,177,135,146,,,,59.11,33.52,59.01,1,,,,,,,,,,,,,,15,81,11.05,11.19,11.17,-3,,,,,,,,,,,,,,,,"5,6,29,40,17,2,0,0,0","3,57,40,0,0",,,,,,114,,,,,,,,,,,,,,,,,,,,,,,,,,,,,,,,,,,,15.7,28,13,33,46,,1008,,,0,5,3,,1,0,I1.000|5:23-I1.000|5:27-I0.734|3:58,,Running,,,,"Polar M430",43,0,,0,168070,250480,30378,,,,,,,,,,,,,,,,,,,,,,,,,,,,,,,,,,,,,,,,,,,
5962967,d07834f6-4978-4a4d-83f1-63985717c711,1481146693,60,1548677874,,0,0,5.19,1667,1667,33,36,,,1,0,0.19,,,,349,,,,,,,35.4,,1,,,,,,,,,,,,,,34,81,11.28,11.26,11.33,,,,,,,,,,,,,,,,,"3,7,34,36,18,1,1,1,0",,,,,,,115,,,,,,,,,,,,,,,,,,,,,,,,,,,,,,,,,,,,,7,7,205,62,,1033,0,,1,5,3,,1,0,,,,,"Aachen Laufen",,"Polar BEAT",,0,,0,168070,250480,30378,,,,,,,,,,,,,,,,,,,,,,,,,,,,,,,,,,,,,,,,,,,
5962968,206059ac-3634-4044-8614-b21c0ce6feb3,1519242507,60,1548677874,,0,0,10.59,1799,1800,54,45,,,1,0,0.1,2.55,,,280,121,163,,,,,,,1,,,,,,,,,,,,,,23,,,22.55,,10.2,-23.6,108,93,,1,132,118,,,,,,,,,"10,23,41,26,0,0,0","18,62,19,1,0","85,5,0,1,9",,,,,,,,,,,,,,,,,,,,,,,,,,,,,,,,,,,,,,,,,22.5,2,4,38,63,,,0,,1,3,3,,1,0,,,Cycling,,,,"Polar M430",43,0,,0,168072,,30378,,,,,,,,,,,,,,,,,,,,,,,,,,,,,,,,,,,,,,,,,,,
5962969,73191566-2469-4ff6-bfdc-5ae0776f8c47,1524852884,120,1548677875,,0,0,10.69,1795,1795,56,43,,,1,0,0.13,2.28,,,283,118,135,,,,,,,1,,,,,,,,,,,,,,19,,,21.99,,5,-30.2,108,95,,1,127,116,,,,,,,,,"4,12,82,1,0,0,0","1,99,0,0,0","89,1,0,1,10",,,,,,,,,,,,,,,,,,,,,,,,,,,,,,,,,,,,,,,,,8.8,21,7,163,35,,1008,,,0,3,3,,1,0,,,Cycling,,,,"Polar M430",43,0,,0,168072,,30378,,,,,,,,,,,,,,,,,,,,,,,,,,,,,,,,,,,,,,,,,,,
5962970,52b398ff-1afb-47a0-aeeb-b54f316104a8,1519026753,60,1548677875,,0,0,9.64,1496,1497,34,40,,,1,0,0.13,,0.5,,286,136,166,,,,,,,1,,,,,,,,,,,,,,27,,,24.12,,5,-31.8,120,101,,1,141,127,,,,,,,,,"6,4,53,34,3,0,0","1,58,37,4,0","82,7,0,1,9",,,,,,,,,,,,,,,,,,,,,,,,,,,,,,,,,,,,,,,,,28.2,0,7,74,98,,1021,,,0,5,1,,1,0,,,Cycling,,,,"Polar M430",43,0,,0,168072,,30378,,,,,,,,,,,,,,,,,,,,,,,,,,,,,,,,,,,,,,,,,,,
5962971,a3612af5-791d-4a14-88ad-e8463ee14cc4,1534270369,120,1548677875,,0,0,12.45,3057,3059,28,28,,,1,0,0.03,,,,921,170,181,,,,60.91,51.34,61.08,1,,,,,,,,,,,,,,119,83,14.69,14.78,14.82,9.5,,,,,,,,,,,,,,,,"0,0,0,2,11,44,42,1,0","0,0,12,87,1",,,,,,147,,,,,,,,,,,,,,,,,,,,,,,,,,,,,,,,,,,,105.8,25,8,275,46,,1016,,,0,5,3,,1,0,I1.000|4:22-I1.000|4:04-I1.000|3:56-I1.000|4:03-I1.000|3:47-I1.000|3:54-I1.000|3:51-I1.000|3:51-I1.000|4:05-I1.000|4:04-I1.000|4:20-I1.000|4:35-I0.457|2:08,,Running,,,,"Polar M430",43,0,,0,168070,250480,30378,,,,,,,,,,,,,,,,,,,,,,,,,,,,,,,,,,,,,,,,,,,
5962972,e0364812-ca63-42e2-8e30-b8e99888fa08,1367620854,120,1548677876,,0,0,0.47,215,298,13,9,,,1,0,0.13,,,,26,,,,,,,18.66,,1,,,,,,,,,,,,,,4,,8.81,12.8,12.55,,,,,,,,,,,,,,,,,"79,1,1,1,1,1,2,2,12",,,,,,,,,,,,,,,,,,,,,,,,,,,,,,,,,,,,,,,,,,,,12,2,351,69,,1018,0,,1,5,3,,1,0,,,,,,,"Polar BEAT",,0,,0,168070,250480,30378,,,,,,,,,,,,,,,,,,,,,,,,,,,,,,,,,,,,,,,,,,,
5962973,eb31c6db-5301-447a-b668-9d4fd4dfc6b3,1400184585,120,1548677876,,0,0,3.33,940,940,62,59,,,1,1.7,0.64,,,442,222,,,,,,,40.06,,1,,,,,,,,,,,,,,19,82,13.2,12.84,13.64,,,,,,,,,,,,,,,,,"0,1,8,25,32,25,9,0,0",,,,,,,130,,,,,,,,,,,,,,,,,,,,,,,,,,,,,,,,,,,,,11,4,32,71,,1036,0,,0,5,3,,1,0,,,,,Einlaufen,,"Polar BEAT",,0,,0,168070,250480,30378,,,,,,,,,,,,,,,,,,,,,,,,,,,,,,,,,,,,,,,,,,4,
5962974,e9b7d784-ddb5-4426-a2db-3278a8680dd3,1537811651,120,1548677877,,0,0,13.58,4193,4327,104,106,,,1,0,0.06,,0.61,,938,142,183,,,,59.03,39.59,59.58,1,,,,,,,,,,,,,,95,79,11.63,13.9,13.95,16.1,,,,,,,,,,,,,,,,"30,2,4,15,9,2,20,19,0","2,52,16,29,0",,,,,,123,,,,,,,,,,,,,,,,,,,,,,,,,,,,,,,,,,,,68.2,16,5,0,39,,1034,,,0,3,3,,1,0,I3.582|20:55-I1.056|3:44-I0.205|1:51-I1.051|3:39-I0.203|1:33-I1.036|3:41-I0.215|1:41-I1.042|3:34-I0.208|1:20-I1.038|3:39-I0.207|2:35-I1.022|3:42-I0.200|2:28-I1.047|3:35-I0.195|2:27-I1.046|3:30-I0.217|8:16,,Running,,,,"Polar M430",43,0,,0,168070,250480,30378,,,,,,,,,,,,,,,,,,,,,,,,,,,,,,,,,,,,,,,,,,,
5962975,6157a672-0bc6-4815-8172-20bd0656b3e8,1426619721,60,1548677877,,0,0,2.3,737,755,29,26,,,1,0.8,0.47,,,,158,,,,,,,33.52,,1,,,,,,,,,,,,,,15,80,11.41,11.39,11.83,,,,,,,,,,,,,,,,,"7,2,20,45,26,0,0,0,0",,,,,,,117,,,,,,,,,,,,,,,,,,,,,,,,,,,,,,,,,,,,,12,2,72,63,,1024,0,,1,5,3,,1,0,,,,,"Aachen Laufen",,"Polar BEAT",,0,,0,168070,250480,30378,,,,,,,,,,,,,,,,,,,,,,,,,,,,,,,,,,,,,,,,,,,
5962976,89b571a6-05da-4f5a-a12f-58608dd91668,1396868272,120,1548677878,,0,0,9.66,2761,2856,137,137,,,1,1.5,0.44,1.06,0.98,322,478,154,170,,,,58.3,42.24,59.33,1,,,,,,,,,,,,,,77,83,12.89,12.77,13.12,-3.5,,,,,,,,,,,,,,,,"4,2,5,19,38,28,3,0,0","1,5,64,30,0",,,,,,126,,,,,,,,,,,,,,,,,,,,,,,,,,,,,,,,,,,,52.3,18,7,195,71,,1017,3,,0,5,3,,1,0,,,,,"Regenerativer DL",,"Polar BEAT",,0,,0,168070,250480,30378,,,,,,,,,,,,,,,,,,,,,,,,,,,,,,,,,,,,,,,,,,5,
5962977,ecfde704-c8d8-4ff8-95a6-0d662e8ab202,1498431451,120,1548677878,,0,0,12.43,3778,3861,214,216,,,1,2.5,0.46,,,523,854,,,,,,,40.05,,1,,,,,,,,,,,,,,78,77,12.19,11.96,12.58,,,,,,,,,,,,,,,,,"4,2,9,34,47,5,0,0,0",,,,,,,128,,,,,,,,,,,,,,,,,,,,,,,,,,,,,,,,,,,,,25,12,273,59,,1013,0,,1,3,3,,1,0,,,,,"Aix-en-Provence Laufen",,"Polar BEAT",,0,,0,168070,250480,30378,,,,,,,,,,,,,,,,,,,,,,,,,,,,,,,,,,,,,,,,,,"4,5,5",
5962978,730cb1d8-1255-40fe-94ce-4d86093dbbd8,1440706418,120,1548677878,,0,0,2.19,690,690,57,46,,,1,1.6,0.63,,,401,150,,,,,,,34.02,,1,,,,,,,,,,,,,,14,81,12.13,11.53,12.84,,,,,,,,,,,,,,,,,"7,3,24,31,25,10,0,0,0",,,,,,,118,,,,,,,,,,,,,,,,,,,,,,,,,,,,,,,,,,,,,13,6,205,97,,1012,,,0,4,3,,1,0,,,,,"Aachen Laufen",,"Polar BEAT",,0,,0,168070,250480,30378,,,,,,,,,,,,,,,,,,,,,,,,,,,,,,,,,,,,,,,,,,5,
5962979,ded1655d-a98d-4c61-8668-54501070a279,1407018238,120,1548677881,,0,0,2.67,1179,1293,8,9,,,1,0,0,,,,179,,,,,,,23.15,,1,,,,,,,,,,,,,,24,78,8.15,8.68,8.72,,,,,,,,,,,,,,,,,"73,20,8,0,0,0,0,0,0",,,,,,,87,,,,,,,,,,,,,,,,,,,,,,,,,,,,,,,,,,,,,20,1,171,79,,1008,0,,1,5,3,,1,0,,,,,Auslaufen,,"Polar BEAT",,0,,0,168070,250480,30378,,,,,,,,,,,,,,,,,,,,,,,,,,,,,,,,,,,,,,,,,,,
5962980,,1401917448,120,1548677881,,0,0,5,0,0,,,,,0,,,,,,,,,,,,,,,1,,,,,,,,,,,,,,0,,,,,,,,,,,,,,,,,,,,,,,,,,,,,,,,,,,,,,,,,,,,,,,,,,,,,,,,,,,,,,,,,,,,,,,,,,1,,,0,0,,,,,Ein/Auslaufen,,"Polar BEAT",,0,,0,168070,250480,30378,,,,,,,,,,,,,,,,,,,,,,,,,,,,,,,,,,,,,,,,,,,
5962981,a05b47e5-f7ba-4cf6-a9c5-e582ee0ebf3b,1400151495,120,1548677881,,0,0,13.28,3544,3614,157,157,,,1,1.6,0.43,1.04,1,494,603,146,172,,,,68.2,46.83,69.2,1,,,,,,,,,,,,,,81,82,13.69,13.59,13.95,0.2,,,,,,,,,,,,,,,,"1,0,1,6,28,54,8,1,0","0,28,63,9,0",,,,,,137,,,,,,,,,,,,,,,,,,,,,,,,,,,,,,,,,,,,45.2,9,7,27,69,,1036,4,,0,5,3,,1,0,,,,,"Lockerer DL",,"Polar BEAT",,0,,0,168070,250480,30378,,,,,,,,,,,,,,,,,,,,,,,,,,,,,,,,,,,,,,,,,,4,
5962982,0cab4b23-20fd-443a-8d94-e8be0fb39f65,1392751981,60,1548677882,,0,0,9.02,2295,2301,103,102,,,1,0,0.01,0.65,0.49,,462,161,183,,,,63.21,48.19,64.11,1,,,,,,,,,,,,,,81,84,14.2,16.16,16.23,10.2,,,,,,,,,,,,,,,,"26,4,1,1,1,1,2,65,0","0,26,6,50,17",,,,,,140,,,,,,,,,,,,,,,,,,,,,,,,,,,,,,,,,,,,93.1,6,6,189,80,,1013,0,,1,4,3,,1,0,,,,,"4x2000m in 6:35",,"Polar BEAT",,0,,0,168070,250480,30378,,,,,,,,,,,,,,,,,,,,,,,,,,,,,,,,,,,,,,,,,,,
5962983,92c7a0af-3d29-45e1-8831-096fd5e194bb,1542993763,60,1548677882,,0,0,6.27,2025,2028,32,36,,,1,0,0.16,1.08,0.89,,402,132,148,,,,61.09,35.57,61.43,1,,,,,,,,,,,,,,31,80,11.18,11.18,11.31,-2.4,,,,,,,,,,,,,,,,"2,6,25,60,8,0,0,0,0","2,89,9,0,0",,,,,,116,,,,,,,,,,,,,,,,,,,,,,,,,,,,,,,,,,,,16.5,0,9,189,100,,1016,0,320,1,9,3,,1,0,I1.000|5:15-I1.000|5:23-I1.000|5:21-I1.000|5:22-I1.000|5:27-I1.000|5:29-I0.269|1:32,,Running,,,,"Polar M430",43,0,,0,168070,250480,30378,,,,,,,,,,,,,,,,,,,,,,,,,,,,,,,,,,,,,,,,,,,
5962984,6eedd311-7eb9-418d-9fd6-bc730865ed50,1405629816,120,1548677883,,0,0,3.26,1010,1142,0,0,,,1,0,0.01,,,,167,,,,,,,35.88,,1,,,,,,,,,,,,,,20,74,11.83,14.27,14.21,,,,,,,,,,,,,,,,,"45,2,2,3,4,4,6,10,23",,,,,,,131,,,,,,,,,,,,,,,,,,,,,,,,,,,,,,,,,,,,,25,4,54,63,,1019,0,,0,3,3,,1,0,,,,,"2x 4x 300m",,"Polar BEAT",,0,,0,168070,250480,30378,,,,,,,,,,,,,,,,,,,,,,,,,,,,,,,,,,,,,,,,,,,
5962985,1297b0d5-1721-4bd5-a322-f561c01bb25b,1425408498,60,1548677883,,0,0,21.01,5827,6483,205,204,,,1,1,0.45,,,,1411,,,,,,,46.44,,1,,,,,,,,,,,,,,121,82,13.1,14.15,14.34,,,,,,,,,,,,,,,,,"13,3,4,10,14,15,33,8,0",,,,,,,132,,,,,,,,,,,,,,,,,,,,,,,,,,,,,,,,,,,,,4,14,241,89,,1018,,,1,5,3,,1,0,,,,,"3 Doppel",,"Polar BEAT",,0,,0,168070,250480,30378,,,,,,,,,,,,,,,,,,,,,,,,,,,,,,,,,,,,,,,,,,,
5962986,4af78aa7-8220-4e0c-9b71-ebf2ee94c62c,1465140581,120,1548677884,,0,0,5.71,1166,1166,9,8,,,1,0,0,,,,395,,,,,,,60.67,,1,,,,,,,,,,,,,,24,86,17.67,17.71,17.77,,,,,,,,,,,,,,,,,"0,0,0,0,0,1,20,80,0",,,,,,,171,,,,,,,,,,,,,,,,,,,,,,,,,,,,,,,,,,,,,23,9,28,61,,1017,,,0,3,3,,1,0,,,,,"Aachen Laufen",,"Polar BEAT",,0,,0,168070,250480,30378,,,,,,,,,,,,,,,,,,,,,,,,,,,,,,,,,,,,,,,,,,,
5962987,9442b90b-7f86-4e15-8501-fa3166f29c74,1528278107,120,1548677884,,0,0,9.56,1485,1547,36,46,,,1,0,0.08,,0.51,,231,116,138,,,,,,,1,,,,,,,,,,,,,,14,,,24.32,,-2.3,-31.6,118,100,,1,136,123,,,,,,,,,"7,5,35,52,1,0,0","0,100,0,0,0","88,2,0,0,10",,,,,,,,,,,,,,,,,,,,,,,,,,,,,,,,,,,,,,,,,6.8,21,7,41,70,,1012,,,0,5,3,,1,0,,,Cycling,,,,"Polar M430",43,0,,0,168072,,30378,,,,,,,,,,,,,,,,,,,,,,,,,,,,,,,,,,,,,,,,,,,
5962988,eb38cd85-5995-4f6a-a69f-8ffbd9ccc5ed,1456736100,60,1548677884,,0,0,6.44,2039,2039,112,109,,,1,1.6,0.47,,,249,449,,,,,,,36.48,,1,,,,,,,,,,,,,,42,84,11.67,11.5,12.02,,,,,,,,,,,,,,,,,"4,10,26,29,26,4,1,0,0",,,,,,,113,,,,,,,,,,,,,,,,,,,,,,,,,,,,,,,,,,,,,0,15,16,81,,1023,,,0,3,3,,1,0,,,,,"Aachen Laufen",,"Polar BEAT",,0,,0,168070,250480,30378,,,,,,,,,,,,,,,,,,,,,,,,,,,,,,,,,,,,,,,,,,4,
5962989,f7c99b89-7acd-445c-8a69-4951a0f8f289,1481579428,60,1548677885,,0,0,1.57,519,739,4,4,,,1,0,0,,,,105,,,,,,,31.1,,1,,,,,,,,,,,,,,10,80,10.85,11.13,11.14,,,,,,,,,,,,,,,,,"8,8,20,55,9,0,0,0,0",,,,,,,113,,,,,,,,,,,,,,,,,,,,,,,,,,,,,,,,,,,,,4,4,180,88,,1027,0,,1,5,3,,1,0,,,,,"Aachen Laufen",,"Polar BEAT",,0,,0,168070,250480,30378,,,,,,,,,,,,,,,,,,,,,,,,,,,,,,,,,,,,,,,,,,,
5962990,a4609d3d-2038-4fdd-8afc-c2cc5e463a28,1472075009,120,1548677885,,0,0,11.57,3525,3545,181,186,,,1,2.3,0.56,,,601,789,,,,,,,39.72,,1,,,,,,,,,,,,,,73,79,12.1,12.8,13.18,,,,,,,,,,,,,,,,,"12,3,6,15,33,24,5,2,0",,,,,,,125,,,,,,,,,,,,,,,,,,,,,,,,,,,,,,,,,,,,,24,4,121,61,,1019,0,,1,3,3,,1,0,,,,,"Aachen Laufen",,"Polar BEAT",,0,,0,168070,250480,30378,,,,,,,,,,,,,,,,,,,,,,,,,,,,,,,,,,,,,,,,,,4,
5962991,50408b3b-b725-45ea-9e3b-d7fe242e43fd,1348601694,120,1548677886,,0,0,38.75,4659,4717,207,210,,,1,0,0.14,,0.56,,1473,129,210,,,,,,,1,,,,,,,,,,,,,,72,,,32.68,,8.3,-38.9,238,186,,1,286,242,,,,,,,,,"10,4,10,19,22,16,19","3,89,5,1,2","47,13,14,14,12",,,,,,,,,,,,,,,,,,,,,,,,,,,,,,,,,,,,,,,,,28.4,17,3,11,68,,1004,,,1,5,3,,1,0,,,,,,,"Polar BEAT",,0,,0,168072,,30378,,,,,,,,,,,,,,,,,,,,,,,,,,,,,,,,,,,,,,,,,,,
5962992,29f8c5f1-6638-457b-abf4-dde870a914d6,1415564550,60,1548677887,,0,0,10.58,3373,4830,175,175,,,1,2.2,0.63,,,224,686,,,,,,,37.41,,1,,,,,,,,,,,,,,70,83,11.46,11.75,12.36,,,,,,,,,,,,,,,,,"14,18,20,16,20,3,4,4,1",,,,,,,113,,,,,,,,,,,,,,,,,,,,,,,,,,,,,,,,,,,,,8,10,150,88,,1009,,,1,5,3,,1,0,,,,,"10x 150m + Ein/Auslaufen",,"Polar BEAT",,0,,0,168070,250480,30378,,,,,,,,,,,,,,,,,,,,,,,,,,,,,,,,,,,,,,,,,,5,
5962993,debd0356-9af1-4601-b851-702f9d9eacbc,1527617303,120,1548677887,,0,0,15.07,3847,3848,50,50,,,1,0,0.03,1.1,,,1076,165,185,,,,60.73,49.78,60.98,1,,,,,,,,,,,,,,141,84,14.14,14.54,14.58,13.9,,,,,,,,,,,,,,,,"2,3,5,7,12,33,32,5,0","0,6,31,49,13",,,,,,140,,,,,,,,,,,,,,,,,,,,,,,,,,,,,,,,,,,,118.1,24,11,259,62,,1013,,,0,3,3,,1,0,I2.888|12:48-I0.972|3:51-I2.050|7:35-I0.967|3:35-I0.979|4:05-I0.994|3:42-I0.974|4:00-I0.969|3:49-I4.277|20:45,,Running,,,,"Polar M430",43,0,,0,168070,250480,30378,,,,,,,,,,,,,,,,,,,,,,,,,,,,,,,,,,,,,,,,,,,
5962994,15daa9b2-a558-48a0-a5e0-04a8c1a6a967,1461877129,120,1548677888,,0,0,2.55,771,771,37,40,,,1,1,0.55,,,,178,,,,,,,36.18,,1,,,,,,,,,,,,,,16,82,12.07,12.05,12.32,,,,,,,,,,,,,,,,,"1,8,6,36,40,9,0,0,0",,,,,,,121,,,,,,,,,,,,,,,,,,,,,,,,,,,,,,,,,,,,,5,2,191,88,,1017,0,,1,3,3,,1,0,,,,,"Aachen Laufen",,"Polar BEAT",,0,,0,168070,250480,30378,,,,,,,,,,,,,,,,,,,,,,,,,,,,,,,,,,,,,,,,,,,
5962995,f0d709f5-ffe2-48d3-a0ce-10e7c2d37ae9,1417878446,60,1548677888,,0,0,15.01,3335,3335,369,373,,,1,3.5,0.66,,,485,983,,,,,,,58.45,,1,,,,,,,,,,,,,,69,87,16.67,16.21,17.24,,,,,,,,,,,,,,,,,"0,0,0,0,0,4,84,12,0",,,,,,,155,,,,,,,,,,,,,,,,,,,,,,,,,,,,,,,,,,,,,4,2,318,98,,,0,,0,5,3,,1,0,,,,,TDL,,"Polar BEAT",,0,,0,168070,250480,30378,,,,,,,,,,,,,,,,,,,,,,,,,,,,,,,,,,,,,,,,,,"4,5,5,5,5,5",
5962996,2b0676f8-7656-4258-b67c-592f49a0a7e5,1417354900,60,1548677888,,0,0,1.96,623,636,9,12,,,1,0,0,,,,135,,,,,,,33.31,,1,,,,,,,,,,,,,,12,83,11.24,11.43,11.45,,,,,,,,,,,,,,,,,"9,5,16,42,23,4,0,0,0",,,,,,,114,,,,,,,,,,,,,,,,,,,,,,,,,,,,,,,,,,,,,3,3,155,92,,1012,0,,0,4,3,,1,0,,,,,Auslaufen,,"Polar BEAT",,0,,0,168070,250480,30378,,,,,,,,,,,,,,,,,,,,,,,,,,,,,,,,,,,,,,,,,,,
5962997,65ca1b26-f185-459f-8237-62d0c079e966,1408392122,120,1548677889,,0,0,5.03,1518,1883,49,34,,,1,0,0.24,,,,336,,,,,,,38.05,,1,,,,,,,,,,,,,,31,82,12.11,12.06,12.35,,,,,,,,,,,,,,,,,"3,3,10,30,47,8,0,0,0",,,,,,,121,,,,,,,,,,,,,,,,,,,,,,,,,,,,,,,,,,,,,14,7,295,80,,1011,0,,0,5,3,,1,0,,,,,"Lauf ABC",,"Polar BEAT",,0,,0,168070,250480,30378,,,,,,,,,,,,,,,,,,,,,,,,,,,,,,,,,,,,,,,,,,,
5962998,c92ba7d0-590d-4fb4-b28d-12469a221450,1499011498,120,1548677889,,0,0,0.01,2,2,0,0,,,1,0,0,,,,0,,,,,,,46.2,,1,,,,,,,,,,,,,,0,53,12.29,12.29,12.29,,,,,,,,,,,,,,,,,"0,0,0,0,100,0,0,0,0",,,,,,,,,,,,,,,,,,,,,,,,,,,,,,,,,,,,,,,,,,,,26,29,327,44,,1017,7,,0,3,3,,1,0,,,,,"Le Tholonet Laufen",,"Polar BEAT",,0,,0,168070,250480,30378,,,,,,,,,,,,,,,,,,,,,,,,,,,,,,,,,,,,,,,,,,,
5962999,a7e38510-3732-4dea-b52b-7d45104527bd,1402856607,120,1548677890,,0,0,11,2952,2952,125,127,,,1,1.6,0.58,,,412,742,,,,,,,45.89,,1,,,,,,,,,,,,,,61,82,13.57,13.51,13.76,,,,,,,,,,,,,,,,,"0,1,2,6,32,53,6,0,0",,,,,,,136,,,,,,,,,,,,,,,,,,,,,,,,,,,,,,,,,,,,,20,5,14,53,,1022,2,,0,5,3,,1,0,,,,,"Lockerer DL",,"Polar BEAT",,0,,0,168070,250480,30378,,,,,,,,,,,,,,,,,,,,,,,,,,,,,,,,,,,,,,,,,,5,
5963000,,1333197402,120,1548677890,,0,0,16.11,0,0,,,,,0,,,,,,1058,,,,,,,,,1,,,,,,,,,,,,,,0,,,,,,,,,,,,,,,,,,,,,,,,,,,,,,,,,,,,,,,,,,,,,,,,,,,,,,,,,,,,,,,,,,,,,,,,,,1,,,0,0,,,,,,,"Polar BEAT",,0,,0,168070,250480,30378,,,,,,,,,,,,,,,,,,,,,,,,,,,,,,,,,,,,,,,,,,,
5963001,db0f939c-edc4-41e9-bec2-aaf1f27c9efb,1427995607,120,1548677890,,0,0,15.01,3908,3909,205,207,,,1,2.2,0.65,,,493,1020,,,,,,,48.64,,1,,,,,,,,,,,,,,81,85,14.07,13.97,14.27,,,,,,,,,,,,,,,,,"1,1,1,7,17,55,17,0,0",,,,,,,136,,,,,,,,,,,,,,,,,,,,,,,,,,,,,,,,,,,,,6,21,315,53,,1021,,,0,5,3,,1,0,,,,,"Aachen Laufen",,"Polar BEAT",,0,,0,168070,250480,30378,,,,,,,,,,,,,,,,,,,,,,,,,,,,,,,,,,,,,,,,,,"5,5",
5963002,39fa78db-604c-4704-a1c5-c15dd4b6314c,1423595748,60,1548677891,,0,0,14.65,4109,4731,146,147,,,1,1.2,0.45,,,,954,,,,,,,44.54,,1,,,,,,,,,,,,,,85,82,12.91,14.92,15.17,,,,,,,,,,,,,,,,,"19,2,7,14,3,2,26,23,2",,,,,,,130,,,,,,,,,,,,,,,,,,,,,,,,,,,,,,,,,,,,,4,9,54,93,,1031,,,1,4,3,,1,0,,,,,"1 Doppel, 2 Einzel, 1 Sprint",,"Polar BEAT",,0,,0,168070,250480,30378,,,,,,,,,,,,,,,,,,,,,,,,,,,,,,,,,,,,,,,,,,,
5963003,6244a2bd-fd1b-41bf-a154-c836edea97d2,1415447651,60,1548677891,,0,0,7.38,2139,2139,157,125,,,1,2,0.59,,,789,495,,,,,,,40.83,,1,,,,,,,,,,,,,,44,85,13.02,12.53,13.45,,,,,,,,,,,,,,,,,"1,2,10,24,38,23,2,0,0",,,,,,,122,,,,,,,,,,,,,,,,,,,,,,,,,,,,,,,,,,,,,12,10,201,74,,1012,1,,0,5,3,,1,0,,,,,"Einlaufen + Lauf ABC",,"Polar BEAT",,0,,0,168070,250480,30378,,,,,,,,,,,,,,,,,,,,,,,,,,,,,,,,,,,,,,,,,,"5,5",
5963004,10d40d61-6db8-456b-a1d5-1f08c5631aa5,1417432667,60,1548677893,,0,0,3.16,888,888,36,42,,,1,0.8,0.57,,,,207,,,,,,,40.1,,1,,,,,,,,,,,,,,18,83,13,12.98,13.15,,,,,,,,,,,,,,,,,"0,2,7,16,47,18,10,0,0",,,,,,,129,,,,,,,,,,,,,,,,,,,,,,,,,,,,,,,,,,,,,3,7,57,94,,1011,1,,0,5,3,,1,0,,,,,Auslaufen,,"Polar BEAT",,0,,0,168070,250480,30378,,,,,,,,,,,,,,,,,,,,,,,,,,,,,,,,,,,,,,,,,,,
5963005,aebf2c6a-00a0-42fe-8593-82f1474bdc34,1497032611,120,1548677894,,0,0,12.29,3488,3579,200,193,,,1,2.1,0.56,,,392,827,,,,,,,43.34,,1,,,,,,,,,,,,,,72,79,13.11,12.98,13.38,,,,,,,,,,,,,,,,,"4,3,6,15,36,26,7,2,0",,,,,,,134,,,,,,,,,,,,,,,,,,,,,,,,,,,,,,,,,,,,,20,10,267,53,,1015,2,,0,5,3,,1,0,,,,,"Aachen Laufen",,"Polar BEAT",,0,,0,168070,250480,30378,,,,,,,,,,,,,,,,,,,,,,,,,,,,,,,,,,,,,,,,,,4,
5963006,aa015319-332b-4fbd-8371-19a41d35caae,1527670345,120,1548677895,,0,0,10.57,1721,1743,29,38,,,1,0,0.13,,0.56,,286,122,144,,,,,,,1,,,,,,,,,,,,,,21,,,23.04,,1.4,-35.9,102,90,,1,120,111,,,,,,,,,"4,15,64,17,0,0,0","0,97,2,0,0","89,2,0,1,9",,,,,,,,,,,,,,,,,,,,,,,,,,,,,,,,,,,,,,,,,11.4,20,5,341,79,,,,,0,3,3,,1,0,,,Cycling,,,,"Polar M430",43,0,,0,168072,,30378,,,,,,,,,,,,,,,,,,,,,,,,,,,,,,,,,,,,,,,,,,,
5963007,5192e51b-efe4-405e-bdbd-7e53faf6acbb,1472908566,120,1548677895,,0,0,1.66,752,753,24,24,,,1,1.2,0.76,,,,110,,,,,,,21.62,,1,,,,,,,,,,,,,,15,71,8.05,9.1,9.38,,,,,,,,,,,,,,,,,"47,22,22,7,3,0,0,0,0",,,,,,,93,,,,,,,,,,,,,,,,,,,,,,,,,,,,,,,,,,,,,22,4,238,62,,1018,5,,0,5,3,,1,0,,,,,"Aachen Laufen",,"Polar BEAT",,0,,0,168070,250480,30378,,,,,,,,,,,,,,,,,,,,,,,,,,,,,,,,,,,,,,,,,,,
5963008,f45f49ff-54eb-49eb-a1f0-9b89d090dacd,1496347925,120,1548677895,,0,0,3.31,1064,1064,63,62,,,1,1.6,0.57,,,403,216,,,,,,,34.39,,1,,,,,,,,,,,,,,22,78,11.57,11.28,12.06,,,,,,,,,,,,,,,,,"6,11,24,35,18,6,0,0,0",,,,,,,120,,,,,,,,,,,,,,,,,,,,,,,,,,,,,,,,,,,,,23,4,43,54,,1019,0,,0,5,3,,1,0,,,,,"Aachen Laufen",,"Polar BEAT",,0,,0,168070,250480,30378,,,,,,,,,,,,,,,,,,,,,,,,,,,,,,,,,,,,,,,,,,5,
5963009,20c8a0b5-80bb-4e9e-a028-094533e68c40,1504258641,120,1548677896,,0,0,9.87,3582,3582,353,351,,,1,5.1,0.84,1.06,0.87,762,881,154,170,,,,43.42,31.94,45.36,1,,,,,,,,,,,,,,100,82,10.88,10.11,11.63,12.9,,,,,,,,,,,,,,,,"34,13,30,19,4,0,0,0,0","1,9,55,35,0",,,,,,101,,,,,,,,,,,,,,,,,,,,,,,,,,,,,,,,,,,,56.8,10,1,234,100,,,2,,0,4,3,,1,0,I4.728|31:05-I5.140|28:40,,Running,,,,"Polar M430",43,0,,0,168070,250480,30378,,,,,,,,,,,,,,,,,,,,,,,,,,,,,,,,,,,,,,,,,,2,
5963010,c37ffe25-1a33-4765-b65e-7e1572c71af8,1531648710,120,1548677897,,0,0,21.17,6056,6062,451,449,,,1,4.1,0.64,1.06,0.96,476,1747,166,186,,,,52.29,44.83,53.68,1,,,,,,,,,,,,,,223,83,13.21,12.79,13.59,5.3,,,,,,,,,,,,,,,,"3,4,8,19,28,33,4,0,0","0,2,27,66,5",,,,,,126,,,,,,,,,,,,,,,,,,,,,,,,,,,,,,,,,,,,104.3,19,7,45,68,,1018,,,0,3,3,,1,0,I1.000|4:54-I1.000|4:23-I1.000|4:36-I1.000|4:37-I1.000|4:43-I1.000|4:43-I1.000|4:22-I1.000|4:24-I1.000|4:53-I1.000|5:32-I1.000|4:33-I1.000|5:15-I1.000|5:06-I1.000|4:33-I1.000|4:44-I1.000|4:35-I1.000|4:38-I1.000|5:06-I1.000|4:28-I1.000|4:27-I1.000|5:38-I0.178|0:54,,Running,,,,"Polar M430",43,0,,0,168070,250480,30378,,,,,,,,,,,,,,,,,,,,,,,,,,,,,,,,,,,,,,,,,,"4,4,4,5,5",
5963011,1016e9f2-8ed9-49cb-93c5-d76ae797354d,1487009176,60,1548677897,,0,0,10.31,2937,2941,136,150,,,1,1.8,0.41,,,741,696,,,,,,,42.6,,1,,,,,,,,,,,,,,61,80,12.86,12.86,13.62,,,,,,,,,,,,,,,,,"3,1,5,18,41,26,6,0,0",,,,,,,132,,,,,,,,,,,,,,,,,,,,,,,,,,,,,,,,,,,,,5,10,99,70,,1025,0,,1,3,3,,1,0,,,,,"Aachen Laufen",,"Polar BEAT",,0,,0,168070,250480,30378,,,,,,,,,,,,,,,,,,,,,,,,,,,,,,,,,,,,,,,,,,4,
5963012,74816a70-0136-4a8e-b560-fa554bd869fc,1401393702,120,1548677898,,0,0,8.76,2477,2477,123,136,,,1,1.6,0.55,,,,604,,,,,,,42.5,,1,,,,,,,,,,,,,,51,83,12.96,12.85,13.18,,,,,,,,,,,,,,,,,"4,4,4,7,50,31,1,1,0",,,,,,,128,,,,,,,,,,,,,,,,,,,,,,,,,,,,,,,,,,,,,12,5,57,88,,1018,0,,0,5,3,,1,0,,,,,Auslaufen,,"Polar BEAT",,0,,0,168070,250480,30378,,,,,,,,,,,,,,,,,,,,,,,,,,,,,,,,,,,,,,,,,,,
5963013,a6bcfa54-d80a-4c3d-b495-a8adc224929f,1464729604,120,1548677898,,0,0,4.69,1353,1370,45,66,,,1,0.9,0.47,,,,326,,,,,,,39.97,,1,,,,,,,,,,,,,,28,82,12.5,12.63,12.78,,,,,,,,,,,,,,,,,"3,3,6,21,36,29,2,0,0",,,,,,,127,,,,,,,,,,,,,,,,,,,,,,,,,,,,,,,,,,,,,16,1,98,84,,1013,0,,0,5,3,,1,0,,,,,"Aachen Laufen",,"Polar BEAT",,0,,0,168070,250480,30378,,,,,,,,,,,,,,,,,,,,,,,,,,,,,,,,,,,,,,,,,,,
5963014,2d123162-873b-4d0b-aea2-46d1be4d1906,1412592637,120,1548677899,,0,0,13.11,3973,4008,170,171,,,1,1.6,0.45,,,339,882,,,,,,,40.35,,1,,,,,,,,,,,,,,82,82,12.09,12.06,12.32,,,,,,,,,,,,,,,,,"5,5,14,26,39,8,1,1,0",,,,,,,121,,,,,,,,,,,,,,,,,,,,,,,,,,,,,,,,,,,,,13,4,155,96,,1012,1,,0,5,3,,1,0,,,,,"Langsamer DL",,"Polar BEAT",,0,,0,168070,250480,30378,,,,,,,,,,,,,,,,,,,,,,,,,,,,,,,,,,,,,,,,,,"5,5",
5963015,0e0153f6-703f-43cd-a473-5ca4ce41985b,1398285369,120,1548677899,,0,0,17,4561,4650,228,235,,,1,2.3,0.51,1.12,1.06,425,954,159,180,,,,60.27,47.45,61.24,1,,,,,,,,,,,,,,142,83,13.66,13.81,14.16,-6.2,,,,,,,,,,,,,,,,"4,1,2,7,23,45,17,2,0","0,4,47,48,0",,,,,,135,,,,,,,,,,,,,,,,,,,,,,,,,,,,,,,,,,,,76.5,15,2,29,68,,1019,,,1,5,3,,1,0,,,,,"Zügiger DL",,"Polar BEAT",,0,,0,168070,250480,30378,,,,,,,,,,,,,,,,,,,,,,,,,,,,,,,,,,,,,,,,,,"5,5",
5963016,,1465854873,120,1548677899,,0,0,,0,0,,,,,0,,,,,,,,,,,,,,,1,,,,,,,,,,,,,,0,,,,,,,,,,,,,,,,,,,,,,,,,,,,,,,,,,,,,,,,,,,,,,,,,,,,,,,,,,,,,,,,,,,,,,,,,,1,,,0,0,,,,,"Gym ",,"Polar BEAT",,0,,0,168075,,30378,,,,,,,,,,,,,,,,,,,,,,,,,,,,,,,,,,,,,,,,,,,
5963017,0042b55a-222e-4eea-aa5a-1f26cb693f26,1476826231,120,1548677900,,0,0,1.62,483,483,26,17,,,1,0.9,0.5,,,,111,,,,,,,35.1,,1,,,,,,,,,,,,,,10,82,12.53,12.3,13.08,,,,,,,,,,,,,,,,,"1,7,13,34,33,8,1,2,1",,,,,,,123,,,,,,,,,,,,,,,,,,,,,,,,,,,,,,,,,,,,,9,5,242,93,,1020,0,,1,6,3,,1,0,,,,,"Aachen Laufen",,"Polar BEAT",,0,,0,168070,250480,30378,,,,,,,,,,,,,,,,,,,,,,,,,,,,,,,,,,,,,,,,,,,
5963018,e491b842-688a-48c5-bcd9-585921fdf96e,1535700906,120,1548677900,,0,0,14.93,4320,4323,45,44,,,1,0,0.03,1.11,0.93,,1110,154,167,,,,57.43,43.02,57.64,1,,,,,,,,,,,,,,117,81,12.47,12.5,12.58,1.6,,,,,,,,,,,,,,,,"0,1,3,29,54,12,2,0,0","0,4,83,12,0",,,,,,128,,,,,,,,,,,,,,,,,,,,,,,,,,,,,,,,,,,,50.7,14,12,23,74,,,,,0,3,3,,1,0,I1.000|5:20-I1.000|4:40-I1.000|4:46-I1.000|4:55-I1.000|4:40-I1.000|4:32-I1.000|4:41-I1.000|4:45-I1.000|4:43-I1.000|4:51-I1.000|4:47-I1.000|4:44-I1.000|4:53-I1.000|5:02-I0.932|4:44,,Running,,,,"Polar M430",43,0,,0,168070,250480,30378,,,,,,,,,,,,,,,,,,,,,,,,,,,,,,,,,,,,,,,,,,,
5963019,2a54dc18-a115-411c-ac94-0df074c54f92,1446924668,60,1548677900,,0,0,1.77,588,622,43,50,,,1,1.5,0.68,,,,121,,,,,,,31.33,,1,,,,,,,,,,,,,,12,83,11.16,10.9,11.49,,,,,,,,,,,,,,,,,"6,7,29,58,0,0,0,0,0",,,,,,,109,,,,,,,,,,,,,,,,,,,,,,,,,,,,,,,,,,,,,17,20,210,85,,1023,,,1,5,3,,1,0,,,,,"Aachen Laufen",,"Polar BEAT",,0,,0,168070,250480,30378,,,,,,,,,,,,,,,,,,,,,,,,,,,,,,,,,,,,,,,,,,,
5963020,88cd0cea-2838-4998-a25a-f7d3954fb9f1,1463221827,120,1548677901,,0,0,5.33,1744,1744,98,95,,,1,1.9,0.51,,,513,375,,,,,,,34.68,,1,,,,,,,,,,,,,,36,82,11.42,11.17,11.84,,,,,,,,,,,,,,,,,"12,12,18,37,17,3,0,0,0",,,,,,,112,,,,,,,,,,,,,,,,,,,,,,,,,,,,,,,,,,,,,9,7,327,64,,1014,3,,0,5,3,,1,0,,,,,"Aachen Laufen",,"Polar BEAT",,0,,0,168070,250480,30378,,,,,,,,,,,,,,,,,,,,,,,,,,,,,,,,,,,,,,,,,,4,
5963021,d8e361d9-2abc-4f0b-85dc-7769e29f0e4f,1516119006,60,1548677901,,0,0,11.22,2188,2212,51,37,,,1,0,0.09,2.35,,,326,116,144,,,,,,,1,,,,,,,,,,,,,,23,,,20.42,,42,2.6,91,73,,1,111,99,,,,,,,,,"18,16,66,1,0,0,0","23,73,4,0,0","87,0,7,4,2",,,,,,,,,,,,,,,,,,,,,,,,,,,,,,,,,,,,,,,,,14.5,6,30,250,75,,998,,,0,8,1,,1,0,,,Cycling,,,,"Polar M430",43,0,,0,168072,,30378,,,,,,,,,,,,,,,,,,,,,,,,,,,,,,,,,,,,,,,,,,,
5963022,db3732d0-c6e2-44e6-8a41-4a203d22365c,1517964591,60,1548677903,,0,0,2.58,942,1296,27,24,,,2,0.1,0.31,1.19,1.01,,163,120,151,,,,58.48,29.05,59.32,1,,,,,,,,,,,,,,11,79,10.01,11.3,11.36,30.8,,,,,,,,,,,,,,,,"31,5,12,14,23,12,4,0,0","22,60,18,0,0",,,,,,104,,,,,,,,,,,,,,,,,,,,,,,,,,,,,,,,,,,,12.1,0,15,275,51,,1020,1,,0,3,3,,1,0,I1.000|4:52-I1.000|13:05-I0.591|3:40,,Running,,,,"Polar M430",43,0,,0,168070,250480,30378,,,,,,,,,,,,,,,,,,,,,,,,,,,,,,,,,,,,,,,,,,,
5963023,c6d2ab84-25d6-4ec2-9b1c-9255d9ef6289,1532019256,120,1548677904,,0,0,7.97,6177,6371,275,271,,,1,3.7,0.9,,,316,642,92,117,,,,,,,1,,,,,,,,,,,,,,26,,,4.98,,-22.4,,,,,,,,,,,,,,,,"56,43,1,0,0,0","78,22,0,0,0",,,,,,,,,,,,,,,,,,,,,,,,,,,,,,,,,,,,,,,,,,3.9,27,12,341,32,,,,,0,3,3,,1,0,I1.000|13:46-I1.000|14:33-I1.000|15:12-I1.000|11:29-I1.000|13:31-I1.000|13:16-I1.000|11:58-I1.000|11:55-I0.067|0:31,,Hiking,,,,"Polar M430",43,0,,0,168075,,30378,,,,,,,,,,,,,,,,,,,,,,,,,,,,,,,,,,,,,,,,,,3,
5963024,f336a026-71fc-4cea-93be-7b6489f18a7c,1524766187,120,1548677905,,0,0,15.23,3973,3974,48,49,,,1,0,0.04,1.16,0.91,,969,151,179,,,,67.06,48.59,67.31,1,,,,,,,,,,,,,,108,82,13.83,14.04,14.1,9.2,,,,,,,,,,,,,,,,"0,0,1,8,35,33,19,3,0","1,36,18,46,0",,,,,,140,,,,,,,,,,,,,,,,,,,,,,,,,,,,,,,,,,,,81.7,16,4,266,38,,,,,0,3,3,,1,0,I1.000|5:05-I1.000|4:51-I1.000|4:41-I1.000|4:41-I1.000|4:33-I1.000|4:34-I1.000|4:28-I1.000|4:05-I1.000|4:02-I1.000|3:51-I1.000|3:41-I1.000|3:35-I1.000|4:18-I1.000|4:27-I1.000|4:20-I0.240|1:04,,Running,,,,"Polar M430",43,0,,0,168070,250480,30378,,,,,,,,,,,,,,,,,,,,,,,,,,,,,,,,,,,,,,,,,,,
5963025,de3c0640-e001-4880-8c7e-d6da1fbc4142,1528823451,120,1548677905,,0,0,9.91,1433,1437,43,45,,,1,0,0.12,,,,241,120,135,,,,,,,1,,,,,,,,,,,,,,16,,,25.22,,8,-31.2,129,113,,1,149,137,,,,,,,,,"2,3,22,72,0,0,0","8,92,0,0,0","85,4,0,0,10",,,,,,,,,,,,,,,,,,,,,,,,,,,,,,,,,,,,,,,,,9.4,18,11,359,94,,,3,,0,5,3,,1,0,,,Cycling,,,,"Polar M430",43,0,,0,168072,,30378,,,,,,,,,,,,,,,,,,,,,,,,,,,,,,,,,,,,,,,,,,,
5963026,365174b7-b4f1-43ae-a5b2-63af838b3223,1498599850,120,1548677905,,0,0,1.85,613,613,14,16,,,1,0,0.22,,,,126,,,,,,,31.57,,1,,,,,,,,,,,,,,12,80,10.87,10.9,10.9,,,,,,,,,,,,,,,,,"0,16,40,38,6,0,0,0,0",,,,,,,113,,,,,,,,,,,,,,,,,,,,,,,,,,,,,,,,,,,,,24,10,129,72,,1005,0,,1,3,3,,1,0,,,,,"Aix-en-Provence Laufen",,"Polar BEAT",,0,,0,168070,250480,30378,,,,,,,,,,,,,,,,,,,,,,,,,,,,,,,,,,,,,,,,,,,
5963027,f6138d20-cf49-4fe3-b923-0ad7aed5c589,1496153846,120,1548677906,,0,0,0.52,151,151,23,0,,,1,1.1,0.61,,,,36,,,,,,,32.12,,1,,,,,,,,,,,,,,3,80,14.58,12.94,15.42,,,,,,,,,,,,,,,,,"11,2,1,5,57,25,0,0,0",,,,,,,129,,,,,,,,,,,,,,,,,,,,,,,,,,,,,,,,,,,,,23,11,257,68,,1015,6,,0,5,3,,1,0,,,,,"Aachen Laufen",,"Polar BEAT",,0,,0,168070,250480,30378,,,,,,,,,,,,,,,,,,,,,,,,,,,,,,,,,,,,,,,,,,,
5963028,8095d8a5-576e-47f1-840b-2c658fdc4ee6,1347736923,120,1548677907,,0,0,8.42,2425,2428,153,153,,,1,2,0.69,1.05,1,329,584,150,210,,,,59.87,41.49,61.22,1,,,,,,,,,,,,,,61,,12.92,12.91,13.22,1.8,,,,,,,,,,,,,,,,"4,3,4,22,33,28,3,3,0","2,12,78,8,1",,,,,,,,,,,,,,,,,,,,,,,,,,,,,,,,,,,,,,,,,,36.7,15,4,243,75,,1018,0,,0,5,3,,1,0,,,,,,,"Polar BEAT",,0,,0,168070,250480,30378,,,,,,,,,,,,,,,,,,,,,,,,,,,,,,,,,,,,,,,,,,5,
5963029,ed4f0cc3-12ef-4364-b8c8-6a860f2ed1a0,1421953912,60,1548677908,,0,0,2.85,829,829,36,36,,,1,1.1,0.58,,,,194,,,,,,,38.2,,1,,,,,,,,,,,,,,17,82,12.55,12.48,12.68,,,,,,,,,,,,,,,,,"0,0,7,24,53,15,0,0,0",,,,,,,126,,,,,,,,,,,,,,,,,,,,,,,,,,,,,,,,,,,,,-1,10,3,88,,1021,,,1,4,3,,1,0,,,,,Einlaufen,,"Polar BEAT",,0,,0,168070,250480,30378,,,,,,,,,,,,,,,,,,,,,,,,,,,,,,,,,,,,,,,,,,,
5963030,3e2d6142-e3dd-4001-af08-7f910a966286,1396001639,60,1548677909,,0,0,0.96,332,342,0,27,,,1,0.4,0.42,,1.11,,56,129,145,,,,57.68,27.94,55.68,1,,,,,,,,,,,,,,4,82,9.91,10.82,10.19,-7.2,,,,,,,,,,,,,,,,"24,15,18,20,21,2,0,0,0","0,88,12,0,0",,,,,,106,,,,,,,,,,,,,,,,,,,,,,,,,,,,,,,,,,,,8.3,12,7,101,62,,1016,3,,0,5,3,,1,0,,,,,Auslaufen,,"Polar BEAT",,0,,0,168070,250480,30378,,,,,,,,,,,,,,,,,,,,,,,,,,,,,,,,,,,,,,,,,,,
5963031,29eb3587-f1b9-48d3-8555-f9dc8a1b703c,1472675170,120,1548677909,,0,0,0.7,232,232,11,12,,,1,1.3,0.86,,,,50,,,,,,,28.35,,1,,,,,,,,,,,,,,4,79,11.15,11.05,11.43,,,,,,,,,,,,,,,,,"17,3,6,48,26,0,0,0,0",,,,,,,115,,,,,,,,,,,,,,,,,,,,,,,,,,,,,,,,,,,,,21,1,300,63,,1020,0,,1,5,3,,1,0,,,,,"Aachen Laufen",,"Polar BEAT",,0,,0,168070,250480,30378,,,,,,,,,,,,,,,,,,,,,,,,,,,,,,,,,,,,,,,,,,,
5963032,00a5b6e1-e918-4df7-a0ee-2df339adace0,1431799351,120,1548677910,,0,0,11.24,2898,2898,324,325,,,1,4,0.7,,,741,1028,,,,,,,48.15,,1,,,,,,,,,,,,,,60,84,14.8,14.2,15.51,,,,,,,,,,,,,,,,,"1,0,4,9,15,40,30,0,0",,,,,,,139,,,,,,,,,,,,,,,,,,,,,,,,,,,,,,,,,,,,,12,7,253,93,,,2,,0,5,3,,1,0,,,,,"Balve Laufen",,"Polar BEAT",,0,,0,168070,250480,30378,,,,,,,,,,,,,,,,,,,,,,,,,,,,,,,,,,,,,,,,,,3,
5963033,95ca5ebb-dd65-479c-aa44-c828c264dc71,1334574883,120,1548677911,,0,0,13.68,4146,4192,165,178,,,1,1.4,0.41,,,492,953,,,,,,,40.48,,1,,,,,,,,,,,,,,86,,12.08,12.47,12.83,,,,,,,,,,,,,,,,,"8,4,10,25,29,17,5,3,0",,,,,,,,,,,,,,,,,,,,,,,,,,,,,,,,,,,,,,,,,,,,6,11,5,63,,1022,3,,0,5,3,,1,0,,,,,,,"Polar BEAT",,0,,0,168070,250480,30378,,,,,,,,,,,,,,,,,,,,,,,,,,,,,,,,,,,,,,,,,,5,
5963034,e8f8c3f6-8e88-4fbc-9a95-1d1bb46ceff0,1459281440,120,1548677911,,0,0,5.72,1728,1839,70,52,,,1,0.8,0.53,,,,405,,,,,,,38.29,,1,,,,,,,,,,,,,,35,81,12.2,12.02,12.36,,,,,,,,,,,,,,,,,"4,7,8,25,47,9,0,0,0",,,,,,,123,,,,,,,,,,,,,,,,,,,,,,,,,,,,,,,,,,,,,8,8,216,71,,1010,,,1,3,3,,1,0,,,,,"Aachen Laufen",,"Polar BEAT",,0,,0,168070,250480,30378,,,,,,,,,,,,,,,,,,,,,,,,,,,,,,,,,,,,,,,,,,,
5963035,0c04da5f-bf62-478e-84b8-bfa0427f7ea7,1479753944,60,1548677911,,0,0,0.88,387,392,15,12,,,1,1.1,0.69,,,,57,,,,,,,20.94,,1,,,,,,,,,,,,,,8,68,8.4,10.38,10.71,,,,,,,,,,,,,,,,,"50,3,4,17,16,10,0,0,0",,,,,,,100,,,,,,,,,,,,,,,,,,,,,,,,,,,,,,,,,,,,,12,17,181,84,,1000,,,1,6,3,,1,0,,,,,"Aachen Laufen",,"Polar BEAT",,0,,0,168070,250480,30378,,,,,,,,,,,,,,,,,,,,,,,,,,,,,,,,,,,,,,,,,,,
5963036,7ed09a93-3ccf-4d0f-b547-c2035a86ccd0,1366104941,120,1548677912,,0,0,30.81,3958,4045,222,228,,,1,0.4,0.25,,,535,1332,,,,,,,,,1,,,,,,,,,,,,,,44,,,32.46,,,,267,204,,1,354,308,,,,,,,,,"17,10,14,17,12,8,22",,"53,8,12,3,23",,,,,,,,,,,,,,,,,,,,,,,,,,,,,,,,,,,,,,,,,,14,11,225,72,,1020,2,,0,5,3,,1,0,,,,,Untitled,,"Polar BEAT",,0,,0,168072,,30378,,,,,,,,,,,,,,,,,,,,,,,,,,,,,,,,,,,,,,,,,,5,
5963037,8c0e9843-b875-488d-b9b9-3b4322c21e9a,1506019845,120,1548677912,,0,0,13.01,3308,3308,179,189,,,1,2.2,0.59,1.06,1.03,438,908,164,189,,,,61.58,49.46,62.57,1,,,,,,,,,,,,,,116,81,14.4,14.29,14.67,1.1,,,,,,,,,,,,,,,,"0,0,1,5,14,60,17,3,0","0,3,40,44,13",,,,,,146,,,,,,,,,,,,,,,,,,,,,,,,,,,,,,,,,,,,117.8,16,3,137,67,,1019,,,0,5,3,,1,0,I1.000|4:39-I1.000|4:18-I1.000|4:27-I1.000|4:17-I1.000|4:12-I1.000|4:26-I1.000|4:40-I1.000|4:18-I1.000|4:18-I1.000|3:57-I1.000|4:06-I1.000|3:58-I1.000|3:29-I0.021|0:04,,Running,,,,"Polar M430",43,0,,0,168070,250480,30378,,,,,,,,,,,,,,,,,,,,,,,,,,,,,,,,,,,,,,,,,,4,
5963038,323ccf78-f2fb-49ed-9afe-9284cfbe45ab,1413925729,120,1548677913,,0,0,1.42,422,422,18,12,,,1,0.7,0.43,,,,93,,,,,,,34.7,,1,,,,,,,,,,,,,,8,83,12.52,12.39,12.55,,,,,,,,,,,,,,,,,"0,7,19,25,26,24,0,0,0",,,,,,,122,,,,,,,,,,,,,,,,,,,,,,,,,,,,,,,,,,,,,7,12,250,89,,1010,0,,1,5,3,,1,0,,,,,Auslaufen,,"Polar BEAT",,0,,0,168070,250480,30378,,,,,,,,,,,,,,,,,,,,,,,,,,,,,,,,,,,,,,,,,,,
5963039,6609ec58-b99f-4457-99f4-2dea0001d86d,1453546146,60,1548677913,,0,0,19.44,6223,6306,347,313,,,1,2.7,0.52,,,597,1345,,,,,,,39.06,,1,,,,,,,,,,,,,,129,79,11.65,11.83,12.36,,,,,,,,,,,,,,,,,"14,5,7,29,32,12,1,0,0",,,,,,,119,,,,,,,,,,,,,,,,,,,,,,,,,,,,,,,,,,,,,6,8,213,97,,1033,,,0,9,3,,1,0,,,,,"Aachen Laufen",,"Polar BEAT",,0,,0,168070,250480,30378,,,,,,,,,,,,,,,,,,,,,,,,,,,,,,,,,,,,,,,,,,"4,5",
5963040,e63c2a47-c989-4e13-a115-86df7f6ee747,1474207099,120,1548677914,,0,0,4.92,998,1226,60,34,,,1,0.9,0.42,,,,195,,,,,,,,,1,,,,,,,,,,,,,,11,,,21.11,,,,104,100,,1,138,134,,,,,,,,,"38,23,18,10,10,0,0",,"78,16,0,0,6",,,,,,,,,,,,,,,,,,,,,,,,,,,,,,,,,,,,,,,,,,16,4,11,87,,1017,3,,0,5,3,,1,0,,,,,"Aachen Radfahren",,"Polar BEAT",,0,,0,168072,,30378,,,,,,,,,,,,,,,,,,,,,,,,,,,,,,,,,,,,,,,,,,,
5963041,c6249e96-9c77-4d5d-8e1f-3a12d0a90c5d,1413833745,120,1548677914,,0,0,11.92,2789,2789,107,109,,,1,0.4,0.34,,,,788,,,,,,,54.14,,1,,,,,,,,,,,,,,57,85,15.49,15.45,15.6,,,,,,,,,,,,,,,,,"0,0,0,0,4,25,66,4,0",,,,,,,151,,,,,,,,,,,,,,,,,,,,,,,,,,,,,,,,,,,,,13,6,231,87,,1017,0,,1,5,3,,1,0,,,,,"Zügiger DL",,"Polar BEAT",,0,,0,168070,250480,30378,,,,,,,,,,,,,,,,,,,,,,,,,,,,,,,,,,,,,,,,,,,
5963042,5e4e7396-750f-4317-8bba-d14c48c12344,1424977922,60,1548677914,,0,0,3.35,1010,1010,61,61,,,1,1.6,0.58,,,403,229,,,,,,,37.11,,1,,,,,,,,,,,,,,20,82,12.31,12.06,12.85,,,,,,,,,,,,,,,,,"3,7,19,28,26,16,2,0,0",,,,,,,121,,,,,,,,,,,,,,,,,,,,,,,,,,,,,,,,,,,,,6,17,178,90,,1012,,,1,5,3,,1,0,,,,,"Aachen Laufen",,"Polar BEAT",,0,,0,168070,250480,30378,,,,,,,,,,,,,,,,,,,,,,,,,,,,,,,,,,,,,,,,,,4,
5963043,5848883e-ad0a-4b75-99f7-5b04859281bb,1346843904,120,1548677914,,0,0,7.34,1090,1090,178,104,,,1,2.1,0.56,,,569,305,,,,,,,,,1,,,,,,,,,,,,,,12,,,26.99,,,,249,222,,1,323,289,,,,,,,,,"3,27,38,13,6,9,4",,"64,10,3,3,20",,,,,,,,,,,,,,,,,,,,,,,,,,,,,,,,,,,,,,,,,,16,11,341,76,,1023,,,0,5,3,,1,0,,,,,,,"Polar BEAT",,0,,0,168072,,30378,,,,,,,,,,,,,,,,,,,,,,,,,,,,,,,,,,,,,,,,,,"4,4",
5963044,086d6f93-8dcf-47d8-96de-0363e7563f09,1532590209,120,1548677915,,0,0,13,3875,3878,60,61,,,1,0,0.19,1.1,0.94,,958,150,170,,,,57.38,41.11,57.7,1,,,,,,,,,,,,,,97,81,12.12,12.17,12.26,8.9,,,,,,,,,,,,,,,,"0,1,9,42,37,11,0,0,0","0,18,60,23,0",,,,,,124,,,,,,,,,,,,,,,,,,,,,,,,,,,,,,,,,,,,54.3,19,5,84,80,,1015,,,0,5,3,,1,0,I1.000|4:59-I1.000|4:37-I1.000|4:53-I1.000|4:47-I1.000|4:53-I1.000|4:35-I1.000|4:55-I1.000|4:55-I1.000|5:12-I1.000|5:14-I1.000|5:19-I1.000|5:12-I1.000|5:02-I0.004|0:04,,Running,,,,"Polar M430",43,0,,0,168070,250480,30378,,,,,,,,,,,,,,,,,,,,,,,,,,,,,,,,,,,,,,,,,,,
5963045,e183d235-0041-4363-af4a-1052685a7aef,1461924269,120,1548677915,,0,0,1.11,383,383,16,12,,,1,1.1,0.64,,,,78,,,,,,,28.48,,1,,,,,,,,,,,,,,7,83,10.73,10.45,10.95,,,,,,,,,,,,,,,,,"7,35,25,26,7,0,0,0,0",,,,,,,105,,,,,,,,,,,,,,,,,,,,,,,,,,,,,,,,,,,,,9,24,213,63,,1014,,,0,5,3,,1,0,,,,,"Aachen Laufen",,"Polar BEAT",,0,,0,168070,250480,30378,,,,,,,,,,,,,,,,,,,,,,,,,,,,,,,,,,,,,,,,,,,
5963046,edcf7ea8-e6ee-4926-8143-a1eb2a4768f7,1491673822,120,1548677915,,0,0,1.39,751,2482,0,32,,,1,0,0.14,,,,79,,,,,,,17.13,,1,,,,,,,,,,,,,,15,47,6.81,7.93,7.81,,,,,,,,,,,,,,,,,"79,5,4,4,5,2,1,0,0",,,,,,,118,,,,,,,,,,,,,,,,,,,,,,,,,,,,,,,,,,,,,21,3,332,37,,1020,,,0,3,3,,1,0,,,,,"Freiburg im Breisgau Laufen",,"Polar BEAT",,0,,0,168070,250480,30378,,,,,,,,,,,,,,,,,,,,,,,,,,,,,,,,,,,,,,,,,,,
5963047,ce598356-13d0-4ab9-817d-33c1c76e80f2,1440534858,120,1548677916,,0,0,11.16,2666,2793,115,115,,,1,0,0,,,,754,,,,,,,52.61,,1,,,,,,,,,,,,,,55,84,15.12,16.25,16.31,,,,,,,,,,,,,,,,,"18,2,2,1,1,1,15,60,0",,,,,,,150,,,,,,,,,,,,,,,,,,,,,,,,,,,,,,,,,,,,,16,18,189,67,,1014,,,1,5,3,,1,0,,,,,"Aachen Laufen",,"Polar BEAT",,0,,0,168070,250480,30378,,,,,,,,,,,,,,,,,,,,,,,,,,,,,,,,,,,,,,,,,,,
5963048,930ed15a-152e-4a42-b190-22918cc4e12c,1412112691,120,1548677916,,0,0,1.76,607,607,24,23,,,1,0.7,0.43,,,,115,,,,,,,29.99,,1,,,,,,,,,,,,,,12,82,10.66,10.52,10.93,,,,,,,,,,,,,,,,,"11,26,29,25,10,0,0,0,0",,,,,,,106,,,,,,,,,,,,,,,,,,,,,,,,,,,,,,,,,,,,,14,2,143,93,,1027,0,,1,3,3,,1,0,,,,,Auslaufen,,"Polar BEAT",,0,,0,168070,250480,30378,,,,,,,,,,,,,,,,,,,,,,,,,,,,,,,,,,,,,,,,,,,
5963049,19b8f555-02f5-480b-9b39-00f977bbab44,1511944549,60,1548677916,,0,0,,2878,2878,,,,,0,,,,,,567,137,165,,,,,,,1,,,,,,,,,,,,,,54,,,,,,,,,,,,,,,,,,,,,,"4,45,48,3,0",,,,,,,,,,,,,,,,,,,,,,,,,,,,,,,,,,,,,,,,,,33.5,,,,,,,,,,1,,,1,0,,,"Other indoor",,,,"Polar M430",43,0,,0,168075,,30378,,,,,,,,,,,,,,,,,,,,,,,,,,,,,,,,,,,,,,,,,,,
5963050,d58ce895-37a0-484f-9b69-e34c5e502f93,1399581154,120,1548677917,,0,0,6.76,1775,1775,102,90,,,1,1.2,0.43,,,,412,,,,,,,45.63,,1,,,,,,,,,,,,,,36,86,13.79,14.17,14.91,,,,,,,,,,,,,,,,,"9,4,6,11,24,17,10,18,2",,,,,,,133,,,,,,,,,,,,,,,,,,,,,,,,,,,,,,,,,,,,,11,13,218,94,,1010,0,,0,6,3,,1,0,,,,,"10x Allee",,"Polar BEAT",,0,,0,168070,250480,30378,,,,,,,,,,,,,,,,,,,,,,,,,,,,,,,,,,,,,,,,,,,
5963051,dd36afc3-717a-42d7-9c34-65beec98e829,1406029639,120,1548677917,,0,0,17.1,4805,4834,225,225,,,1,2.1,0.57,,,709,1154,,,,,,,44.99,,1,,,,,,,,,,,,,,99,81,13.05,12.92,13.2,,,,,,,,,,,,,,,,,"1,3,5,11,46,32,2,0,0",,,,,,,132,,,,,,,,,,,,,,,,,,,,,,,,,,,,,,,,,,,,,22,6,10,86,,1018,5,,0,5,3,,1,0,,,,,"Lockerer DL",,"Polar BEAT",,0,,0,168070,250480,30378,,,,,,,,,,,,,,,,,,,,,,,,,,,,,,,,,,,,,,,,,,4,
5963052,,1448454600,60,1548677917,,0,0,10,0,0,,,,,0,,,,,,673,,,,,,,,,1,,,,,,,,,,,,,,0,,,,,,,,,,,,,,,,,,,,,,,,,,,,,,,,,,,,,,,,,,,,,,,,,,,,,,,,,,,,,,,,,,,,,,,,,,1,,,0,0,,,,,Laufen,,"Polar BEAT",,0,,0,168070,250480,30378,,,,,,,,,,,,,,,,,,,,,,,,,,,,,,,,,,,,,,,,,,,
5963053,a6ece2ce-fb62-4b00-b89f-a23f2c3200ce,1464899897,120,1548677918,,0,0,8.28,2043,2043,316,292,,,1,4.6,0.73,,,894,526,,,,,,,49.69,,1,,,,,,,,,,,,,,42,85,15.45,14.97,17.08,,,,,,,,,,,,,,,,,"2,3,9,13,13,11,22,26,1",,,,,,,143,,,,,,,,,,,,,,,,,,,,,,,,,,,,,,,,,,,,,16,4,356,98,,1011,0,,0,6,3,,1,0,,,,,"Aachen Laufen",,"Polar BEAT",,0,,0,168070,250480,30378,,,,,,,,,,,,,,,,,,,,,,,,,,,,,,,,,,,,,,,,,,"5,5,5,5,5,5,5,5,5,5,5,5",
5963054,d20474ee-197b-4cc9-950c-e06428e93f7e,1430047538,120,1548677920,,0,0,15,3515,3870,373,374,,,1,3.5,0.73,,,489,1009,,,,,,,54.95,,1,,,,,,,,,,,,,,73,85,15.85,15.46,16.48,,,,,,,,,,,,,,,,,"1,0,0,0,2,26,62,8,0",,,,,,,151,,,,,,,,,,,,,,,,,,,,,,,,,,,,,,,,,,,,,14,14,242,75,,1006,,,0,4,3,,1,0,,,,,"Balve Laufen",,"Polar BEAT",,0,,0,168070,250480,30378,,,,,,,,,,,,,,,,,,,,,,,,,,,,,,,,,,,,,,,,,,"5,5,5,5,5,5",
5963055,4774fbaf-c807-417e-ab03-d380bb736c2b,1365446544,120,1548677921,,0,0,12.56,3872,3947,58,58,,,1,0,0.22,,,,874,,,,,,,39.42,,1,,,,,,,,,,,,,,80,,11.76,11.92,12.07,,,,,,,,,,,,,,,,,"5,3,12,33,38,8,0,0,0",,,,,,,,,,,,,,,,,,,,,,,,,,,,,,,,,,,,,,,,,,,,9,3,206,52,,1005,0,,0,4,3,,1,0,,,,,,,"Polar BEAT",,0,,0,168070,250480,30378,,,,,,,,,,,,,,,,,,,,,,,,,,,,,,,,,,,,,,,,,,,
5963056,27a5dbe9-18ea-461b-a049-412c8c1c8cf0,1412716551,120,1548677921,,0,0,4.41,1344,1386,44,78,,,1,1.2,0.59,1.06,1,,245,135,153,,,,63.89,37.32,64.07,1,,,,,,,,,,,,,,23,84,11.73,11.92,11.9,1.1,,,,,,,,,,,,,,,,"0,9,11,28,48,4,0,0,0","0,75,25,0,0",,,,,,117,,,,,,,,,,,,,,,,,,,,,,,,,,,,,,,,,,,,18.1,11,9,219,85,,1007,0,,1,5,3,,1,0,,,,,Auslaufen,,"Polar BEAT",,0,,0,168070,250480,30378,,,,,,,,,,,,,,,,,,,,,,,,,,,,,,,,,,,,,,,,,,,
5963057,80d37a4a-6f92-4218-9eb6-b602a29e4c4a,1405861365,120,1548677922,,0,0,6.09,1714,2395,71,75,,,1,1.2,0.47,,,331,411,,,,,,,41.79,,1,,,,,,,,,,,,,,35,80,13,12.9,13.28,,,,,,,,,,,,,,,,,"2,0,1,12,56,26,3,0,0",,,,,,,133,,,,,,,,,,,,,,,,,,,,,,,,,,,,,,,,,,,,,27,7,171,53,,,,,0,3,3,,1,0,,,,,"Auslaufen + Steigerungen",,"Polar BEAT",,0,,0,168070,250480,30378,,,,,,,,,,,,,,,,,,,,,,,,,,,,,,,,,,,,,,,,,,5,
5963058,886ee398-eed3-44f6-b9a0-62cb139cb5bf,1524682157,120,1548677922,,0,0,11.05,1595,1595,42,35,,,1,0,0.04,,,,324,138,155,,,,,,,1,,,,,,,,,,,,,,30,,,26.68,,13.6,-29.2,139,117,,1,157,142,,,,,,,,,"8,4,17,68,3,0,0","3,33,63,0,0","65,25,0,0,9",,,,,,,,,,,,,,,,,,,,,,,,,,,,,,,,,,,,,,,,,25.8,19,13,262,54,,,1,,0,5,3,,1,0,,,Cycling,,,,"Polar M430",43,0,,0,168072,,30378,,,,,,,,,,,,,,,,,,,,,,,,,,,,,,,,,,,,,,,,,,,
5963059,ecfecbe3-4f48-43ef-9f3a-ec885a7f1593,1474200965,120,1548677923,,0,0,20.01,5146,5223,148,148,,,1,0,0.22,,,,1349,,,,,,,50.48,,1,,,,,,,,,,,,,,106,82,14.08,14.5,14.69,,,,,,,,,,,,,,,,,"5,0,0,1,9,44,40,1,0",,,,,,,142,,,,,,,,,,,,,,,,,,,,,,,,,,,,,,,,,,,,,15,5,13,91,,1017,3,,0,5,3,,1,0,,,,,"Aachen Laufen",,"Polar BEAT",,0,,0,168070,250480,30378,,,,,,,,,,,,,,,,,,,,,,,,,,,,,,,,,,,,,,,,,,,
5963060,bf02f9ab-f4bc-47eb-8469-601b45bc3d9e,1495370223,120,1548677923,,0,0,11,3117,3887,179,187,,,1,2.7,0.61,,,485,770,,,,,,,43.07,,1,,,,,,,,,,,,,,64,80,13.06,13.21,13.66,,,,,,,,,,,,,,,,,"6,3,6,13,27,34,11,0,0",,,,,,,132,,,,,,,,,,,,,,,,,,,,,,,,,,,,,,,,,,,,,19,3,135,48,,1027,7,,0,5,3,,1,0,,,,,"Aachen Laufen",,"Polar BEAT",,0,,0,168070,250480,30378,,,,,,,,,,,,,,,,,,,,,,,,,,,,,,,,,,,,,,,,,,4,
5963061,4e678d65-3a52-4c49-8b84-411de82ac7a4,1504555835,120,1548677923,,0,0,0.67,224,226,6,12,,,1,1.1,0.7,1.38,1.08,,39,126,147,,,,61.78,27.94,61.78,1,,,,,,,,,,,,,,3,80,10.69,10.95,10.88,-15.8,,,,,,,,,,,,,,,,"21,3,15,29,27,5,0,0,0","12,81,7,0,0",,,,,,112,,,,,,,,,,,,,,,,,,,,,,,,,,,,,,,,,,,,5.3,16,8,192,81,,1018,0,,0,5,3,,1,0,,,Running,,,,"Polar M430",43,0,,0,168070,250480,30378,,,,,,,,,,,,,,,,,,,,,,,,,,,,,,,,,,,,,,,,,,,
5963063,a6bc2875-ab90-41fb-88f5-948900f487d5,1349204564,120,1548677925,,0,0,31.7,3669,3759,153,153,,,1,0,0.18,1.64,0.86,,1147,128,151,,,,,,,1,,,,,,,,,,,,,,54,,,33.14,,-0.2,-23.6,252,204,,1,284,251,,,,,,,,,"7,4,8,15,29,22,15","7,75,18,0,0","42,15,13,18,11",,,,,,,,,,,,,,,,,,,,,,,,,,,,,,,,,,,,,,,,,18.7,16,3,219,61,,1019,0,,1,5,3,,1,0,,,,,,,"Polar BEAT",,0,,0,168072,,30378,,,,,,,,,,,,,,,,,,,,,,,,,,,,,,,,,,,,,,,,,,,
5963064,15de1ea5-323b-4344-b276-007d041d7512,1533975363,120,1548677925,,0,0,7.53,2649,2649,32,33,,,1,0,0.09,1.08,0.91,,467,121,137,,,,60.68,32.51,60.99,1,,,,,,,,,,,,,,31,81,10.26,10.32,10.39,-11.8,,,,,,,,,,,,,,,,"15,14,52,18,0,0,0,0,0","5,95,0,0,0",,,,,,105,,,,,,,,,,,,,,,,,,,,,,,,,,,,,,,,,,,,11.7,17,12,210,64,,,,,0,3,3,,1,0,I1.000|7:05-I1.000|5:45-I1.000|5:41-I1.000|5:37-I1.000|5:43-I1.000|5:42-I1.000|5:41-I0.529|2:58,,Running,,,,"Polar M430",43,0,,0,168070,250480,30378,,,,,,,,,,,,,,,,,,,,,,,,,,,,,,,,,,,,,,,,,,,
5963065,76e88cf9-d77d-4302-b54f-5d57ec0b3e28,1500381233,120,1548677925,,0,0,1.47,517,597,21,17,,,1,1.2,0.73,,,,100,,,,,,,28.76,,1,,,,,,,,,,,,,,10,74,10.62,11.45,11.45,,,,,,,,,,,,,,,,,"38,15,12,6,4,10,15,0,0",,,,,,,115,,,,,,,,,,,,,,,,,,,,,,,,,,,,,,,,,,,,,29,9,177,34,,1019,9,,0,3,3,,1,0,,,,,"Aix-en-Provence Laufen",,"Polar BEAT",,0,,0,168070,250480,30378,,,,,,,,,,,,,,,,,,,,,,,,,,,,,,,,,,,,,,,,,,,
5963066,0d8e4dbc-4e25-4372-b0d3-8fec29d7c76c,1515316809,60,1548677925,,0,0,2.6,883,884,19,20,,,1,0,0.22,1.07,0.86,,151,132,149,,,,57.42,31.66,57.91,1,,,,,,,,,,,,,,14,81,10.64,10.69,10.83,-4.4,,,,,,,,,,,,,,,,"6,8,53,31,0,0,0,0,0","3,90,8,0,0",,,,,,109,,,,,,,,,,,,,,,,,,,,,,,,,,,,,,,,,,,,14.1,7,30,30,93,,1016,,,0,4,1,,1,0,I1.000|5:54-I1.000|5:29-I0.602|3:22,,Running,,,,"Polar M430",43,0,,0,168070,250480,30378,,,,,,,,,,,,,,,,,,,,,,,,,,,,,,,,,,,,,,,,,,,
5963067,6618a5eb-58a0-41dc-bccc-1001302b9aa8,1347025038,120,1548677927,,0,0,32.64,4709,4781,783,783,,,1,5.1,0.61,,,795,1210,,,,,,,,,1,,,,,,,,,,,,,,52,,,32.46,,,,348,250,,1,653,556,,,,,,,,,"24,23,13,9,8,6,16",,"47,17,7,10,19",,,,,,,,,,,,,,,,,,,,,,,,,,,,,,,,,,,,,,,,,,20,14,249,55,,1024,4,,0,5,3,,1,0,,,,,,,"Polar BEAT",,0,,0,168072,,30378,,,,,,,,,,,,,,,,,,,,,,,,,,,,,,,,,,,,,,,,,,"2,4,4,5",
5963068,64c451c1-a17c-404a-8d15-c67a546da6c5,1349728039,120,1548677927,,0,0,9.23,2749,2773,55,54,,,1,0,0.22,,,,639,,,,,,,40.13,,1,,,,,,,,,,,,,,57,,12.2,13.19,13.28,,,,,,,,,,,,,,,,,"16,5,8,15,17,19,11,5,4",,,,,,,,,,,,,,,,,,,,,,,,,,,,,,,,,,,,,,,,,,,,10,2,87,75,,1017,0,,1,5,3,,1,0,,,,,,,"Polar BEAT",,0,,0,168070,250480,30378,,,,,,,,,,,,,,,,,,,,,,,,,,,,,,,,,,,,,,,,,,,
5963069,d06d3f65-0756-41d9-a851-f00b7718b2d6,1432760721,120,1548677928,,0,0,16.01,4402,4708,287,292,,,1,2.6,0.47,,,480,1084,,,,,,,45.9,,1,,,,,,,,,,,,,,91,83,13.51,13.4,14,,,,,,,,,,,,,,,,,"6,1,4,8,28,42,12,0,0",,,,,,,131,,,,,,,,,,,,,,,,,,,,,,,,,,,,,,,,,,,,,16,3,199,54,,1020,0,,1,5,3,,1,0,,,,,"Aachen Laufen",,"Polar BEAT",,0,,0,168070,250480,30378,,,,,,,,,,,,,,,,,,,,,,,,,,,,,,,,,,,,,,,,,,"5,5,5,5",
5963070,27bc3700-44e3-49a6-ae04-b4c8c5d9423a,1498596688,120,1548677929,,0,0,5.39,1347,1424,45,41,,,1,0,0.22,,,,364,,,,,,,47.72,,1,,,,,,,,,,,,,,27,83,14.56,15.13,15.18,,,,,,,,,,,,,,,,,"7,1,2,7,15,17,28,22,1",,,,,,,145,,,,,,,,,,,,,,,,,,,,,,,,,,,,,,,,,,,,,25,14,125,71,,1005,0,,0,3,3,,1,0,,,,,"Aix-en-Provence Laufen",,"Polar BEAT",,0,,0,168070,250480,30378,,,,,,,,,,,,,,,,,,,,,,,,,,,,,,,,,,,,,,,,,,,
5963071,2a14b92e-0819-429d-aafe-f7c26d9bd9fb,1430565618,120,1548677929,,0,0,11.03,3181,3186,320,322,,,1,4.1,0.66,,,649,749,,,,,,,42.2,,1,,,,,,,,,,,,,,66,82,13.31,12.83,13.97,,,,,,,,,,,,,,,,,"3,6,12,20,30,19,9,0,0",,,,,,,127,,,,,,,,,,,,,,,,,,,,,,,,,,,,,,,,,,,,,12,2,278,51,,1013,,,0,5,3,,1,0,,,,,"Balve Laufen",,"Polar BEAT",,0,,0,168070,250480,30378,,,,,,,,,,,,,,,,,,,,,,,,,,,,,,,,,,,,,,,,,,3,
5963072,3447848f-6c3e-4421-bc58-5965404ff735,1368374384,120,1548677929,,0,0,0.86,484,803,0,0,,,1,0,0,,,,73,,,,,,,15.49,,1,,,,,,,,,,,,,,10,,6.38,12.27,12.36,,,,,,,,,,,,,,,,,"74,0,0,1,1,1,3,20,0",,,,,,,,,,,,,,,,,,,,,,,,,,,,,,,,,,,,,,,,,,,,10,12,273,76,,1017,4,,0,5,3,,1,0,,,,,,,"Polar BEAT",,0,,0,168070,250480,30378,,,,,,,,,,,,,,,,,,,,,,,,,,,,,,,,,,,,,,,,,,,
5963073,bf0393ac-40b8-4a7d-b2b3-b7ebe616edce,1497384620,120,1548677929,,0,0,3.33,952,952,65,65,,,1,1.6,0.58,,,456,218,,,,,,,39.47,,1,,,,,,,,,,,,,,19,80,13,12.67,13.56,,,,,,,,,,,,,,,,,"0,2,14,24,29,23,7,0,0",,,,,,,131,,,,,,,,,,,,,,,,,,,,,,,,,,,,,,,,,,,,,19,9,4,62,,1019,,,0,5,3,,1,0,,,,,"Aachen Laufen",,"Polar BEAT",,0,,0,168070,250480,30378,,,,,,,,,,,,,,,,,,,,,,,,,,,,,,,,,,,,,,,,,,4,
5963074,126f8735-8fef-437d-98de-fde905f62b84,1528297170,120,1548677930,,0,0,11.33,2763,2866,55,48,,,1,0,0.14,1.54,0.38,,340,104,128,,,,,,,1,,,,,,,,,,,,,,19,,,20.81,,48.9,1.9,112,65,,1,134,106,,,,,,,,,"40,5,42,13,0,0,0","37,63,0,0,0","88,1,3,6,2",,,,,,,,,,,,,,,,,,,,,,,,,,,,,,,,,,,,,,,,,6.4,28,5,59,48,,,7,,0,3,3,,1,0,,,Cycling,,,,"Polar M430",43,0,,0,168072,,30378,,,,,,,,,,,,,,,,,,,,,,,,,,,,,,,,,,,,,,,,,,,
5963075,77090042-50d3-41fc-b840-6c7ca010b8c3,1399127241,120,1548677930,,0,0,1.82,593,593,25,23,,,1,0.9,0.55,,,,122,,,,,,,32.13,,1,,,,,,,,,,,,,,12,83,11.25,11.07,11.38,,,,,,,,,,,,,,,,,"1,11,31,41,16,0,0,0,0",,,,,,,111,,,,,,,,,,,,,,,,,,,,,,,,,,,,,,,,,,,,,12,10,32,48,,1025,6,,0,5,3,,1,0,,,,,Auslaufen,,"Polar BEAT",,0,,0,168070,250480,30378,,,,,,,,,,,,,,,,,,,,,,,,,,,,,,,,,,,,,,,,,,,
5963076,bdd3ea79-fb47-4f34-a66c-e7e2d33ecc6d,1460802979,120,1548677931,,0,0,6.25,1780,1780,102,100,,,1,1.7,0.55,,,259,435,,,,,,,41.27,,1,,,,,,,,,,,,,,36,83,12.95,12.84,13.31,,,,,,,,,,,,,,,,,"2,6,9,19,28,29,7,0,0",,,,,,,127,,,,,,,,,,,,,,,,,,,,,,,,,,,,,,,,,,,,,11,22,235,72,,1002,,,0,5,3,,1,0,,,,,"Aachen Laufen",,"Polar BEAT",,0,,0,168070,250480,30378,,,,,,,,,,,,,,,,,,,,,,,,,,,,,,,,,,,,,,,,,,4,
5963077,23b87579-7e89-4b3e-b9ed-fa56308b5e04,1400843283,120,1548677931,,0,0,3.02,912,912,32,42,,,1,1,0.6,,,,199,,,,,,,36.75,,1,,,,,,,,,,,,,,18,83,12,11.99,12.24,,,,,,,,,,,,,,,,,"2,5,8,35,48,2,0,0,0",,,,,,,120,,,,,,,,,,,,,,,,,,,,,,,,,,,,,,,,,,,,,16,5,203,78,,1011,4,,0,5,3,,1,0,,,,,Auslaufen,,"Polar BEAT",,0,,0,168070,250480,30378,,,,,,,,,,,,,,,,,,,,,,,,,,,,,,,,,,,,,,,,,,,
5963078,dc785a35-d39d-4a2d-afd1-4718bd1acbe1,1399236747,120,1548677931,,0,0,5,1108,1108,49,46,,,1,0.5,0.36,,,,333,,,,,,,54.66,,1,,,,,,,,,,,,,,23,85,16.43,16.48,16.68,,,,,,,,,,,,,,,,,"0,0,1,3,6,7,48,34,0",,,,,,,159,,,,,,,,,,,,,,,,,,,,,,,,,,,,,,,,,,,,,11,3,49,59,,1021,0,,0,5,3,,1,0,,,,,"Kurzer TDL + Steigerungen",,"Polar BEAT",,0,,0,168070,250480,30378,,,,,,,,,,,,,,,,,,,,,,,,,,,,,,,,,,,,,,,,,,,
5963079,8e1399fd-fcf6-4996-98b0-79ce6528c409,1452708910,60,1548677932,,0,0,16.54,5110,5558,217,213,,,1,2.2,0.46,,,,1125,,,,,,,40.19,,1,,,,,,,,,,,,,,106,79,11.87,12.32,12.65,,,,,,,,,,,,,,,,,"10,3,9,17,36,22,3,0,0",,,,,,,123,,,,,,,,,,,,,,,,,,,,,,,,,,,,,,,,,,,,,3,9,221,86,,1017,,,1,5,3,,1,0,,,,,"Aachen Laufen",,"Polar BEAT",,0,,0,168070,250480,30378,,,,,,,,,,,,,,,,,,,,,,,,,,,,,,,,,,,,,,,,,,,
5963080,a0cd70e1-db33-4246-bb6d-a4d6a1de65d6,1440707499,120,1548677934,,0,0,8.55,2211,2214,312,312,,,1,4.7,0.76,,,828,536,,,,,,,47.12,,1,,,,,,,,,,,,,,45,85,14.86,14.31,16.3,,,,,,,,,,,,,,,,,"2,2,11,16,15,10,32,12,0",,,,,,,136,,,,,,,,,,,,,,,,,,,,,,,,,,,,,,,,,,,,,13,6,205,97,,1012,,,1,4,3,,1,0,,,,,"Aachen Laufen",,"Polar BEAT",,0,,0,168070,250480,30378,,,,,,,,,,,,,,,,,,,,,,,,,,,,,,,,,,,,,,,,,,"5,5,5,5,5,5,5,5,5,5,5,5",
5963081,f53222d7-507b-44df-84dc-1638d4df838c,1482585169,60,1548677935,,0,0,16.7,4391,4391,253,253,,,1,2.9,0.53,,,654,1113,,,,,,,48.5,,1,,,,,,,,,,,,,,91,82,14.08,14.2,14.53,,,,,,,,,,,,,,,,,"4,3,5,11,19,25,25,7,1",,,,,,,139,,,,,,,,,,,,,,,,,,,,,,,,,,,,,,,,,,,,,7,15,254,85,,,0,,0,5,3,,1,0,,,,,"Menden Laufen",,"Polar BEAT",,0,,0,168070,250480,30378,,,,,,,,,,,,,,,,,,,,,,,,,,,,,,,,,,,,,,,,,,"4,4",
5963082,57e0e3c3-f37f-4f01-abb4-735a9d60ec83,1399205047,120,1548677936,,0,0,19.09,5404,5410,305,304,,,1,2.6,0.49,,,368,1291,,,,,,,45.01,,1,,,,,,,,,,,,,,112,83,13.09,12.92,13.49,,,,,,,,,,,,,,,,,"2,2,5,18,41,28,3,0,1",,,,,,,128,,,,,,,,,,,,,,,,,,,,,,,,,,,,,,,,,,,,,12,2,352,57,,1024,6,,0,3,3,,1,0,,,,,"Regenerativer DL ",,"Polar BEAT",,0,,0,168070,250480,30378,,,,,,,,,,,,,,,,,,,,,,,,,,,,,,,,,,,,,,,,,,"4,4,5",
5963083,665c2748-4312-4964-949c-8995c4c476f5,1397243797,120,1548677937,,0,0,11.5,3589,4093,49,47,,,1,0,0.09,1.2,,,525,147,210,,,,55.7,38.6,56.01,1,,,,,,,,,,,,,,88,80,11.59,12.23,12.3,-3.9,,,,,,,,,,,,,,,,"11,2,5,20,36,25,0,0,0","1,17,72,7,2",,,,,,120,,,,,,,,,,,,,,,,,,,,,,,,,,,,,,,,,,,,80.1,11,14,332,83,,1021,0,,0,5,3,,1,0,,,,,"Regenerativer DL",,"Polar BEAT",,0,,0,168070,250480,30378,,,,,,,,,,,,,,,,,,,,,,,,,,,,,,,,,,,,,,,,,,,
5963084,14379e56-83cb-4bab-b8ae-5ca5d22fc9c2,1397811754,120,1548677937,,0,0,8.63,2496,2496,36,36,,,1,0,0.09,1.1,0.94,,473,148,173,,,,60.64,41.35,60.95,1,,,,,,,,,,,,,,59,85,12.48,12.52,12.59,-9.9,,,,,,,,,,,,,,,,"2,1,5,20,57,15,0,0,0","1,7,85,8,0",,,,,,122,,,,,,,,,,,,,,,,,,,,,,,,,,,,,,,,,,,,35.9,8,21,337,72,,1015,1,,0,5,3,,1,0,,,,,"Regenerativer DL ",,"Polar BEAT",,0,,0,168070,250480,30378,,,,,,,,,,,,,,,,,,,,,,,,,,,,,,,,,,,,,,,,,,,
5963085,1b6cdc81-93e7-4d55-81dc-260a2885a5c7,1429733167,120,1548677938,,0,0,14.42,4016,4020,181,188,,,1,1.8,0.5,,,721,986,,,,,,,44.85,,1,,,,,,,,,,,,,,83,81,13.12,13.11,13.41,,,,,,,,,,,,,,,,,"3,1,2,11,43,40,2,0,0",,,,,,,133,,,,,,,,,,,,,,,,,,,,,,,,,,,,,,,,,,,,,12,8,7,61,,1024,,,0,3,3,,1,0,,,,,"Aachen Laufen",,"Polar BEAT",,0,,0,168070,250480,30378,,,,,,,,,,,,,,,,,,,,,,,,,,,,,,,,,,,,,,,,,,"5,5",
5963086,950dc310-e9b5-4761-b5be-25ab9d5bca75,1524161332,120,1548677938,,0,0,5.42,1449,1449,33,34,,,1,0.3,0.3,1.09,0.9,,364,154,175,,,,63.32,44.1,63.78,1,,,,,,,,,,,,,,40,81,13.52,13.49,13.65,6.3,,,,,,,,,,,,,,,,"0,0,0,3,38,56,2,0,0","0,10,67,23,0",,,,,,139,,,,,,,,,,,,,,,,,,,,,,,,,,,,,,,,,,,,53.4,28,4,81,29,,,,,0,3,3,,1,0,I1.000|4:32-I1.000|4:35-I1.000|4:19-I1.000|4:25-I1.000|4:29-I0.426|1:49,,Running,,,,"Polar M430",43,0,,0,168070,250480,30378,,,,,,,,,,,,,,,,,,,,,,,,,,,,,,,,,,,,,,,,,,,
5963087,3e09efe8-ac8f-4b42-bc86-7740b05e8034,1467329065,120,1548677938,,0,0,3.73,1119,1148,,,,,0,,,,,,261,,,,,,,37.61,,1,,,,,,,,,,,,,,23,78,,12.1,,,,,,,,,,,,,,,,,,"6,1,3,9,82,0,0,0,0",,,,,,,128,,,,,,,,,,,,,,,,,,,,,,,,,,,,,,,,,,,,,,,,,,,,,,1,,,1,0,,,,,Laufen,,"Polar BEAT",,0,,0,168070,250480,30378,,,,,,,,,,,,,,,,,,,,,,,,,,,,,,,,,,,,,,,,,,,
5963088,baa7add0-d9c3-475c-8b0b-fd791e19c6e4,1500211458,120,1548677938,,0,0,3.6,1258,1328,32,36,,,1,0,0.28,,,,250,,,,,,,31.32,,1,,,,,,,,,,,,,,26,78,10.29,10.54,10.69,,,,,,,,,,,,,,,,,"21,12,24,30,13,1,0,0,0",,,,,,,110,,,,,,,,,,,,,,,,,,,,,,,,,,,,,,,,,,,,,30,9,266,29,,1019,9,,0,3,3,,1,0,,,,,"Aix-en-Provence Laufen",,"Polar BEAT",,0,,0,168070,250480,30378,,,,,,,,,,,,,,,,,,,,,,,,,,,,,,,,,,,,,,,,,,,
5963089,2dbf33f8-3249-4cce-b274-df8bb6aa6397,1370959477,120,1548677940,,0,0,57.44,7678,7827,739,751,,,1,2.6,0.41,,,841,1980,,,,,,,,,1,,,,,,,,,,,,,,85,,,31.27,,,,267,201,,1,354,296,,,,,,,,,"16,15,18,14,13,9,16",,"48,16,12,7,17",,,,,,,,,,,,,,,,,,,,,,,,,,,,,,,,,,,,,,,,,,20,6,247,55,,1017,6,,0,5,3,,1,0,,,,,,,"Polar BEAT",,0,,0,168072,,30378,,,,,,,,,,,,,,,,,,,,,,,,,,,,,,,,,,,,,,,,,,"4,4,4,5",
5963090,,1400619651,120,1548677940,,0,0,4,0,0,,,,,0,,,,,,,,,,,,,,,1,,,,,,,,,,,,,,0,,,,,,,,,,,,,,,,,,,,,,,,,,,,,,,,,,,,,,,,,,,,,,,,,,,,,,,,,,,,,,,,,,,,,,,,,,1,,,0,0,,,,,"5x(500m+500m Trab)",,"Polar BEAT",,0,,0,168070,250480,30378,,,,,,,,,,,,,,,,,,,,,,,,,,,,,,,,,,,,,,,,,,,
5963091,54eb7784-fc3a-4d88-8687-056c327fa50f,1466021069,120,1548677940,,0,0,13,2925,2925,182,189,,,1,2.1,0.57,,,502,887,,,,,,,57,,1,,,,,,,,,,,,,,60,84,16.31,16.13,16.46,,,,,,,,,,,,,,,,,"0,0,1,1,3,13,66,17,0",,,,,,,159,,,,,,,,,,,,,,,,,,,,,,,,,,,,,,,,,,,,,14,4,231,90,,1001,0,,0,6,3,,1,0,,,,,"Aachen Laufen",,"Polar BEAT",,0,,0,168070,250480,30378,,,,,,,,,,,,,,,,,,,,,,,,,,,,,,,,,,,,,,,,,,4,
5963092,952f5e1d-7d87-4561-be22-8d5a338c4315,1397851698,120,1548677941,,0,0,15,3371,3388,369,375,,,1,3.9,0.69,1.22,0.89,519,773,167,175,,,,69.83,57.68,71.93,1,,,,,,,,,,,,,,121,85,16.48,16.09,17.07,-2.6,,,,,,,,,,,,,,,,"0,0,0,1,3,13,65,18,0","0,0,11,89,0",,,,,,157,,,,,,,,,,,,,,,,,,,,,,,,,,,,,,,,,,,,75.9,8,5,348,67,,,0,,1,3,3,,1,0,,,,,TDL,,"Polar BEAT",,0,,0,168070,250480,30378,,,,,,,,,,,,,,,,,,,,,,,,,,,,,,,,,,,,,,,,,,"4,5,5,5,5",
5963093,,1400104821,120,1548677941,,0,0,4,0,0,,,,,0,,,,,,,,,,,,,,,1,,,,,,,,,,,,,,0,,,,,,,,,,,,,,,,,,,,,,,,,,,,,,,,,,,,,,,,,,,,,,,,,,,,,,,,,,,,,,,,,,,,,,,,,,1,,,0,0,,,,,"Einlaufen + Auslaufen",,"Polar BEAT",,0,,0,168070,250480,30378,,,,,,,,,,,,,,,,,,,,,,,,,,,,,,,,,,,,,,,,,,,
5963094,3beb2504-30fe-46fb-87a1-79310a7a3d98,1459156996,120,1548677941,,0,0,2.69,901,901,28,29,,,1,0,0.3,,,,184,,,,,,,32.26,,1,,,,,,,,,,,,,,18,83,10.9,10.84,11.07,,,,,,,,,,,,,,,,,"5,11,39,43,3,0,0,0,0",,,,,,,108,,,,,,,,,,,,,,,,,,,,,,,,,,,,,,,,,,,,,9,30,161,65,,997,,,0,11,3,,1,0,,,,,Laufen,,"Polar BEAT",,0,,0,168070,250480,30378,,,,,,,,,,,,,,,,,,,,,,,,,,,,,,,,,,,,,,,,,,,
5963095,1c8e18ac-aedf-41fa-93ec-763a9ca084e9,1477165276,120,1548677942,,0,0,10,2658,2665,134,145,,,1,1.3,0.44,,,459,679,,,,,,,46.1,,1,,,,,,,,,,,,,,55,82,13.79,13.74,14.01,,,,,,,,,,,,,,,,,"1,1,4,11,24,45,14,1,0",,,,,,,138,,,,,,,,,,,,,,,,,,,,,,,,,,,,,,,,,,,,,7,2,22,90,,1015,0,,1,5,3,,1,0,,,,,"Aachen Laufen",,"Polar BEAT",,0,,0,168070,250480,30378,,,,,,,,,,,,,,,,,,,,,,,,,,,,,,,,,,,,,,,,,,5,
5963096,e7afe0f3-db62-44e3-b359-6f97feb752aa,1543661803,60,1548677942,,0,0,10.01,2351,2351,32,38,,,1,0,0.07,,,,732,174,182,,,,62.08,53.28,62.28,1,,,,,,,,,,,,,,99,84,15.33,15.35,15.39,4.3,,,,,,,,,,,,,,,,"0,0,0,0,1,31,67,2,0","0,0,7,86,7",,,,,,152,,,,,,,,,,,,,,,,,,,,,,,,,,,,,,,,,,,,110.6,9,15,211,86,,1019,1,289,0,5,3,,1,0,I1.000|3:54-I1.000|3:56-I1.000|3:59-I1.000|3:55-I1.000|3:55-I1.000|3:56-I1.000|4:01-I1.000|3:54-I1.000|3:53-I1.000|3:50,,Running,,,,"Polar M430",43,0,,0,168070,250480,30378,,,,,,,,,,,,,,,,,,,,,,,,,,,,,,,,,,,,,,,,,,,
5963097,feb95aa2-62c8-4ee4-b3e6-8abadcfddc6a,1393073813,60,1548677942,,0,0,0.68,430,516,43,44,,,1,0.8,0.41,11.38,3.41,1620,88,144,173,,,,23.71,,25.6,1,,,,,,,,,,,,,,9,77,6.3,7.45,11.42,52.1,,,,,,,,,,,,,,,,"84,3,3,4,3,2,1,0,0","0,39,33,28,0",,,,,,62,,,,,,,,,,,,,,,,,,,,,,,,,,,,,,,,,,,,23,6,12,233,88,,1015,2,,0,4,3,,1,0,,,,,Bergsprints,,"Polar BEAT",,0,,0,168070,250480,30378,,,,,,,,,,,,,,,,,,,,,,,,,,,,,,,,,,,,,,,,,,5,
5963098,27c7497f-5946-4129-b879-40cf839a411d,1474627412,120,1548677942,,0,0,4,1512,1517,49,52,,,1,1.2,0.6,,,,276,,,,,,,28.68,,1,,,,,,,,,,,,,,31,79,9.75,9.63,9.81,,,,,,,,,,,,,,,,,"30,37,29,4,0,0,0,0,0",,,,,,,100,,,,,,,,,,,,,,,,,,,,,,,,,,,,,,,,,,,,,16,4,246,79,,1025,2,,0,5,3,,1,0,,,,,"Aachen Laufen",,"Polar BEAT",,0,,0,168070,250480,30378,,,,,,,,,,,,,,,,,,,,,,,,,,,,,,,,,,,,,,,,,,,
5963099,9eab6d84-6e3f-4fcd-8c6a-d5841d906878,1430775348,120,1548677943,,0,0,11.56,3269,3500,182,183,,,1,2.3,0.56,,,328,792,,,,,,,43.32,,1,,,,,,,,,,,,,,67,82,13.04,13.04,13.52,,,,,,,,,,,,,,,,,"5,3,4,14,31,38,6,0,0",,,,,,,129,,,,,,,,,,,,,,,,,,,,,,,,,,,,,,,,,,,,,17,5,119,74,,1003,0,,1,6,3,,1,0,,,,,"Aachen Laufen",,"Polar BEAT",,0,,0,168070,250480,30378,,,,,,,,,,,,,,,,,,,,,,,,,,,,,,,,,,,,,,,,,,"4,5",
5963100,a07d1e48-331d-4705-ab4d-87d0b5fee976,1446192896,60,1548677943,,0,0,5.91,2124,2125,112,103,,,1,1.4,0.48,,,210,403,,,,,,,31.2,,1,,,,,,,,,,,,,,44,79,10.45,11.09,11.41,,,,,,,,,,,,,,,,,"20,14,22,19,16,8,1,0,0",,,,,,,106,,,,,,,,,,,,,,,,,,,,,,,,,,,,,,,,,,,,,6,10,136,94,,1025,,,0,5,3,,1,0,,,,,"Aachen Laufen",,"Polar BEAT",,0,,0,168070,250480,30378,,,,,,,,,,,,,,,,,,,,,,,,,,,,,,,,,,,,,,,,,,4,
5963101,3d91c87f-05c0-46d9-b659-7d9c811ce3c1,1452798549,60,1548677944,,0,0,9.65,3090,3108,294,297,,,1,4.2,0.69,,,608,604,,,,,,,36.97,,1,,,,,,,,,,,,,,64,80,11.79,12.4,14.03,,,,,,,,,,,,,,,,,"21,5,13,15,15,13,17,0,0",,,,,,,117,,,,,,,,,,,,,,,,,,,,,,,,,,,,,,,,,,,,,2,14,198,90,,1004,,,1,6,3,,1,0,,,,,"Aachen Laufen",,"Polar BEAT",,0,,0,168070,250480,30378,,,,,,,,,,,,,,,,,,,,,,,,,,,,,,,,,,,,,,,,,,"5,5,5,5,5,5,5,5,5,5",
5963102,d50ac8bb-3dab-4bae-998d-9ffefa7d7b6b,1395220978,60,1548677945,,0,0,13,3693,3788,169,169,,,1,1.5,0.43,1.01,0.99,303,714,150,188,,,,60.89,43.48,61.87,1,,,,,,,,,,,,,,93,84,12.96,12.74,13.1,3.1,,,,,,,,,,,,,,,,"3,1,3,13,56,24,0,0,0","0,17,77,5,0",,,,,,126,,,,,,,,,,,,,,,,,,,,,,,,,,,,,,,,,,,,42.1,9,10,260,83,,1025,1,,0,5,3,,1,0,,,,,"Regenerativer DL ",,"Polar BEAT",,0,,0,168070,250480,30378,,,,,,,,,,,,,,,,,,,,,,,,,,,,,,,,,,,,,,,,,,5,
5963103,8dd0e756-f4f8-400a-8802-dc5570de348b,1521015816,60,1548677945,,0,0,10.87,1887,1891,31,41,,,1,0,0.15,2,0.53,,327,127,153,,,,,,,1,,,,,,,,,,,,,,27,,,22.7,,18.6,4.7,103,87,,1,126,114,,,,,,,,,"12,32,21,35,0,0,0","4,66,30,0,0","87,3,0,1,8",,,,,,,,,,,,,,,,,,,,,,,,,,,,,,,,,,,,,,,,,22.8,6,1,236,84,,,0,,0,5,3,,1,0,,,Cycling,,,,"Polar M430",43,0,,0,168072,,30378,,,,,,,,,,,,,,,,,,,,,,,,,,,,,,,,,,,,,,,,,,,
5963104,c56b7b29-3c46-44c4-aeee-e75ba16200e1,1499207636,120,1548677945,,0,0,6.11,1973,1974,80,81,,,1,1.3,0.5,,,245,420,,,,,,,35.52,,1,,,,,,,,,,,,,,40,77,11.37,11.23,11.53,,,,,,,,,,,,,,,,,"8,7,23,43,19,0,0,0,0",,,,,,,121,,,,,,,,,,,,,,,,,,,,,,,,,,,,,,,,,,,,,21,2,142,67,,1019,0,,1,3,3,,1,0,,,,,"Aix-en-Provence Laufen",,"Polar BEAT",,0,,0,168070,250480,30378,,,,,,,,,,,,,,,,,,,,,,,,,,,,,,,,,,,,,,,,,,5,
5963105,e4510887-5f5e-42ce-9536-e49d7374b7f9,1499118453,120,1548677948,,0,0,2.05,649,680,16,17,,,1,0,0.21,,,,141,,,,,,,33.61,,1,,,,,,,,,,,,,,13,78,11.44,11.43,11.53,,,,,,,,,,,,,,,,,"1,3,24,53,19,0,0,0,0",,,,,,,121,,,,,,,,,,,,,,,,,,,,,,,,,,,,,,,,,,,,,25,6,288,45,,1018,0,,1,3,3,,1,0,,,,,"Aix-en-Provence Laufen",,"Polar BEAT",,0,,0,168070,250480,30378,,,,,,,,,,,,,,,,,,,,,,,,,,,,,,,,,,,,,,,,,,,
5963106,8fa1b698-43db-4939-96ad-ff77bc9c897f,1474722919,120,1548677948,,0,0,6.09,1878,1891,113,113,,,1,2.2,0.6,,,406,407,,,,,,,37.51,,1,,,,,,,,,,,,,,39,80,12.04,11.88,12.7,,,,,,,,,,,,,,,,,"4,10,20,26,24,14,2,0,0",,,,,,,122,,,,,,,,,,,,,,,,,,,,,,,,,,,,,,,,,,,,,22,6,196,52,,1024,4,,0,3,3,,1,0,,,,,"Aachen Laufen",,"Polar BEAT",,0,,0,168070,250480,30378,,,,,,,,,,,,,,,,,,,,,,,,,,,,,,,,,,,,,,,,,,"5,5",
5963107,04b81c42-db36-4707-834b-0c237bb44550,1489927738,60,1548677949,,0,0,17.64,5062,5374,279,278,,,1,2.8,0.6,,,529,1247,,,,,,,44.02,,1,,,,,,,,,,,,,,105,81,12.84,12.82,13.2,,,,,,,,,,,,,,,,,"4,4,9,15,34,25,8,0,0",,,,,,,129,,,,,,,,,,,,,,,,,,,,,,,,,,,,,,,,,,,,,11,16,246,81,,1010,,,0,5,3,,1,0,,,,,"Aachen Laufen",,"Polar BEAT",,0,,0,168070,250480,30378,,,,,,,,,,,,,,,,,,,,,,,,,,,,,,,,,,,,,,,,,,"4,5",
5963108,d60f5a6b-d91b-49e6-a81d-8718998257c1,1506621334,120,1548677949,,0,0,1.44,419,420,13,8,,,1,0.7,0.44,0.98,1.02,,121,170,177,,,,49.4,35.6,50.16,1,,,,,,,,,,,,,,16,81,12.71,12.7,12.76,-7.1,,,,,,,,,,,,,,,,"6,8,4,11,39,32,0,0,0","0,0,2,98,0",,,,,,127,,,,,,,,,,,,,,,,,,,,,,,,,,,,,,,,,,,,51.5,19,4,94,77,,1022,0,,0,5,3,,1,0,I1.000|4:53-I0.443|2:07,,Running,,,,"Polar M430",43,0,,0,168070,250480,30378,,,,,,,,,,,,,,,,,,,,,,,,,,,,,,,,,,,,,,,,,,,
5963109,93f84abf-fec9-4396-ba3b-bf9ef5db78cf,1421061305,60,1548677949,,0,0,2.94,1226,1239,151,112,,,1,3.4,0.86,4.41,3.08,925,232,150,179,,,,37.9,24.98,40.96,1,,,,,,,,,,,,,,32,,9.57,9.76,13.48,-0.6,,,,,,,,,,,,,,,,"48,12,13,10,10,6,1,0,0","0,45,16,39,0",,,,,,,,,,,,,,,,,,,,,,,,,,,,,,,,,,,,,,,,,,44.7,6,21,220,83,,1020,1,,0,5,3,,1,0,,,,,"4x Bergsprint",,"Polar BEAT",,0,,0,168070,250480,30378,,,,,,,,,,,,,,,,,,,,,,,,,,,,,,,,,,,,,,,,,,"5,5,5,5",
5963110,,1547547600,60,1548677949,,0,0,14,3660,3660,,,,,0,,,,,,895,,,,,,,48.15,,1,,,,,,,,,,,,,,76,,,,,,,,,,,,,,,,,,,,,,,,,,,,,,,,,,,,,,,,,,,,,,,,,,,,,,,,,,,,,,,,,,,,,,,,,,1,,,0,0,,,Running,,,,"no device name available",,0,,0,168070,250480,30378,,,,,,,,,,,,,,,,,,,,,,,,,,,,,,,,,,,,,,,,,,,
5963111,777dfc1e-1f32-4a28-82b6-1ecd54a7f4a3,1467242797,120,1548677950,,0,0,5.37,1406,1414,8,60,,,1,0,0.17,,,,373,,,,,,,45.17,,1,,,,,,,,,,,,,,29,80,13.42,13.97,13.64,,,,,,,,,,,,,,,,,"4,0,2,4,17,53,18,1,0",,,,,,,143,,,,,,,,,,,,,,,,,,,,,,,,,,,,,,,,,,,,,16,3,179,76,,1012,0,,1,5,3,,1,0,,,,,"Aachen Laufen",,"Polar BEAT",,0,,0,168070,250480,30378,,,,,,,,,,,,,,,,,,,,,,,,,,,,,,,,,,,,,,,,,,,
5963112,badb34c3-3bd9-47a2-9ee6-6c37367e41c0,1416594935,60,1548677950,,0,0,5.23,1673,2526,53,52,,,1,0.1,0.27,,,,348,,,,,,,35.59,,1,,,,,,,,,,,,,,34,81,11.45,11.4,11.59,,,,,,,,,,,,,,,,,"9,7,16,35,30,3,0,0,0",,,,,,,116,,,,,,,,,,,,,,,,,,,,,,,,,,,,,,,,,,,,,6,4,121,89,,1019,0,,1,5,3,,1,0,,,,,Auslaufen,,"Polar BEAT",,0,,0,168070,250480,30378,,,,,,,,,,,,,,,,,,,,,,,,,,,,,,,,,,,,,,,,,,,
5963113,a12f5ed9-bacf-47c3-bbd7-c72a7cec373a,1480710755,60,1548677950,,0,0,1.58,576,630,12,11,,,1,0,0,,,,109,,,,,,,27.81,,1,,,,,,,,,,,,,,11,78,9.91,9.93,9.99,,,,,,,,,,,,,,,,,"22,36,28,14,0,0,0,0,0",,,,,,,106,,,,,,,,,,,,,,,,,,,,,,,,,,,,,,,,,,,,,5,2,26,95,,1024,0,,1,5,3,,1,0,,,,,"Aachen Laufen",,"Polar BEAT",,0,,0,168070,250480,30378,,,,,,,,,,,,,,,,,,,,,,,,,,,,,,,,,,,,,,,,,,,
5963114,e09beeb7-f58e-47bb-afeb-266da45eeb85,1402654738,120,1548677951,,0,0,3.77,1210,1579,45,45,,,1,0.4,0.32,,,,255,,,,,,,34.76,,1,,,,,,,,,,,,,,25,81,11.36,11.37,11.75,,,,,,,,,,,,,,,,,"9,4,22,35,25,4,0,0,0",,,,,,,115,,,,,,,,,,,,,,,,,,,,,,,,,,,,,,,,,,,,,19,5,346,68,,1024,4,,0,3,3,,1,0,,,,,"Lauf ABC",,"Polar BEAT",,0,,0,168070,250480,30378,,,,,,,,,,,,,,,,,,,,,,,,,,,,,,,,,,,,,,,,,,,
5963115,442fe596-2f23-41dd-8b8e-87f85a883e5f,1364406555,60,1548677951,,0,0,0.31,112,112,0,9,,,1,0.9,0.65,,,,21,,,,,,,23.91,,1,,,,,,,,,,,,,,2,,9.62,10.51,9.81,,,,,,,,,,,,,,,,,"35,13,18,7,27,0,0,0,0",,,,,,,,,,,,,,,,,,,,,,,,,,,,,,,,,,,,,,,,,,,,4,9,74,45,,1009,0,,0,5,3,,1,0,,,,,,,"Polar BEAT",,0,,0,168070,250480,30378,,,,,,,,,,,,,,,,,,,,,,,,,,,,,,,,,,,,,,,,,,,
5963116,b417a588-55c9-4e09-8dc1-99e5b6fd92a8,1502907379,120,1548677951,,0,0,2.21,732,733,48,50,,,1,1.1,0.46,1.23,1.08,,149,137,150,,,,56.62,32.14,58.08,1,,,,,,,,,,,,,,13,79,11.12,10.95,11.39,-2,,,,,,,,,,,,,,,,"14,15,18,35,18,0,0,0,0","3,47,49,0,0",,,,,,115,,,,,,,,,,,,,,,,,,,,,,,,,,,,,,,,,,,,17.6,23,1,123,65,,1020,1,,0,5,3,,1,0,I1.000|5:46-I1.000|5:24-I0.211|1:04,,Running,,,,"Polar M430",43,0,,0,168070,250480,30378,,,,,,,,,,,,,,,,,,,,,,,,,,,,,,,,,,,,,,,,,,,
5963117,b93bae21-43d4-402c-83c5-9119688f548b,1512463263,60,1548677952,,0,0,13.58,1886,1887,34,34,,,1,0,0.06,,,,412,144,166,,,,,,,1,,,,,,,,,,,,,,42,,,26.64,,-4.9,-23.6,136,119,,1,150,136,,,,,,,,,"5,5,18,60,13,0,0","0,28,67,4,0","65,25,0,1,9",,,,,,,,,,,,,,,,,,,,,,,,,,,,,,,,,,,,,,,,,36.9,4,1,242,90,,,0,,0,4,3,,1,0,I3.609|9:53-I8.429|18:05-I0.000|0:01-I1.541|3:31,,Cycling,,,,"Polar M430",43,0,,0,168072,,30378,,,,,,,,,,,,,,,,,,,,,,,,,,,,,,,,,,,,,,,,,,,
5963118,01dafbc1-6b0c-4c5d-901f-4628f6fb3dd3,1406494113,120,1548677952,,0,0,5.01,1012,1012,38,41,,,1,0.5,0.41,1.06,1.01,,233,170,182,,,,77.59,60.89,78.27,1,,,,,,,,,,,,,,40,87,17.91,17.82,18,4.8,,,,,,,,,,,,,,,,"0,0,0,0,0,0,23,77,0","0,2,12,79,7",,,,,,171,,,,,,,,,,,,,,,,,,,,,,,,,,,,,,,,,,,,90.1,22,1,50,71,,1015,0,,0,5,3,,1,0,,,,,TDL,,"Polar BEAT",,0,,0,168070,250480,30378,,,,,,,,,,,,,,,,,,,,,,,,,,,,,,,,,,,,,,,,,,,
5963119,69acebe6-468b-4a62-9d04-39f56a229b1b,1443120649,120,1548677952,,0,0,2.37,804,811,4,0,,,1,0,0,,,,161,,,,,,,31.45,,1,,,,,,,,,,,,,,16,82,10.65,10.88,10.96,,,,,,,,,,,,,,,,,"9,11,26,35,19,0,0,0,0",,,,,,,108,,,,,,,,,,,,,,,,,,,,,,,,,,,,,,,,,,,,,15,14,211,72,,1016,,,0,4,3,,1,0,,,,,"Münster Laufen",,"Polar BEAT",,0,,0,168070,250480,30378,,,,,,,,,,,,,,,,,,,,,,,,,,,,,,,,,,,,,,,,,,,
5963120,4406f56c-51f9-4430-b81f-0a83231e0305,1497607638,120,1548677952,,0,0,9.94,2816,2816,316,328,,,1,4.1,0.73,,,645,667,,,,,,,42.77,,1,,,,,,,,,,,,,,58,82,13.62,13.06,14.16,,,,,,,,,,,,,,,,,"1,9,11,14,22,34,9,0,0",,,,,,,129,,,,,,,,,,,,,,,,,,,,,,,,,,,,,,,,,,,,,16,13,260,67,,1018,,,0,4,1,,1,0,,,,,"Balve Laufen",,"Polar BEAT",,0,,0,168070,250480,30378,,,,,,,,,,,,,,,,,,,,,,,,,,,,,,,,,,,,,,,,,,3,
5963121,7b20e362-1c48-4eb0-b90a-f8dd3f7740b2,1393962018,60,1548677953,,0,0,6.68,1825,1879,0,2,,,1,0,0.06,,0.57,,372,161,183,,,,57.89,43.52,57.87,1,,,,,,,,,,,,,,62,82,13.23,16.06,16.12,7.6,,,,,,,,,,,,,,,,"33,1,1,1,3,2,3,54,2","0,24,12,50,14",,,,,,134,,,,,,,,,,,,,,,,,,,,,,,,,,,,,,,,,,,,80.6,6,5,257,78,,1009,0,,1,5,3,,1,0,,,,,"6x 1000m in 3:10-3:15",,"Polar BEAT",,0,,0,168070,250480,30378,,,,,,,,,,,,,,,,,,,,,,,,,,,,,,,,,,,,,,,,,,,
5963122,948bc443-6a49-43c7-a18b-4c2129f03758,1474926879,120,1548677953,,0,0,6.01,2254,2254,70,70,,,1,0.7,0.43,,,,409,,,,,,,29.67,,1,,,,,,,,,,,,,,46,78,9.76,9.7,9.93,,,,,,,,,,,,,,,,,"34,35,22,7,1,0,0,0,0",,,,,,,103,,,,,,,,,,,,,,,,,,,,,,,,,,,,,,,,,,,,,13,0,146,79,,1025,0,,1,4,3,,1,0,,,,,"Aachen Laufen",,"Polar BEAT",,0,,0,168070,250480,30378,,,,,,,,,,,,,,,,,,,,,,,,,,,,,,,,,,,,,,,,,,,
5963123,6158d5c4-64ac-4838-8d88-b5d6dced2f33,1428744254,120,1548677953,,0,0,0.56,114,114,7,8,,,1,0,0,,,,38,,,,,,,48.79,,1,,,,,,,,,,,,,,2,91,17.46,17.84,17.73,,,,,,,,,,,,,,,,,"0,0,0,0,0,0,29,71,0",,,,,,,162,,,,,,,,,,,,,,,,,,,,,,,,,,,,,,,,,,,,,12,22,215,80,,1015,,,0,4,3,,1,0,,,,,"Rotterdam Laufen",,"Polar BEAT",,0,,0,168070,250480,30378,,,,,,,,,,,,,,,,,,,,,,,,,,,,,,,,,,,,,,,,,,,
5963124,05a6389f-3e08-41a2-ac5b-1f616a26f2ac,1410294911,120,1548677954,,0,0,9.32,2142,2256,0,0,,,1,0,0,,,,617,,,,,,,54.4,,1,,,,,,,,,,,,,,44,85,15.68,16.58,16.62,,,,,,,,,,,,,,,,,"11,0,0,0,0,1,36,51,0",,,,,,,154,,,,,,,,,,,,,,,,,,,,,,,,,,,,,,,,,,,,,15,3,10,82,,1020,0,,1,5,3,,1,0,,,,,"3x 5 Außenrunden",,"Polar BEAT",,0,,0,168070,250480,30378,,,,,,,,,,,,,,,,,,,,,,,,,,,,,,,,,,,,,,,,,,,
5963125,be29ea15-1198-4bff-be12-36ffc44aa631,1452105289,60,1548677954,,0,0,4.5,1541,1562,69,95,,,1,0.9,0.37,,,,307,,,,,,,32.52,,1,,,,,,,,,,,,,,32,74,10.57,12.89,13.08,,,,,,,,,,,,,,,,,"26,0,0,3,21,32,18,0,0",,,,,,,118,,,,,,,,,,,,,,,,,,,,,,,,,,,,,,,,,,,,,6,7,174,95,,1000,,,1,5,3,,1,0,,,,,,,"Polar BEAT",,0,,0,168070,250480,30378,,,,,,,,,,,,,,,,,,,,,,,,,,,,,,,,,,,,,,,,,,,
5963126,60e2fde3-b25a-4207-adaa-1e2a51b64ae4,1370179062,120,1548677955,,0,0,30,8721,8843,352,352,,,1,2.1,0.42,,,265,2068,,,,,,,45.14,,1,,,,,,,,,,,,,,181,,12.61,12.62,12.92,,,,,,,,,,,,,,,,,"4,5,9,19,31,23,8,0,0",,,,,,,,,,,,,,,,,,,,,,,,,,,,,,,,,,,,,,,,,,,,14,15,347,49,,1025,8,,0,3,3,,1,0,,,,,,,"Polar BEAT",,0,,0,168070,250480,30378,,,,,,,,,,,,,,,,,,,,,,,,,,,,,,,,,,,,,,,,,,"4,4",
5963127,,1333125559,120,1548677955,,0,0,10.87,0,0,,,,,0,,,,,,747,,,,,,,,,1,,,,,,,,,,,,,,0,,,,,,,,,,,,,,,,,,,,,,,,,,,,,,,,,,,,,,,,,,,,,,,,,,,,,,,,,,,,,,,,,,,,,,,,,,1,,,0,0,,,,,,,"Polar BEAT",,0,,0,168070,250480,30378,,,,,,,,,,,,,,,,,,,,,,,,,,,,,,,,,,,,,,,,,,,
5963128,,1417471380,60,1548677955,,0,0,5,0,0,,,,,0,,,,,,332,,,,,,,,,1,,,,,,,,,,,,,,0,,,,,,,,,,,,,,,,,,,,,,,,,,,,,,,,,,,,,,,,,,,,,,,,,,,,,,,,,,,,,,,,,,,,,,,,,,1,,,0,0,,,,,"Lauf ABC",,"Polar BEAT",,0,,0,168070,250480,30378,,,,,,,,,,,,,,,,,,,,,,,,,,,,,,,,,,,,,,,,,,,
5963130,8fc9b914-ec1a-4ee8-97f8-ff0925b4a922,1502048168,120,1548677956,,0,0,11.09,3106,3108,325,327,,,1,3.9,0.65,1.03,1.01,666,700,147,168,,,,63.67,43.68,65.97,1,,,,,,,,,,,,,,74,80,13.75,13.53,14.48,-15.3,,,,,,,,,,,,,,,,"2,9,11,18,29,15,6,9,0","0,40,31,28,0",,,,,,134,,,,,,,,,,,,,,,,,,,,,,,,,,,,,,,,,,,,52.6,19,2,244,53,,,,,0,3,3,,1,0,I1.000|5:19-I1.000|5:33-I1.000|5:42-I1.000|4:34-I1.000|4:47-I1.000|5:12-I1.000|4:52-I1.000|4:39-I1.000|3:07-I1.000|4:09-I1.000|3:34-I0.100|0:21,,Running,,,,"Polar M430",43,0,,0,168070,250480,30378,,,,,,,,,,,,,,,,,,,,,,,,,,,,,,,,,,,,,,,,,,3,
5963131,9d48360e-76d1-467f-862e-d5d2a7e6f567,1417773378,60,1548677958,,0,0,13.26,4162,4242,156,156,,,1,1.5,0.5,,,396,880,,,,,,,38.77,,1,,,,,,,,,,,,,,86,80,11.63,12.58,12.74,,,,,,,,,,,,,,,,,"13,2,5,13,28,38,3,0,0",,,,,,,119,,,,,,,,,,,,,,,,,,,,,,,,,,,,,,,,,,,,,3,4,202,94,,1019,0,,0,5,3,,1,0,,,,,"Lockerer DL",,"Polar BEAT",,0,,0,168070,250480,30378,,,,,,,,,,,,,,,,,,,,,,,,,,,,,,,,,,,,,,,,,,5,
5963132,c9e44a6d-b50b-46b5-b863-ce6314585990,1406754207,120,1548677959,,0,0,15.82,4288,4373,192,217,,,1,2,0.59,,,712,1060,,,,,,,46.62,,1,,,,,,,,,,,,,,89,83,13.45,13.51,13.76,,,,,,,,,,,,,,,,,"3,2,2,8,27,48,9,0,0",,,,,,,133,,,,,,,,,,,,,,,,,,,,,,,,,,,,,,,,,,,,,19,4,308,75,,1015,0,,1,5,3,,1,0,,,,,"Lockerer DL",,"Polar BEAT",,0,,0,168070,250480,30378,,,,,,,,,,,,,,,,,,,,,,,,,,,,,,,,,,,,,,,,,,4,
5963133,29e8abbe-7db0-49ed-b174-f241ffbaf07c,1446582444,60,1548677959,,0,0,2.53,781,781,27,20,,,1,0.4,0.36,,,,177,,,,,,,35.3,,1,,,,,,,,,,,,,,16,85,11.86,11.78,11.99,,,,,,,,,,,,,,,,,"1,8,18,35,35,4,0,0,0",,,,,,,114,,,,,,,,,,,,,,,,,,,,,,,,,,,,,,,,,,,,,11,6,135,74,,1019,,,1,5,3,,1,0,,,,,"Aachen Laufen",,"Polar BEAT",,0,,0,168070,250480,30378,,,,,,,,,,,,,,,,,,,,,,,,,,,,,,,,,,,,,,,,,,,
5963134,33080b3b-09a4-4c82-a24b-2426b89f6c97,1477225473,120,1548677959,,0,0,5.38,1666,1667,64,63,,,1,1,0.51,,,,366,,,,,,,37.05,,1,,,,,,,,,,,,,,34,81,11.85,11.8,11.94,,,,,,,,,,,,,,,,,"7,7,8,38,31,7,2,0,0",,,,,,,120,,,,,,,,,,,,,,,,,,,,,,,,,,,,,,,,,,,,,5,3,85,96,,1012,2,,0,5,3,,1,0,,,,,"Aachen Laufen",,"Polar BEAT",,0,,0,168070,250480,30378,,,,,,,,,,,,,,,,,,,,,,,,,,,,,,,,,,,,,,,,,,,
5963135,da118297-2f66-49cc-9726-7ef284e9a7e3,1516179800,60,1548677960,,0,0,11.16,1843,1847,32,42,,,1,0,0.05,,,,317,126,159,,,,,,,1,,,,,,,,,,,,,,26,,,23.31,,-4.7,-25.6,106,90,,1,124,113,,,,,,,,,"15,11,39,33,2,0,0","10,72,18,0,0","88,3,0,1,8",,,,,,,,,,,,,,,,,,,,,,,,,,,,,,,,,,,,,,,,,21.8,4,11,266,75,,,0,,0,5,3,,1,0,,,Cycling,,,,"Polar M430",43,0,,0,168072,,30378,,,,,,,,,,,,,,,,,,,,,,,,,,,,,,,,,,,,,,,,,,,
5963136,c8ef6250-a548-47e0-bf27-6c4e0f1a9567,1481967975,60,1548677960,,0,0,10.89,3099,3108,137,141,,,1,1.5,0.5,,,751,743,,,,,,,42.82,,1,,,,,,,,,,,,,,64,80,12.94,12.71,13.1,,,,,,,,,,,,,,,,,"0,2,4,12,60,22,0,0,0",,,,,,,132,,,,,,,,,,,,,,,,,,,,,,,,,,,,,,,,,,,,,2,2,204,93,,1038,0,,0,5,3,,1,0,,,,,"Aachen Laufen",,"Polar BEAT",,0,,0,168070,250480,30378,,,,,,,,,,,,,,,,,,,,,,,,,,,,,,,,,,,,,,,,,,5,
5963137,a2dbbe03-4ce4-4246-9dfc-ce81d1bf2b91,1401576877,120,1548677960,,0,0,1.52,512,512,32,16,,,1,0.9,0.47,,,,108,,,,,,,30.33,,1,,,,,,,,,,,,,,10,82,11.41,10.95,11.55,,,,,,,,,,,,,,,,,"20,25,13,21,15,6,0,0,0",,,,,,,109,,,,,,,,,,,,,,,,,,,,,,,,,,,,,,,,,,,,,14,0,292,65,,,0,,1,3,3,,1,0,,,,,Auslaufen,,"Polar BEAT",,0,,0,168070,250480,30378,,,,,,,,,,,,,,,,,,,,,,,,,,,,,,,,,,,,,,,,,,,
5963138,f3c4a853-7849-4a67-b8b3-37aa5f2eb9a9,1369044087,120,1548677961,,0,0,15.01,3952,4452,446,454,,,1,3.5,0.73,,,439,1029,,,,,,,48.02,,1,,,,,,,,,,,,,,82,,14.37,14.02,15.11,,,,,,,,,,,,,,,,,"3,0,2,5,24,43,19,4,0",,,,,,,,,,,,,,,,,,,,,,,,,,,,,,,,,,,,,,,,,,,,10,5,272,99,,,3,,0,6,3,,1,0,,,,,,,"Polar BEAT",,0,,0,168070,250480,30378,,,,,,,,,,,,,,,,,,,,,,,,,,,,,,,,,,,,,,,,,,"4,4,5,5,5,5",
5963139,c7dcc949-d4d5-43df-abb1-6f7be4299851,1457183996,60,1548677961,,0,0,4.5,1054,1054,30,29,,,1,0,0.18,,,,308,,,,,,,50.88,,1,,,,,,,,,,,,,,21,89,15.47,15.55,15.68,,,,,,,,,,,,,,,,,"0,0,0,0,6,35,49,9,2",,,,,,,144,,,,,,,,,,,,,,,,,,,,,,,,,,,,,,,,,,,,,5,3,47,83,,996,,,0,4,3,,1,0,,,,,"Herten Laufen",,"Polar BEAT",,0,,0,168070,250480,30378,,,,,,,,,,,,,,,,,,,,,,,,,,,,,,,,,,,,,,,,,,,
5963140,85bffcbf-aba0-4404-b029-ced918702a21,1547017171,60,1548677962,,0,0,10.32,1808,1838,40,47,,,1,0,0.1,2.01,0.52,,277,115,132,,,,,,,1,,,,,,,,,,,,,,17,,,21.42,,9.6,-18.4,97,84,,1,113,104,,,,,,,,,"10,7,81,2,0,0,0","1,99,0,0,0","89,1,0,1,9",,,,,,,,,,,,,,,,,,,,,,,,,,,,,,,,,,,,,,,,,6.9,3,13,251,86,,1015,0,422,1,6,3,,1,0,,,Cycling,,,,"Polar M430",43,0,,0,168072,,30378,,,,,,,,,,,,,,,,,,,,,,,,,,,,,,,,,,,,,,,,,,,
5963141,762a268f-28ea-4840-ab00-be3e46fdbc90,1483350251,60,1548677962,,0,0,4.48,1410,1416,45,45,,,1,1,0.55,,,,306,,,,,,,35.96,,1,,,,,,,,,,,,,,29,80,11.64,11.53,11.69,,,,,,,,,,,,,,,,,"4,10,17,36,28,6,0,0,0",,,,,,,119,,,,,,,,,,,,,,,,,,,,,,,,,,,,,,,,,,,,,0,4,264,97,,1024,0,,0,9,3,,1,0,,,,,"Aachen Laufen",,"Polar BEAT",,0,,0,168070,250480,30378,,,,,,,,,,,,,,,,,,,,,,,,,,,,,,,,,,,,,,,,,,,
5963142,3aad036b-453a-4958-a503-ef7b33ac18e1,1434302898,120,1548677962,,0,0,4.17,1941,2177,81,71,,,1,0.8,0.44,,,,202,,,,,,,22.27,,1,,,,,,,,,,,,,,40,69,7.74,12.08,12.93,,,,,,,,,,,,,,,,,"71,1,1,2,3,4,3,7,8",,,,,,,93,,,,,,,,,,,,,,,,,,,,,,,,,,,,,,,,,,,,,22,9,332,45,,1010,,,0,3,3,,1,0,,,,,"Aachen Laufen",,"Polar BEAT",,0,,0,168070,250480,30378,,,,,,,,,,,,,,,,,,,,,,,,,,,,,,,,,,,,,,,,,,,
5963143,37a53632-cf11-4058-bdfa-688594096738,1527097315,120,1548677963,,0,0,10.85,1827,1833,61,47,,,1,0,0.13,1.78,,,255,112,130,,,,,,,1,,,,,,,,,,,,,,16,,,23.33,,18.7,-13.5,121,100,,1,139,125,,,,,,,,,"15,6,43,36,0,0,0","14,86,0,0,0","87,3,0,1,10",,,,,,,,,,,,,,,,,,,,,,,,,,,,,,,,,,,,,,,,,7.2,23,9,12,63,,,2,,0,5,3,,1,0,,,Cycling,,,,"Polar M430",43,0,,0,168072,,30378,,,,,,,,,,,,,,,,,,,,,,,,,,,,,,,,,,,,,,,,,,,
5963144,8c37a2f5-ce96-4de7-977c-d851ade0c8b7,1395950180,60,1548677963,,0,0,5.08,1514,1514,93,91,,,1,1.6,0.68,1.07,1,439,278,140,159,,,,62.79,38.64,64.24,1,,,,,,,,,,,,,,29,83,12.4,12.17,12.76,-7.1,,,,,,,,,,,,,,,,"3,2,7,35,42,11,0,0,0","0,52,48,0,0",,,,,,121,,,,,,,,,,,,,,,,,,,,,,,,,,,,,,,,,,,,27.7,10,4,101,54,,1012,0,,1,5,3,,1,0,,,,,Auslaufen,,"Polar BEAT",,0,,0,168070,250480,30378,,,,,,,,,,,,,,,,,,,,,,,,,,,,,,,,,,,,,,,,,,5,
5963145,bda5403a-0f35-4683-961d-31ff038c3292,1509726952,60,1548677964,,0,0,11.86,3641,3648,48,47,,,1,0,0.1,1.13,0.95,,765,139,161,,,,61.08,39.44,61.39,1,,,,,,,,,,,,,,69,81,11.77,11.77,11.86,6.3,,,,,,,,,,,,,,,,"0,0,11,60,27,2,0,0,0","0,61,39,0,0",,,,,,121,,,,,,,,,,,,,,,,,,,,,,,,,,,,,,,,,,,,27.8,13,11,10,71,,1015,,,1,2,1,,1,0,I1.000|5:09-I1.000|4:47-I1.000|4:54-I1.000|5:06-I1.000|4:56-I1.000|5:20-I1.000|5:15-I1.000|5:06-I1.000|5:01-I1.000|5:15-I1.000|5:17-I0.860|4:42,,Running,,,,"Polar M430",43,0,,0,168070,250480,30378,,,,,,,,,,,,,,,,,,,,,,,,,,,,,,,,,,,,,,,,,,,
5963146,317f3331-0d88-4fd5-9c6c-1df48020761f,1403377918,120,1548677964,,0,0,13.13,3512,3535,158,158,,,1,1.4,0.51,,,415,882,,,,,,,46.66,,1,,,,,,,,,,,,,,72,82,13.67,13.59,13.79,,,,,,,,,,,,,,,,,"1,1,2,12,26,48,9,1,0",,,,,,,137,,,,,,,,,,,,,,,,,,,,,,,,,,,,,,,,,,,,,19,2,311,55,,1019,1,,0,5,3,,1,0,,,,,"Lockerer DL",,"Polar BEAT",,0,,0,168070,250480,30378,,,,,,,,,,,,,,,,,,,,,,,,,,,,,,,,,,,,,,,,,,5,
5963147,610fd075-4138-4da9-af61-398c34299f72,1457767104,60,1548677965,,0,0,5.23,1867,1870,88,85,,,1,1.7,0.54,,,239,362,,,,,,,31.22,,1,,,,,,,,,,,,,,38,83,10.36,10.23,10.72,,,,,,,,,,,,,,,,,"22,20,38,17,1,1,0,0,0",,,,,,,101,,,,,,,,,,,,,,,,,,,,,,,,,,,,,,,,,,,,,-2,3,89,94,,1030,,,0,9,3,,1,0,,,,,"Aachen Laufen",,"Polar BEAT",,0,,0,168070,250480,30378,,,,,,,,,,,,,,,,,,,,,,,,,,,,,,,,,,,,,,,,,,4,
5963148,f7b5f1e4-e685-4bc9-a1de-12b1a49ff066,1475963188,120,1548677965,,0,0,10.1,2625,2634,121,119,,,1,1.1,0.42,,,235,686,,,,,,,47.36,,1,,,,,,,,,,,,,,54,82,14.16,14,14.4,,,,,,,,,,,,,,,,,"2,0,2,5,14,57,19,0,0",,,,,,,141,,,,,,,,,,,,,,,,,,,,,,,,,,,,,,,,,,,,,7,1,26,80,,1026,0,,1,3,3,,1,0,,,,,"Aachen Laufen",,"Polar BEAT",,0,,0,168070,250480,30378,,,,,,,,,,,,,,,,,,,,,,,,,,,,,,,,,,,,,,,,,,"5,5",
5963149,a1bdb42a-ac2f-4b73-9709-14dfeee27036,1521055031,60,1548677966,,0,0,5.2,1513,1514,36,39,,,1,0,0.08,1.08,0.96,,352,148,174,,,,60.19,39.81,60.66,1,,,,,,,,,,,,,,37,81,12.41,12.55,12.63,6.9,,,,,,,,,,,,,,,,"0,1,7,40,36,8,8,0,0","0,26,50,24,0",,,,,,127,,,,,,,,,,,,,,,,,,,,,,,,,,,,,,,,,,,,47,9,3,69,64,,,0,,1,3,3,,1,0,I1.000|4:57-I1.000|4:54-I1.000|4:51-I1.000|4:21-I1.000|5:09-I0.207|1:04,,Running,,,,"Polar M430",43,0,,0,168070,250480,30378,,,,,,,,,,,,,,,,,,,,,,,,,,,,,,,,,,,,,,,,,,,
5963150,e502ec75-073c-4945-a922-99e3fc0ef0b1,1525174797,120,1548677966,,0,0,1.01,322,322,4,4,,,1,0,0,1.17,0.91,,57,126,151,,,,65.52,30.83,65.84,1,,,,,,,,,,,,,,4,81,11.29,11.26,11.28,9.3,,,,,,,,,,,,,,,,"0,17,22,35,25,0,0,0,0","0,82,18,0,0",,,,,,116,,,,,,,,,,,,,,,,,,,,,,,,,,,,,,,,,,,,7.1,10,14,256,55,,1014,,,0,5,3,,1,0,I1.000|5:20-I0.010|0:03,,Running,,,,"Polar M430",43,0,,0,168070,250480,30378,,,,,,,,,,,,,,,,,,,,,,,,,,,,,,,,,,,,,,,,,,,
5963151,,1547676000,60,1548677966,,0,0,10,1800,1800,,,,,0,,,,,,385,,,,,,,,,1,,,,,,,,,,,,,,20,,,,,,,,,,,,,,,,,,,,,,,,,,,,,,,,,,,,,,,,,,,,,,,,,,,,,,,,,,,,,,,,,,,,,,,,,,1,,,0,0,,,,,,,"no device name available",,0,,0,168072,,30378,,,,,,,,,,,,,,,,,,,,,,,,,,,,,,,,,,,,,,,,,,,
5963152,dc6a887b-9aa6-45f9-acf6-07dac876beb8,1415396095,60,1548677966,,0,0,6.96,1596,1596,144,156,,,1,1.8,0.68,,,,457,,,,,,,53.61,,1,,,,,,,,,,,,,,33,87,15.96,15.73,16.25,,,,,,,,,,,,,,,,,"0,0,0,0,0,5,91,4,0",,,,,,,150,,,,,,,,,,,,,,,,,,,,,,,,,,,,,,,,,,,,,9,8,204,88,,1007,0,,1,5,3,,1,0,,,,,TDL,,"Polar BEAT",,0,,0,168070,250480,30378,,,,,,,,,,,,,,,,,,,,,,,,,,,,,,,,,,,,,,,,,,,
5963153,fed2b258-ae6c-4cc0-b545-94bfb23bd1f6,1527763303,120,1548677966,,0,0,4.21,1393,1393,8,17,,,1,0,0.04,1.07,0.89,,341,153,170,,,,49.11,33.75,49.09,1,,,,,,,,,,,,,,37,83,10.85,11.03,11.01,-1.8,,,,,,,,,,,,,,,,"4,14,43,29,5,6,0,0,0","1,1,85,13,0",,,,,,109,,,,,,,,,,,,,,,,,,,,,,,,,,,,,,,,,,,,43.5,22,10,244,69,,1015,,,0,3,3,,1,0,I1.000|5:33-I1.000|5:38-I1.000|5:02-I1.000|5:44-I0.217|1:18,,Running,,,,"Polar M430",43,0,,0,168070,250480,30378,,,,,,,,,,,,,,,,,,,,,,,,,,,,,,,,,,,,,,,,,,,
5963154,4f6dba45-7ba4-4d46-bfff-62efc42e6cc3,1432286296,120,1548677967,,0,0,3.18,1107,1107,70,56,,,1,1.6,0.56,,,241,219,,,,,,,31.21,,1,,,,,,,,,,,,,,22,82,10.93,10.5,11.28,,,,,,,,,,,,,,,,,"22,18,22,26,11,0,0,0,0",,,,,,,105,,,,,,,,,,,,,,,,,,,,,,,,,,,,,,,,,,,,,13,5,249,61,,1027,,,0,5,3,,1,0,,,,,"Aachen Laufen",,"Polar BEAT",,0,,0,168070,250480,30378,,,,,,,,,,,,,,,,,,,,,,,,,,,,,,,,,,,,,,,,,,4,
5963155,,1406235642,120,1548677967,,0,0,8,0,0,,,,,0,,,,,,,,,,,,,,,1,,,,,,,,,,,,,,0,,,,,,,,,,,,,,,,,,,,,,,,,,,,,,,,,,,,,,,,,,,,,,,,,,,,,,,,,,,,,,,,,,,,,,,,,,1,,,0,0,,,,,"4x 5x 300m - 300er in 54-56
50m Trab in 18-22
letzte in 46.5",,"Polar BEAT",,0,,0,168070,250480,30378,,,,,,,,,,,,,,,,,,,,,,,,,,,,,,,,,,,,,,,,,,,
5963156,fa7176c5-725f-443b-afdd-719d738892dd,1476738681,120,1548677969,,0,0,4.82,1136,1136,42,43,,,1,0.7,0.45,,,,320,,,,,,,50.75,,1,,,,,,,,,,,,,,23,82,15.38,15.3,15.43,,,,,,,,,,,,,,,,,"0,0,0,0,2,37,61,0,0",,,,,,,155,,,,,,,,,,,,,,,,,,,,,,,,,,,,,,,,,,,,,11,1,195,91,,1024,0,,1,5,3,,1,0,,,,,"Aachen Laufen",,"Polar BEAT",,0,,0,168070,250480,30378,,,,,,,,,,,,,,,,,,,,,,,,,,,,,,,,,,,,,,,,,,,
5963157,07a6170e-fef2-424a-b8d0-5d5206b10402,1395947466,60,1548677969,,0,0,3.3,928,928,69,68,,,1,1.7,0.63,1.1,1.02,471,180,142,157,,,,66.26,40.21,68.01,1,,,,,,,,,,,,,,19,82,13.23,12.97,13.64,-2.7,,,,,,,,,,,,,,,,"2,5,6,13,35,27,11,0,0","1,38,61,0,0",,,,,,130,,,,,,,,,,,,,,,,,,,,,,,,,,,,,,,,,,,,22.1,10,4,101,54,,1012,0,,1,5,3,,1,0,,,,,Einlaufen,,"Polar BEAT",,0,,0,168070,250480,30378,,,,,,,,,,,,,,,,,,,,,,,,,,,,,,,,,,,,,,,,,,4,
5963158,787776cf-3d82-400d-80c9-de991e857d9c,1506619173,120,1548677969,,0,0,9.01,2084,2086,56,72,,,1,0.1,0.3,1.11,0.99,,659,180,191,,,,59.94,53.88,60.27,1,,,,,,,,,,,,,,101,82,15.56,15.6,15.66,3.3,,,,,,,,,,,,,,,,"0,0,0,0,3,17,74,5,0","0,0,5,32,62",,,,,,158,,,,,,,,,,,,,,,,,,,,,,,,,,,,,,,,,,,,155.3,20,4,219,73,,1022,1,,0,5,3,,1,0,I1.000|4:10-I1.000|3:52-I1.000|3:41-I1.000|3:49-I1.000|4:01-I1.000|3:53-I1.000|3:44-I1.000|3:48-I1.000|3:46-I0.016|0:03,,Running,,,,"Polar M430",43,0,,0,168070,250480,30378,,,,,,,,,,,,,,,,,,,,,,,,,,,,,,,,,,,,,,,,,,,
5963159,c2869151-9f8a-419d-a747-8004ff9e596a,1474625537,120,1548677970,,0,0,2.57,1568,1593,38,33,,,1,0.7,0.53,,,,153,,,,,,,15.28,,1,,,,,,,,,,,,,,32,66,6.07,6.64,6.75,,,,,,,,,,,,,,,,,"93,4,3,1,0,0,0,0,0",,,,,,,75,,,,,,,,,,,,,,,,,,,,,,,,,,,,,,,,,,,,,15,4,238,82,,1025,1,,0,5,3,,1,0,,,,,"Aachen Laufen",,"Polar BEAT",,0,,0,168070,250480,30378,,,,,,,,,,,,,,,,,,,,,,,,,,,,,,,,,,,,,,,,,,,
5963160,f2791814-3929-44a7-bc17-cf4cd6aa31f1,1444940120,120,1548677970,,0,0,14.47,4178,4815,136,137,,,1,1.4,0.53,,,,958,,,,,,,43.02,,1,,,,,,,,,,,,,,86,84,12.6,13.64,13.78,,,,,,,,,,,,,,,,,"16,13,11,14,12,7,6,17,3",,,,,,,124,,,,,,,,,,,,,,,,,,,,,,,,,,,,,,,,,,,,,4,9,268,98,,1018,,,1,9,3,,1,0,,,,,"Aachen Laufen",,"Polar BEAT",,0,,0,168070,250480,30378,,,,,,,,,,,,,,,,,,,,,,,,,,,,,,,,,,,,,,,,,,,
5963161,16f1503c-dc7b-4a7b-97c5-0b29bc208b5b,1454767251,60,1548677971,,0,0,2.76,570,570,12,8,,,1,0,0.15,,,,194,,,,,,,56.26,,1,,,,,,,,,,,,,,11,87,17.57,17.5,17.67,,,,,,,,,,,,,,,,,"0,0,0,0,0,0,27,73,0",,,,,,,167,,,,,,,,,,,,,,,,,,,,,,,,,,,,,,,,,,,,,11,24,197,69,,1010,,,0,5,3,,1,0,,,,,"Mönchengladbach Laufen",,"Polar BEAT",,0,,0,168070,250480,30378,,,,,,,,,,,,,,,,,,,,,,,,,,,,,,,,,,,,,,,,,,,
5963162,172d8061-31db-4db1-8ede-7c5691ba2d8a,1439320601,120,1548677971,,0,0,11.85,3259,3270,0,0,,,1,0,0,,,,760,,,,,,,44.83,,1,,,,,,,,,,,,,,67,81,13.09,14.55,14.55,,,,,,,,,,,,,,,,,"26,2,2,2,2,3,57,6,0",,,,,,,135,,,,,,,,,,,,,,,,,,,,,,,,,,,,,,,,,,,,,24,12,348,65,,1020,,,0,5,3,,1,0,,,,,"Balve Laufen",,"Polar BEAT",,0,,0,168070,250480,30378,,,,,,,,,,,,,,,,,,,,,,,,,,,,,,,,,,,,,,,,,,,
5963163,1f6704c4-89f5-4f5b-99f4-3858fc55fde2,1462108931,120,1548677972,,0,0,20,5332,5332,277,270,,,1,2.9,0.55,,,637,1372,,,,,,,48.42,,1,,,,,,,,,,,,,,110,82,13.8,13.7,14.06,,,,,,,,,,,,,,,,,"2,2,4,8,18,54,13,0,0",,,,,,,137,,,,,,,,,,,,,,,,,,,,,,,,,,,,,,,,,,,,,11,9,0,68,,1026,6,,0,5,3,,1,0,,,,,"Aachen Laufen",,"Polar BEAT",,0,,0,168070,250480,30378,,,,,,,,,,,,,,,,,,,,,,,,,,,,,,,,,,,,,,,,,,"4,4",
5963164,2fc3dfe9-4c64-4fef-85a4-bb0b0ad64d6a,1494928625,120,1548677972,,0,0,7.34,2548,2735,100,102,,,1,1.4,0.59,,,,509,,,,,,,32.97,,1,,,,,,,,,,,,,,52,79,10.58,10.61,10.79,,,,,,,,,,,,,,,,,"15,8,34,35,8,0,0,0,0",,,,,,,109,,,,,,,,,,,,,,,,,,,,,,,,,,,,,,,,,,,,,20,8,211,59,,1028,3,,0,5,3,,1,0,,,,,"Aachen Laufen",,"Polar BEAT",,0,,0,168070,250480,30378,,,,,,,,,,,,,,,,,,,,,,,,,,,,,,,,,,,,,,,,,,,
5963165,e366b20a-48ab-4f65-924a-35795aabcc85,1450206273,60,1548677973,,0,0,19.43,5385,5861,200,208,,,1,1.4,0.48,,,,1335,,,,,,,46.19,,1,,,,,,,,,,,,,,111,81,13.11,14.04,14.24,,,,,,,,,,,,,,,,,"10,3,6,10,14,23,29,5,0",,,,,,,134,,,,,,,,,,,,,,,,,,,,,,,,,,,,,,,,,,,,,8,10,148,91,,1024,,,1,5,3,,1,0,,,,,"Aachen Laufen",,"Polar BEAT",,0,,0,168070,250480,30378,,,,,,,,,,,,,,,,,,,,,,,,,,,,,,,,,,,,,,,,,,,
5963166,ca66c2a8-bf9b-4376-96af-348ef2234932,1495645381,120,1548677974,,0,0,4.94,1419,1472,73,74,,,1,1.5,0.55,,,248,334,,,,,,,40.3,,1,,,,,,,,,,,,,,29,78,12.83,12.89,13.07,,,,,,,,,,,,,,,,,"1,3,16,30,20,17,10,3,0",,,,,,,134,,,,,,,,,,,,,,,,,,,,,,,,,,,,,,,,,,,,,18,5,309,71,,,3,,0,5,3,,1,0,,,,,"Balve Laufen",,"Polar BEAT",,0,,0,168070,250480,30378,,,,,,,,,,,,,,,,,,,,,,,,,,,,,,,,,,,,,,,,,,5,
5963167,9a1cdec6-da38-46b1-9e24-fbb39b0a5a0b,1481738316,60,1548677974,,0,0,0.47,151,151,5,8,,,1,0,0,,,,36,,,,,,,28.33,,1,,,,,,,,,,,,,,3,80,11.21,11.52,11.38,,,,,,,,,,,,,,,,,"17,1,2,27,40,13,0,0,0",,,,,,,117,,,,,,,,,,,,,,,,,,,,,,,,,,,,,,,,,,,,,8,5,128,83,,1025,0,,1,5,3,,1,0,,,,,"Aachen Laufen",,"Polar BEAT",,0,,0,168070,250480,30378,,,,,,,,,,,,,,,,,,,,,,,,,,,,,,,,,,,,,,,,,,,
5963168,e8fac1d2-0118-4127-b9ab-b2117edf0a58,1410899466,120,1548677974,,0,0,2.26,687,775,0,0,,,1,0,0.02,,,,150,152,164,,,,55.01,35.55,55.01,1,,,,,,,,,,,,,,17,80,11.86,12.02,12.08,6,,,,,,,,,,,,,,,,"5,1,4,34,55,1,0,0,0","0,5,87,7,0",,,,,,123,,,,,,,,,,,,,,,,,,,,,,,,,,,,,,,,,,,,32.1,18,1,62,82,,1014,0,,1,3,3,,1,0,,,,,einlaufen,,"Polar BEAT",,0,,0,168070,250480,30378,,,,,,,,,,,,,,,,,,,,,,,,,,,,,,,,,,,,,,,,,,,
5963170,d3f47c46-47fb-4d3d-96be-c2ccc0c0d2f5,1498593231,120,1548677974,,0,0,1.61,478,531,16,17,,,1,0.6,0.5,,,,112,,,,,,,35.24,,1,,,,,,,,,,,,,,9,79,12.23,12.43,12.7,,,,,,,,,,,,,,,,,"11,1,2,19,44,23,0,0,0",,,,,,,128,,,,,,,,,,,,,,,,,,,,,,,,,,,,,,,,,,,,,26,18,128,68,,1005,0,,0,3,3,,1,0,,,,,"Aix-en-Provence Laufen",,"Polar BEAT",,0,,0,168070,250480,30378,,,,,,,,,,,,,,,,,,,,,,,,,,,,,,,,,,,,,,,,,,,
5963171,a4c6cc07-e55c-4846-8426-85a812b5abb2,1494453054,120,1548677975,,0,0,0.96,316,350,16,22,,,1,0.9,0.58,,,,70,,,,,,,29.56,,1,,,,,,,,,,,,,,6,80,10.85,11,11.12,,,,,,,,,,,,,,,,,"8,30,22,12,18,9,0,0,0",,,,,,,114,,,,,,,,,,,,,,,,,,,,,,,,,,,,,,,,,,,,,13,4,81,58,,1004,0,,1,3,3,,1,0,,,,,"Aachen Laufen",,"Polar BEAT",,0,,0,168070,250480,30378,,,,,,,,,,,,,,,,,,,,,,,,,,,,,,,,,,,,,,,,,,,
5963172,,1415400180,60,1548677975,,0,0,3,0,0,,,,,0,,,,,,199,,,,,,,,,1,,,,,,,,,,,,,,0,,,,,,,,,,,,,,,,,,,,,,,,,,,,,,,,,,,,,,,,,,,,,,,,,,,,,,,,,,,,,,,,,,,,,,,,,,1,,,0,0,,,,,Auslaufen,,"Polar BEAT",,0,,0,168070,250480,30378,,,,,,,,,,,,,,,,,,,,,,,,,,,,,,,,,,,,,,,,,,,
5963173,f0897eb2-39df-4b88-82c4-3ec87319b085,1460663782,120,1548677975,,0,0,4.04,1249,1271,55,37,,,1,0.7,0.45,,,,287,,,,,,,36.49,,1,,,,,,,,,,,,,,25,80,11.94,11.87,12.3,,,,,,,,,,,,,,,,,"8,6,9,32,34,9,2,0,0",,,,,,,121,,,,,,,,,,,,,,,,,,,,,,,,,,,,,,,,,,,,,12,2,139,72,,1011,0,,0,6,3,,1,0,,,,,"Aachen Laufen",,"Polar BEAT",,0,,0,168070,250480,30378,,,,,,,,,,,,,,,,,,,,,,,,,,,,,,,,,,,,,,,,,,,
5963174,106e4ef6-d1f2-430c-b583-1f2a64bff046,1470689487,120,1548677976,,0,0,14.2,3842,4177,205,202,,,1,2.1,0.59,,,328,971,,,,,,,46.32,,1,,,,,,,,,,,,,,79,81,13.57,13.95,14.31,,,,,,,,,,,,,,,,,"5,1,3,13,39,19,11,7,2",,,,,,,137,,,,,,,,,,,,,,,,,,,,,,,,,,,,,,,,,,,,,17,4,301,67,,1021,0,,1,5,3,,1,0,,,,,"Aachen Laufen",,"Polar BEAT",,0,,0,168070,250480,30378,,,,,,,,,,,,,,,,,,,,,,,,,,,,,,,,,,,,,,,,,,"4,5",
5963175,d1810a9c-8511-41a2-b0dc-bda3d64c3cfe,1495047181,120,1548677976,,0,0,13.25,3866,4151,187,212,,,1,2,0.62,,,399,934,,,,,,,42.21,,1,,,,,,,,,,,,,,80,79,12.51,12.48,12.77,,,,,,,,,,,,,,,,,"3,1,5,25,48,18,0,0,0",,,,,,,130,,,,,,,,,,,,,,,,,,,,,,,,,,,,,,,,,,,,,30,12,160,34,,1013,,,0,5,3,,1,0,,,,,"Aachen Laufen",,"Polar BEAT",,0,,0,168070,250480,30378,,,,,,,,,,,,,,,,,,,,,,,,,,,,,,,,,,,,,,,,,,"5,5",
5963176,11d3805c-3946-4ed9-992c-fe414a296bdc,1519554687,60,1548677977,,0,0,15.01,4315,4317,207,234,,,1,2,0.46,1.12,1.01,604,1194,165,187,,,,52.45,43.36,53.22,1,,,,,,,,,,,,,,156,84,12.69,12.65,13.08,5.7,,,,,,,,,,,,,,,,"0,1,8,29,32,26,3,0,0","0,9,30,47,15",,,,,,124,,,,,,,,,,,,,,,,,,,,,,,,,,,,,,,,,,,,120.4,-3,13,87,50,,1029,1,,0,3,3,,1,0,I1.000|5:00-I1.000|4:24-I1.000|4:32-I1.000|4:22-I1.000|5:10-I1.000|5:13-I1.000|4:42-I1.000|4:34-I1.000|4:35-I1.000|4:32-I1.000|4:29-I1.000|4:50-I1.000|5:18-I1.000|5:14-I1.000|5:03-I0.013|0:03,,Running,,,,"Polar M430",43,0,,0,168070,250480,30378,,,,,,,,,,,,,,,,,,,,,,,,,,,,,,,,,,,,,,,,,,4,
5963177,0a8e5913-85db-4ae3-a732-3fed2ca66b02,1475183486,120,1548677977,,0,0,1.83,588,588,26,38,,,1,0.7,0.44,,,,125,,,,,,,32.66,,1,,,,,,,,,,,,,,12,80,11.25,11.3,11.53,,,,,,,,,,,,,,,,,"5,7,16,62,10,0,0,0,0",,,,,,,117,,,,,,,,,,,,,,,,,,,,,,,,,,,,,,,,,,,,,17,9,238,76,,1015,0,,1,5,3,,1,0,,,,,"Aachen Laufen",,"Polar BEAT",,0,,0,168070,250480,30378,,,,,,,,,,,,,,,,,,,,,,,,,,,,,,,,,,,,,,,,,,,
5963178,ccfb00e1-45c3-4ea7-a4c4-eefd3bdf05b3,1463517445,120,1548677978,,0,0,8.44,2284,2341,0,2,,,1,0,0.04,,,,514,,,,,,,44.64,,1,,,,,,,,,,,,,,47,84,13.38,15.43,15.47,,,,,,,,,,,,,,,,,"38,2,2,2,3,3,4,31,14",,,,,,,132,,,,,,,,,,,,,,,,,,,,,,,,,,,,,,,,,,,,,15,4,236,62,,1016,0,,0,5,3,,1,0,,,,,"Aachen Laufen",,"Polar BEAT",,0,,0,168070,250480,30378,,,,,,,,,,,,,,,,,,,,,,,,,,,,,,,,,,,,,,,,,,,
5963179,4007e973-da6d-40cf-b19d-6d1865aedd5f,1541849142,60,1548677978,,0,0,13.85,4156,4159,49,52,,,1,0,0.03,1.08,0.9,,994,146,158,,,,58.99,40.99,59.24,1,,,,,,,,,,,,,,95,81,12.02,12.02,12.07,4.9,,,,,,,,,,,,,,,,"0,1,6,49,42,3,0,0,0","0,9,91,0,0",,,,,,123,,,,,,,,,,,,,,,,,,,,,,,,,,,,,,,,,,,,33.6,9,0,,92,,1010,1,298,0,4,3,,1,0,I1.000|5:05-I1.000|4:56-I1.000|5:01-I1.000|4:58-I1.000|4:53-I1.000|5:04-I1.000|5:00-I1.000|4:59-I1.000|4:58-I1.000|5:06-I1.000|5:04-I1.000|4:58-I1.000|5:08-I0.851|4:12,,Running,,,,"Polar M430",43,0,,0,168070,250480,30378,,,,,,,,,,,,,,,,,,,,,,,,,,,,,,,,,,,,,,,,,,,
5963180,18f838f1-8e5d-4137-a098-484760e12152,1461266833,120,1548677979,,0,0,1.54,500,500,37,35,,,1,1.2,0.52,,,,98,,,,,,,31.68,,1,,,,,,,,,,,,,,10,80,11.48,11.19,11.87,,,,,,,,,,,,,,,,,"4,4,27,61,5,0,0,0,0",,,,,,,116,,,,,,,,,,,,,,,,,,,,,,,,,,,,,,,,,,,,,17,5,44,45,,1019,0,,0,5,3,,1,0,,,,,"Aachen Laufen",,"Polar BEAT",,0,,0,168070,250480,30378,,,,,,,,,,,,,,,,,,,,,,,,,,,,,,,,,,,,,,,,,,,
5963181,ceb3fcce-cb93-4438-9ef7-8ead2e08383f,1403121778,120,1548677980,,0,0,19.12,5260,5782,257,256,,,1,1.4,0.41,,,364,1271,,,,,,,46.53,,1,,,,,,,,,,,,,,109,81,13.33,13.42,13.76,,,,,,,,,,,,,,,,,"4,2,4,12,20,44,12,1,0",,,,,,,135,,,,,,,,,,,,,,,,,,,,,,,,,,,,,,,,,,,,,19,4,9,65,,1021,0,,0,3,3,,1,0,,,,,"Lockerer DL",,"Polar BEAT",,0,,0,168070,250480,30378,,,,,,,,,,,,,,,,,,,,,,,,,,,,,,,,,,,,,,,,,,"5,5",
5963183,c5f75082-b5be-4ff5-81c3-1114f7a02e81,1346850520,120,1548677982,,0,0,7.16,893,894,94,187,,,1,1.4,0.54,,,,212,,,,,,,,,1,,,,,,,,,,,,,,9,,,33.39,,,,271,235,,1,351,321,,,,,,,,,"9,13,21,15,11,5,26",,"57,11,8,11,12",,,,,,,,,,,,,,,,,,,,,,,,,,,,,,,,,,,,,,,,,,17,5,354,70,,1023,4,,0,5,3,,1,0,,,,,,,"Polar BEAT",,0,,0,168072,,30378,,,,,,,,,,,,,,,,,,,,,,,,,,,,,,,,,,,,,,,,,,,
5963184,f5966b16-3bba-48a4-958b-901b7846d62d,1395861725,60,1548677982,,0,0,0.98,324,348,0,29,,,1,0.4,0.41,,0.92,,56,126,146,,,,62.64,29.48,60.36,1,,,,,,,,,,,,,,4,83,10.29,10.97,10.45,-27.5,,,,,,,,,,,,,,,,"24,15,8,23,18,12,0,0,0","3,86,10,0,0",,,,,,109,,,,,,,,,,,,,,,,,,,,,,,,,,,,,,,,,,,,6.5,6,3,87,70,,1015,0,,1,3,3,,1,0,,,,,"Lauf ABC + Auslaufen",,"Polar BEAT",,0,,0,168070,250480,30378,,,,,,,,,,,,,,,,,,,,,,,,,,,,,,,,,,,,,,,,,,,
5963185,2f266ca7-2883-4389-ba28-2f8fa306faf9,1363716165,60,1548677983,,0,0,7.43,2063,2074,4,0,,,1,0,0,,,,517,163,210,,,,55.73,42.97,55.81,1,,,,,,,,,,,,,,70,,13.01,13.26,13.29,6.8,,,,,,,,,,,,,,,,"4,1,3,5,47,32,5,2,1","0,2,23,73,2",,,,,,,,,,,,,,,,,,,,,,,,,,,,,,,,,,,,,,,,,,78.9,8,23,250,51,,1002,0,,0,5,3,,1,0,,,,,,,"Polar BEAT",,0,,0,168070,250480,30378,,,,,,,,,,,,,,,,,,,,,,,,,,,,,,,,,,,,,,,,,,,
5963186,318a79ec-5c30-4cf4-af14-693f9fee5ca1,1464345465,120,1548677983,,0,0,1.14,374,374,12,18,,,1,0.4,0.35,,,,78,,,,,,,30.26,,1,,,,,,,,,,,,,,7,80,11.04,10.94,11.16,,,,,,,,,,,,,,,,,"5,9,33,42,12,0,0,0,0",,,,,,,114,,,,,,,,,,,,,,,,,,,,,,,,,,,,,,,,,,,,,19,1,109,72,,1015,4,,0,5,3,,1,0,,,,,"Aachen Laufen",,"Polar BEAT",,0,,0,168070,250480,30378,,,,,,,,,,,,,,,,,,,,,,,,,,,,,,,,,,,,,,,,,,,
5963187,,1413500520,120,1548677983,,0,0,3.3,0,0,,,,,0,,,,,,211,,,,,,,,,1,,,,,,,,,,,,,,0,,,,,,,,,,,,,,,,,,,,,,,,,,,,,,,,,,,,,,,,,,,,,,,,,,,,,,,,,,,,,,,,,,,,,,,,,,1,,,0,0,,,,,Einlaufen,,"Polar BEAT",,0,,0,168070,250480,30378,,,,,,,,,,,,,,,,,,,,,,,,,,,,,,,,,,,,,,,,,,,
5963188,a01305e3-05db-489f-8024-d248466fb087,1501614863,120,1548677983,,0,0,3.41,1004,1005,62,64,,,1,1.5,0.53,1.06,1.01,439,231,148,168,,,,59.32,38.21,60.61,1,,,,,,,,,,,,,,24,82,12.58,12.45,13.2,0.9,,,,,,,,,,,,,,,,"4,3,5,29,34,24,0,0,0","0,17,72,11,0",,,,,,124,,,,,,,,,,,,,,,,,,,,,,,,,,,,,,,,,,,,32.4,22,6,358,71,,1016,,,0,5,3,,1,0,I1.000|5:16-I1.000|4:54-I1.000|4:30-I0.414|2:06,,Running,,,,"Polar M430",43,0,,0,168070,250480,30378,,,,,,,,,,,,,,,,,,,,,,,,,,,,,,,,,,,,,,,,,,4,
5963189,9ca66047-6b9a-453f-99a0-2101fbd9c90c,1458384485,60,1548677983,,0,0,4.97,1518,1787,87,66,,,1,0.6,0.43,,,179,356,,,,,,,37.49,,1,,,,,,,,,,,,,,31,82,12.3,12.12,12.47,,,,,,,,,,,,,,,,,"10,6,11,14,47,9,3,0,0",,,,,,,120,,,,,,,,,,,,,,,,,,,,,,,,,,,,,,,,,,,,,4,9,1,88,,1024,,,0,5,3,,1,0,,,,,"Aachen Laufen",,"Polar BEAT",,0,,0,168070,250480,30378,,,,,,,,,,,,,,,,,,,,,,,,,,,,,,,,,,,,,,,,,,4,
5963190,1df57a96-1aec-4f85-ae8f-f80a9489065b,1473799001,120,1548677984,,0,0,1.74,585,743,0,1,,,1,0,0,,,,120,,,,,,,30.85,,1,,,,,,,,,,,,,,12,80,10.68,10.78,10.8,,,,,,,,,,,,,,,,,"5,11,39,43,2,0,0,0,0",,,,,,,112,,,,,,,,,,,,,,,,,,,,,,,,,,,,,,,,,,,,,25,3,101,59,,1012,0,,1,3,3,,1,0,,,,,"Aachen Laufen",,"Polar BEAT",,0,,0,168070,250480,30378,,,,,,,,,,,,,,,,,,,,,,,,,,,,,,,,,,,,,,,,,,,
5963191,62ddfaa5-6888-42a9-a101-db3f6f5ca851,1403868259,120,1548677984,,0,0,11.94,3595,3753,207,208,,,1,2.7,0.7,,,507,806,,,,,,,40.37,,1,,,,,,,,,,,,,,74,82,12.31,12.27,12.77,,,,,,,,,,,,,,,,,"8,6,11,19,36,18,2,1,0",,,,,,,122,,,,,,,,,,,,,,,,,,,,,,,,,,,,,,,,,,,,,20,5,215,54,,1015,5,,0,5,3,,1,0,,,,,"Regenerativer DL",,"Polar BEAT",,0,,0,168070,250480,30378,,,,,,,,,,,,,,,,,,,,,,,,,,,,,,,,,,,,,,,,,,"4,5",
5963193,20c4bda7-1bf0-4686-aee8-21b9e52aeb99,1409572443,120,1548677985,,0,0,8.01,2386,2386,89,89,,,1,1.1,0.48,,,,540,,,,,,,39.74,,1,,,,,,,,,,,,,,49,83,12.25,12.16,12.43,,,,,,,,,,,,,,,,,"2,1,12,30,42,12,1,0,0",,,,,,,121,,,,,,,,,,,,,,,,,,,,,,,,,,,,,,,,,,,,,16,4,276,85,,1022,4,,0,5,3,,1,0,,,,,"Regenerativer DL ",,"Polar BEAT",,0,,0,168070,250480,30378,,,,,,,,,,,,,,,,,,,,,,,,,,,,,,,,,,,,,,,,,,,
5963194,08eaeb99-a16c-406b-84f2-b0e317a6fd9b,1406664739,120,1548677985,,0,0,2.99,876,885,25,21,,,1,0.4,0.34,,,,197,,,,,,,38.04,,1,,,,,,,,,,,,,,18,80,12.45,12.34,12.71,,,,,,,,,,,,,,,,,"5,2,6,27,36,25,0,0,0",,,,,,,128,,,,,,,,,,,,,,,,,,,,,,,,,,,,,,,,,,,,,19,4,293,99,,1010,0,,0,5,3,,1,0,,,,,Einlaufen,,"Polar BEAT",,0,,0,168070,250480,30378,,,,,,,,,,,,,,,,,,,,,,,,,,,,,,,,,,,,,,,,,,,
5963195,5b8b12a6-edeb-4795-a099-49ecbe95b8c8,1418746202,60,1548677986,,0,0,8.33,2596,3373,94,94,,,1,1,0.44,,,,557,,,,,,,37.78,,1,,,,,,,,,,,,,,53,82,11.69,11.69,11.86,,,,,,,,,,,,,,,,,"3,3,20,41,27,5,1,0,0",,,,,,,117,,,,,,,,,,,,,,,,,,,,,,,,,,,,,,,,,,,,,5,13,249,86,,1014,0,,0,5,3,,1,0,,,,,"Sehr langsamer DL",,"Polar BEAT",,0,,0,168070,250480,30378,,,,,,,,,,,,,,,,,,,,,,,,,,,,,,,,,,,,,,,,,,,
5963196,801b27a1-8601-4c53-b5b6-a0b4d38eccfe,1455905748,60,1548677986,,0,0,14.33,4164,4437,267,276,,,1,3,0.62,,,743,979,,,,,,,42.67,,1,,,,,,,,,,,,,,86,83,12.76,12.7,13.22,,,,,,,,,,,,,,,,,"6,3,10,19,25,31,5,1,0",,,,,,,124,,,,,,,,,,,,,,,,,,,,,,,,,,,,,,,,,,,,,3,10,203,74,,1021,,,1,3,3,,1,0,,,,,"Aachen Laufen",,"Polar BEAT",,0,,0,168070,250480,30378,,,,,,,,,,,,,,,,,,,,,,,,,,,,,,,,,,,,,,,,,,4,
5963197,20e80c20-6892-4b75-8cf3-e976a0575867,1466586952,120,1548677987,,0,0,16,4569,4629,293,293,,,1,3,0.71,,,421,1108,,,,,,,43.92,,1,,,,,,,,,,,,,,94,82,13.06,12.86,13.21,,,,,,,,,,,,,,,,,"2,3,12,21,30,27,7,0,0",,,,,,,128,,,,,,,,,,,,,,,,,,,,,,,,,,,,,,,,,,,,,19,5,186,90,,1023,2,,0,5,3,,1,0,,,,,"Voeren Sint-Martens-Voeren Laufen",,"Polar BEAT",,0,,0,168070,250480,30378,,,,,,,,,,,,,,,,,,,,,,,,,,,,,,,,,,,,,,,,,,"4,5,5",
5963198,0715c90c-4ff1-4b24-b3fe-ac1b5e2e70af,1406666153,120,1548677987,,0,0,6.71,1839,1839,0,0,,,1,0,0,,,,422,,,,,,,43.37,,1,,,,,,,,,,,,,,38,79,13.16,15.59,15.59,,,,,,,,,,,,,,,,,"33,1,1,1,2,2,5,53,2",,,,,,,139,,,,,,,,,,,,,,,,,,,,,,,,,,,,,,,,,,,,,19,4,293,99,,1010,0,,0,5,3,,1,0,,,,,"2x2000m 600,500,500,300",,"Polar BEAT",,0,,0,168070,250480,30378,,,,,,,,,,,,,,,,,,,,,,,,,,,,,,,,,,,,,,,,,,,
5963199,ac04c51a-22d0-43c5-833c-b60b044cd75d,1507314073,120,1548677988,,0,0,15.16,4483,4484,196,202,,,1,2,0.53,1.09,1.01,317,1101,153,172,,,,56.41,42,57.28,1,,,,,,,,,,,,,,120,80,12.36,12.34,12.69,-0.5,,,,,,,,,,,,,,,,"3,2,5,32,40,16,1,0,0","0,9,71,19,0",,,,,,127,,,,,,,,,,,,,,,,,,,,,,,,,,,,,,,,,,,,49,11,8,285,89,,1023,0,,0,6,3,,1,0,I1.000|5:23-I1.000|4:43-I1.000|4:56-I1.000|5:01-I1.000|4:32-I1.000|4:47-I1.000|5:36-I1.000|5:07-I1.000|5:09-I1.000|4:25-I1.000|4:50-I1.000|4:51-I1.000|4:34-I1.000|5:24-I1.000|4:35-I0.160|0:50,,Running,,,,"Polar M430",43,0,,0,168070,250480,30378,,,,,,,,,,,,,,,,,,,,,,,,,,,,,,,,,,,,,,,,,,4,
5963200,b746fbda-be85-4387-9dc9-15672aae243a,1502131080,120,1548677989,,0,0,10.33,2782,2783,134,142,,,1,1.8,0.53,1.05,1.02,321,685,156,176,,,,61.63,45.5,62.56,1,,,,,,,,,,,,,,80,81,13.66,13.53,13.81,1.4,,,,,,,,,,,,,,,,"2,1,2,8,33,43,11,0,0","1,10,52,37,0",,,,,,138,,,,,,,,,,,,,,,,,,,,,,,,,,,,,,,,,,,,70.6,23,3,11,47,,1016,,,0,5,3,,1,0,I1.000|4:54-I1.000|4:23-I1.000|4:36-I1.000|4:37-I1.000|5:01-I1.000|4:18-I1.000|4:17-I1.000|4:32-I1.000|4:11-I1.000|4:15-I0.341|1:21,,Running,,,,"Polar M430",43,0,,0,168070,250480,30378,,,,,,,,,,,,,,,,,,,,,,,,,,,,,,,,,,,,,,,,,,4,
5963201,4704fbf8-b80a-4501-8a06-d10956af770b,1502309800,120,1548677989,,0,0,10,2340,2340,12,13,,,1,0,0.02,,,,659,170,179,,,,64.65,53.5,64.74,1,,,,,,,,,,,,,,92,83,15.4,15.43,15.47,2.6,,,,,,,,,,,,,,,,"0,0,0,0,2,27,68,2,0","1,2,10,88,0",,,,,,154,,,,,,,,,,,,,,,,,,,,,,,,,,,,,,,,,,,,98.3,20,4,273,62,,,0,,0,5,3,,1,0,I1.000|4:08-I1.000|4:00-I1.000|3:50-I1.000|3:50-I1.000|3:58-I1.000|3:45-I1.000|3:54-I1.000|3:56-I1.000|3:41-I1.000|3:55-I0.012|0:03,,Running,,,,"Polar M430",43,0,,0,168070,250480,30378,,,,,,,,,,,,,,,,,,,,,,,,,,,,,,,,,,,,,,,,,,,
5963202,ddaf8ac0-f609-425d-b0ef-58a5feb17b6e,1499119874,120,1548677989,,0,0,0.7,214,214,0,2,,,1,0,0.14,,,,47,,,,,,,31.1,,1,,,,,,,,,,,,,,4,78,11.72,11.96,11.94,,,,,,,,,,,,,,,,,"0,7,7,35,51,0,0,0,0",,,,,,,126,,,,,,,,,,,,,,,,,,,,,,,,,,,,,,,,,,,,,25,6,288,45,,1018,0,,1,3,3,,1,0,,,,,"Aix-en-Provence Laufen",,"Polar BEAT",,0,,0,168070,250480,30378,,,,,,,,,,,,,,,,,,,,,,,,,,,,,,,,,,,,,,,,,,,
5963203,65569779-5bb3-4306-a0b2-d9b623ac9939,1499623632,120,1548677990,,0,0,13.18,4520,5180,233,233,,,1,2.6,0.53,,,540,904,,,,,,,34.93,,1,,,,,,,,,,,,,,93,79,10.82,10.73,11.33,,,,,,,,,,,,,,,,,"13,13,27,38,8,0,0,0,0",,,,,,,111,,,,,,,,,,,,,,,,,,,,,,,,,,,,,,,,,,,,,28,13,190,63,,1012,2,,0,3,3,,1,0,,,,,"Aix-en-Provence Laufen",,"Polar BEAT",,0,,0,168070,250480,30378,,,,,,,,,,,,,,,,,,,,,,,,,,,,,,,,,,,,,,,,,,"4,5,5",
5963204,41375056-fcd7-4dbc-a074-3712928073c1,1425925103,60,1548677991,,0,0,18.54,5655,5946,270,279,,,1,2.2,0.48,,,331,1262,,,,,,,41.17,,1,,,,,,,,,,,,,,117,80,12.05,12.44,12.85,,,,,,,,,,,,,,,,,"9,1,7,20,39,23,2,0,0",,,,,,,123,,,,,,,,,,,,,,,,,,,,,,,,,,,,,,,,,,,,,10,0,23,83,,1026,0,,1,5,3,,1,0,,,,,"lockerer DL",,"Polar BEAT",,0,,0,168070,250480,30378,,,,,,,,,,,,,,,,,,,,,,,,,,,,,,,,,,,,,,,,,,"4,5",
5963205,32db0d67-a280-44ff-8b47-ea47512f74f5,1424979455,60,1548677991,,0,0,8.61,2098,2110,0,3,,,1,0,0.01,,,,576,,,,,,,50.55,,1,,,,,,,,,,,,,,43,85,14.89,15.75,15.75,,,,,,,,,,,,,,,,,"18,1,1,2,2,2,26,48,0",,,,,,,145,,,,,,,,,,,,,,,,,,,,,,,,,,,,,,,,,,,,,6,11,191,92,,1012,0,,1,5,3,,1,0,,,,,"8x1k + 1min Pause",,"Polar BEAT",,0,,0,168070,250480,30378,,,,,,,,,,,,,,,,,,,,,,,,,,,,,,,,,,,,,,,,,,,
5963206,0e09e31c-a255-4975-b75a-34ef7200fc3a,1473970210,120,1548677992,,0,0,0.64,214,214,6,17,,,1,0.3,0.37,,,,42,,,,,,,27.81,,1,,,,,,,,,,,,,,4,79,10.5,10.94,10.71,,,,,,,,,,,,,,,,,"25,23,14,14,8,16,0,0,0",,,,,,,114,,,,,,,,,,,,,,,,,,,,,,,,,,,,,,,,,,,,,20,9,236,76,,1012,0,,1,6,3,,1,0,,,,,"Aachen Laufen",,"Polar BEAT",,0,,0,168070,250480,30378,,,,,,,,,,,,,,,,,,,,,,,,,,,,,,,,,,,,,,,,,,,
5963207,4d87714e-32ae-4add-a3f6-77f9de67cc3d,1403517749,120,1548677993,,0,0,18.47,4725,4725,245,245,,,1,2.5,0.57,,,822,1243,,,,,,,50.46,,1,,,,,,,,,,,,,,98,85,14.3,14.18,14.6,,,,,,,,,,,,,,,,,"1,0,0,3,15,64,17,0,0",,,,,,,138,,,,,,,,,,,,,,,,,,,,,,,,,,,,,,,,,,,,,16,5,68,62,,1023,4,,0,5,3,,1,0,,,,,"Zügiger DL",,"Polar BEAT",,0,,0,168070,250480,30378,,,,,,,,,,,,,,,,,,,,,,,,,,,,,,,,,,,,,,,,,,"4,5",
5963208,ef3fddc3-10b9-4b90-8272-36e95fe9cf3e,1346845055,120,1548677993,,0,0,45.88,5345,5347,1218,1221,,,1,5.1,0.71,,,1066,1728,,,,,,,,,1,,,,,,,,,,,,,,59,,,31.27,,,,432,265,,1,522,357,,,,,,,,,"0,0,4,24,68,4,0",,"47,12,9,7,25",,,,,,,,,,,,,,,,,,,,,,,,,,,,,,,,,,,,,,,,,,16,11,341,76,,1023,,,0,5,3,,1,0,,,,,,,"Polar BEAT",,0,,0,168072,,30378,,,,,,,,,,,,,,,,,,,,,,,,,,,,,,,,,,,,,,,,,,"4,4,4,4,4,4,4,4,4,5,5,5,5,5,5,5,5",
5963209,15272d6a-eda3-4002-a07c-63631246652d,1408197782,120,1548677996,,0,0,9.13,2675,2675,151,211,,,1,2.2,0.6,,,402,602,,,,,,,40.88,,1,,,,,,,,,,,,,,55,82,12.54,12.6,12.85,,,,,,,,,,,,,,,,,"7,4,13,20,27,20,7,1,0",,,,,,,125,,,,,,,,,,,,,,,,,,,,,,,,,,,,,,,,,,,,,17,8,270,72,,1020,5,,0,5,3,,1,0,,,,,Auslaufen,,"Polar BEAT",,0,,0,168070,250480,30378,,,,,,,,,,,,,,,,,,,,,,,,,,,,,,,,,,,,,,,,,,"4,5",
5963210,21a2186c-905e-419e-a87e-966e47befa71,1397305657,120,1548677996,,0,0,13.61,3838,4366,61,60,,,1,0,0.12,1.02,0.99,,632,146,162,,,,63.7,44.01,64.06,1,,,,,,,,,,,,,,85,82,12.84,12.99,13.05,-3.6,,,,,,,,,,,,,,,,"3,4,4,12,35,40,2,0,0","0,23,77,0,0",,,,,,130,,,,,,,,,,,,,,,,,,,,,,,,,,,,,,,,,,,,34.2,12,19,224,68,,1018,4,,0,3,3,,1,0,,,,,"Lockerer DL",,"Polar BEAT",,0,,0,168070,250480,30378,,,,,,,,,,,,,,,,,,,,,,,,,,,,,,,,,,,,,,,,,,,
5963211,fb246fdb-621a-472e-b2c6-fcbc36f3dd25,1435181401,120,1548677997,,0,0,10.33,2067,2067,0,0,,,1,0,0,,,,705,,,,,,,64.4,,1,,,,,,,,,,,,,,42,87,18.01,18.03,18.04,,,,,,,,,,,,,,,,,"0,0,0,0,0,0,18,80,2",,,,,,,172,,,,,,,,,,,,,,,,,,,,,,,,,,,,,,,,,,,,,16,7,192,70,,1021,,,0,5,3,,1,0,,,,,"Münster Laufen",,"Polar BEAT",,0,,0,168070,250480,30378,,,,,,,,,,,,,,,,,,,,,,,,10,2067,,,0,"Leonardo Campus-Run",,,,,,,0,0,30378,5963211,3624,,,
5963212,40133e3a-64df-4006-a717-123ff71f2127,1403467437,120,1548677997,,0,0,7.09,2018,2025,92,66,,,1,1.5,0.6,,,,478,,,,,,,41.62,,1,,,,,,,,,,,,,,41,82,12.94,12.74,13.08,,,,,,,,,,,,,,,,,"2,3,3,17,49,26,0,0,0",,,,,,,129,,,,,,,,,,,,,,,,,,,,,,,,,,,,,,,,,,,,,19,6,0,55,,1021,0,,0,5,3,,1,0,,,,,"Einlaufen + 4x 200 - 200er in ~ 30 + 200m Trab",,"Polar BEAT",,0,,0,168070,250480,30378,,,,,,,,,,,,,,,,,,,,,,,,,,,,,,,,,,,,,,,,,,,
5963213,f4b1543c-f2bb-4289-8924-24a7236cfe85,1509563109,60,1548677998,,0,0,12.17,3551,3553,39,40,,,1,0,0.05,1.05,0.94,,864,151,169,,,,58.39,41.93,58.61,1,,,,,,,,,,,,,,91,82,12.36,12.44,12.49,-3.9,,,,,,,,,,,,,,,,"1,1,7,32,41,17,1,0,0","0,4,88,8,0",,,,,,125,,,,,,,,,,,,,,,,,,,,,,,,,,,,,,,,,,,,44.2,8,0,,79,,,0,,1,3,3,,1,0,I1.000|4:41-I1.000|4:59-I1.000|5:02-I1.000|5:15-I1.000|5:05-I1.000|5:14-I1.000|4:56-I1.000|4:35-I1.000|4:44-I1.000|4:33-I1.000|4:49-I1.000|4:30-I0.168|0:50,,Running,,,,"Polar M430",43,0,,0,168070,250480,30378,,,,,,,,,,,,,,,,,,,,,,,,,,,,,,,,,,,,,,,,,,,
5963214,4cb8ff9d-4e6c-45ca-a78c-9ca11e6f6c9a,1489232742,60,1548677998,,0,0,12.93,3459,3459,188,188,,,1,2.4,0.67,,,401,900,,,,,,,46.6,,1,,,,,,,,,,,,,,71,80,13.82,13.71,13.92,,,,,,,,,,,,,,,,,"1,4,3,10,25,36,21,0,0",,,,,,,140,,,,,,,,,,,,,,,,,,,,,,,,,,,,,,,,,,,,,12,2,98,56,,1022,,,0,5,3,,1,0,,,,,"Aachen Laufen",,"Polar BEAT",,0,,0,168070,250480,30378,,,,,,,,,,,,,,,,,,,,,,,,,,,,,,,,,,,,,,,,,,4,
5963215,02653ad8-f1ac-47e3-9f50-c1ff4d821d57,1451064618,60,1548677999,,0,0,9.26,2680,2687,140,141,,,1,1.7,0.57,,,278,635,,,,,,,41.51,,1,,,,,,,,,,,,,,55,78,12.75,12.6,12.97,,,,,,,,,,,,,,,,,"0,2,9,33,32,20,4,0,0",,,,,,,133,,,,,,,,,,,,,,,,,,,,,,,,,,,,,,,,,,,,,9,15,187,90,,1024,,,1,4,3,,1,0,,,,,"Balve Laufen",,"Polar BEAT",,0,,0,168070,250480,30378,,,,,,,,,,,,,,,,,,,,,,,,,,,,,,,,,,,,,,,,,,5,
5963216,628b0199-0d96-4297-ba9c-4e48f374467a,1421349301,60,1548677999,,0,0,12.82,3660,4158,150,149,,,1,1.3,0.51,,,,834,,,,,,,43.18,,1,,,,,,,,,,,,,,76,82,12.74,13.81,13.91,,,,,,,,,,,,,,,,,"17,7,6,15,12,13,11,18,1",,,,,,,128,,,,,,,,,,,,,,,,,,,,,,,,,,,,,,,,,,,,,8,25,219,85,,999,,,1,5,3,,1,0,,,,,"8x hoch runter am HW",,"Polar BEAT",,0,,0,168070,250480,30378,,,,,,,,,,,,,,,,,,,,,,,,,,,,,,,,,,,,,,,,,,,
5963217,d1b25b00-858e-4046-9cf5-05203fe54f37,1462628372,120,1548678000,,0,0,11,2517,2587,302,323,,,1,3.6,0.69,,,783,746,,,,,,,55.26,,1,,,,,,,,,,,,,,52,84,16.22,15.83,17.01,,,,,,,,,,,,,,,,,"1,0,0,0,2,14,70,11,0",,,,,,,156,,,,,,,,,,,,,,,,,,,,,,,,,,,,,,,,,,,,,23,10,110,39,,,,,0,3,3,,1,0,,,,,"Balve Laufen",,"Polar BEAT",,0,,0,168070,250480,30378,,,,,,,,,,,,,,,,,,,,,,,,,,,,,,,,,,,,,,,,,,"4,5,5",
5963218,83b436d6-056e-489f-ac5e-a80236f3eeab,1403041202,120,1548678000,,0,0,1.2,341,357,19,23,,,1,0.7,0.47,,,,83,,,,,,,35.8,,1,,,,,,,,,,,,,,7,80,12.9,23.14,22.64,,,,,,,,,,,,,,,,,"35,22,21,11,0,0,0,0,11",,,,,,,132,,,,,,,,,,,,,,,,,,,,,,,,,,,,,,,,,,,,,15,11,350,81,,1022,,,0,5,3,,1,0,,,,,Auslaufen,,"Polar BEAT",,0,,0,168070,250480,30378,,,,,,,,,,,,,,,,,,,,,,,,,,,,,,,,,,,,,,,,,,,
5963219,,1415271000,60,1548678000,,0,0,8,0,0,,,,,0,,,,,,532,,,,,,,,,1,,,,,,,,,,,,,,0,,,,,,,,,,,,,,,,,,,,,,,,,,,,,,,,,,,,,,,,,,,,,,,,,,,,,,,,,,,,,,,,,,,,,,,,,,1,,,0,0,,,,,"Regenerativer DL",,"Polar BEAT",,0,,0,168070,250480,30378,,,,,,,,,,,,,,,,,,,,,,,,,,,,,,,,,,,,,,,,,,,
5963220,000f36ed-142d-42a6-90c8-249d202e34f8,1471464579,120,1548678000,,0,0,10.01,2391,2391,44,44,,,1,0,0.08,,,,684,,,,,,,52.24,,1,,,,,,,,,,,,,,49,82,15.12,15.12,15.18,,,,,,,,,,,,,,,,,"0,0,0,1,4,40,53,2,0",,,,,,,153,,,,,,,,,,,,,,,,,,,,,,,,,,,,,,,,,,,,,22,8,256,84,,1014,,,0,3,3,,1,0,,,,,"Naujac-sur-Mer Laufen",,"Polar BEAT",,0,,0,168070,250480,30378,,,,,,,,,,,,,,,,,,,,,,,,,,,,,,,,,,,,,,,,,,,
5963221,3cb7adbe-e0cd-49a4-89de-b5087c934f42,1404939870,120,1548678001,,0,0,15.73,3909,3953,197,223,,,1,1.9,0.54,,,572,1040,,,,,,,51.53,,1,,,,,,,,,,,,,,81,82,14.64,14.63,14.96,,,,,,,,,,,,,,,,,"0,0,1,4,14,39,40,2,0",,,,,,,147,,,,,,,,,,,,,,,,,,,,,,,,,,,,,,,,,,,,,15,7,303,100,,1007,0,,0,6,3,,1,0,,,,,"Zügiger DL ",,"Polar BEAT",,0,,0,168070,250480,30378,,,,,,,,,,,,,,,,,,,,,,,,,,,,,,,,,,,,,,,,,,4,
5963222,e55cbbcf-d62e-4076-b269-d1b55b9edcba,1444989646,120,1548678002,,0,0,13.9,4587,4629,191,197,,,1,2.3,0.59,,,330,954,,,,,,,36.7,,1,,,,,,,,,,,,,,95,83,11.11,11.02,11.24,,,,,,,,,,,,,,,,,"7,12,29,41,12,0,0,0,0",,,,,,,110,,,,,,,,,,,,,,,,,,,,,,,,,,,,,,,,,,,,,4,6,182,93,,1019,,,0,4,3,,1,0,,,,,"Aachen Laufen",,"Polar BEAT",,0,,0,168070,250480,30378,,,,,,,,,,,,,,,,,,,,,,,,,,,,,,,,,,,,,,,,,,4,
5963223,abe475cd-50bb-4c4b-97b0-9abb51186c14,1466257722,120,1548678002,,0,0,1.59,478,508,79,75,,,1,2,0.51,,,457,119,,,,,,,34.7,,1,,,,,,,,,,,,,,9,81,13.29,12.06,14.29,,,,,,,,,,,,,,,,,"21,6,8,12,17,22,11,3,0",,,,,,,123,,,,,,,,,,,,,,,,,,,,,,,,,,,,,,,,,,,,,15,7,243,90,,1017,5,,0,6,3,,1,0,,,,,"Aachen Laufen",,"Polar BEAT",,0,,0,168070,250480,30378,,,,,,,,,,,,,,,,,,,,,,,,,,,,,,,,,,,,,,,,,,5,
5963224,bd00e72d-5180-4c4e-a6ff-c2178cccd0e3,1432671061,120,1548678003,,0,0,3.34,918,918,65,67,,,1,1.6,0.58,,,473,225,,,,,,,41.33,,1,,,,,,,,,,,,,,19,82,13.51,13.21,14.07,,,,,,,,,,,,,,,,,"1,6,6,11,30,34,8,3,0",,,,,,,133,,,,,,,,,,,,,,,,,,,,,,,,,,,,,,,,,,,,,13,7,340,53,,1023,0,,0,5,3,,1,0,,,,,"Aachen Laufen",,"Polar BEAT",,0,,0,168070,250480,30378,,,,,,,,,,,,,,,,,,,,,,,,,,,,,,,,,,,,,,,,,,4,
5963225,c864b60e-cbc5-4d44-9326-0e3b922a932d,1497181259,120,1548678003,,0,0,15.01,4740,4974,264,269,,,1,2.6,0.56,,,314,1007,,,,,,,38.87,,1,,,,,,,,,,,,,,98,79,11.77,11.8,12.38,,,,,,,,,,,,,,,,,"8,6,13,29,32,11,1,0,0",,,,,,,120,,,,,,,,,,,,,,,,,,,,,,,,,,,,,,,,,,,,,26,17,205,51,,1017,,,0,5,3,,1,0,,,,,"Aachen Laufen",,"Polar BEAT",,0,,0,168070,250480,30378,,,,,,,,,,,,,,,,,,,,,,,,,,,,,,,,,,,,,,,,,,"4,5,5",
5963226,cb932f8f-bcf2-4915-be03-ab70f054479b,1368724357,120,1548678003,,0,0,0.42,116,116,1,0,,,1,0,0,,,,29,,,,,,,33.51,,1,,,,,,,,,,,,,,2,,13.05,13.06,13.29,,,,,,,,,,,,,,,,,"0,0,0,10,72,9,8,0,0",,,,,,,,,,,,,,,,,,,,,,,,,,,,,,,,,,,,,,,,,,,,11,4,280,95,,997,3,,0,6,3,,1,0,,,,,,,"Polar BEAT",,0,,0,168070,250480,30378,,,,,,,,,,,,,,,,,,,,,,,,,,,,,,,,,,,,,,,,,,,
5963227,c9dbc2a5-e10d-4d3d-abfd-39d49b788c5c,1502615734,120,1548678004,,0,0,22.58,5939,5940,20,21,,,1,0,0.02,,,,1470,155,172,,,,64.03,49.66,64.1,1,,,,,,,,,,,,,,164,81,13.7,13.75,13.78,1.6,,,,,,,,,,,,,,,,"0,0,1,4,22,65,7,1,0","0,2,84,14,0",,,,,,141,,,,,,,,,,,,,,,,,,,,,,,,,,,,,,,,,,,,55.3,18,2,284,76,,1015,2,,0,5,3,,1,0,I1.000|4:50-I1.000|4:24-I1.000|4:25-I1.000|4:22-I1.000|4:28-I1.000|4:23-I1.000|4:25-I1.000|4:23-I1.000|4:26-I1.000|4:23-I1.000|4:17-I1.000|4:27-I1.000|4:39-I1.000|4:23-I1.000|4:27-I1.000|4:31-I1.000|4:24-I1.000|4:25-I1.000|4:21-I1.000|4:02-I1.000|4:07-I1.000|4:14-I0.582|2:15,,Running,,,,"Polar M430",43,0,,0,168070,250480,30378,,,,,,,,,,,,,,,,,,,,,,,,,,,,,,,,,,,,,,,,,,,
5963228,83ced1ca-7549-4f72-a077-efaddf484b7b,1455130988,60,1548678005,,0,0,12.62,3251,3251,182,180,,,1,2.2,0.58,,,454,867,,,,,,,48.6,,1,,,,,,,,,,,,,,67,83,14.2,14.09,14.62,,,,,,,,,,,,,,,,,"0,0,0,5,23,55,16,0,0",,,,,,,140,,,,,,,,,,,,,,,,,,,,,,,,,,,,,,,,,,,,,3,17,253,92,,999,,,1,5,3,,1,0,,,,,"Aachen Laufen",,"Polar BEAT",,0,,0,168070,250480,30378,,,,,,,,,,,,,,,,,,,,,,,,,,,,,,,,,,,,,,,,,,4,
5963229,930cd748-8632-4c64-83fa-a03899685794,1516298947,60,1548678005,,0,0,13.14,3553,3553,41,38,,,1,0,0.08,1.06,0.92,,911,157,172,,,,60.78,46.08,61.03,1,,,,,,,,,,,,,,104,83,13.36,13.4,13.46,7.9,,,,,,,,,,,,,,,,"0,0,2,9,34,51,4,0,0","0,12,46,42,0",,,,,,134,,,,,,,,,,,,,,,,,,,,,,,,,,,,,,,,,,,,55.1,8,22,239,86,,1005,,,1,6,3,,1,0,I1.000|4:36-I1.000|4:18-I1.000|4:21-I1.000|4:22-I1.000|4:16-I1.000|4:31-I1.000|4:18-I1.000|4:28-I1.000|4:26-I1.000|4:30-I1.000|4:29-I1.000|4:44-I1.000|5:05-I0.149|0:49,,Running,,,,"Polar M430",43,0,,0,168070,250480,30378,,,,,,,,,,,,,,,,,,,,,,,,,,,,,,,,,,,,,,,,,,,
5963230,918d3bc0-d0cb-4e45-b92a-385a3fd8bd41,1411505024,120,1548678006,,0,0,8.46,2051,2059,93,93,,,1,0,0,,,,557,,,,,,,50.8,,1,,,,,,,,,,,,,,42,82,14.92,16.2,16.27,,,,,,,,,,,,,,,,,"16,1,1,1,1,1,37,42,0",,,,,,,151,,,,,,,,,,,,,,,,,,,,,,,,,,,,,,,,,,,,,10,4,103,83,,1020,,,1,5,3,,1,0,,,,,"4x 2.000m",,"Polar BEAT",,0,,0,168070,250480,30378,,,,,,,,,,,,,,,,,,,,,,,,,,,,,,,,,,,,,,,,,,,
5963231,d7b231b5-946c-4c56-b914-9db9432926cd,1454059317,60,1548678006,,0,0,1.15,380,381,24,19,,,1,1.2,0.65,,,,83,,,,,,,30.04,,1,,,,,,,,,,,,,,7,80,11.39,11.01,11.64,,,,,,,,,,,,,,,,,"9,21,22,26,19,2,0,0,0",,,,,,,113,,,,,,,,,,,,,,,,,,,,,,,,,,,,,,,,,,,,,5,23,209,82,,1026,,,0,5,3,,1,0,,,,,"Aachen Laufen",,"Polar BEAT",,0,,0,168070,250480,30378,,,,,,,,,,,,,,,,,,,,,,,,,,,,,,,,,,,,,,,,,,,
5963233,0a8a331c-4936-4196-ba79-6b7f6ea75f5c,1506713140,120,1548678006,,0,0,4.56,1410,1411,60,58,,,1,1.1,0.47,1.11,0.92,237,339,152,178,,,,53.87,36.76,54.77,1,,,,,,,,,,,,,,37,80,11.87,12.03,12.44,-6.1,,,,,,,,,,,,,,,,"9,9,13,32,19,11,7,0,0","1,9,67,22,0",,,,,,121,,,,,,,,,,,,,,,,,,,,,,,,,,,,,,,,,,,,59.1,21,6,185,74,,1018,0,,1,5,3,,1,0,I1.000|6:01-I1.000|5:23-I1.000|5:06-I1.000|4:21-I0.573|2:41,,Running,,,,"Polar M430",43,0,,0,168070,250480,30378,,,,,,,,,,,,,,,,,,,,,,,,,,,,,,,,,,,,,,,,,,5,
5963234,7f95c206-96dc-475e-91a1-c9a4ae7550da,1543514910,60,1548678008,,0,0,13.68,3583,3584,53,54,,,1,0,0.12,1.11,0.92,,913,153,169,,,,65.53,47.97,65.84,1,,,,,,,,,,,,,,95,82,13.79,13.82,13.9,1.6,,,,,,,,,,,,,,,,"0,0,0,3,28,58,10,0,0","0,3,89,8,0",,,,,,140,,,,,,,,,,,,,,,,,,,,,,,,,,,,,,,,,,,,49.9,4,5,286,99,,1017,0,279,1,4,3,,1,0,I1.000|4:49-I1.000|4:30-I1.000|4:28-I1.000|4:25-I1.000|4:14-I1.000|4:12-I1.000|3:56-I1.000|4:17-I1.000|4:18-I1.000|4:26-I1.000|4:25-I1.000|4:22-I1.000|4:23-I0.682|3:02,,Running,,,,"Polar M430",43,0,,0,168070,250480,30378,,,,,,,,,,,,,,,,,,,,,,,,,,,,,,,,,,,,,,,,,,,
5963235,754405ee-ad98-42c0-bca7-7df950896400,1480618934,60,1548678009,,0,0,3,935,1260,50,42,,,1,0.9,0.66,,,,203,,,,,,,35.4,,1,,,,,,,,,,,,,,19,78,12.16,12.04,12.65,,,,,,,,,,,,,,,,,"13,4,6,16,43,18,0,0,0",,,,,,,123,,,,,,,,,,,,,,,,,,,,,,,,,,,,,,,,,,,,,4,13,258,94,,1027,,,1,4,3,,1,0,,,,,"Aachen Laufen",,"Polar BEAT",,0,,0,168070,250480,30378,,,,,,,,,,,,,,,,,,,,,,,,,,,,,,,,,,,,,,,,,,,
5963236,44d14f6c-3284-4706-a47c-03eb2f7ac0b6,1481140372,60,1548678009,,0,0,0.65,227,227,14,9,,,1,1.3,1,,,,48,,,,,,,26.49,,1,,,,,,,,,,,,,,4,80,10.86,10.45,11.03,,,,,,,,,,,,,,,,,"23,12,34,18,13,0,0,0,0",,,,,,,107,,,,,,,,,,,,,,,,,,,,,,,,,,,,,,,,,,,,,7,13,191,68,,1032,,,1,5,3,,1,0,,,,,"Aachen Laufen",,"Polar BEAT",,0,,0,168070,250480,30378,,,,,,,,,,,,,,,,,,,,,,,,,,,,,,,,,,,,,,,,,,,
5963237,4a32cb75-bdba-4f85-b88f-0faa11ffaf76,1460144520,120,1548678010,,0,0,13.04,3783,4163,171,176,,,1,1.5,0.46,,,276,905,,,,,,,42.44,,1,,,,,,,,,,,,,,78,81,12.65,12.54,12.85,,,,,,,,,,,,,,,,,"2,2,7,20,49,19,1,0,0",,,,,,,128,,,,,,,,,,,,,,,,,,,,,,,,,,,,,,,,,,,,,10,0,297,66,,1011,0,,0,5,3,,1,0,,,,,"Aachen Laufen",,"Polar BEAT",,0,,0,168070,250480,30378,,,,,,,,,,,,,,,,,,,,,,,,,,,,,,,,,,,,,,,,,,"5,5",
5963238,8055cf23-abff-4aba-9525-a26180cd5a6f,1346761698,120,1548678010,,0,0,3.89,674,798,35,34,,,1,0,0.11,,,450,147,,,,,,,,,1,,,,,,,,,,,,,,7,,,28.7,,,,234,170,,1,269,231,,,,,,,,,"38,10,5,15,13,5,14",,"63,7,1,23,5",,,,,,,,,,,,,,,,,,,,,,,,,,,,,,,,,,,,,,,,,,21,3,83,60,,1023,5,,0,3,3,,1,0,,,,,,,"Polar BEAT",,0,,0,168072,,30378,,,,,,,,,,,,,,,,,,,,,,,,,,,,,,,,,,,,,,,,,,5,
5963239,5479ab9e-a3e6-407d-be4f-5a32e3e8cd87,1397757744,120,1548678011,,0,0,2.91,864,864,1,0,,,1,0,0,,,,163,144,154,,,,60.85,37.37,60.91,1,,,,,,,,,,,,,,18,82,12.16,12.26,12.29,-0.2,,,,,,,,,,,,,,,,"3,1,4,26,65,0,0,0,0","2,11,87,0,0",,,,,,123,,,,,,,,,,,,,,,,,,,,,,,,,,,,,,,,,,,,25.1,11,24,247,78,,1015,1,,0,5,3,,1,0,,,,,Einlaufen,,"Polar BEAT",,0,,0,168070,250480,30378,,,,,,,,,,,,,,,,,,,,,,,,,,,,,,,,,,,,,,,,,,,
5963240,a09adb2e-b466-4703-9887-2f04e2ae5c77,1536257060,120,1548678011,,0,0,10.01,2382,2382,37,34,,,1,0,0.04,,,,704,168,178,,,,64.47,52.47,64.79,1,,,,,,,,,,,,,,91,84,15.16,15.18,15.26,12.1,,,,,,,,,,,,,,,,"0,0,0,0,3,33,62,2,0","1,7,8,84,0",,,,,,150,,,,,,,,,,,,,,,,,,,,,,,,,,,,,,,,,,,,95.7,18,11,247,88,,,1,,0,5,3,,1,0,I1.000|3:54-I1.000|3:56-I1.000|3:52-I1.000|3:51-I1.000|3:45-I1.000|3:52-I1.000|4:03-I1.000|4:07-I1.000|4:01-I1.000|4:20-I0.013|0:02,,Running,,,,"Polar M430",43,0,,0,168070,250480,30378,,,,,,,,,,,,,,,,,,,,,,,,,,,,,,,,,,,,,,,,,,,
5963241,66573f9c-e7de-4899-9348-c05cb07a5d6d,1365101418,120,1548678012,,0,0,11.22,3291,3309,4,4,,,1,0,0,,,,783,,,,,,,41.42,,1,,,,,,,,,,,,,,68,,12.28,13.21,13.23,,,,,,,,,,,,,,,,,"11,3,4,9,42,15,11,4,1",,,,,,,,,,,,,,,,,,,,,,,,,,,,,,,,,,,,,,,,,,,,5,18,76,62,,1008,0,,0,5,3,,1,0,,,,,,,"Polar BEAT",,0,,0,168070,250480,30378,,,,,,,,,,,,,,,,,,,,,,,,,,,,,,,,,,,,,,,,,,,
5963242,6f174aba-c4ba-45cc-a854-238ef2481e77,1526671407,120,1548678012,,0,0,5.64,1663,1664,20,29,,,1,0,0.18,1.08,1,,356,142,159,,,,62.49,39.38,62.64,1,,,,,,,,,,,,,,34,81,12.23,12.34,12.38,9.4,,,,,,,,,,,,,,,,"7,2,6,16,47,22,0,0,0","1,33,67,0,0",,,,,,126,,,,,,,,,,,,,,,,,,,,,,,,,,,,,,,,,,,,30.3,18,3,14,54,,,,,0,3,3,,1,0,I1.000|4:45-I1.000|4:43-I1.000|5:05-I1.000|5:00-I1.000|4:57-I0.663|3:15,,Running,,,,"Polar M430",43,0,,0,168070,250480,30378,,,,,,,,,,,,,,,,,,,,,,,,,,,,,,,,,,,,,,,,,,,
5963243,35d0073c-a5f6-4424-a025-27f301d459f1,1405892102,120,1548678013,,0,0,3.12,866,866,45,25,,,1,0.4,0.41,,,,217,,,,,,,40.64,,1,,,,,,,,,,,,,,17,80,13.44,13.11,13.67,,,,,,,,,,,,,,,,,"0,0,3,24,39,26,6,1,0",,,,,,,135,,,,,,,,,,,,,,,,,,,,,,,,,,,,,,,,,,,,,21,0,83,82,,1011,0,,1,5,3,,1,0,,,,,"Lauf ABC + Steigerungen",,"Polar BEAT",,0,,0,168070,250480,30378,,,,,,,,,,,,,,,,,,,,,,,,,,,,,,,,,,,,,,,,,,,
5963244,,1426791480,60,1548678013,,0,0,10,0,0,,,,,0,,,,,,657,,,,,,,,,1,,,,,,,,,,,,,,0,,,,,,,,,,,,,,,,,,,,,,,,,,,,,,,,,,,,,,,,,,,,,,,,,,,,,,,,,,,,,,,,,,,,,,,,,,1,,,0,0,,,,,"Lauf ABC",,"Polar BEAT",,0,,0,168070,250480,30378,,,,,,,,,,,,,,,,,,,,,,,,,,,,,,,,,,,,,,,,,,,
5963245,e3ad7508-a706-4e35-b6f9-0d39cd556a6d,1394045063,60,1548678014,,0,0,15,3830,3831,179,152,,,1,1.4,0.4,,,331,986,,,,,,,49.75,,1,,,,,,,,,,,,,,79,84,14.4,14.42,14.73,,,,,,,,,,,,,,,,,"3,0,1,3,13,52,24,3,0",,,,,,,140,,,,,,,,,,,,,,,,,,,,,,,,,,,,,,,,,,,,,7,1,67,72,,1025,0,,1,5,3,,1,0,,,,,"TDL mit Lauf ABC",,"Polar BEAT",,0,,0,168070,250480,30378,,,,,,,,,,,,,,,,,,,,,,,,,,,,,,,,,,,,,,,,,,5,
5963246,608f2013-0bfa-4cd1-9b15-572762772a07,1427055811,60,1548678014,,0,0,5.51,1610,1610,91,90,,,1,0.8,0.4,,,216,378,,,,,,,39.75,,1,,,,,,,,,,,,,,33,83,12.61,12.59,12.97,,,,,,,,,,,,,,,,,"5,5,14,23,27,15,7,2,1",,,,,,,124,,,,,,,,,,,,,,,,,,,,,,,,,,,,,,,,,,,,,3,2,75,83,,1023,0,,1,3,3,,1,0,,,,,"Aachen Laufen",,"Polar BEAT",,0,,0,168070,250480,30378,,,,,,,,,,,,,,,,,,,,,,,,,,,,,,,,,,,,,,,,,,5,
5963247,3fcad8b5-049b-459c-8734-e6ab79ad264b,1535045929,120,1548678014,,0,0,10.4,1376,1397,51,42,,,1,0,0.14,1.73,,,244,128,165,,,,,,,1,,,,,,,,,,,,,,21,,,28.58,,9.1,-25.4,160,140,,1,191,167,,,,,,,,,"2,8,18,39,30,4,0","5,61,31,4,0","60,27,1,1,12",,,,,,,,,,,,,,,,,,,,,,,,,,,,,,,,,,,,,,,,,25.7,31,8,221,34,,,,,0,3,3,,1,0,,,Cycling,,,,"Polar M430",43,0,,0,168072,,30378,,,,,,,,,,,,,,,,,,,,,,,,,,,,,,,,,,,,,,,,,,,
5963248,060ad86c-91b0-4ff5-a48e-f55648c5225f,1368446719,120,1548678016,,0,0,10.8,3448,3478,223,223,,,1,2.7,0.69,,,358,752,,,,,,,37.41,,1,,,,,,,,,,,,,,71,,11.65,11.47,12.13,,,,,,,,,,,,,,,,,"10,7,17,33,22,9,1,0,0",,,,,,,,,,,,,,,,,,,,,,,,,,,,,,,,,,,,,,,,,,,,12,15,251,87,,1015,5,,0,5,3,,1,0,,,,,,,"Polar BEAT",,0,,0,168070,250480,30378,,,,,,,,,,,,,,,,,,,,,,,,,,,,,,,,,,,,,,,,,,"4,5",
5963249,8c1940e7-0673-4c73-bb72-1f4c98637afe,1470853174,120,1548678016,,0,0,10,2500,2667,33,33,,,1,0,0.1,,,,680,,,,,,,49.52,,1,,,,,,,,,,,,,,51,81,14.45,14.92,15.01,,,,,,,,,,,,,,,,,"7,1,1,1,2,20,69,0,0",,,,,,,148,,,,,,,,,,,,,,,,,,,,,,,,,,,,,,,,,,,,,20,6,334,63,,,,,0,3,3,,1,0,,,,,"Naujac-sur-Mer Laufen",,"Polar BEAT",,0,,0,168070,250480,30378,,,,,,,,,,,,,,,,,,,,,,,,,,,,,,,,,,,,,,,,,,,
5963250,72ccbee4-33c6-40d5-9023-227ffc7617a1,1418673574,60,1548678017,,0,0,11.84,3874,4630,125,150,,,1,1.2,0.49,,,271,797,,,,,,,36.6,,1,,,,,,,,,,,,,,80,82,11.13,11.14,11.36,,,,,,,,,,,,,,,,,"6,6,22,56,9,1,1,0,0",,,,,,,112,,,,,,,,,,,,,,,,,,,,,,,,,,,,,,,,,,,,,4,6,207,95,,1016,0,,1,5,3,,1,0,,,,,"Sehr langsamer DL",,"Polar BEAT",,0,,0,168070,250480,30378,,,,,,,,,,,,,,,,,,,,,,,,,,,,,,,,,,,,,,,,,,"5,5",
5963251,25789b50-3087-4102-bcf5-f1d2bc7918a3,1473710503,120,1548678018,,0,0,12.32,3366,3367,193,200,,,1,2.3,0.54,,,829,829,,,,,,,45.31,,1,,,,,,,,,,,,,,69,82,13.48,13.32,13.84,,,,,,,,,,,,,,,,,"1,2,3,12,35,38,9,0,0",,,,,,,134,,,,,,,,,,,,,,,,,,,,,,,,,,,,,,,,,,,,,25,1,64,62,,1015,0,,1,3,3,,1,0,,,,,"Aachen Laufen",,"Polar BEAT",,0,,0,168070,250480,30378,,,,,,,,,,,,,,,,,,,,,,,,,,,,,,,,,,,,,,,,,,4,
5963252,66aa7586-2671-4d3a-937a-1415d4b1dced,1537209119,120,1548678018,,0,0,7.66,2366,2366,36,37,,,1,0,0.1,1.16,0.94,,487,134,153,,,,63.41,37.97,63.76,1,,,,,,,,,,,,,,39,80,11.7,11.78,11.9,0.1,,,,,,,,,,,,,,,,"1,3,23,38,28,6,0,0,0","1,71,27,0,0",,,,,,121,,,,,,,,,,,,,,,,,,,,,,,,,,,,,,,,,,,,20.7,27,3,81,34,,1018,,,0,3,3,,1,0,I1.000|5:15-I1.000|5:05-I1.000|4:50-I1.000|4:41-I1.000|4:59-I1.000|5:28-I1.000|5:33-I0.664|3:36,,Running,,,,"Polar M430",43,0,,0,168070,250480,30378,,,,,,,,,,,,,,,,,,,,,,,,,,,,,,,,,,,,,,,,,,,
5963253,0a870bf7-028d-4b8c-9b9a-97103502f4d6,1538758196,120,1548678018,,0,0,7.44,2249,2312,44,45,,,1,0,0.14,1.23,0.88,,372,117,149,,,,75.92,38.88,76.46,1,,,,,,,,,,,,,,23,80,11.95,13.16,13.26,17.2,,,,,,,,,,,,,,,,"23,3,2,8,29,19,4,14,0","4,95,1,0,0",,,,,,124,,,,,,,,,,,,,,,,,,,,,,,,,,,,,,,,,,,,11,22,5,335,48,,1017,1,249,0,3,3,,1,0,I4.730|22:52-I0.422|1:25-I0.129|1:01-I0.419|1:24-I0.108|0:58-I0.424|1:24-I0.118|1:02-I0.422|1:23-I0.107|1:09-I0.424|1:26-I0.132|4:32,,Running,,,,"Polar M430",43,0,,0,168070,250480,30378,,,,,,,,,,,,,,,,,,,,,,,,,,,,,,,,,,,,,,,,,,,
5963254,,1413809640,120,1548678018,,0,0,5,0,0,,,,,0,,,,,,332,,,,,,,,,1,,,,,,,,,,,,,,0,,,,,,,,,,,,,,,,,,,,,,,,,,,,,,,,,,,,,,,,,,,,,,,,,,,,,,,,,,,,,,,,,,,,,,,,,,1,,,0,0,,,,,"Einlaufen + Dehnen",,"Polar BEAT",,0,,0,168070,250480,30378,,,,,,,,,,,,,,,,,,,,,,,,,,,,,,,,,,,,,,,,,,,
5963255,c9b47077-02f1-4b7b-a226-786abfa8c97a,1449920389,60,1548678019,,0,0,6.71,1773,1773,118,117,,,1,1.9,0.6,,,335,451,,,,,,,45.28,,1,,,,,,,,,,,,,,36,83,14.16,14.35,14.57,,,,,,,,,,,,,,,,,"3,6,4,14,25,27,13,2,6",,,,,,,137,,,,,,,,,,,,,,,,,,,,,,,,,,,,,,,,,,,,,7,11,227,84,,1022,,,0,5,3,,1,0,,,,,"Balve Laufen",,"Polar BEAT",,0,,0,168070,250480,30378,,,,,,,,,,,,,,,,,,,,,,,,,,,,,,,,,,,,,,,,,,"5,5",
5963256,eb6604b2-f031-4d2b-8007-98563619fe9c,1419768051,60,1548678019,,0,0,12.56,3207,3207,341,342,,,1,4.2,0.74,,,735,835,,,,,,,49.09,,1,,,,,,,,,,,,,,66,86,14.89,14.38,15.55,,,,,,,,,,,,,,,,,"1,0,3,11,14,40,28,3,0",,,,,,,137,,,,,,,,,,,,,,,,,,,,,,,,,,,,,,,,,,,,,-4,5,53,80,,,,,0,3,3,,1,0,,,,,"Zügiger DL",,"Polar BEAT",,0,,0,168070,250480,30378,,,,,,,,,,,,,,,,,,,,,,,,,,,,,,,,,,,,,,,,,,3,
5963257,3160a4ec-a78f-4d6b-8e40-37a193ff5b0a,1412343384,120,1548678020,,0,0,9.78,2041,2041,150,151,,,1,1.4,0.46,,,,653,,,,,,,61.1,,1,,,,,,,,,,,,,,42,87,17.51,17.33,17.66,,,,,,,,,,,,,,,,,"0,0,0,0,0,3,47,46,3",,,,,,,165,,,,,,,,,,,,,,,,,,,,,,,,,,,,,,,,,,,,,21,8,135,57,,1025,,,0,5,3,,1,0,,,,,"WK 10k Radio MK",,"Polar BEAT",,0,,0,168070,250480,30378,,,,,,,,,,,,,,,,,,,,,,,,,,,,,,,,,,,,,,,,,,,
5963258,07c4885c-5c99-4e3f-9354-f49de09c4368,1451570248,60,1548678020,,0,0,3.24,1367,1872,4,2,,,1,0,0.06,,,,206,,,,,,,24.78,,1,,,,,,,,,,,,,,28,70,8.53,10.21,10.21,,,,,,,,,,,,,,,,,"43,5,11,21,14,3,3,0,0",,,,,,,102,,,,,,,,,,,,,,,,,,,,,,,,,,,,,,,,,,,,,8,20,218,75,,1019,,,0,5,3,,1,0,,,,,"Werl Laufen",,"Polar BEAT",,0,,0,168070,250480,30378,,,,,,,,,,,,,,,,,,,,,,,,,,,,,,,,,,,,,,,,,,,
5963259,a9589b87-2a92-45b2-afb1-2acd749f5e18,1407442372,120,1548678021,,0,0,3.11,871,871,61,60,,,1,1.7,0.61,1.07,0.99,448,165,142,159,,,,66.6,40.21,68.25,1,,,,,,,,,,,,,,18,82,13.31,12.99,13.92,1,,,,,,,,,,,,,,,,"0,1,5,26,34,21,12,0,0","1,38,61,0,0",,,,,,131,,,,,,,,,,,,,,,,,,,,,,,,,,,,,,,,,,,,22.3,19,4,32,78,,1015,,,0,5,3,,1,0,,,,,Einlaufen,,"Polar BEAT",,0,,0,168070,250480,30378,,,,,,,,,,,,,,,,,,,,,,,,,,,,,,,,,,,,,,,,,,4,
5963260,40587e5d-cb26-4fd5-bb73-e534d68a8b3c,1394626336,60,1548678022,,0,0,9.68,2780,2818,130,130,,,1,1.6,0.46,1.04,0.99,316,499,144,163,,,,63.41,42.01,64.46,1,,,,,,,,,,,,,,60,83,12.81,12.69,13.04,-3.8,,,,,,,,,,,,,,,,"4,2,4,15,50,24,2,0,0","0,32,65,2,0",,,,,,126,,,,,,,,,,,,,,,,,,,,,,,,,,,,,,,,,,,,30.8,14,5,88,56,,1032,3,,0,3,3,,1,0,,,,,"Regenerativer DL",,"Polar BEAT",,0,,0,168070,250480,30378,,,,,,,,,,,,,,,,,,,,,,,,,,,,,,,,,,,,,,,,,,5,
5963261,2a607d4b-172c-45e2-8d6e-605654ac5816,1405175927,120,1548678023,,0,0,3.42,1047,1047,20,50,,,1,0.6,0.47,,,,227,,,,,,,36.51,,1,,,,,,,,,,,,,,21,82,11.62,11.86,11.79,,,,,,,,,,,,,,,,,"2,5,17,42,26,2,2,2,0",,,,,,,120,,,,,,,,,,,,,,,,,,,,,,,,,,,,,,,,,,,,,17,4,266,94,,1014,5,,0,5,3,,1,0,,,,,Auslaufen,,"Polar BEAT",,0,,0,168070,250480,30378,,,,,,,,,,,,,,,,,,,,,,,,,,,,,,,,,,,,,,,,,,,
5963262,7cabd60f-c8c7-4f15-a1fa-edc2cb8e4152,1402226529,120,1548678023,,0,0,15,3794,3870,382,393,,,1,3.5,0.63,,,521,992,,,,,,,50.3,,1,,,,,,,,,,,,,,78,84,14.75,14.39,15.55,,,,,,,,,,,,,,,,,"1,1,1,1,16,57,19,4,1",,,,,,,141,,,,,,,,,,,,,,,,,,,,,,,,,,,,,,,,,,,,,25,4,331,65,,,,,0,3,3,,1,0,,,,,"Gesteigerter DL",,"Polar BEAT",,0,,0,168070,250480,30378,,,,,,,,,,,,,,,,,,,,,,,,,,,,,,,,,,,,,,,,,,"5,5,5,5,5,5",
5963263,80973ea2-5a6c-4205-9aeb-0dccb6d1f472,1546260779,60,1548678023,,0,0,0.9,376,414,0,0,,,1,0,0,,,,73,130,148,,,,45.27,22.29,45.27,1,,,,,,,,,,,,,,5,80,8.63,9.75,9.72,-15,,,,,,,,,,,,,,,,"38,9,8,35,10,0,0,0,0","0,76,24,0,0",,,,,,90,,,,,,,,,,,,,,,,,,,,,,,,,,,,,,,,,,,,9.6,9,14,262,90,,1033,0,297,0,5,3,,1,0,,,Running,,,,"Polar M430",43,0,,0,168070,250480,30378,,,,,,,,,,,,,,,,,,,,,,,,,,,,,,,,,,,,,,,,,,,
5963264,329d4748-9bf4-4835-bf12-f9ac0fcc8226,1397586992,120,1548678024,,0,0,6.77,1661,1661,24,19,,,1,0,0.01,,0.72,,373,167,180,,,,62.64,49.43,62.97,1,,,,,,,,,,,,,,62,89,14.69,15.17,15.34,4.6,,,,,,,,,,,,,,,,"6,6,4,5,4,15,45,15,0","0,8,15,77,0",,,,,,137,,,,,,,,,,,,,,,,,,,,,,,,,,,,,,,,,,,,83.1,9,17,352,65,,1029,1,,0,5,3,,1,0,,,,,"3x Blaue Runde",,"Polar BEAT",,0,,0,168070,250480,30378,,,,,,,,,,,,,,,,,,,,,,,,,,,,,,,,,,,,,,,,,,,
5963265,0b8d5dd9-4806-4246-bba5-04b007ea6250,1464208156,120,1548678024,,0,0,12.6,3807,3809,180,180,,,1,2.2,0.58,,,342,878,,,,,,,40.37,,1,,,,,,,,,,,,,,79,79,12.16,12.34,12.65,,,,,,,,,,,,,,,,,"7,2,5,20,47,20,0,0,0",,,,,,,126,,,,,,,,,,,,,,,,,,,,,,,,,,,,,,,,,,,,,14,0,27,74,,1015,0,,0,5,3,,1,0,,,,,"Aachen Laufen",,"Polar BEAT",,0,,0,168070,250480,30378,,,,,,,,,,,,,,,,,,,,,,,,,,,,,,,,,,,,,,,,,,4,
5963266,8a264713-826c-40a4-87d1-d6537e6ff36f,1518420760,60,1548678025,,0,0,11.03,1999,2008,42,49,,,1,0,0.2,1.97,0.66,,344,125,154,,,,,,,1,,,,,,,,,,,,,,26,,,22.23,,7.3,-39,106,85,,1,129,116,,,,,,,,,"19,12,49,19,2,0,0","0,92,8,0,0","87,4,0,1,8",,,,,,,,,,,,,,,,,,,,,,,,,,,,,,,,,,,,,,,,,15.7,2,5,239,78,,,0,,0,5,3,,1,0,,,Cycling,,,,"Polar M430",43,0,,0,168072,,30378,,,,,,,,,,,,,,,,,,,,,,,,,,,,,,,,,,,,,,,,,,,
5963267,6ae5b3c4-ddb0-4938-b4a0-cad12ff5028a,1534266258,120,1548678025,,0,0,10.06,1457,1457,46,42,,,1,0,0.14,2.19,,,241,120,134,,,,,,,1,,,,,,,,,,,,,,16,,,25.3,,9.3,-7.2,129,114,,1,147,135,,,,,,,,,"0,11,21,63,4,0,0","2,98,0,0,0","82,8,0,0,11",,,,,,,,,,,,,,,,,,,,,,,,,,,,,,,,,,,,,,,,,8.6,25,14,284,49,,,3,,0,5,3,,1,0,,,Cycling,,,,"Polar M430",43,0,,0,168072,,30378,,,,,,,,,,,,,,,,,,,,,,,,,,,,,,,,,,,,,,,,,,,
5963268,af294e0c-1b04-4f1f-b929-1bebed218b8d,1395581860,60,1548678026,,0,0,13,3647,3657,254,254,,,1,2.8,0.65,1.06,0.97,361,677,147,168,,,,63.54,44.12,65.07,1,,,,,,,,,,,,,,86,82,13.24,12.9,13.58,-0.4,,,,,,,,,,,,,,,,"0,0,4,16,51,28,1,0,0","1,23,66,10,0",,,,,,130,,,,,,,,,,,,,,,,,,,,,,,,,,,,,,,,,,,,35.3,8,10,257,64,,,3,,0,5,3,,1,0,,,,,"Regenerativer DL",,"Polar BEAT",,0,,0,168070,250480,30378,,,,,,,,,,,,,,,,,,,,,,,,,,,,,,,,,,,,,,,,,,"4,4",
5963269,8f363a95-d3e5-40a3-b80a-d0f41cb3ea0d,1413317639,120,1548678027,,0,0,3.32,933,933,67,65,,,1,1.7,0.64,1.13,0.95,495,189,147,162,,,,63.4,40.26,65.03,1,,,,,,,,,,,,,,21,82,13.22,12.99,14.1,6.4,,,,,,,,,,,,,,,,"0,2,9,22,39,17,8,4,0","0,19,80,2,0",,,,,,130,,,,,,,,,,,,,,,,,,,,,,,,,,,,,,,,,,,,26.5,13,5,220,74,,1008,0,,1,5,3,,1,0,,,,,Einlaufen,,"Polar BEAT",,0,,0,168070,250480,30378,,,,,,,,,,,,,,,,,,,,,,,,,,,,,,,,,,,,,,,,,,4,
5963270,44e8d362-ee3c-4774-adb3-999f8bd5b942,1456353249,60,1548678027,,0,0,0.54,170,170,,,,,0,,,,,,37,,,,,,,29.35,,1,,,,,,,,,,,,,,3,83,,11.5,,,,,,,,,,,,,,,,,,"5,5,2,61,28,0,0,0,0",,,,,,,115,,,,,,,,,,,,,,,,,,,,,,,,,,,,,,,,,,,,,,,,,,,,,,1,,,1,0,,,,,,,"Polar BEAT",,0,,0,168070,250480,30378,,,,,,,,,,,,,,,,,,,,,,,,,,,,,,,,,,,,,,,,,,,
5963271,c3159168-029f-4a0b-be62-3c4db0965683,1467487639,120,1548678027,,0,0,10.19,2832,2965,267,270,,,1,3.6,0.58,,,571,701,,,,,,,43.81,,1,,,,,,,,,,,,,,58,83,13.93,13.48,14.39,,,,,,,,,,,,,,,,,"10,6,5,11,17,33,14,4,0",,,,,,,130,,,,,,,,,,,,,,,,,,,,,,,,,,,,,,,,,,,,,16,8,260,68,,,,,0,3,3,,1,0,,,,,"Balve Laufen",,"Polar BEAT",,0,,0,168070,250480,30378,,,,,,,,,,,,,,,,,,,,,,,,,,,,,,,,,,,,,,,,,,"4,4,5,5",
5963272,27215912-00c9-41d4-8e39-aeb62888759a,1400758629,120,1548678028,,0,0,15.47,4614,4707,214,214,,,1,1.9,0.63,,,240,1047,,,,,,,41.65,,1,,,,,,,,,,,,,,95,83,12.25,12.67,12.96,,,,,,,,,,,,,,,,,"7,1,7,16,39,27,3,0,0",,,,,,,121,,,,,,,,,,,,,,,,,,,,,,,,,,,,,,,,,,,,,19,5,204,55,,1008,5,,0,5,3,,1,0,,,,,"Regenerativer DL",,"Polar BEAT",,0,,0,168070,250480,30378,,,,,,,,,,,,,,,,,,,,,,,,,,,,,,,,,,,,,,,,,,"5,5",
5963273,47fe5ff0-3fd1-40aa-bd76-2db92d4b128b,1419278136,60,1548678029,,0,0,1.14,406,406,26,5,,,1,1.3,0.65,,,,68,,,,,,,27.55,,1,,,,,,,,,,,,,,8,81,10.97,10.16,11.06,,,,,,,,,,,,,,,,,"23,16,38,23,0,0,0,0,0",,,,,,,104,,,,,,,,,,,,,,,,,,,,,,,,,,,,,,,,,,,,,10,14,243,94,,1022,0,,1,5,3,,1,0,,,,,"Aachen Laufen",,"Polar BEAT",,0,,0,168070,250480,30378,,,,,,,,,,,,,,,,,,,,,,,,,,,,,,,,,,,,,,,,,,,
5963274,,1396555247,120,1548678029,,0,0,3.3,0,0,,,,,0,,,,,,,,,,,,,,,1,,,,,,,,,,,,,,0,,,,,,,,,,,,,,,,,,,,,,,,,,,,,,,,,,,,,,,,,,,,,,,,,,,,,,,,,,,,,,,,,,,,,,,,,,1,,,0,0,,,,,Einlaufen,,"Polar BEAT",,0,,0,168070,250480,30378,,,,,,,,,,,,,,,,,,,,,,,,,,,,,,,,,,,,,,,,,,,
5963275,e13d118c-5525-447a-80c6-ed1109812413,1421408162,60,1548678030,,0,0,21.74,5978,6018,297,297,,,1,2.4,0.51,,,381,1467,,,,,,,47.03,,1,,,,,,,,,,,,,,124,84,13.35,13.18,13.47,,,,,,,,,,,,,,,,,"0,1,4,9,40,43,3,0,0",,,,,,,130,,,,,,,,,,,,,,,,,,,,,,,,,,,,,,,,,,,,,6,6,193,86,,1007,1,,0,5,3,,1,0,,,,,"Langsamer DL",,"Polar BEAT",,0,,0,168070,250480,30378,,,,,,,,,,,,,,,,,,,,,,,,,,,,,,,,,,,,,,,,,,"4,5",
5963276,a96284d4-dd29-4617-8b67-b553e3525a82,1429381412,120,1548678030,,0,0,11.14,2937,3035,146,122,,,1,1.8,0.53,,,767,756,,,,,,,46.89,,1,,,,,,,,,,,,,,61,84,14,13.86,14.27,,,,,,,,,,,,,,,,,"4,1,2,5,21,49,16,0,1",,,,,,,135,,,,,,,,,,,,,,,,,,,,,,,,,,,,,,,,,,,,,12,15,50,37,,1025,,,0,3,3,,1,0,,,,,"Aachen Laufen",,"Polar BEAT",,0,,0,168070,250480,30378,,,,,,,,,,,,,,,,,,,,,,,,,,,,,,,,,,,,,,,,,,5,
5963277,1848951e-8d42-4a4e-a9ba-c651e2b146d0,1502215906,120,1548678030,,0,0,11.14,3109,3136,50,47,,,1,0,0.16,0.95,0.78,,678,147,179,,,,63.95,43.88,64.32,1,,,,,,,,,,,,,,75,81,13.03,14.35,14.46,4.3,,,,,,,,,,,,,,,,"19,1,3,10,20,11,9,25,2","1,29,49,20,0",,,,,,133,,,,,,,,,,,,,,,,,,,,,,,,,,,,,,,,,,,,52.4,17,11,235,86,,1010,,,0,3,3,,1,0,I2.303|11:53-I0.601|2:08-I0.610|2:08-I0.611|2:06-I0.062|1:51-I0.612|2:05-I0.609|2:08-I0.148|1:55-I0.610|2:03-I0.609|2:05-I0.131|2:16-I0.516|1:40-I0.187|1:30-I0.530|1:40-I0.098|1:09-I0.530|1:34-I0.079|1:12-I2.291|10:58,,Running,,,,"Polar M430",43,0,,0,168070,250480,30378,,,,,,,,,,,,,,,,,,,,,,,,,,,,,,,,,,,,,,,,,,,
5963278,7dea101c-274e-43b2-86a6-6e1e7a16f07e,1512134516,60,1548678031,,0,0,13.67,2545,2610,47,45,,,1,0,0.07,,,,419,122,151,,,,,,,1,,,,,,,,,,,,,,31,,,20.97,,24.5,10.4,98,75,,1,112,97,,,,,,,,,"18,13,64,5,0,0,0","3,93,4,0,0","87,1,5,6,1",,,,,,,,,,,,,,,,,,,,,,,,,,,,,,,,,,,,,,,,,14.3,2,0,293,89,,,1,,0,7,3,,1,0,,,Cycling,,,,"Polar M430",43,0,,0,168072,,30378,,,,,,,,,,,,,,,,,,,,,,,,,,,,,,,,,,,,,,,,,,,
5963279,685bbb70-18ea-4880-a7d5-af02e31b8a9b,1503513470,120,1548678031,,0,0,9.55,3182,3191,156,157,,,1,1.2,0.51,1.24,0.94,,719,150,187,,,,50.02,35.25,51.02,1,,,,,,,,,,,,,,85,80,11.01,12.84,13.21,23.3,,,,,,,,,,,,,,,,"28,1,2,6,36,11,2,8,4","0,25,40,30,4",,,,,,113,,,,,,,,,,,,,,,,,,,,,,,,,,,,,,,,,,,,79,24,10,205,58,,1014,,,0,5,3,,1,0,I5.874|28:01-I0.411|1:15-I0.108|1:02-I0.418|1:16-I0.104|1:00-I0.421|1:17-I0.102|1:10-I0.417|1:20-I0.101|1:10-I0.416|1:21-I0.264|10:02-I0.208|0:37-I0.101|1:10-I0.209|0:38-I0.099|0:38-I0.210|0:36-I0.081|0:43,,Running,,,,"Polar M430",43,0,,0,168070,250480,30378,,,,,,,,,,,,,,,,,,,,,,,,,,,,,,,,,,,,,,,,,,,
5963280,6bab9ca8-48ef-4dc4-921b-1250904ea884,1479840642,60,1548678032,,0,0,0.26,62,62,1,9,,,1,1.2,1,,,,16,,,,,,,38.84,,1,,,,,,,,,,,,,,1,89,14.92,17.35,15.95,,,,,,,,,,,,,,,,,"16,3,5,5,5,8,8,50,0",,,,,,,141,,,,,,,,,,,,,,,,,,,,,,,,,,,,,,,,,,,,,10,2,170,84,,1013,0,,1,5,3,,1,0,,,,,"Aachen Laufen",,"Polar BEAT",,0,,0,168070,250480,30378,,,,,,,,,,,,,,,,,,,,,,,,,,,,,,,,,,,,,,,,,,,
5963281,,1446379260,60,1548678032,,0,0,11,0,0,,,,,0,,,,,,722,,,,,,,,,1,,,,,,,,,,,,,,0,,,,,,,,,,,,,,,,,,,,,,,,,,,,,,,,,,,,,,,,,,,,,,,,,,,,,,,,,,,,,,,,,,,,,,,,,,1,,,0,0,,,,,"Balver Wald",,"Polar BEAT",,0,,0,168070,250480,30378,,,,,,,,,,,,,,,,,,,,,,,,,,,,,,,,,,,,,,,,,,,
5963282,fcdac04d-eb55-409b-850c-b7cf35df9d40,1443352337,120,1548678033,,0,0,21.85,6722,6808,640,639,,,1,5.3,0.73,,,539,1493,,,,,,,41.29,,1,,,,,,,,,,,,,,139,83,12.39,12.18,13.46,,,,,,,,,,,,,,,,,"11,5,11,18,33,21,2,0,0",,,,,,,117,,,,,,,,,,,,,,,,,,,,,,,,,,,,,,,,,,,,,13,8,38,79,,1034,,,0,5,3,,1,0,,,,,"Balve Laufen",,"Polar BEAT",,0,,0,168070,250480,30378,,,,,,,,,,,,,,,,,,,,,,,,,,,,,,,,,,,,,,,,,,"3,4",
5963283,b17923b7-4493-4471-915b-fe7d412f2c38,1458991948,60,1548678033,,0,0,3.91,995,1043,109,96,,,1,2.2,0.69,,,454,267,,,,,,,45.74,,1,,,,,,,,,,,,,,20,84,14.79,14.15,15.29,,,,,,,,,,,,,,,,,"0,0,0,1,21,62,14,1,0",,,,,,,140,,,,,,,,,,,,,,,,,,,,,,,,,,,,,,,,,,,,,11,20,179,64,,1016,,,0,5,3,,1,0,,,,,"Sundern Laufen",,"Polar BEAT",,0,,0,168070,250480,30378,,,,,,,,,,,,,,,,,,,,,,,,,,,,,,,,,,,,,,,,,,"5,5",
5963284,c5221385-1bcb-4fe1-95de-d5f41830e0ce,1538225430,120,1548678034,,0,0,2.7,850,852,8,10,,,1,0,0.08,1.09,0.87,,168,131,144,,,,63.62,34.7,63.8,1,,,,,,,,,,,,,,13,80,11.44,11.44,11.48,0.2,,,,,,,,,,,,,,,,"1,4,17,62,16,0,0,0,0","5,90,5,0,0",,,,,,119,,,,,,,,,,,,,,,,,,,,,,,,,,,,,,,,,,,,13.6,16,30,33,38,,1026,,,0,11,3,,1,0,I1.000|5:21-I1.000|5:13-I0.699|3:40,,Running,,,,"Polar M430",43,0,,0,168070,250480,30378,,,,,,,,,,,,,,,,,,,,,,,,,,,,,,,,,,,,,,,,,,,
5963285,ce999588-4a2e-4c5a-8be0-7ff1453891b4,1454440205,60,1548678035,,0,0,15.86,4255,5027,161,154,,,1,1,0.39,,,,1094,,,,,,,47.19,,1,,,,,,,,,,,,,,88,83,13.47,14.09,14.53,,,,,,,,,,,,,,,,,"3,3,10,21,18,14,16,13,0",,,,,,,135,,,,,,,,,,,,,,,,,,,,,,,,,,,,,,,,,,,,,6,23,243,89,,1016,,,1,5,3,,1,0,,,,,"Aachen Laufen",,"Polar BEAT",,0,,0,168070,250480,30378,,,,,,,,,,,,,,,,,,,,,,,,,,,,,,,,,,,,,,,,,,,
5963286,6a36c644-93f1-4e8e-b39f-75ef11e670cb,1445544582,120,1548678035,,0,0,7.66,2435,2614,79,80,,,1,1.3,0.61,,,,505,,,,,,,36.7,,1,,,,,,,,,,,,,,50,83,11.55,12.7,12.84,,,,,,,,,,,,,,,,,"24,7,11,21,17,4,3,10,3",,,,,,,114,,,,,,,,,,,,,,,,,,,,,,,,,,,,,,,,,,,,,12,9,272,94,,1019,,,1,4,3,,1,0,,,,,"Aachen Laufen",,"Polar BEAT",,0,,0,168070,250480,30378,,,,,,,,,,,,,,,,,,,,,,,,,,,,,,,,,,,,,,,,,,,
5963287,e4392f3a-12ff-4f3f-b11f-8c979b8a44d3,1511090164,60,1548678036,,0,0,4.7,1044,1074,24,13,,,1,0,0.04,,,,137,109,126,,,,,,,1,,,,,,,,,,,,,,8,,,17.12,,15.5,12.9,71,61,,1,85,80,,,,,,,,,"22,66,11,0,0,0,0","16,84,0,0,0","92,0,0,3,5",,,,,,,,,,,,,,,,,,,,,,,,,,,,,,,,,,,,,,,,,5.4,7,4,249,81,,1020,,,0,5,3,,1,0,,,Cycling,,,,"Polar M430",43,0,,0,168072,,30378,,,,,,,,,,,,,,,,,,,,,,,,,,,,,,,,,,,,,,,,,,,
5963288,4fb71ed4-4a13-4a8d-90b8-0f72976dbae4,1514913519,60,1548678036,,0,0,11.11,1643,1644,51,44,,,1,0,0.07,,,,251,126,150,,,,,,,1,,,,,,,,,,,,,,23,,,24.63,,11.5,-19.3,125,111,,1,142,130,,,,,,,,,"2,7,35,57,0,0,0","9,81,9,0,0","85,4,0,0,11",,,,,,,,,,,,,,,,,,,,,,,,,,,,,,,,,,,,,,,,,14.7,6,4,217,74,,,0,,1,5,3,,1,0,,,Cycling,,,,"Polar M430",43,0,,0,168072,,30378,,,,,,,,,,,,,,,,,,,,,,,,,,,,,,,,,,,,,,,,,,,
5963289,69eca34b-c44d-4eea-9fcc-6496e5fb5dfc,1368713178,120,1548678037,,0,0,61.95,9234,9341,762,755,,,1,2.6,0.38,,,657,2152,,,,,,,,,1,,,,,,,,,,,,,,103,,,27.98,,,,223,149,,1,274,225,,,,,,,,,"18,17,18,16,14,7,10",,"54,15,13,7,10",,,,,,,,,,,,,,,,,,,,,,,,,,,,,,,,,,,,,,,,,,10,5,321,96,,998,5,,0,6,3,,1,0,,,,,,,"Polar BEAT",,0,,0,168072,,30378,,,,,,,,,,,,,,,,,,,,,,,,,,,,,,,,,,,,,,,,,,"4,4,5,5",
5963290,e3e2d6bd-3df8-4909-b3d9-867827fb66f4,1496011865,120,1548678038,,0,0,7.4,2233,2313,129,122,,,1,2.2,0.57,,,392,511,,,,,,,38.94,,1,,,,,,,,,,,,,,46,78,12.27,12.31,12.85,,,,,,,,,,,,,,,,,"8,4,5,23,39,18,3,0,0",,,,,,,127,,,,,,,,,,,,,,,,,,,,,,,,,,,,,,,,,,,,,22,3,72,80,,1016,0,,1,5,3,,1,0,,,,,"Aachen Laufen",,"Polar BEAT",,0,,0,168070,250480,30378,,,,,,,,,,,,,,,,,,,,,,,,,,,,,,,,,,,,,,,,,,4,
5963291,8fbb6e66-be08-4d06-bb66-b4315d9ad89b,1420746692,60,1548678038,,0,0,5,1103,1103,42,39,,,1,0.3,0.37,1.04,0.98,,272,174,183,,,,67.08,54.95,67.83,1,,,,,,,,,,,,,,46,,16.5,16.54,16.7,8.6,,,,,,,,,,,,,,,,"0,0,0,0,2,17,57,23,1","0,1,1,83,14",,,,,,,,,,,,,,,,,,,,,,,,,,,,,,,,,,,,,,,,,,94.2,5,21,270,94,,1027,,,1,4,3,,1,0,,,,,TDL,,"Polar BEAT",,0,,0,168070,250480,30378,,,,,,,,,,,,,,,,,,,,,,,,,,,,,,,,,,,,,,,,,,,
5963292,d00721d9-ec10-4160-8a51-0354c23ede04,1349380512,120,1548678048,,0,0,17.25,83020,83077,82,81,,,1,0,0.16,,,,1204,,,,,,,,,1,,,,,,,,,,,,,,1724,,0.75,6.07,6.13,,,,,,,,,,,,,,,,,"94,0,0,2,3,1,0,0,0",,,,,,,,,,,,,,,,,,,,,,,,,,,,,,,,,,,,,,,,,,,,11,16,278,87,,1018,0,,0,5,3,,1,0,,,,,,,"Polar BEAT",,0,,0,168070,250480,30378,,,,,,,,,,,,,,,,,,,,,,,,,,,,,,,,,,,,,,,,,,,
5963293,f7b5124c-82d9-48ba-9166-f782cb8846a0,1533364324,120,1548678049,,0,0,17.37,5114,5120,71,72,,,1,0,0.06,1.14,0.95,,1204,145,159,,,,60.94,42.68,61.24,1,,,,,,,,,,,,,,113,81,12.26,12.29,12.37,7.1,,,,,,,,,,,,,,,,"1,1,5,30,55,7,0,0,0","0,24,75,0,0",,,,,,126,,,,,,,,,,,,,,,,,,,,,,,,,,,,,,,,,,,,35.6,20,1,26,83,,1017,,,0,3,3,,1,0,I1.000|5:08-I1.000|5:12-I1.000|4:51-I1.000|4:55-I1.000|5:04-I1.000|4:48-I1.000|4:36-I1.000|4:48-I1.000|4:56-I1.000|4:45-I1.000|4:50-I1.000|4:49-I1.000|4:49-I1.000|4:53-I1.000|4:50-I1.000|5:00-I1.000|5:08-I0.373|2:02,,Running,,,,"Polar M430",43,0,,0,168070,250480,30378,,,,,,,,,,,,,,,,,,,,,,,,,,,,,,,,,,,,,,,,,,,
5963294,c22fc8ca-c121-4e08-ab12-35031865752d,1403037284,120,1548678050,,0,0,4.54,1768,1898,0,0,,,1,0,0,,,,216,,,,,,,27.87,,1,,,,,,,,,,,,,,36,68,9.33,12.88,12.85,,,,,,,,,,,,,,,,,"63,1,1,2,2,2,4,7,17",,,,,,,113,,,,,,,,,,,,,,,,,,,,,,,,,,,,,,,,,,,,,18,6,1,77,,1021,0,,0,5,3,,1,0,,,,,"2x (500,300,200,300,200)",,"Polar BEAT",,0,,0,168070,250480,30378,,,,,,,,,,,,,,,,,,,,,,,,,,,,,,,,,,,,,,,,,,,
5963295,d5c70641-ae4d-4f7f-977d-53f8aafc19c4,1477045879,120,1548678050,,0,0,0.18,66,66,0,3,,,1,0,0,,,,16,,,,,,,22.8,,1,,,,,,,,,,,,,,1,80,9.7,9.81,9.55,,,,,,,,,,,,,,,,,"27,24,18,30,0,0,0,0,0",,,,,,,102,,,,,,,,,,,,,,,,,,,,,,,,,,,,,,,,,,,,,6,3,313,95,,1017,1,,0,5,3,,1,0,,,,,"Aachen Laufen",,"Polar BEAT",,0,,0,168070,250480,30378,,,,,,,,,,,,,,,,,,,,,,,,,,,,,,,,,,,,,,,,,,,
5963296,4c6b7946-9c5f-4103-938d-47e6ba13699f,1474660022,120,1548678050,,0,0,13.01,3287,3287,185,187,,,1,2.3,0.6,,,448,878,,,,,,,49.82,,1,,,,,,,,,,,,,,68,82,14.53,14.43,14.76,,,,,,,,,,,,,,,,,"2,1,2,2,10,48,34,0,0",,,,,,,145,,,,,,,,,,,,,,,,,,,,,,,,,,,,,,,,,,,,,17,1,337,72,,1026,0,,1,3,3,,1,0,,,,,"Aachen Laufen",,"Polar BEAT",,0,,0,168070,250480,30378,,,,,,,,,,,,,,,,,,,,,,,,,,,,,,,,,,,,,,,,,,4,
5963297,8bfd1c88-663c-4450-bbc8-5019461e671a,1473283040,120,1548678051,,0,0,0.69,246,246,10,12,,,1,1.3,0.88,,,,47,,,,,,,26.02,,1,,,,,,,,,,,,,,5,81,10.26,10.1,10.48,,,,,,,,,,,,,,,,,"15,29,33,22,0,0,0,0,0",,,,,,,104,,,,,,,,,,,,,,,,,,,,,,,,,,,,,,,,,,,,,20,2,91,68,,1016,0,,1,3,3,,1,0,,,,,"Aachen Laufen",,"Polar BEAT",,0,,0,168070,250480,30378,,,,,,,,,,,,,,,,,,,,,,,,,,,,,,,,,,,,,,,,,,,
5963298,69c7aa01-d39a-49f5-93bd-8de293ab5b6c,1472851377,120,1548678051,,0,0,1.1,485,486,25,23,,,1,0.9,0.55,,,,61,,,,,,,21.41,,1,,,,,,,,,,,,,,10,74,8.63,12.83,13.61,,,,,,,,,,,,,,,,,"54,4,7,10,5,6,1,1,12",,,,,,,92,,,,,,,,,,,,,,,,,,,,,,,,,,,,,,,,,,,,,19,1,262,76,,1020,0,,1,5,3,,1,0,,,,,"Aachen Laufen",,"Polar BEAT",,0,,0,168070,250480,30378,,,,,,,,,,,,,,,,,,,,,,,,,,,,,,,,,,,,,,,,,,,
5963299,296d2a26-692c-4a10-8ba6-73ea15272ee4,1407534962,120,1548678051,,0,0,9.87,2999,3013,96,95,,,1,0.5,0.33,,,,661,,,,,,,39.38,,1,,,,,,,,,,,,,,62,81,11.99,11.95,12.14,,,,,,,,,,,,,,,,,"2,7,10,27,50,4,0,0,0",,,,,,,122,,,,,,,,,,,,,,,,,,,,,,,,,,,,,,,,,,,,,19,9,141,96,,1007,,,1,5,3,,1,0,,,,,"Langsamer DL",,"Polar BEAT",,0,,0,168070,250480,30378,,,,,,,,,,,,,,,,,,,,,,,,,,,,,,,,,,,,,,,,,,,
5963300,9612b62d-d180-4e1d-8b78-99b583f90eee,1370609820,120,1548678052,,0,0,12.01,3498,4066,167,167,,,1,1.7,0.44,,,360,814,,,,,,,41.98,,1,,,,,,,,,,,,,,72,,12.74,13.4,13.84,,,,,,,,,,,,,,,,,"16,2,4,8,18,29,19,4,1",,,,,,,,,,,,,,,,,,,,,,,,,,,,,,,,,,,,,,,,,,,,24,6,12,44,,1020,8,,0,3,3,,1,0,,,,,,,"Polar BEAT",,0,,0,168070,250480,30378,,,,,,,,,,,,,,,,,,,,,,,,,,,,,,,,,,,,,,,,,,"5,5",
5963301,01e6f515-73de-449d-9211-3d3f577e156e,1527244815,120,1548678052,,0,0,3.71,1092,1092,20,16,,,1,0,0.08,1.03,0.87,,245,144,155,,,,61.51,38.45,62,1,,,,,,,,,,,,,,23,82,12.32,12.32,12.44,2,,,,,,,,,,,,,,,,"0,1,6,33,50,10,0,0,0","0,21,79,0,0",,,,,,124,,,,,,,,,,,,,,,,,,,,,,,,,,,,,,,,,,,,26.8,23,5,52,62,,1019,,,0,9,3,,1,0,I1.000|4:47-I1.000|4:59-I1.000|5:01-I0.717|3:26,,Running,,,,"Polar M430",43,0,,0,168070,250480,30378,,,,,,,,,,,,,,,,,,,,,,,,,,,,,,,,,,,,,,,,,,,
5963302,00fefe1d-169c-4aaf-838c-8bde1871a78e,1536084407,120,1548678053,,0,0,15.24,3974,3975,49,49,,,1,0,0.05,,0.98,,763,128,160,,,,82.6,48.61,82.93,1,,,,,,,,,,,,,,58,83,13.84,13.84,13.9,0.7,,,,,,,,,,,,,,,,"0,0,0,1,21,72,5,0,0","1,78,21,0,0",,,,,,139,,,,,,,,,,,,,,,,,,,,,,,,,,,,,,,,,,,,25.7,25,4,96,41,,1015,,,0,5,3,,1,0,I1.000|4:25-I1.000|4:25-I1.000|4:25-I1.000|4:26-I1.000|4:22-I1.000|4:18-I1.000|4:17-I1.000|4:11-I1.000|4:15-I1.000|4:26-I1.000|4:24-I1.000|4:10-I1.000|4:16-I1.000|4:36-I1.000|4:20-I0.247|1:02,,Running,,,,"Polar M430",43,0,,0,168070,250480,30378,,,,,,,,,,,,,,,,,,,,,,,,,,,,,,,,,,,,,,,,,,,
5963303,b7a93c39-860c-4f34-8531-39adfff549ac,1505246798,120,1548678053,,0,0,2.43,763,764,42,50,,,1,1,0.5,1.14,0.88,,166,143,157,,,,57.31,34.48,58.3,1,,,,,,,,,,,,,,16,79,11.62,11.95,12.35,23.9,,,,,,,,,,,,,,,,"7,17,22,36,6,1,8,3,0","1,28,71,0,0",,,,,,121,,,,,,,,,,,,,,,,,,,,,,,,,,,,,,,,,,,,26.2,13,15,224,79,,1010,,,1,6,3,,1,0,I0.283|1:33-I0.417|1:30-I1.729|9:42,,Running,,,,"Polar M430",43,0,,0,168070,250480,30378,,,,,,,,,,,,,,,,,,,,,,,,,,,,,,,,,,,,,,,,,,,
5963304,beb2b678-e317-4d08-9f93-d0a4e7ff3281,1474726260,120,1548678053,,0,0,4.25,1362,1388,40,54,,,1,1,0.57,,,,184,,,,,,,,,1,,,,,,,,,,,,,,15,,,11.7,,,,49,45,,1,81,79,,,,,,,,,"97,3,0,0,0,0,0",,"92,0,0,8,0",,,,,,,,,,,,,,,,,,,,,,,,,,,,,,,,,,,,,,,,,,23,6,195,45,,1023,4,,0,3,3,,1,0,,,,,"Aachen Radfahren",,"Polar BEAT",,0,,0,168072,,30378,,,,,,,,,,,,,,,,,,,,,,,,,,,,,,,,,,,,,,,,,,,
5963305,f4562b3c-5e03-4835-93b6-c24b5d6ed0ab,1494880571,120,1548678054,,0,0,7.63,3656,4074,131,134,,,1,1.5,0.39,,,169,469,,,,,,,22.38,,1,,,,,,,,,,,,,,75,73,7.81,9.59,9.95,,,,,,,,,,,,,,,,,"66,10,5,4,5,4,5,1,0",,,,,,,86,,,,,,,,,,,,,,,,,,,,,,,,,,,,,,,,,,,,,19,1,286,50,,1028,0,,0,5,3,,1,0,,,,,"Aachen Laufen",,"Polar BEAT",,0,,0,168070,250480,30378,,,,,,,,,,,,,,,,,,,,,,,,,,,,,,,,,,,,,,,,,,4,
5963306,aed6019c-943d-467a-ade0-e7086a6fd857,1525599052,120,1548678054,,0,0,7.4,2419,2421,42,40,,,1,0,0.1,1.11,0.95,,520,140,160,,,,56.02,35.43,56.43,1,,,,,,,,,,,,,,47,81,11.09,11.09,11.21,-3.7,,,,,,,,,,,,,,,,"3,13,32,40,11,2,0,0,0","2,31,67,0,0",,,,,,113,,,,,,,,,,,,,,,,,,,,,,,,,,,,,,,,,,,,24.1,17,18,22,56,,1020,,,0,3,3,,1,0,I1.000|5:42-I1.000|5:19-I1.000|5:38-I1.000|5:17-I1.000|5:28-I1.000|5:27-I1.000|5:19-I0.411|2:13,,Running,,,,"Polar M430",43,0,,0,168070,250480,30378,,,,,,,,,,,,,,,,,,,,,,,,,,,,,,,,,,,,,,,,,,,
5963307,,1419354905,60,1548678054,,0,0,1,0,0,,,,,0,,,,,,,,,,,,,,,1,,,,,,,,,,,,,,0,,,,,,,,,,,,,,,,,,,,,,,,,,,,,,,,,,,,,,,,,,,,,,,,,,,,,,,,,,,,,,,,,,,,,,,,,,1,,,0,0,,,,,"Lauf ABC ",,"Polar BEAT",,0,,0,168070,250480,30378,,,,,,,,,,,,,,,,,,,,,,,,,,,,,,,,,,,,,,,,,,,
5963308,ad1b51aa-78ab-458a-9d9e-81500250eb10,1501329645,120,1548678055,,0,0,1.4,479,485,25,27,,,1,0,0.29,1.61,0.63,,94,139,169,,,,53.43,29.53,54.51,1,,,,,,,,,,,,,,9,81,10.66,12.21,12.47,29.2,,,,,,,,,,,,,,,,"38,6,10,7,7,9,13,7,2","8,36,50,6,0",,,,,,108,,,,,,,,,,,,,,,,,,,,,,,,,,,,,,,,,,,,18.3,22,12,232,68,,1013,5,,0,5,3,,1,0,I0.704|3:32-I0.148|1:09-I0.139|0:30-I0.177|1:03-I0.132|0:30-I0.102|1:22,,Running,,,,"Polar M430",43,0,,0,168070,250480,30378,,,,,,,,,,,,,,,,,,,,,,,,,,,,,,,,,,,,,,,,,,,
5963309,62f1775e-7b97-4560-a8bf-ef47e7d279b4,1446898402,60,1548678056,,0,0,3.5,1466,1673,54,79,,,1,0.8,0.4,,,,221,,,,,,,25.12,,1,,,,,,,,,,,,,,30,73,8.68,10.09,10.26,,,,,,,,,,,,,,,,,"30,11,25,24,9,1,0,0,0",,,,,,,98,,,,,,,,,,,,,,,,,,,,,,,,,,,,,,,,,,,,,17,16,201,88,,1023,,,0,5,3,,1,0,,,,,"Aachen Laufen",,"Polar BEAT",,0,,0,168070,250480,30378,,,,,,,,,,,,,,,,,,,,,,,,,,,,,,,,,,,,,,,,,,,
5963310,7c423b58-a2e1-4dcd-be39-2a68c1c4b6cd,1427748585,120,1548678057,,0,0,15.1,4190,4351,300,301,,,1,3.4,0.61,,,661,1022,,,,,,,45.2,,1,,,,,,,,,,,,,,87,83,13.37,13.49,14.25,,,,,,,,,,,,,,,,,"8,1,2,8,25,40,17,0,0",,,,,,,130,,,,,,,,,,,,,,,,,,,,,,,,,,,,,,,,,,,,,6,11,222,65,,1012,,,1,5,3,,1,0,,,,,"Aachen Laufen",,"Polar BEAT",,0,,0,168070,250480,30378,,,,,,,,,,,,,,,,,,,,,,,,,,,,,,,,,,,,,,,,,,"4,4,5",
5963311,fbeb84e5-69c9-4767-9bd0-39056d2b73e0,1513065989,60,1548678058,,0,0,11.16,1458,1459,18,31,,,1,0,0.09,,,,355,154,177,,,,,,,1,,,,,,,,,,,,,,41,,,28.46,,2.3,-16.5,149,130,,1,170,154,,,,,,,,,"3,7,15,37,36,3,0","3,14,41,42,0","43,47,0,0,9",,,,,,,,,,,,,,,,,,,,,,,,,,,,,,,,,,,,,,,,,56.1,4,6,229,79,,,0,,0,4,3,,1,0,,,Cycling,,,,"Polar M430",43,0,,0,168072,,30378,,,,,,,,,,,,,,,,,,,,,,,,,,,,,,,,,,,,,,,,,,,
5963312,3e6ee5b5-51d8-46a2-bfdf-1f07a9dc4d1f,1416250333,60,1548678059,,0,0,15.22,4313,4413,183,183,,,1,1.7,0.48,1.03,1.02,329,725,140,163,,,,66.83,44.14,67.83,1,,,,,,,,,,,,,,85,83,12.92,12.89,13.17,-4.4,,,,,,,,,,,,,,,,"3,1,6,12,48,24,6,0,0","1,45,53,1,0",,,,,,128,,,,,,,,,,,,,,,,,,,,,,,,,,,,,,,,,,,,34.7,8,2,112,93,,1006,0,,1,5,3,,1,0,,,,,"Lockerer DL",,"Polar BEAT",,0,,0,168070,250480,30378,,,,,,,,,,,,,,,,,,,,,,,,,,,,,,,,,,,,,,,,,,5,
5963313,fa5251ec-0ba6-402b-a0b0-9d493d293838,1543660858,60,1548678059,,0,0,2.83,872,872,8,12,,,1,0,0.07,1.14,0.85,,206,146,159,,,,57.1,35.71,57.19,1,,,,,,,,,,,,,,19,81,11.67,11.8,11.87,-5.5,,,,,,,,,,,,,,,,"3,5,15,37,33,7,0,0,0","0,26,74,0,0",,,,,,120,,,,,,,,,,,,,,,,,,,,,,,,,,,,,,,,,,,,29.1,8,13,208,91,,,1,,0,5,3,,1,0,I1.000|5:35-I1.000|5:05-I0.836|3:54,,Running,,,,"Polar M430",43,0,,0,168070,250480,30378,,,,,,,,,,,,,,,,,,,,,,,,,,,,,,,,,,,,,,,,,,,
5963314,94406057-2793-407f-935d-bf20681f5bf9,1396296383,120,1548678059,,0,0,5.06,1144,1144,114,114,,,1,0,0,1.19,0.9,,262,162,175,,,,72.51,53.44,74.55,1,,,,,,,,,,,,,,37,86,16.26,15.91,16.51,3.7,,,,,,,,,,,,,,,,"0,0,0,0,0,2,98,0,0","1,3,22,75,0",,,,,,154,,,,,,,,,,,,,,,,,,,,,,,,,,,,,,,,,,,,64.2,17,3,82,44,,1013,0,,1,5,3,,1,0,,,,,"kurzer TDL ",,"Polar BEAT",,0,,0,168070,250480,30378,,,,,,,,,,,,,,,,,,,,,,,,,,,,,,,,,,,,,,,,,,,
5963315,,1403557244,120,1548678060,,0,0,5,0,0,,,,,0,,,,,,,,,,,,,,,1,,,,,,,,,,,,,,0,,,,,,,,,,,,,,,,,,,,,,,,,,,,,,,,,,,,,,,,,,,,,,,,,,,,,,,,,,,,,,,,,,,,,,,,,,1,,,0,0,,,,,"Lousberglauf Vorkurs",,"Polar BEAT",,0,,0,168070,250480,30378,,,,,,,,,,,,,,,,,,,,,,,,,,,,,,,,,,,,,,,,,,,
5963316,8832f0b3-d841-4939-81eb-9c5ba2cf557c,1410617260,120,1548678060,,0,0,1,218,218,8,1,,,1,0,0.2,,,,64,,,,,,,47.33,,1,,,,,,,,,,,,,,4,92,16.76,16.66,17.36,,,,,,,,,,,,,,,,,"0,0,5,4,11,7,20,54,0",,,,,,,150,,,,,,,,,,,,,,,,,,,,,,,,,,,,,,,,,,,,,17,7,36,76,,1024,3,,0,5,3,,1,0,,,,,Samstagstraining,,"Polar BEAT",,0,,0,168070,250480,30378,,,,,,,,,,,,,,,,,,,,,,,,,,,,,,,,,,,,,,,,,,,
5963317,3617884f-ca06-40fb-bead-7bee19c4830c,1420039852,60,1548678060,,0,0,2.1,662,662,0,2,,,1,0,0,,,,141,,,,,,,33.86,,1,,,,,,,,,,,,,,13,87,11.4,11.48,11.46,,,,,,,,,,,,,,,,,"5,4,20,45,23,3,0,0,0",,,,,,,109,,,,,,,,,,,,,,,,,,,,,,,,,,,,,,,,,,,,,4,7,249,94,,,0,,0,9,3,,1,0,,,,,Auslaufen,,"Polar BEAT",,0,,0,168070,250480,30378,,,,,,,,,,,,,,,,,,,,,,,,,,,,,,,,,,,,,,,,,,,
5963318,1753bf7c-c0cb-4e83-b318-e1bac733d976,1394703933,60,1548678060,,0,0,4.34,1245,1245,49,32,,,1,0.4,0.3,1.07,1.02,,245,146,167,,,,62.37,40.04,63.54,1,,,,,,,,,,,,,,28,84,12.83,12.7,13.08,-3.5,,,,,,,,,,,,,,,,"4,1,1,9,68,17,0,0,0","1,27,62,11,0",,,,,,124,,,,,,,,,,,,,,,,,,,,,,,,,,,,,,,,,,,,31.4,10,1,244,65,,1029,1,,0,3,3,,1,0,,,,,"Einlaufen + Lauf ABC",,"Polar BEAT",,0,,0,168070,250480,30378,,,,,,,,,,,,,,,,,,,,,,,,,,,,,,,,,,,,,,,,,,,
5963319,53b33cf4-c088-4487-91e4-abc31be93bf1,1446146835,60,1548678061,,0,0,3.29,1041,1069,61,61,,,1,1.5,0.57,,,418,225,,,,,,,35.02,,1,,,,,,,,,,,,,,21,80,11.8,11.55,12.29,,,,,,,,,,,,,,,,,"5,8,13,45,25,4,0,0,0",,,,,,,119,,,,,,,,,,,,,,,,,,,,,,,,,,,,,,,,,,,,,9,8,171,88,,1022,,,1,5,3,,1,0,,,,,"Aachen Laufen",,"Polar BEAT",,0,,0,168070,250480,30378,,,,,,,,,,,,,,,,,,,,,,,,,,,,,,,,,,,,,,,,,,5,
5963320,1820735a-71e2-4470-bd64-9b6ccd5fcfce,1454842573,60,1548678061,,0,0,7.02,2098,2225,67,68,,,1,1,0.52,,,,487,,,,,,,39.26,,1,,,,,,,,,,,,,,43,80,12.2,12.28,12.5,,,,,,,,,,,,,,,,,"6,3,12,23,39,15,2,1,0",,,,,,,125,,,,,,,,,,,,,,,,,,,,,,,,,,,,,,,,,,,,,7,20,227,84,,1001,,,0,5,3,,1,0,,,,,"Aachen Laufen",,"Polar BEAT",,0,,0,168070,250480,30378,,,,,,,,,,,,,,,,,,,,,,,,,,,,,,,,,,,,,,,,,,,
5963321,3266144a-2fed-4097-b0c7-01a32d944ec6,1545818430,60,1548678062,,0,0,15.2,3669,3669,416,419,,,1,3.7,0.77,1.19,0.87,340,879,146,182,,,,77.25,53.15,79.87,1,,,,,,,,,,,,,,94,85,15.48,15.15,16.18,30.3,,,,,,,,,,,,,,,,"1,0,0,1,15,34,40,8,0","3,29,37,30,0",,,,,,146,,,,,,,,,,,,,,,,,,,,,,,,,,,,,,,,,,,,86.7,1,11,210,87,,,0,,0,4,3,,1,0,I10.006|37:50-I5.009|22:30-I0.187|0:50,,Running,,,,"Polar M430",43,0,,0,168070,250480,30378,,,,,,,,,,,,,,,,,,,,,,,,,,,,,,,,,,,,,,,,,,"4,4,5,5,5",
5963323,1605bf57-4033-493f-9fbb-b9dd8e4be94e,1414315232,60,1548678063,,0,0,10.5,3409,4127,119,147,,,1,1.2,0.48,,,504,687,,,,,,,36.6,,1,,,,,,,,,,,,,,70,80,11.17,11.76,11.92,,,,,,,,,,,,,,,,,"10,10,32,33,10,2,1,1,1",,,,,,,116,,,,,,,,,,,,,,,,,,,,,,,,,,,,,,,,,,,,,11,3,187,92,,1026,1,,0,4,3,,1,0,,,,,Auslaufen,,"Polar BEAT",,0,,0,168070,250480,30378,,,,,,,,,,,,,,,,,,,,,,,,,,,,,,,,,,,,,,,,,,5,
5963324,4f43e2dc-dce6-445d-b224-1ef221c07227,1478208112,60,1548678063,,0,0,7.2,2238,2310,69,69,,,1,0.8,0.44,,,,487,,,,,,,37.54,,1,,,,,,,,,,,,,,46,79,11.69,11.95,12.12,,,,,,,,,,,,,,,,,"3,9,36,31,7,3,10,1,0",,,,,,,122,,,,,,,,,,,,,,,,,,,,,,,,,,,,,,,,,,,,,5,3,198,91,,1022,0,,1,5,3,,1,0,,,,,"Aachen Laufen",,"Polar BEAT",,0,,0,168070,250480,30378,,,,,,,,,,,,,,,,,,,,,,,,,,,,,,,,,,,,,,,,,,,
5963325,62ebe90d-e7ac-438e-915b-e8f105931928,1472675748,120,1548678064,,0,0,12.79,3405,3414,182,189,,,1,2.2,0.57,,,425,871,,,,,,,46.83,,1,,,,,,,,,,,,,,70,81,13.74,13.59,14,,,,,,,,,,,,,,,,,"0,0,0,7,28,57,6,0,0",,,,,,,139,,,,,,,,,,,,,,,,,,,,,,,,,,,,,,,,,,,,,21,1,300,63,,1020,0,,1,5,3,,1,0,,,,,"Aachen Laufen",,"Polar BEAT",,0,,0,168070,250480,30378,,,,,,,,,,,,,,,,,,,,,,,,,,,,,,,,,,,,,,,,,,4,
5963326,2d1b6398-976c-4a08-b4c1-5d5288d87391,1392146861,60,1548678064,,0,0,2.21,474,474,24,22,,,1,0.7,0.46,1.02,1.05,,108,170,180,,,,72.02,52.62,73.07,1,,,,,,,,,,,,,,18,88,16.97,17.04,17.13,10.9,,,,,,,,,,,,,,,,"0,0,0,0,0,17,38,43,2","0,1,11,88,0",,,,,,159,,,,,,,,,,,,,,,,,,,,,,,,,,,,,,,,,,,,61.5,5,24,206,73,,1002,,,1,5,3,,1,0,,,,,"1 Einzel HW",,"Polar BEAT",,0,,0,168070,250480,30378,,,,,,,,,,,,,,,,,,,,,,,,,,,,,,,,,,,,,,,,,,,
5963327,37e5eafe-cf34-4b1c-83b4-9cb5663b2616,1462998818,120,1548678064,,0,0,4.34,1262,1426,39,38,,,1,0.5,0.37,,,,303,,,,,,,39.41,,1,,,,,,,,,,,,,,26,79,12.48,12.96,13.14,,,,,,,,,,,,,,,,,"9,4,4,20,25,23,14,1,0",,,,,,,131,,,,,,,,,,,,,,,,,,,,,,,,,,,,,,,,,,,,,21,6,65,48,,,,,0,3,3,,1,0,,,,,"Dortmund Laufen",,"Polar BEAT",,0,,0,168070,250480,30378,,,,,,,,,,,,,,,,,,,,,,,,,,,,,,,,,,,,,,,,,,,
5963328,53c0c673-199c-46dc-8cf5-92a77bcea3c8,1401746862,120,1548678065,,0,0,2.12,541,541,22,29,,,1,0.1,0.29,,,,143,,,,,,,43.09,,1,,,,,,,,,,,,,,11,83,14.14,14.13,14.39,,,,,,,,,,,,,,,,,"0,3,3,3,19,48,17,7,0",,,,,,,142,,,,,,,,,,,,,,,,,,,,,,,,,,,,,,,,,,,,,15,0,7,62,,1018,0,,1,3,3,,1,0,,,,,Auslaufen,,"Polar BEAT",,0,,0,168070,250480,30378,,,,,,,,,,,,,,,,,,,,,,,,,,,,,,,,,,,,,,,,,,,
5963329,ef324cff-46d5-4e27-857f-8c9cf0336b85,1546360655,60,1548678065,,0,0,10.31,3049,3049,333,339,,,1,4.2,0.78,1.12,0.99,572,751,149,170,,,,58.47,40.78,60.77,1,,,,,,,,,,,,,,75,81,13.04,12.43,13.73,-7.5,,,,,,,,,,,,,,,,"4,9,12,21,29,22,4,0,0","0,32,51,17,0",,,,,,125,,,,,,,,,,,,,,,,,,,,,,,,,,,,,,,,,,,,51.1,6,19,297,81,,1026,0,293,1,5,3,,1,0,I1.000|5:39-I1.000|6:05-I1.000|5:07-I1.000|4:53-I1.000|5:15-I1.000|4:31-I1.000|4:20-I1.000|4:27-I1.000|4:19-I1.000|4:41-I0.312|1:32,,Running,,,,"Polar M430",43,0,,0,168070,250480,30378,,,,,,,,,,,,,,,,,,,,,,,,,,,,,,,,,,,,,,,,,,3,
5963330,e290b5ee-f775-4ec1-bb93-328868ec7c24,1413729033,120,1548678066,,0,0,5.2,1032,1032,18,16,,,1,0,0.03,,,,351,,,,,,,62.32,,1,,,,,,,,,,,,,,21,88,18.2,18.26,18.34,,,,,,,,,,,,,,,,,"0,0,0,0,0,0,22,75,3",,,,,,,172,,,,,,,,,,,,,,,,,,,,,,,,,,,,,,,,,,,,,22,9,229,71,,1016,2,,0,3,3,,1,0,,,,,"5k WK Kerkrade",,"Polar BEAT",,0,,0,168070,250480,30378,,,,,,,,,,,,,,,,,,,,,,,,,,,,,,,,,,,,,,,,,,,
5963331,4045b8e9-1737-4d3f-8c42-42217e6853cb,1432470428,120,1548678066,,0,0,4,1078,1078,13,18,,,1,0,0.09,,,,274,,,,,,,42.85,,1,,,,,,,,,,,,,,22,82,13.42,13.45,13.5,,,,,,,,,,,,,,,,,"0,0,0,11,33,51,5,0,0",,,,,,,136,,,,,,,,,,,,,,,,,,,,,,,,,,,,,,,,,,,,,16,1,339,63,,,5,,0,5,3,,1,0,,,,,"Menden Laufen",,"Polar BEAT",,0,,0,168070,250480,30378,,,,,,,,,,,,,,,,,,,,,,,,,,,,,,,,,,,,,,,,,,,
5963332,4b32e95f-2c91-4c70-a1db-080135a36a6c,1489752242,60,1548678067,,0,0,12.85,3781,4017,192,192,,,1,2.5,0.65,,,382,912,,,,,,,41.7,,1,,,,,,,,,,,,,,78,80,12.53,12.39,12.68,,,,,,,,,,,,,,,,,"5,2,8,24,41,21,0,0,0",,,,,,,127,,,,,,,,,,,,,,,,,,,,,,,,,,,,,,,,,,,,,10,8,287,68,,1018,3,,0,5,3,,1,0,,,,,"Aachen Laufen",,"Polar BEAT",,0,,0,168070,250480,30378,,,,,,,,,,,,,,,,,,,,,,,,,,,,,,,,,,,,,,,,,,4,
5963333,4df95b39-c9c2-4bde-8135-7fa81b3c524e,1398602318,120,1548678067,,0,0,11.35,2315,2315,46,43,,,1,0,0.09,,,,769,,,,,,,63.34,,1,,,,,,,,,,,,,,48,89,17.72,17.7,17.83,,,,,,,,,,,,,,,,,"0,0,0,0,0,0,30,68,2",,,,,,,165,,,,,,,,,,,,,,,,,,,,,,,,,,,,,,,,,,,,,13,0,237,87,,,4,,0,6,3,,1,0,,,,,"WK 10k Staffel Düsseldorf",,"Polar BEAT",,0,,0,168070,250480,30378,,,,,,,,,,,,,,,,,,,,,,,,,,,,,,,,,,,,,,,,,,,
5963334,06f4f12d-0549-471e-b260-4e767b8a23ce,1543944362,60,1548678068,,0,0,0.4,211,213,3,4,,,1,0,0,,1.06,,33,114,127,,,,39.19,15.43,39.43,1,,,,,,,,,,,,,,2,76,6.81,7.29,7.33,-41.2,,,,,,,,,,,,,,,,"100,0,0,0,0,0,0,0,0","19,81,0,0,0",,,,,,75,,,,,,,,,,,,,,,,,,,,,,,,,,,,,,,,,,,,3.1,8,6,45,88,,1025,0,296,1,5,3,,1,0,,,Running,,,,"Polar M430",43,0,,0,168070,250480,30378,,,,,,,,,,,,,,,,,,,,,,,,,,,,,,,,,,,,,,,,,,,
5963335,cb228c67-6bf8-47ef-867e-ae4fe2241079,1393169473,60,1548678070,,0,0,21.1,5314,5536,298,280,,,1,1.9,0.43,1.06,1,364,1028,156,173,,,,66.96,51.94,68.2,1,,,,,,,,,,,,,,153,86,14.61,14.38,14.77,-2.5,,,,,,,,,,,,,,,,"1,1,1,2,11,57,27,0,0","0,6,63,32,0",,,,,,139,,,,,,,,,,,,,,,,,,,,,,,,,,,,,,,,,,,,66,10,11,200,69,,1020,1,,0,5,3,,1,0,,,,,"Zügiger Halbmarathon",,"Polar BEAT",,0,,0,168070,250480,30378,,,,,,,,,,,,,,,,,,,,,,,,,,,,,,,,,,,,,,,,,,4,
5963336,cb6f1bb9-e903-41ab-8a42-63dd13542f85,1460667937,120,1548678070,,0,0,4.67,1495,1563,51,65,,,1,1.1,0.57,,,,331,,,,,,,35.32,,1,,,,,,,,,,,,,,31,81,11.37,11.41,11.61,,,,,,,,,,,,,,,,,"9,11,13,37,24,6,0,0,0",,,,,,,116,,,,,,,,,,,,,,,,,,,,,,,,,,,,,,,,,,,,,11,2,141,77,,1011,0,,1,5,3,,1,0,,,,,"Aachen Laufen",,"Polar BEAT",,0,,0,168070,250480,30378,,,,,,,,,,,,,,,,,,,,,,,,,,,,,,,,,,,,,,,,,,,
5963337,1fd05e5a-f205-43dd-a09d-f34822348513,1482434933,60,1548678071,,0,0,1.68,665,896,35,33,,,1,1.5,0.76,,,,114,,,,,,,25.43,,1,,,,,,,,,,,,,,13,74,9.63,10.71,11.01,,,,,,,,,,,,,,,,,"40,8,21,10,6,8,7,0,0",,,,,,,102,,,,,,,,,,,,,,,,,,,,,,,,,,,,,,,,,,,,,5,3,221,95,,1032,0,,1,5,3,,1,0,,,,,"Aachen Laufen",,"Polar BEAT",,0,,0,168070,250480,30378,,,,,,,,,,,,,,,,,,,,,,,,,,,,,,,,,,,,,,,,,,,
5963338,af669ce4-f2bc-49dd-a422-880609f28aad,1393232600,60,1548678071,,0,0,9.93,2965,3077,153,154,,,1,1.7,0.49,1.07,0.97,268,539,149,174,,,,57.78,40.21,58.87,1,,,,,,,,,,,,,,73,83,12.31,12.15,12.52,-5.1,,,,,,,,,,,,,,,,"2,4,10,25,48,10,0,0,0","1,20,62,17,0",,,,,,121,,,,,,,,,,,,,,,,,,,,,,,,,,,,,,,,,,,,38.3,4,8,146,85,,1015,0,,0,5,3,,1,0,,,,,"Regeneration ",,"Polar BEAT",,0,,0,168070,250480,30378,,,,,,,,,,,,,,,,,,,,,,,,,,,,,,,,,,,,,,,,,,5,
5963339,70a00002-95c8-4edc-b692-9bb5e1164f06,1362910107,60,1548678073,,0,0,19.05,6352,14352,84,84,,,1,0,0.11,0.98,0.87,,1325,161,172,,,,45.27,37.18,45.52,1,,,,,,,,,,,,,,203,,10.86,11.65,11.72,9.3,,,,,,,,,,,,,,,,"13,6,17,33,20,7,3,1,1","0,0,52,48,0",,,,,,,,,,,,,,,,,,,,,,,,,,,,,,,,,,,,,,,,,,72.7,8,8,222,87,,1000,2,,0,5,3,,1,0,,,,,,,"Polar BEAT",,0,,0,168070,250480,30378,,,,,,,,,,,,,,,,,,,,,,,,,,,,,,,,,,,,,,,,,,,
5963340,2d8a9d31-76c7-4e8f-87cc-1f36f4fc1ebd,1392492960,60,1548678073,,0,0,3.14,1611,1612,46,47,,,1,0.6,0.48,,,99,203,,,,,,,19.37,,1,,,,,,,,,,,,,,33,73,7.19,11.03,11.38,,,,,,,,,,,,,,,,,"47,5,5,3,15,26,0,0,0",,,,,,,80,,,,,,,,,,,,,,,,,,,,,,,,,,,,,,,,,,,,,9,14,217,60,,,0,,1,3,3,,1,0,,,,,Regeneration,,"Polar BEAT",,0,,0,168070,250480,30378,,,,,,,,,,,,,,,,,,,,,,,,,,,,,,,,,,,,,,,,,,5,
5963341,a22ce368-d65a-4740-9b0f-5c364db4be3e,1475007438,120,1548678073,,0,0,0.59,140,140,4,8,,,1,0,0,,,,40,,,,,,,40.99,,1,,,,,,,,,,,,,,2,84,14.99,15.19,14.96,,,,,,,,,,,,,,,,,"0,0,0,0,0,36,64,0,0",,,,,,,151,,,,,,,,,,,,,,,,,,,,,,,,,,,,,,,,,,,,,15,1,216,71,,1027,0,,1,5,3,,1,0,,,,,"Aachen Laufen",,"Polar BEAT",,0,,0,168070,250480,30378,,,,,,,,,,,,,,,,,,,,,,,,,,,,,,,,,,,,,,,,,,,
5963342,970e889d-574e-4b3b-bd63-c91390481097,1545583340,60,1548678074,,0,0,8.59,2688,2696,129,129,,,1,1.9,0.68,1.19,1.14,267,625,145,169,,,,56.52,37.68,57.57,1,,,,,,,,,,,,,,60,80,11.82,12.26,12.46,4.1,,,,,,,,,,,,,,,,"5,4,20,38,20,5,3,4,0","0,26,69,5,0",,,,,,120,,,,,,,,,,,,,,,,,,,,,,,,,,,,,,,,,,,,39.3,6,8,192,99,,,0,,1,5,3,,1,0,I1.000|4:59-I1.000|5:21-I1.000|5:35-I1.000|5:08-I1.000|5:11-I1.000|5:10-I1.000|5:14-I1.000|3:56-I0.594|4:24,,Running,,,,"Polar M430",43,0,,0,168070,250480,30378,,,,,,,,,,,,,,,,,,,,,,,,,,,,,,,,,,,,,,,,,,5,
5963343,9571da21-0024-423c-81ea-089b2c327577,1541007939,60,1548678074,,0,0,10.71,2021,2023,51,42,,,1,0,0.15,2.84,0.41,,256,105,120,,,,,,,1,,,,,,,,,,,,,,14,,,19.65,,9.4,-6.3,90,75,,1,115,105,,,,,,,,,"8,47,42,2,0,0,0","19,81,0,0,0","85,1,9,3,2",,,,,,,,,,,,,,,,,,,,,,,,,,,,,,,,,,,,,,,,,4.7,10,11,9,73,,,0,,1,3,3,,1,0,,,Cycling,,,,"Polar M430",43,0,,0,168072,,30378,,,,,,,,,,,,,,,,,,,,,,,,,,,,,,,,,,,,,,,,,,,
5963344,887ea70c-b7f8-41e1-9c78-93323f53311e,1470169022,120,1548678075,,0,0,14.56,4331,4376,162,160,,,1,0.9,0.42,,,,1003,,,,,,,41.58,,1,,,,,,,,,,,,,,89,79,12.25,12.8,12.98,,,,,,,,,,,,,,,,,"8,2,4,11,43,27,5,0,0",,,,,,,128,,,,,,,,,,,,,,,,,,,,,,,,,,,,,,,,,,,,,17,10,231,95,,1015,0,,0,6,3,,1,0,,,,,"Aachen Laufen",,"Polar BEAT",,0,,0,168070,250480,30378,,,,,,,,,,,,,,,,,,,,,,,,,,,,,,,,,,,,,,,,,,,
5963345,ecc17d63-4b6a-40bb-87ac-d6daea9f456a,1534234626,120,1548678075,,0,0,9.47,1401,1420,37,47,,,1,0,0.11,,0.61,,266,129,147,,,,,,,1,,,,,,,,,,,,,,20,,,25.12,,10.7,-17.2,122,106,,1,137,126,,,,,,,,,"6,2,28,65,0,0,0","0,97,3,0,0","83,7,0,0,10",,,,,,,,,,,,,,,,,,,,,,,,,,,,,,,,,,,,,,,,,15.4,18,11,244,84,,1015,,,0,5,3,,1,0,,,Cycling,,,,"Polar M430",43,0,,0,168072,,30378,,,,,,,,,,,,,,,,,,,,,,,,,,,,,,,,,,,,,,,,,,,
5963346,599f17a0-7d85-4564-8aca-91d8a70dbce0,1496860304,120,1548678076,,0,0,26.32,4641,4901,416,464,,,1,3.1,0.6,,,640,993,,,,,,,,,1,,,,,,,,,,,,,,51,,,25.32,,,,139,107,,1,196,160,,,,,,,,,"31,28,16,8,9,4,5",,"55,33,3,6,3",,,,,,,,,,,,,,,,,,,,,,,,,,,,,,,,,,,,,,,,,,18,7,35,53,,1015,,,0,6,3,,1,0,,,,,"Aachen Radfahren",,"Polar BEAT",,0,,0,168072,,30378,,,,,,,,,,,,,,,,,,,,,,,,,,,,,,,,,,,,,,,,,,"4,4,5",
5963347,394c69f4-3d72-41d6-978c-3cae6c7e830d,1512916530,60,1548678077,,0,0,13.03,4262,4276,59,57,,,1,0,0.13,1.06,0.92,,969,146,170,,,,53.04,36.89,53.35,1,,,,,,,,,,,,,,97,81,11.05,11.12,11.2,13.4,,,,,,,,,,,,,,,,"7,7,23,52,11,0,0,0,0","0,31,57,11,0",,,,,,113,,,,,,,,,,,,,,,,,,,,,,,,,,,,,,,,,,,,52.1,1,3,195,89,,,0,,0,4,3,,1,0,I1.000|4:58-I1.000|5:03-I1.000|5:06-I1.000|5:11-I1.000|5:46-I1.000|5:33-I1.000|6:07-I1.000|5:16-I1.000|5:41-I1.000|5:39-I1.000|5:27-I1.000|5:28-I1.000|5:52-I0.034|0:10,,Running,,,,"Polar M430",43,0,,0,168070,250480,30378,,,,,,,,,,,,,,,,,,,,,,,,,,,,,,,,,,,,,,,,,,,
5963348,8e17a31c-5941-4643-991e-bc241745daf0,1403177558,120,1548678078,,0,0,11.09,3736,3761,144,144,,,1,1.4,0.55,,,340,753,,,,,,,35.19,,1,,,,,,,,,,,,,,77,81,10.84,10.75,10.94,,,,,,,,,,,,,,,,,"3,17,38,40,2,0,0,0,0",,,,,,,110,,,,,,,,,,,,,,,,,,,,,,,,,,,,,,,,,,,,,15,6,299,70,,1022,4,,0,5,3,,1,0,,,,,Auslaufen,,"Polar BEAT",,0,,0,168070,250480,30378,,,,,,,,,,,,,,,,,,,,,,,,,,,,,,,,,,,,,,,,,,5,
5963349,ed2e23c4-359a-4a4e-8dce-419d4b6a5054,1450529946,60,1548678078,,0,0,1.43,530,586,0,3,,,1,0,0.01,,,,82,,,,,,,27,,1,,,,,,,,,,,,,,11,78,9.83,11.66,11.73,,,,,,,,,,,,,,,,,"42,4,3,5,15,14,8,9,0",,,,,,,104,,,,,,,,,,,,,,,,,,,,,,,,,,,,,,,,,,,,,13,18,195,81,,1022,,,0,5,3,,1,0,,,,,"Aachen Laufen",,"Polar BEAT",,0,,0,168070,250480,30378,,,,,,,,,,,,,,,,,,,,,,,,,,,,,,,,,,,,,,,,,,,
5963350,01f0fa4d-f06d-4b79-b7e8-146e9e138647,1475405091,120,1548678078,,0,0,8.14,2374,2523,101,101,,,1,1.2,0.43,,,,554,,,,,,,40.79,,1,,,,,,,,,,,,,,49,81,12.6,12.57,12.73,,,,,,,,,,,,,,,,,"5,4,7,22,34,24,2,1,0",,,,,,,127,,,,,,,,,,,,,,,,,,,,,,,,,,,,,,,,,,,,,11,11,227,87,,1012,1,,0,6,3,,1,0,,,,,"Aachen Laufen",,"Polar BEAT",,0,,0,168070,250480,30378,,,,,,,,,,,,,,,,,,,,,,,,,,,,,,,,,,,,,,,,,,,
5963351,36b55608-1c26-4684-bbd4-4adf92fbd922,1412626771,120,1548678079,,0,0,7,1507,1507,73,67,,,1,0.6,0.43,1.05,1,,359,166,182,,,,74.32,57.75,75.36,1,,,,,,,,,,,,,,55,87,16.89,16.82,17.05,-1.5,,,,,,,,,,,,,,,,"0,0,0,0,0,3,62,35,0","0,1,29,61,9",,,,,,160,,,,,,,,,,,,,,,,,,,,,,,,,,,,,,,,,,,,96.8,14,4,164,83,,1007,0,,1,5,3,,1,0,,,,,TDL,,"Polar BEAT",,0,,0,168070,250480,30378,,,,,,,,,,,,,,,,,,,,,,,,,,,,,,,,,,,,,,,,,,,
5963352,1518f573-0091-443c-bfe7-476582c3c91d,1531329219,120,1548678079,,0,0,11.07,2990,2992,57,66,,,1,0,0.22,1.08,0.92,,715,146,166,,,,67.19,45.56,67.55,1,,,,,,,,,,,,,,68,81,13.36,13.44,13.53,0.8,,,,,,,,,,,,,,,,"0,1,2,11,40,40,7,0,0","1,20,77,2,0",,,,,,137,,,,,,,,,,,,,,,,,,,,,,,,,,,,,,,,,,,,43,21,8,318,45,,1016,3,,0,5,3,,1,0,I1.000|4:39-I1.000|4:38-I1.000|4:27-I1.000|4:41-I1.000|4:46-I1.000|4:53-I1.000|4:52-I1.000|4:10-I1.000|4:09-I1.000|4:10-I1.000|4:07-I0.072|0:22,,Running,,,,"Polar M430",43,0,,0,168070,250480,30378,,,,,,,,,,,,,,,,,,,,,,,,,,,,,,,,,,,,,,,,,,,
5963353,08d4aeb7-16ad-40bf-bf32-04e4695ea89a,1407444015,120,1548678080,,0,0,7.19,2408,2572,4,5,,,1,0,0.03,0.47,0.73,,439,151,184,,,,49.26,34.36,49.28,1,,,,,,,,,,,,,,67,76,10.92,13.92,13.97,18.4,,,,,,,,,,,,,,,,"52,2,2,3,3,4,5,11,19","0,37,19,42,2",,,,,,118,,,,,,,,,,,,,,,,,,,,,,,,,,,,,,,,,,,,62.2,19,4,32,78,,1015,,,0,5,3,,1,0,,,,,"10x400m, 200 300 200 300 200",,"Polar BEAT",,0,,0,168070,250480,30378,,,,,,,,,,,,,,,,,,,,,,,,,,,,,,,,,,,,,,,,,,,
5963354,f6613b9f-6d11-43b5-98d6-ad4bfcc62875,1433070097,120,1548678080,,0,0,20.92,4561,4561,36,36,,,1,0,0.03,,,,1414,,,,,,,61.3,,1,,,,,,,,,,,,,,94,88,16.54,16.58,16.62,,,,,,,,,,,,,,,,,"0,0,0,0,2,9,55,35,0",,,,,,,156,,,,,,,,,,,,,,,,,,,,,,,,,,,,,,,,,,,,,16,7,208,61,,,,,0,3,3,,1,0,,,,,"Menden Laufen",,"Polar BEAT",,0,,0,168070,250480,30378,,,,,,,,,,,,,,,,,,,,,,,,,,,,,,,,,,,,,,,,,,,
5963355,651ee5c5-73eb-496b-9ab7-1f10bce85d56,1490647661,120,1548678081,,0,0,13.12,3743,3767,197,199,,,1,2.7,0.57,,,466,916,,,,,,,43.29,,1,,,,,,,,,,,,,,77,81,13.01,12.92,13.24,,,,,,,,,,,,,,,,,"6,3,4,18,34,27,8,0,0",,,,,,,130,,,,,,,,,,,,,,,,,,,,,,,,,,,,,,,,,,,,,13,4,123,41,,1021,0,,1,3,3,,1,0,,,,,"Aachen Laufen",,"Polar BEAT",,0,,0,168070,250480,30378,,,,,,,,,,,,,,,,,,,,,,,,,,,,,,,,,,,,,,,,,,"4,5",
5963356,,1396382432,120,1548678081,,0,0,3.3,0,0,,,,,0,,,,,,,,,,,,,,,1,,,,,,,,,,,,,,0,,,,,,,,,,,,,,,,,,,,,,,,,,,,,,,,,,,,,,,,,,,,,,,,,,,,,,,,,,,,,,,,,,,,,,,,,,1,,,0,0,,,,,Einlaufen,,"Polar BEAT",,0,,0,168070,250480,30378,,,,,,,,,,,,,,,,,,,,,,,,,,,,,,,,,,,,,,,,,,,
5963357,791de980-71c3-46ef-9070-91b95ec5509b,1396437742,120,1548678081,,0,0,4.99,1321,1322,50,32,,,1,0,0.16,1.04,1,,275,148,162,,,,67.65,44.39,68.8,1,,,,,,,,,,,,,,31,84,13.84,13.67,13.96,3.9,,,,,,,,,,,,,,,,"0,1,3,4,28,59,5,0,0","2,7,89,3,0",,,,,,135,,,,,,,,,,,,,,,,,,,,,,,,,,,,,,,,,,,,35.8,18,3,136,55,,1007,3,,0,5,3,,1,0,,,,,"Einlaufen + Lauf ABC",,"Polar BEAT",,0,,0,168070,250480,30378,,,,,,,,,,,,,,,,,,,,,,,,,,,,,,,,,,,,,,,,,,,
5963358,33c36a41-c32f-4e15-aba1-115e29fb72de,1510415704,60,1548678082,,0,0,4.51,1430,1430,44,56,,,1,0.8,0.46,1.1,0.94,,288,135,155,,,,60.84,35.66,61.37,1,,,,,,,,,,,,,,25,80,11.4,11.85,11.87,-1.9,,,,,,,,,,,,,,,,"2,8,47,30,2,2,5,3,0","1,59,40,0,0",,,,,,118,,,,,,,,,,,,,,,,,,,,,,,,,,,,,,,,,,,,23.5,7,6,304,97,,1008,0,,0,4,3,,1,0,I1.000|5:40-I1.000|5:34-I1.000|5:31-I1.000|4:52-I0.511|2:14,,Running,,,,"Polar M430",43,0,,0,168070,250480,30378,,,,,,,,,,,,,,,,,,,,,,,,,,,,,,,,,,,,,,,,,,,
5963359,cd3a2ffa-ef4c-40b0-bc69-e00dc57c6562,1521742091,60,1548678082,,0,0,12,3261,3261,48,48,,,1,0,0.07,1.16,0.91,,915,166,179,,,,55.71,45.51,55.99,1,,,,,,,,,,,,,,120,83,13.29,13.42,13.48,10.4,,,,,,,,,,,,,,,,"2,1,2,6,33,53,4,0,0","1,11,8,80,0",,,,,,133,,,,,,,,,,,,,,,,,,,,,,,,,,,,,,,,,,,,91.5,2,14,229,92,,1015,,,0,6,3,,1,0,I1.000|4:43-I1.000|4:29-I1.000|4:25-I1.000|4:15-I1.000|4:19-I1.000|4:30-I1.000|4:28-I1.000|4:25-I1.000|4:23-I1.000|4:33-I1.000|4:38-I1.000|5:13-I0.004|0:02,,Running,,,,"Polar M430",43,0,,0,168070,250480,30378,,,,,,,,,,,,,,,,,,,,,,,,,,,,,,,,,,,,,,,,,,,
5963360,65a135ae-5dec-4b58-b3c0-7e7093981a16,1476354326,120,1548678084,,0,0,6.63,1875,1875,72,67,,,1,1,0.48,,,,452,,,,,,,41.76,,1,,,,,,,,,,,,,,38,80,12.92,12.86,13.08,,,,,,,,,,,,,,,,,"3,1,2,12,55,22,5,0,0",,,,,,,133,,,,,,,,,,,,,,,,,,,,,,,,,,,,,,,,,,,,,7,8,94,86,,1016,1,,0,5,3,,1,0,,,,,"Aachen Laufen",,"Polar BEAT",,0,,0,168070,250480,30378,,,,,,,,,,,,,,,,,,,,,,,,,,,,,,,,,,,,,,,,,,,
5963361,d3b16a45-d34d-45aa-b0f2-ed2057d38844,1412014478,120,1548678085,,0,0,5.01,1030,1030,39,41,,,1,0.7,0.44,1.04,1,,243,169,182,,,,76.6,59.66,77.3,1,,,,,,,,,,,,,,39,88,17.63,17.56,17.7,3.4,,,,,,,,,,,,,,,,"0,0,0,0,0,0,50,50,0","0,2,10,85,3",,,,,,166,,,,,,,,,,,,,,,,,,,,,,,,,,,,,,,,,,,,81.8,16,4,207,91,,1024,0,,0,6,3,,1,0,,,,,"TDL Campus Boulevard",,"Polar BEAT",,0,,0,168070,250480,30378,,,,,,,,,,,,,,,,,,,,,,,,,,,,,,,,,,,,,,,,,,,
5963362,19fdcf92-92f4-495d-8cf7-f90934016102,1474576487,120,1548678085,,0,0,3.59,1079,1083,6,8,,,1,0,0,,,,225,,,,,,,37.43,,1,,,,,,,,,,,,,,22,85,12,12.86,12.83,,,,,,,,,,,,,,,,,"29,7,7,9,10,13,9,15,1",,,,,,,117,,,,,,,,,,,,,,,,,,,,,,,,,,,,,,,,,,,,,14,1,189,81,,1022,0,,1,5,3,,1,0,,,,,"Aachen Laufen",,"Polar BEAT",,0,,0,168070,250480,30378,,,,,,,,,,,,,,,,,,,,,,,,,,,,,,,,,,,,,,,,,,,
5963363,c2a681e0-a2a4-4d75-b579-076255f698a8,1500925580,120,1548678085,,0,0,0.77,267,267,14,13,,,1,1.3,0.79,,,,52,,,,,,,27.18,,1,,,,,,,,,,,,,,5,79,10.74,10.48,10.79,,,,,,,,,,,,,,,,,"14,19,31,33,3,0,0,0,0",,,,,,,110,,,,,,,,,,,,,,,,,,,,,,,,,,,,,,,,,,,,,15,4,268,86,,1011,0,,0,5,3,,1,0,,,,,"Aachen Laufen",,"Polar BEAT",,0,,0,168070,250480,30378,,,,,,,,,,,,,,,,,,,,,,,,,,,,,,,,,,,,,,,,,,,
5963364,23fb8981-0c88-4d3e-8d5d-2e22f035757e,1345901653,120,1548678087,,0,0,29.94,3535,3578,728,728,,,1,4.1,0.62,,,1198,1121,,,,,,,,,1,,,,,,,,,,,,,,39,,,33.13,,,,491,328,,1,580,432,,,,,,,,,"8,7,12,20,19,15,19",,"49,7,6,6,33",,,,,,,,,,,,,,,,,,,,,,,,,,,,,,,,,,,,,,,,,,20,17,246,68,,1007,5,,0,5,3,,1,0,,,,,,,"Polar BEAT",,0,,0,168072,,30378,,,,,,,,,,,,,,,,,,,,,,,,,,,,,,,,,,,,,,,,,,"4,4,4,4,5,5,5,5,5",
5963366,0ed864ef-0d18-4725-ae73-1de19881ca16,1521983635,120,1548678088,,0,0,15.94,12545,12928,802,802,,,1,7.3,0.79,,,385,1844,113,150,,,,,,,1,,,,,,,,,,,,,,118,,,5.34,,-27.4,,,,,,,,,,,,,,,,"50,49,1,0,0,0","12,86,2,0,0",,,,,,,,,,,,,,,,,,,,,,,,,,,,,,,,,,,,,,,,,,13.7,10,2,294,61,,,,,0,3,3,,1,0,I1.000|12:08-I1.000|8:16-I1.000|14:08-I1.000|12:49-I1.000|15:40-I1.000|22:42-I1.000|16:25-I1.000|13:21-I1.000|15:34-I1.000|14:29-I1.000|13:27-I1.000|11:26-I1.000|12:41-I1.000|10:50-I1.000|10:08-I1.000|11:26,,Hiking,,,,"Polar M430",43,0,,0,168075,,30378,,,,,,,,,,,,,,,,,,,,,,,,,,,,,,,,,,,,,,,,,,"1,2,4,4,4",
5963367,477aff4c-50f5-462b-a669-d64e3d7d156a,1369340012,120,1548678089,,0,0,2.23,647,710,54,42,,,1,1.7,0.73,,,459,153,,,,,,,37.45,,1,,,,,,,,,,,,,,13,,13.19,12.51,13.84,,,,,,,,,,,,,,,,,"1,1,2,35,43,19,0,0,0",,,,,,,,,,,,,,,,,,,,,,,,,,,,,,,,,,,,,,,,,,,,5,5,293,88,,1010,0,,0,5,3,,1,0,,,,,,,"Polar BEAT",,0,,0,168070,250480,30378,,,,,,,,,,,,,,,,,,,,,,,,,,,,,,,,,,,,,,,,,,5,
5963368,,1463617158,120,1548678089,,0,0,1.3,0,0,,,,,0,,,,,,,,,,,,,,,1,,,,,,,,,,,,,,0,,,,,,,,,,,,,,,,,,,,,,,,,,,,,,,,,,,,,,,,,,,,,,,,,,,,,,,,,,,,,,,,,,,,,,,,,,1,,,0,0,,,,,Laufen,,"Polar BEAT",,0,,0,168070,250480,30378,,,,,,,,,,,,,,,,,,,,,,,,,,,,,,,,,,,,,,,,,,,
5963369,2ea1a415-3147-4284-8525-40059a940de1,1481047490,60,1548678089,,0,0,12.92,4111,4221,187,186,,,1,2.4,0.62,,,360,883,,,,,,,38.07,,1,,,,,,,,,,,,,,85,79,11.61,11.62,11.84,,,,,,,,,,,,,,,,,"9,4,12,38,33,4,0,0,0",,,,,,,119,,,,,,,,,,,,,,,,,,,,,,,,,,,,,,,,,,,,,3,7,140,79,,1032,0,,1,3,3,,1,0,,,,,"Aachen Laufen",,"Polar BEAT",,0,,0,168070,250480,30378,,,,,,,,,,,,,,,,,,,,,,,,,,,,,,,,,,,,,,,,,,4,
5963370,6cc60678-48b2-4571-a6a1-bb7c40f31905,1400792271,120,1548678090,,0,0,2.07,651,651,18,20,,,1,0.2,0.32,,,,139,,,,,,,33.9,,1,,,,,,,,,,,,,,13,83,11.53,11.66,11.77,,,,,,,,,,,,,,,,,"9,4,4,41,42,0,0,0,0",,,,,,,115,,,,,,,,,,,,,,,,,,,,,,,,,,,,,,,,,,,,,14,8,152,88,,1008,0,,0,6,3,,1,0,,,,,Auslaufen,,"Polar BEAT",,0,,0,168070,250480,30378,,,,,,,,,,,,,,,,,,,,,,,,,,,,,,,,,,,,,,,,,,,
5963371,43b6b721-2200-4f39-99a2-9053005772d1,1533545642,120,1548678090,,0,0,9.69,1536,1536,33,38,,,1,0,0.11,,0.56,,250,121,136,,,,,,,1,,,,,,,,,,,,,,17,,,23.73,,9.9,-24.4,107,94,,1,127,117,,,,,,,,,"5,6,60,29,0,0,0","0,100,0,0,0","87,4,0,0,9",,,,,,,,,,,,,,,,,,,,,,,,,,,,,,,,,,,,,,,,,8.5,23,11,36,60,,1017,,,0,3,3,,1,0,,,Cycling,,,,"Polar M430",43,0,,0,168072,,30378,,,,,,,,,,,,,,,,,,,,,,,,,,,,,,,,,,,,,,,,,,,
5963372,b7d6fc41-be4d-4eee-ba1d-504aef141161,1479761417,60,1548678090,,0,0,8.77,2979,3286,48,49,,,1,0,0.14,,,,597,,,,,,,34.25,,1,,,,,,,,,,,,,,61,80,10.67,10.82,10.85,,,,,,,,,,,,,,,,,"10,17,35,28,9,1,1,1,0",,,,,,,110,,,,,,,,,,,,,,,,,,,,,,,,,,,,,,,,,,,,,11,9,155,88,,1000,0,,1,6,3,,1,0,,,,,"Aachen Laufen",,"Polar BEAT",,0,,0,168070,250480,30378,,,,,,,,,,,,,,,,,,,,,,,,,,,,,,,,,,,,,,,,,,,
5963373,3da8cd2d-ec9a-4b24-8eca-9d5de4a04a0f,1392052353,60,1548678091,,0,0,10,2322,2322,171,183,,,1,1.1,0.43,1.14,0.89,,484,161,177,,,,70.79,53.99,72.18,1,,,,,,,,,,,,,,74,86,15.75,15.6,16.07,-1.8,,,,,,,,,,,,,,,,"0,0,0,0,1,28,61,10,0","0,1,54,46,0",,,,,,150,,,,,,,,,,,,,,,,,,,,,,,,,,,,,,,,,,,,78.5,4,4,180,85,,994,0,,0,5,3,,1,0,,,,,"Zügiger DL 10.000m Bahn",,"Polar BEAT",,0,,0,168070,250480,30378,,,,,,,,,,,,,,,,,,,,,,,,,,,,,,,,,,,,,,,,,,,
5963374,84918dd6-04e2-400c-aef1-ace64a0c252c,1545240187,60,1548678091,,0,0,6.09,1852,1854,21,21,,,1,0,0.14,1.14,0.93,,401,138,157,,,,62.35,38.14,62.62,1,,,,,,,,,,,,,,34,79,11.89,11.89,11.97,2.5,,,,,,,,,,,,,,,,"0,0,12,51,35,2,0,0,0","1,59,41,0,0",,,,,,125,,,,,,,,,,,,,,,,,,,,,,,,,,,,,,,,,,,,23.5,5,5,155,95,,,0,,1,5,3,,1,0,I1.000|5:04-I1.000|5:04-I1.000|4:58-I1.000|5:15-I1.000|4:58-I1.000|5:08-I0.093|0:28,,Running,,,,"Polar M430",43,0,,0,168070,250480,30378,,,,,,,,,,,,,,,,,,,,,,,,,,,,,,,,,,,,,,,,,,,
5963375,d694ce75-6836-4843-8dc1-1b2f4fcbe14a,1459599885,120,1548678092,,0,0,11.12,3463,3811,241,241,,,1,3.3,0.73,,,449,767,,,,,,,38.6,,1,,,,,,,,,,,,,,71,82,12.07,11.72,12.63,,,,,,,,,,,,,,,,,"7,10,17,31,22,13,1,0,0",,,,,,,117,,,,,,,,,,,,,,,,,,,,,,,,,,,,,,,,,,,,,11,4,96,71,,1017,4,,0,5,3,,1,0,,,,,"Aachen Laufen",,"Polar BEAT",,0,,0,168070,250480,30378,,,,,,,,,,,,,,,,,,,,,,,,,,,,,,,,,,,,,,,,,,"4,5,5",
5963376,6893cb47-604b-4074-ac6f-4fd2923883db,1371393899,120,1548678093,,0,0,15.12,3565,3583,405,398,,,1,4,0.76,,,575,1023,,,,,,,54.59,,1,,,,,,,,,,,,,,74,,15.84,15.53,16.53,,,,,,,,,,,,,,,,,"3,0,0,0,1,29,56,10,0",,,,,,,,,,,,,,,,,,,,,,,,,,,,,,,,,,,,,,,,,,,,19,12,254,54,,,6,,0,5,3,,1,0,,,,,Untitled,,"Polar BEAT",,0,,0,168070,250480,30378,,,,,,,,,,,,,,,,,,,,,,,,,,,,,,,,,,,,,,,,,,"4,5,5,5,5",
5963377,0432a203-561b-4306-bba1-5c1531748dfe,1471351834,120,1548678093,,0,0,13.52,2681,2791,9,20,,,1,0,0,,,,459,,,,,,,,,1,,,,,,,,,,,,,,29,,,19.08,,,,62,54,,1,72,66,,,,,,,,,"11,58,32,0,0,0,0",,"91,0,8,0,0",,,,,,,,,,,,,,,,,,,,,,,,,,,,,,,,,,,,,,,,,,28,3,181,61,,1014,,,0,3,3,,1,0,,,,,"Naujac-sur-Mer Radfahren",,"Polar BEAT",,0,,0,168072,,30378,,,,,,,,,,,,,,,,,,,,,,,,,,,,,,,,,,,,,,,,,,,
5963378,a6be1360-f7f5-4c25-9417-872c6b506f6d,1406840124,120,1548678093,,0,0,3.32,1052,1052,67,67,,,1,1.6,0.57,,,402,215,,,,,,,34.99,,1,,,,,,,,,,,,,,21,83,11.71,11.45,12.29,,,,,,,,,,,,,,,,,"4,6,27,35,22,5,0,0,0",,,,,,,114,,,,,,,,,,,,,,,,,,,,,,,,,,,,,,,,,,,,,19,1,7,70,,1014,,,0,5,3,,1,0,,,,,Auslaufen,,"Polar BEAT",,0,,0,168070,250480,30378,,,,,,,,,,,,,,,,,,,,,,,,,,,,,,,,,,,,,,,,,,4,
5963379,ef22dd8a-8bdb-4393-830f-0c17f23c2886,1445372097,120,1548678093,,0,0,2.82,805,805,29,25,,,1,0.5,0.36,,,,194,,,,,,,39.01,,1,,,,,,,,,,,,,,16,83,12.77,12.64,13.01,,,,,,,,,,,,,,,,,"0,1,6,16,58,20,0,0,0",,,,,,,127,,,,,,,,,,,,,,,,,,,,,,,,,,,,,,,,,,,,,9,6,328,96,,1025,,,1,5,3,,1,0,,,,,"Aachen Laufen",,"Polar BEAT",,0,,0,168070,250480,30378,,,,,,,,,,,,,,,,,,,,,,,,,,,,,,,,,,,,,,,,,,,
5963380,93e5ac1c-364f-4a46-a8cb-0b21b0ce0d41,1408988380,120,1548678094,,0,0,2.51,823,823,25,42,,,1,0.8,0.56,,,,169,,,,,,,32.89,,1,,,,,,,,,,,,,,17,81,10.98,11.14,11.13,,,,,,,,,,,,,,,,,"9,2,25,46,19,0,0,0,0",,,,,,,113,,,,,,,,,,,,,,,,,,,,,,,,,,,,,,,,,,,,,15,5,184,91,,1012,1,,0,6,3,,1,0,,,,,Auslaufen,,"Polar BEAT",,0,,0,168070,250480,30378,,,,,,,,,,,,,,,,,,,,,,,,,,,,,,,,,,,,,,,,,,,
5963381,,1368531108,120,1548678094,,0,0,,32293,32293,,,,,0,,,,,,7894,,,,,,,,,1,,,,,,,,,,,,,,670,,,,,,,,,,,,,,,,,,,,,,,,,,,,,,,,,,,,,,,,,,,,,,,,,,,,,,,,,,,,,,,,,,,,,,,,,,1,,,0,0,,,,,,,"Polar BEAT",,0,,0,168070,250480,30378,,,,,,,,,,,,,,,,,,,,,,,,,,,,,,,,,,,,,,,,,,,
5963382,d7b13af6-6428-473f-9a89-fd2135f0d896,1461266022,120,1548678094,,0,0,2.89,715,717,57,57,,,1,1.4,1,,,,164,,,,,,,46.06,,1,,,,,,,,,,,,,,14,86,15.01,15.82,16.38,,,,,,,,,,,,,,,,,"13,10,11,7,5,6,8,11,28",,,,,,,141,,,,,,,,,,,,,,,,,,,,,,,,,,,,,,,,,,,,,17,5,44,45,,1019,0,,0,5,3,,1,0,,,,,"Aachen Laufen",,"Polar BEAT",,0,,0,168070,250480,30378,,,,,,,,,,,,,,,,,,,,,,,,,,,,,,,,,,,,,,,,,,,
5963383,e10285e6-573f-4719-8cb9-977d85a78214,1459420143,120,1548678094,,0,0,5.64,1776,1776,112,111,,,1,2,0.54,,,558,389,,,,,,,36.42,,1,,,,,,,,,,,,,,36,83,11.83,11.54,12.36,,,,,,,,,,,,,,,,,"4,7,18,43,22,5,1,0,0",,,,,,,115,,,,,,,,,,,,,,,,,,,,,,,,,,,,,,,,,,,,,6,6,53,96,,1012,2,,0,5,3,,1,0,,,,,"Aachen Laufen",,"Polar BEAT",,0,,0,168070,250480,30378,,,,,,,,,,,,,,,,,,,,,,,,,,,,,,,,,,,,,,,,,,4,
5963384,d85ec795-5fba-478e-9d22-057e39ad3c6c,1400528481,120,1548678095,,0,0,5,1160,1160,110,112,,,1,0,0.08,,,,327,,,,,,,51.82,,1,,,,,,,,,,,,,,24,84,15.86,15.57,16.18,,,,,,,,,,,,,,,,,"0,0,0,0,0,21,79,0,0",,,,,,,154,,,,,,,,,,,,,,,,,,,,,,,,,,,,,,,,,,,,,24,5,184,39,,1006,0,,0,5,3,,1,0,,,,,"kurzer TDL",,"Polar BEAT",,0,,0,168070,250480,30378,,,,,,,,,,,,,,,,,,,,,,,,,,,,,,,,,,,,,,,,,,,
5963385,64d8a8fa-14f9-4bdd-af6f-11535a93e31d,1515435572,60,1548678095,,0,0,13.66,3829,3833,146,153,,,1,0.9,0.43,1.1,0.95,227,937,152,172,,,,60.8,44.33,61.57,1,,,,,,,,,,,,,,102,82,13,12.95,13.18,5.5,,,,,,,,,,,,,,,,"0,2,6,15,42,32,3,0,0","1,15,59,25,0",,,,,,131,,,,,,,,,,,,,,,,,,,,,,,,,,,,,,,,,,,,52,4,10,98,85,,1019,0,,1,5,3,,1,0,I1.000|4:57-I1.000|4:48-I1.000|4:53-I1.000|4:39-I1.000|4:46-I1.000|4:50-I1.000|4:49-I1.000|4:44-I1.000|4:29-I1.000|4:20-I1.000|4:25-I1.000|4:39-I1.000|4:41-I0.666|2:54,,Running,,,,"Polar M430",43,0,,0,168070,250480,30378,,,,,,,,,,,,,,,,,,,,,,,,,,,,,,,,,,,,,,,,,,5,
5963386,55a9586a-5ccc-4a4e-891f-fe5c39e3d1a5,1482750179,60,1548678098,,0,0,15,3617,3633,386,388,,,1,3.5,0.7,,,406,1016,,,,,,,53.16,,1,,,,,,,,,,,,,,75,83,15.41,14.99,15.97,,,,,,,,,,,,,,,,,"0,0,0,0,3,52,41,3,0",,,,,,,150,,,,,,,,,,,,,,,,,,,,,,,,,,,,,,,,,,,,,6,10,284,100,,,0,,0,6,3,,1,0,,,,,"Sundern Laufen",,"Polar BEAT",,0,,0,168070,250480,30378,,,,,,,,,,,,,,,,,,,,,,,,,,,,,,,,,,,,,,,,,,"4,4,5,5",
5963387,,1433595463,120,1548678098,,0,0,3,0,0,,,,,0,,,,,,183,,,,,,,,,1,,,,,,,,,,,,,,0,,,,,,,,,,,,,,,,,,,,,,,,,,,,,,,,,,,,,,,,,,,,,,,,,,,,,,,,,,,,,,,,,,,,,,,,,,1,,,0,0,,,,,"3.000m Wettkampf",,"Polar BEAT",,0,,0,168070,250480,30378,,,,,,,,,,,,,,,,,,,,,,,,,,,,,,,,,,,,,,,,,,,
5963388,,1402603209,120,1548678098,,0,0,3,0,0,,,,,0,,,,,,,,,,,,,,,1,,,,,,,,,,,,,,0,,,,,,,,,,,,,,,,,,,,,,,,,,,,,,,,,,,,,,,,,,,,,,,,,,,,,,,,,,,,,,,,,,,,,,,,,,1,,,0,0,,,,,Einlaufen,,"Polar BEAT",,0,,0,168070,250480,30378,,,,,,,,,,,,,,,,,,,,,,,,,,,,,,,,,,,,,,,,,,,
5963389,a198e881-4307-4bd2-9aa4-8b0bd2e6f494,1425892739,60,1548678098,,0,0,6.63,1968,1968,102,80,,,1,1.4,0.52,,,600,453,,,,,,,39.44,,1,,,,,,,,,,,,,,40,82,12.44,12.36,12.68,,,,,,,,,,,,,,,,,"7,1,6,19,49,17,0,0,0",,,,,,,123,,,,,,,,,,,,,,,,,,,,,,,,,,,,,,,,,,,,,7,2,81,95,,1028,1,,0,9,3,,1,0,,,,,"Lauf ABC",,"Polar BEAT",,0,,0,168070,250480,30378,,,,,,,,,,,,,,,,,,,,,,,,,,,,,,,,,,,,,,,,,,5,
5963390,7e11d006-1f51-47d9-bdc3-c30db284bb4b,1533142074,120,1548678099,,0,0,7.91,2220,2221,32,32,,,1,0,0.13,1.13,0.88,,522,145,159,,,,64.66,42.6,64.98,1,,,,,,,,,,,,,,48,81,12.87,12.89,13.03,2.3,,,,,,,,,,,,,,,,"0,0,2,13,58,25,2,0,0","1,11,88,0,0",,,,,,132,,,,,,,,,,,,,,,,,,,,,,,,,,,,,,,,,,,,30.3,27,21,319,47,,,3,,0,5,3,,1,0,I1.000|4:47-I1.000|4:40-I1.000|4:32-I1.000|4:38-I1.000|4:27-I1.000|4:30-I1.000|4:46-I0.918|4:41,,Running,,,,"Polar M430",43,0,,0,168070,250480,30378,,,,,,,,,,,,,,,,,,,,,,,,,,,,,,,,,,,,,,,,,,,
5963391,0eec497d-35dc-484e-9eab-019321d02c3d,1430743927,120,1548678099,,0,0,11.02,3190,3190,311,314,,,1,4,0.71,,,536,749,,,,,,,42.01,,1,,,,,,,,,,,,,,66,82,13.27,12.77,13.87,,,,,,,,,,,,,,,,,"2,8,11,23,31,17,9,0,0",,,,,,,126,,,,,,,,,,,,,,,,,,,,,,,,,,,,,,,,,,,,,18,18,225,63,,,,,0,3,3,,1,0,,,,,"Balve Laufen",,"Polar BEAT",,0,,0,168070,250480,30378,,,,,,,,,,,,,,,,,,,,,,,,,,,,,,,,,,,,,,,,,,3,
5963392,03092725-36bb-4040-9e43-5b60d0f2d3db,1416135104,60,1548678100,,0,0,17.56,5269,5787,332,330,,,1,3.6,0.69,,,555,1173,,,,,,,41.78,,1,,,,,,,,,,,,,,109,84,12.41,12.23,12.86,,,,,,,,,,,,,,,,,"5,6,14,25,31,16,3,0,0",,,,,,,119,,,,,,,,,,,,,,,,,,,,,,,,,,,,,,,,,,,,,8,1,152,97,,1001,1,,0,6,3,,1,0,,,,,"Langsamer DL",,"Polar BEAT",,0,,0,168070,250480,30378,,,,,,,,,,,,,,,,,,,,,,,,,,,,,,,,,,,,,,,,,,"4,5,5,5",
5963393,20e44f1f-69d6-4491-81ef-c58d61310beb,1478107083,60,1548678101,,0,0,9.82,2637,2978,146,143,,,1,1.7,0.57,,,505,667,,,,,,,45.49,,1,,,,,,,,,,,,,,54,82,13.69,13.68,14.08,,,,,,,,,,,,,,,,,"3,2,4,9,20,44,16,1,0",,,,,,,136,,,,,,,,,,,,,,,,,,,,,,,,,,,,,,,,,,,,,7,6,264,83,,1021,0,,1,5,3,,1,0,,,,,"Aachen Laufen",,"Polar BEAT",,0,,0,168070,250480,30378,,,,,,,,,,,,,,,,,,,,,,,,,,,,,,,,,,,,,,,,,,5,
5963394,fcf3604f-950c-4f02-b52f-c76a4131fd26,1523556313,120,1548678101,,0,0,10.91,2846,2846,50,49,,,1,0,0.06,1.2,0.95,,769,161,177,,,,61.29,47.4,61.64,1,,,,,,,,,,,,,,95,83,13.84,13.85,13.93,13.2,,,,,,,,,,,,,,,,"0,0,0,2,22,69,6,0,0","1,15,9,76,0",,,,,,139,,,,,,,,,,,,,,,,,,,,,,,,,,,,,,,,,,,,84.5,19,5,313,46,,1000,,,0,5,3,,1,0,I1.000|4:39-I1.000|4:16-I1.000|4:19-I1.000|4:14-I1.000|4:13-I1.000|4:18-I1.000|4:22-I1.000|4:22-I1.000|4:22-I1.000|4:26-I0.916|3:58,,Running,,,,"Polar M430",43,0,,0,168070,250480,30378,,,,,,,,,,,,,,,,,,,,,,,,,,,,,,,,,,,,,,,,,,,
5963395,ed228b28-d48e-424f-93cb-1f03972c5954,1533200621,120,1548678102,,0,0,9.7,1490,1490,36,41,,,1,0,0.15,,0.58,,244,123,148,,,,,,,1,,,,,,,,,,,,,,18,,,24.63,,12.9,-3.8,122,104,,1,139,126,,,,,,,,,"8,2,31,59,0,0,0","1,98,1,0,0","86,4,0,0,10",,,,,,,,,,,,,,,,,,,,,,,,,,,,,,,,,,,,,,,,,11.8,21,6,202,88,,,2,,0,3,3,,1,0,,,Cycling,,,,"Polar M430",43,0,,0,168072,,30378,,,,,,,,,,,,,,,,,,,,,,,,,,,,,,,,,,,,,,,,,,,
5963396,bd989fda-7219-477c-ac9a-f07babba48cb,1481577747,60,1548678102,,0,0,3.33,1089,1200,52,52,,,1,1.3,0.58,,,,225,,,,,,,33.72,,1,,,,,,,,,,,,,,22,80,11.38,11.33,11.55,,,,,,,,,,,,,,,,,"18,3,12,34,33,0,0,0,0",,,,,,,115,,,,,,,,,,,,,,,,,,,,,,,,,,,,,,,,,,,,,4,4,180,88,,1027,0,,1,5,3,,1,0,,,,,"Aachen Laufen",,"Polar BEAT",,0,,0,168070,250480,30378,,,,,,,,,,,,,,,,,,,,,,,,,,,,,,,,,,,,,,,,,,,
5963397,8fa9e9ae-f067-48fc-9b90-6208130527db,1424285945,60,1548678102,,0,0,13.18,3694,3861,207,224,,,1,2.3,0.49,,,425,910,,,,,,,44.21,,1,,,,,,,,,,,,,,76,84,13.16,13.24,13.59,,,,,,,,,,,,,,,,,"6,1,6,13,29,32,12,1,0",,,,,,,127,,,,,,,,,,,,,,,,,,,,,,,,,,,,,,,,,,,,,2,7,176,90,,1038,,,1,5,3,,1,0,,,,,"Aachen Laufen",,"Polar BEAT",,0,,0,168070,250480,30378,,,,,,,,,,,,,,,,,,,,,,,,,,,,,,,,,,,,,,,,,,"4,5",
5963399,dbcb02c9-0204-49c7-a831-ec3a45df086e,1446984360,60,1548678103,,0,0,18.12,4764,4837,219,286,,,1,1.9,0.43,,,430,1233,,,,,,,48.82,,1,,,,,,,,,,,,,,98,83,13.85,14.15,14.34,,,,,,,,,,,,,,,,,"2,2,6,14,23,23,23,6,0",,,,,,,137,,,,,,,,,,,,,,,,,,,,,,,,,,,,,,,,,,,,,15,12,165,77,,1028,,,0,5,3,,1,0,,,,,"Stolberg (Rheinland) Laufen",,"Polar BEAT",,0,,0,168070,250480,30378,,,,,,,,,,,,,,,,,,,,,,,,,,,,,,,,,,,,,,,,,,5,
5963400,,1403643627,120,1548678103,,0,0,3,0,0,,,,,0,,,,,,,,,,,,,,,1,,,,,,,,,,,,,,0,,,,,,,,,,,,,,,,,,,,,,,,,,,,,,,,,,,,,,,,,,,,,,,,,,,,,,,,,,,,,,,,,,,,,,,,,,1,,,0,0,,,,,"500,500,300,200,300 - 500m 3 min pause
500m 3 min pause
200, 50 trab, 300 3 min pause
200, 50 trab, 300",,"Polar BEAT",,0,,0,168070,250480,30378,,,,,,,,,,,,,,,,,,,,,,,,,,,,,,,,,,,,,,,,,,,
5963401,249f477b-82aa-476d-b83e-c8e6da393366,1496952568,120,1548678103,,0,0,2.65,811,864,94,41,,,1,2.2,0.62,,,586,182,,,,,,,35.8,,1,,,,,,,,,,,,,,16,79,13.1,11.85,13.79,,,,,,,,,,,,,,,,,"5,3,15,28,48,0,0,0,0",,,,,,,124,,,,,,,,,,,,,,,,,,,,,,,,,,,,,,,,,,,,,23,10,218,53,,1013,0,,0,5,3,,1,0,,,,,"Aachen Laufen",,"Polar BEAT",,0,,0,168070,250480,30378,,,,,,,,,,,,,,,,,,,,,,,,,,,,,,,,,,,,,,,,,,"5,5",
5963402,583b9aff-906f-49ff-b374-de160ad54a07,1409891193,120,1548678104,,0,0,6.44,2142,2569,121,87,,,1,1.7,0.56,,,463,424,,,,,,,34.4,,1,,,,,,,,,,,,,,44,78,11.27,12,12.67,,,,,,,,,,,,,,,,,"16,2,5,22,32,20,3,0,0",,,,,,,116,,,,,,,,,,,,,,,,,,,,,,,,,,,,,,,,,,,,,16,1,140,92,,1016,0,,1,5,3,,1,0,,,,,Einlaufen,,"Polar BEAT",,0,,0,168070,250480,30378,,,,,,,,,,,,,,,,,,,,,,,,,,,,,,,,,,,,,,,,,,4,
5963403,104fb110-35f4-45df-ae58-4ca36614567d,1367409949,120,1548678105,,0,0,25,7289,7300,361,357,,,1,2.1,0.56,1.06,1.02,227,1750,149,172,,,,59.5,44.41,60.58,1,,,,,,,,,,,,,,177,,12.59,12.46,12.78,0.1,,,,,,,,,,,,,,,,"1,1,6,30,44,15,2,0,0","0,17,74,8,0",,,,,,,,,,,,,,,,,,,,,,,,,,,,,,,,,,,,,,,,,,46.5,14,8,87,59,,1022,5,,0,5,3,,1,0,,,,,,,"Polar BEAT",,0,,0,168070,250480,30378,,,,,,,,,,,,,,,,,,,,,,,,,,,,,,,,,,,,,,,,,,"5,5,5,5",
5963404,4b8923c3-77ef-4be2-88f8-d07aa0253d23,1401742957,120,1548678106,,0,0,5.4,1904,3539,94,92,,,1,1.7,0.48,,,228,357,,,,,,,31.74,,1,,,,,,,,,,,,,,39,81,10.48,10.72,11.36,,,,,,,,,,,,,,,,,"31,22,21,15,4,3,2,2,0",,,,,,,105,,,,,,,,,,,,,,,,,,,,,,,,,,,,,,,,,,,,,18,1,350,52,,1018,0,,0,3,3,,1,0,,,,,"LBL Vorkurs",,"Polar BEAT",,0,,0,168070,250480,30378,,,,,,,,,,,,,,,,,,,,,,,,,,,,,,,,,,,,,,,,,,4,
5963405,cc4679c3-d9ff-4353-b973-bae77800c071,1516297827,60,1548678106,,0,0,1.41,387,388,4,9,,,1,0,0,1.14,0.8,,76,136,152,,,,72.08,37.92,72.02,1,,,,,,,,,,,,,,6,83,12.95,13.16,13.09,-3.6,,,,,,,,,,,,,,,,"0,2,5,12,25,56,0,0,0","4,63,33,0,0",,,,,,132,,,,,,,,,,,,,,,,,,,,,,,,,,,,,,,,,,,,12.5,8,22,239,86,,1005,,,1,6,3,,1,0,I1.000|4:39-I0.410|1:49,,Running,,,,"Polar M430",43,0,,0,168070,250480,30378,,,,,,,,,,,,,,,,,,,,,,,,,,,,,,,,,,,,,,,,,,,
5963406,bf0dc698-87c7-43ae-afc6-7d2afe482f7b,1434573039,120,1548678106,,0,0,9.94,2052,2052,72,70,,,1,0,0.21,,,,672,,,,,,,61.94,,1,,,,,,,,,,,,,,42,88,17.52,17.48,17.59,,,,,,,,,,,,,,,,,"0,0,0,0,0,5,34,58,3",,,,,,,165,,,,,,,,,,,,,,,,,,,,,,,,,,,,,,,,,,,,,20,13,246,52,,1020,,,0,5,3,,1,0,,,,,"Köln Laufen",,"Polar BEAT",,0,,0,168070,250480,30378,,,,,,,,,,,,,,,,,,,,,,,,10,2052,,,0,"Unilauf Köln",,,,,,,0,0,30378,5963406,10152,,,
5963407,66bba030-5cbf-4cb8-88b7-247a27c7ad14,1521052174,60,1548678107,,0,0,11.62,2035,2068,57,43,,,1,0,0.13,1.82,,,374,129,154,,,,,,,1,,,,,,,,,,,,,,29,,,21.88,,7.3,-30.8,108,87,,1,130,112,,,,,,,,,"12,11,73,4,0,0,0","0,96,4,0,0","84,1,5,7,3",,,,,,,,,,,,,,,,,,,,,,,,,,,,,,,,,,,,,,,,,16.9,10,2,76,60,,,0,,1,5,3,,1,0,,,Cycling,,,,"Polar M430",43,0,,0,168072,,30378,,,,,,,,,,,,,,,,,,,,,,,,,,,,,,,,,,,,,,,,,,,
5963408,49b506fc-b311-4860-bb4d-36407106e354,1497109613,120,1548678107,,0,0,3.11,1063,1065,48,45,,,1,1.1,0.52,,,,212,,,,,,,31.85,,1,,,,,,,,,,,,,,22,76,10.81,11.83,11.98,,,,,,,,,,,,,,,,,"22,5,7,17,26,21,1,0,0",,,,,,,115,,,,,,,,,,,,,,,,,,,,,,,,,,,,,,,,,,,,,24,7,224,47,,1020,6,,0,5,3,,1,0,,,,,"Aachen Laufen",,"Polar BEAT",,0,,0,168070,250480,30378,,,,,,,,,,,,,,,,,,,,,,,,,,,,,,,,,,,,,,,,,,,
5963409,4535afd5-7da7-462f-a24e-4b50a94a5f7d,1392149470,60,1548678107,,0,0,3.66,1186,1256,24,51,,,1,0.9,0.56,1.17,1.03,,205,134,159,,,,59.76,34.3,59.7,1,,,,,,,,,,,,,,20,82,10.97,11.49,11.6,-7.4,,,,,,,,,,,,,,,,"12,5,14,35,20,13,0,0,0","0,75,25,0,0",,,,,,113,,,,,,,,,,,,,,,,,,,,,,,,,,,,,,,,,,,,19.9,5,12,214,77,,1003,0,,1,5,3,,1,0,,,,,Auslaufen,,"Polar BEAT",,0,,0,168070,250480,30378,,,,,,,,,,,,,,,,,,,,,,,,,,,,,,,,,,,,,,,,,,,
5963410,b17b70fc-d7da-47ab-a7d3-515e9043fe3c,1496257780,120,1548678108,,0,0,9.52,2869,3357,117,117,,,1,1,0.49,,,174,640,,,,,,,39.66,,1,,,,,,,,,,,,,,59,77,12.13,12.08,12.34,,,,,,,,,,,,,,,,,"5,5,7,24,49,10,0,0,0",,,,,,,129,,,,,,,,,,,,,,,,,,,,,,,,,,,,,,,,,,,,,22,10,347,52,,1021,,,0,5,3,,1,0,,,,,"Aachen Laufen",,"Polar BEAT",,0,,0,168070,250480,30378,,,,,,,,,,,,,,,,,,,,,,,,,,,,,,,,,,,,,,,,,,5,
5963411,02c52d56-451e-44e6-b685-ab4f11ff920f,1535878771,120,1548678109,,0,0,31.02,8724,8730,130,137,,,1,0,0.1,1.1,0.93,,2096,148,167,,,,62.77,47.03,63.08,1,,,,,,,,,,,,,,208,82,12.83,12.86,12.93,1.9,,,,,,,,,,,,,,,,"0,0,2,18,52,28,0,0,0","0,21,75,4,0",,,,,,130,,,,,,,,,,,,,,,,,,,,,,,,,,,,,,,,,,,,42.3,15,13,29,63,,1023,,,0,5,3,,1,0,I1.000|5:18-I1.000|5:05-I1.000|4:38-I1.000|4:31-I1.000|4:40-I1.000|4:30-I1.000|4:27-I1.000|4:37-I1.000|4:38-I1.000|4:34-I1.000|4:34-I1.000|4:39-I1.000|4:36-I1.000|4:26-I1.000|4:35-I1.000|4:35-I1.000|4:35-I1.000|4:43-I1.000|4:46-I1.000|4:33-I1.000|4:43-I1.000|4:38-I1.000|4:39-I1.000|4:40-I1.000|4:36-I1.000|4:26-I1.000|4:36-I1.000|4:49-I1.000|4:57-I1.000|5:03-I1.000|5:17-I0.023|0:07,,Running,,,,"Polar M430",43,0,,0,168070,250480,30378,,,,,,,,,,,,,,,,,,,,,,,,,,,,,,,,,,,,,,,,,,,
5963412,107b20ff-3994-4523-ae86-da679fbc3bb6,1519400877,60,1548678111,,0,0,10.63,1499,1499,49,37,,,1,0,0.12,2.04,,,302,140,165,,,,,,,1,,,,,,,,,,,,,,29,,,26.26,,13.8,0,146,126,,1,165,151,,,,,,,,,"4,3,17,73,3,0,0","1,50,47,2,0","75,13,0,0,11",,,,,,,,,,,,,,,,,,,,,,,,,,,,,,,,,,,,,,,,,28.9,3,25,54,47,,1017,,,0,5,3,,1,0,,,Cycling,,,,"Polar M430",43,0,,0,168072,,30378,,,,,,,,,,,,,,,,,,,,,,,,,,,,,,,,,,,,,,,,,,,
5963413,719bbf65-0ee6-42a1-82d8-5eaac95d1c03,1499121422,120,1548678111,,0,0,1.68,542,542,14,16,,,1,0,0.28,,,,116,,,,,,,32.22,,1,,,,,,,,,,,,,,11,79,11.22,11.4,11.3,,,,,,,,,,,,,,,,,"14,10,18,39,7,6,4,0,0",,,,,,,118,,,,,,,,,,,,,,,,,,,,,,,,,,,,,,,,,,,,,23,8,279,48,,1018,0,,1,3,3,,1,0,,,,,"Aix-en-Provence Laufen",,"Polar BEAT",,0,,0,168070,250480,30378,,,,,,,,,,,,,,,,,,,,,,,,,,,,,,,,,,,,,,,,,,,
5963414,,1432904131,120,1548678112,,0,0,5,0,0,,,,,0,,,,,,331,,,,,,,,,1,,,,,,,,,,,,,,0,,,,,,,,,,,,,,,,,,,,,,,,,,,,,,,,,,,,,,,,,,,,,,,,,,,,,,,,,,,,,,,,,,,,,,,,,,1,,,0,0,,,,,Laufen,,"Polar BEAT",,0,,0,168070,250480,30378,,,,,,,,,,,,,,,,,,,,,,,,,,,,,,,,,,,,,,,,,,,
5963415,70dc02b5-d938-44e8-b971-f41acd18c631,1532849293,120,1548678112,,0,0,17.49,5683,5684,69,68,,,1,0,0.07,1.05,0.92,,1123,130,157,,,,61.74,38.06,62.04,1,,,,,,,,,,,,,,87,82,11.12,11.21,11.28,-3,,,,,,,,,,,,,,,,"3,11,39,28,16,3,0,0,0","1,84,16,0,0",,,,,,113,,,,,,,,,,,,,,,,,,,,,,,,,,,,,,,,,,,,23.8,18,5,165,92,,1016,,,0,5,3,,1,0,I11.646|1:05:34-I5.841|29:13,,Running,,,,"Polar M430",43,0,,0,168070,250480,30378,,,,,,,,,,,,,,,,,,,,,,,,,,,,,,,,,,,,,,,,,,,
5963416,a8b249f2-a74d-4fd5-b72e-4c9d080af508,1519836108,60,1548678113,,0,0,10.23,2108,2187,45,45,,,1,0,0.1,0.81,0.33,,350,123,163,,,,,,,1,,,,,,,,,,,,,,28,,,23.33,,52.7,11.2,111,80,,1,147,121,,,,,,,,,"36,5,10,49,0,0,0","19,57,23,1,0","81,7,2,8,2",,,,,,,,,,,,,,,,,,,,,,,,,,,,,,,,,,,,,,,,,24.4,-3,9,67,40,,,,,0,3,3,,1,0,,,Cycling,,,,"Polar M430",43,0,,0,168072,,30378,,,,,,,,,,,,,,,,,,,,,,,,,,,,,,,,,,,,,,,,,,,
5963417,995ade3c-af26-4317-bc93-9044076b9d8d,1396989350,120,1548678113,,0,0,7.41,1984,1993,0,2,,,1,0,0.02,,,,360,156,180,,,,62.08,44.84,62.05,1,,,,,,,,,,,,,,61,83,13.51,15.94,15.97,-1.8,,,,,,,,,,,,,,,,"27,3,4,3,2,3,5,42,9","0,21,21,57,0",,,,,,135,,,,,,,,,,,,,,,,,,,,,,,,,,,,,,,,,,,,66.7,8,10,258,73,,1022,0,,1,5,3,,1,0,,,,,"4x (1000m, 200m Trab, 500m)",,"Polar BEAT",,0,,0,168070,250480,30378,,,,,,,,,,,,,,,,,,,,,,,,,,,,,,,,,,,,,,,,,,,
5963418,517b5aa7-7836-455b-a52a-16b2315495a0,1505495493,120,1548678114,,0,0,12.01,2979,2979,172,174,,,1,2.5,0.58,1.11,0.98,497,785,160,181,,,,65.82,50.61,66.97,1,,,,,,,,,,,,,,95,83,14.8,14.65,15.09,1.8,,,,,,,,,,,,,,,,"0,0,1,5,16,35,41,2,0","0,2,45,52,0",,,,,,146,,,,,,,,,,,,,,,,,,,,,,,,,,,,,,,,,,,,75.9,12,7,251,81,,1012,1,,0,6,3,,1,0,I1.000|4:30-I1.000|4:39-I1.000|4:16-I1.000|3:58-I1.000|4:15-I1.000|4:06-I1.000|3:59-I1.000|4:24-I1.000|4:03-I1.000|3:39-I1.000|3:56-I1.000|3:50-I0.016|0:04,,Running,,,,"Polar M430",43,0,,0,168070,250480,30378,,,,,,,,,,,,,,,,,,,,,,,,,,,,,,,,,,,,,,,,,,"4,5,5",
5963419,cdbfb1d3-80a7-49d7-8d1f-ba8437335367,1461427229,120,1548678115,,0,0,20.95,4402,4402,462,461,,,1,4.6,0.51,,,473,1437,,,,,,,63.97,,1,,,,,,,,,,,,,,91,86,17.73,17.2,18.47,,,,,,,,,,,,,,,,,"0,0,0,0,0,1,48,47,2",,,,,,,166,,,,,,,,,,,,,,,,,,,,,,,,,,,,,,,,,,,,,6,5,340,92,,,3,,0,6,3,,1,0,,,,,"Bad Liebenzell Laufen",,"Polar BEAT",,0,,0,168070,250480,30378,,,,,,,,,,,,,,,,,,,,,,,,21.1,4402,,,0,"DM Halbmarathon Bad Liebenzell",,,,,,,0,0,30378,5963419,3391,,"4,4,4,5,5,5",
5963420,86ed196f-6d08-4a76-9bfe-eba24bed9e1c,1344766797,120,1548678116,,0,0,70.76,9242,9396,1851,1852,,,1,5.3,0.63,,,876,2344,,,,,,,,,1,,,,,,,,,,,,,,103,,,31.23,,,,447,269,,1,591,413,,,,,,,,,"10,8,14,24,24,11,10",,"51,11,8,6,23",,,,,,,,,,,,,,,,,,,,,,,,,,,,,,,,,,,,,,,,,,19,9,123,60,,1018,3,,0,5,3,,1,0,,,,,,,"Polar BEAT",,0,,0,168072,,30378,,,,,,,,,,,,,,,,,,,,,,,,,,,,,,,,,,,,,,,,,,"4,4,4,4,4,4,4,4,4,4,4,5,5,5,5,5,5,5,5",
5963421,e7efa075-0244-43c8-8443-25590252bd35,1470421518,120,1548678117,,0,0,9.7,2856,2931,98,92,,,1,0.9,0.38,,,214,673,,,,,,,40.81,,1,,,,,,,,,,,,,,59,79,12.4,12.38,12.6,,,,,,,,,,,,,,,,,"5,2,4,23,53,12,1,0,0",,,,,,,129,,,,,,,,,,,,,,,,,,,,,,,,,,,,,,,,,,,,,19,4,258,77,,1021,,,0,5,3,,1,0,,,,,"Aachen Laufen",,"Polar BEAT",,0,,0,168070,250480,30378,,,,,,,,,,,,,,,,,,,,,,,,,,,,,,,,,,,,,,,,,,5,
5963422,a54026b0-fc22-4563-83be-63f9237b7392,1395856677,60,1548678117,,0,0,14.09,3408,3485,156,139,,,1,1.3,0.38,1.02,0.99,331,762,160,175,,,,67.9,52.72,68.94,1,,,,,,,,,,,,,,107,86,15.15,15.11,15.39,-2.6,,,,,,,,,,,,,,,,"2,1,2,2,5,32,49,6,0","0,3,37,60,0",,,,,,144,,,,,,,,,,,,,,,,,,,,,,,,,,,,,,,,,,,,69.4,8,2,70,57,,1015,0,,0,3,3,,1,0,,,,,TDL,,"Polar BEAT",,0,,0,168070,250480,30378,,,,,,,,,,,,,,,,,,,,,,,,,,,,,,,,,,,,,,,,,,5,
5963423,74b717a4-a741-46e5-ab58-0b30348de756,1432553585,120,1548678118,,0,0,5.2,1625,1625,134,134,,,1,2.4,0.73,,,335,353,,,,,,,36.58,,1,,,,,,,,,,,,,,33,83,12.2,11.7,12.66,,,,,,,,,,,,,,,,,"6,9,21,27,28,9,0,0,0",,,,,,,116,,,,,,,,,,,,,,,,,,,,,,,,,,,,,,,,,,,,,11,2,257,96,,,4,,0,9,3,,1,0,,,,,"Balve Laufen",,"Polar BEAT",,0,,0,168070,250480,30378,,,,,,,,,,,,,,,,,,,,,,,,,,,,,,,,,,,,,,,,,,4,
5963424,ef3f2398-4857-4654-8e00-341047497736,1473968377,120,1548678118,,0,0,0.65,225,225,9,12,,,1,1.1,0.69,,,,43,,,,,,,26.76,,1,,,,,,,,,,,,,,4,78,10.53,10.28,10.54,,,,,,,,,,,,,,,,,"21,33,15,14,12,4,0,0,0",,,,,,,111,,,,,,,,,,,,,,,,,,,,,,,,,,,,,,,,,,,,,21,10,240,71,,1012,0,,0,6,3,,1,0,,,,,"Aachen Laufen",,"Polar BEAT",,0,,0,168070,250480,30378,,,,,,,,,,,,,,,,,,,,,,,,,,,,,,,,,,,,,,,,,,,
5963425,a9b594c8-7c14-429e-b3ac-5714a5b5ccd5,1462306355,120,1548678118,,0,0,4.71,2224,2371,81,79,,,1,1.6,0.56,,,449,299,,,,,,,22.04,,1,,,,,,,,,,,,,,46,71,7.74,11.26,11.74,,,,,,,,,,,,,,,,,"48,4,3,8,20,8,4,2,2",,,,,,,89,,,,,,,,,,,,,,,,,,,,,,,,,,,,,,,,,,,,,10,10,315,54,,1027,,,0,3,3,,1,0,,,,,"Aachen Laufen",,"Polar BEAT",,0,,0,168070,250480,30378,,,,,,,,,,,,,,,,,,,,,,,,,,,,,,,,,,,,,,,,,,4,
5963426,bd0e3261-743c-47d4-861b-1dcd8ce5b8d5,1508610641,120,1548678119,,0,0,10.03,2942,2942,148,142,,,1,1.2,0.48,1.03,0.99,256,660,144,170,,,,61.78,41.09,62.95,1,,,,,,,,,,,,,,64,81,12.61,12.35,12.83,1.3,,,,,,,,,,,,,,,,"1,2,6,24,56,11,1,0,0","1,39,57,3,0",,,,,,126,,,,,,,,,,,,,,,,,,,,,,,,,,,,,,,,,,,,38.5,14,10,212,76,,1012,0,,1,5,3,,1,0,I1.000|4:59-I1.000|5:18-I1.000|5:05-I1.000|4:49-I1.000|4:50-I1.000|4:40-I1.000|5:01-I1.000|4:53-I1.000|4:40-I1.000|4:41-I0.029|0:08,,Running,,,,"Polar M430",43,0,,0,168070,250480,30378,,,,,,,,,,,,,,,,,,,,,,,,,,,,,,,,,,,,,,,,,,"5,5",
5963427,928b9e4d-132d-4b80-9f8a-ac49e7d39a5f,1483103253,60,1548678120,,0,0,9.21,2390,2390,96,103,,,1,0.7,0.48,,,,624,,,,,,,47.15,,1,,,,,,,,,,,,,,49,82,14.01,13.93,14.16,,,,,,,,,,,,,,,,,"0,0,0,4,21,64,12,0,0",,,,,,,141,,,,,,,,,,,,,,,,,,,,,,,,,,,,,,,,,,,,,5,5,187,68,,1037,1,,0,5,3,,1,0,,,,,"Aachen Laufen",,"Polar BEAT",,0,,0,168070,250480,30378,,,,,,,,,,,,,,,,,,,,,,,,,,,,,,,,,,,,,,,,,,,
5963428,00cc9cff-0401-42d5-996e-892d294be014,1394280611,60,1548678120,,0,0,3.23,919,919,66,70,,,1,1.6,0.62,,,463,212,,,,,,,39.6,,1,,,,,,,,,,,,,,19,82,13.04,12.72,13.55,,,,,,,,,,,,,,,,,"2,0,6,21,47,21,4,0,0",,,,,,,129,,,,,,,,,,,,,,,,,,,,,,,,,,,,,,,,,,,,,13,16,151,54,,1031,,,0,3,3,,1,0,,,,,"Einlaufen mit Lauf ABC",,"Polar BEAT",,0,,0,168070,250480,30378,,,,,,,,,,,,,,,,,,,,,,,,,,,,,,,,,,,,,,,,,,5,
5963429,2e780ba0-6243-4155-8e01-4c119d6c4967,1457375415,60,1548678120,,0,0,6.01,1359,1359,54,71,,,1,0.7,0.43,,,,408,,,,,,,54.02,,1,,,,,,,,,,,,,,28,85,15.92,16,16.08,,,,,,,,,,,,,,,,,"0,0,0,0,0,14,72,13,0",,,,,,,156,,,,,,,,,,,,,,,,,,,,,,,,,,,,,,,,,,,,,1,3,355,88,,1008,,,1,5,3,,1,0,,,,,"Aachen Laufen",,"Polar BEAT",,0,,0,168070,250480,30378,,,,,,,,,,,,,,,,,,,,,,,,,,,,,,,,,,,,,,,,,,,
5963430,a3265af2-6265-48de-8b20-331dbb5ba12f,1457949439,60,1548678120,,0,0,4.1,1187,1187,25,25,,,1,0,0.16,,,,287,,,,,,,39.47,,1,,,,,,,,,,,,,,24,84,12.51,12.56,12.66,,,,,,,,,,,,,,,,,"1,4,7,20,46,20,1,0,0",,,,,,,123,,,,,,,,,,,,,,,,,,,,,,,,,,,,,,,,,,,,,11,15,61,75,,1018,,,0,5,3,,1,0,,,,,"Benimamet Laufen",,"Polar BEAT",,0,,0,168070,250480,30378,,,,,,,,,,,,,,,,,,,,,,,,,,,,,,,,,,,,,,,,,,,
5963432,4bb2ac7b-6a1f-47b6-9e9e-5ef2fe52a4ff,1414676784,60,1548678121,,0,0,15.91,4689,4689,384,385,,,1,4.3,0.72,,,474,1073,,,,,,,42.33,,1,,,,,,,,,,,,,,97,82,12.76,12.39,13.34,,,,,,,,,,,,,,,,,"2,6,11,22,39,16,3,0,0",,,,,,,124,,,,,,,,,,,,,,,,,,,,,,,,,,,,,,,,,,,,,14,1,232,85,,,1,,0,5,3,,1,0,,,,,"Langsamer DL",,"Polar BEAT",,0,,0,168070,250480,30378,,,,,,,,,,,,,,,,,,,,,,,,,,,,,,,,,,,,,,,,,,"3,5",
5963433,f33ab587-e7fe-429f-9f95-31847f2baa97,1473803970,120,1548678121,,0,0,4.37,1401,1651,44,63,,,1,1,0.49,,,,298,,,,,,,35.12,,1,,,,,,,,,,,,,,29,82,11.32,11.61,11.64,,,,,,,,,,,,,,,,,"13,7,8,32,32,6,1,0,0",,,,,,,114,,,,,,,,,,,,,,,,,,,,,,,,,,,,,,,,,,,,,23,3,110,63,,1012,0,,1,3,3,,1,0,,,,,"Aachen Laufen",,"Polar BEAT",,0,,0,168070,250480,30378,,,,,,,,,,,,,,,,,,,,,,,,,,,,,,,,,,,,,,,,,,,
5963434,37286a3a-a704-4712-bfaa-8022d59546fe,1503336764,120,1548678122,,0,0,12.09,3129,3130,165,165,,,1,1.2,0.43,1.03,1.02,233,787,157,176,,,,64.16,48.19,65.24,1,,,,,,,,,,,,,,95,81,14.23,14.02,14.43,9.2,,,,,,,,,,,,,,,,"0,1,1,6,23,46,23,0,0","1,16,31,52,0",,,,,,143,,,,,,,,,,,,,,,,,,,,,,,,,,,,,,,,,,,,73.2,20,3,252,59,,1023,2,,0,5,3,,1,0,I1.000|4:41-I1.000|4:36-I1.000|4:14-I1.000|4:11-I1.000|4:03-I1.000|4:20-I1.000|4:01-I1.000|4:33-I1.000|4:23-I1.000|4:21-I1.000|4:08-I1.000|4:13-I0.089|0:27,,Running,,,,"Polar M430",43,0,,0,168070,250480,30378,,,,,,,,,,,,,,,,,,,,,,,,,,,,,,,,,,,,,,,,,,"5,5",
5963435,0186ae81-7ca2-4443-a5d5-b424ba33676e,1501015037,120,1548678122,,0,0,10.64,2958,2971,0,0,,,1,0,0,,,,679,,,,,,,43.93,,1,,,,,,,,,,,,,,61,82,12.97,14.35,14.4,,,,,,,,,,,,,,,,,"27,1,1,2,2,5,59,4,0",,,,,,,132,,,,,,,,,,,,,,,,,,,,,,,,,,,,,,,,,,,,,15,10,294,93,,1010,0,,0,6,3,,1,0,,,,,,,"Polar BEAT",,0,,0,168070,250480,30378,,,,,,,,,,,,,,,,,,,,,,,,,,,,,,,,,,,,,,,,,,,
5963436,3048d769-f930-428a-88be-8b473d780512,1400942653,120,1548678123,,0,0,3.39,1015,1070,25,57,,,1,0.7,0.52,,,,228,,,,,,,37.45,,1,,,,,,,,,,,,,,21,82,11.9,12.2,12.08,,,,,,,,,,,,,,,,,"4,2,10,26,44,9,4,0,0",,,,,,,122,,,,,,,,,,,,,,,,,,,,,,,,,,,,,,,,,,,,,17,10,202,52,,1016,5,,0,5,3,,1,0,,,,,Auslaufen,,"Polar BEAT",,0,,0,168070,250480,30378,,,,,,,,,,,,,,,,,,,,,,,,,,,,,,,,,,,,,,,,,,,
5963438,5969bfb4-d236-4215-841f-407e1590e08b,1407960266,120,1548678124,,0,0,15.78,4323,4370,201,226,,,1,2,0.55,,,780,1053,,,,,,,46.04,,1,,,,,,,,,,,,,,89,82,13.32,13.55,13.88,,,,,,,,,,,,,,,,,"4,1,1,9,30,44,9,2,0",,,,,,,134,,,,,,,,,,,,,,,,,,,,,,,,,,,,,,,,,,,,,18,4,277,70,,1007,0,,0,5,3,,1,0,,,,,"Lockerer DL",,"Polar BEAT",,0,,0,168070,250480,30378,,,,,,,,,,,,,,,,,,,,,,,,,,,,,,,,,,,,,,,,,,4,
5963440,6ef23c74-4d0b-432b-8d7b-93356c772502,1547661396,60,1548678126,,0,0,20.02,4674,4674,96,96,,,1,0,0.13,1.09,0.91,,1361,166,179,,,,67.21,56.44,67.61,1,,,,,,,,,,,,,,169,84,15.47,15.45,15.55,2,,,,,,,,,,,,,,,,"0,0,0,0,0,27,71,2,0","0,1,25,74,0",,,,,,153,,,,,,,,,,,,,,,,,,,,,,,,,,,,,,,,,,,,98.1,4,8,186,75,,1010,0,288,1,5,3,,1,0,I6.661|26:40-I6.662|25:58-I6.675|25:13-I0.022|0:05,,Running,,Gt5,,"Polar M430",43,0,,0,168070,250480,30378,,,,,,,,,,,,,,,,,,,,,,,,,,,,,,,,,,,,,,,,,,,
5963442,354e4d73-f00f-43a9-9771-2fd9cebe0158,1461493574,120,1548678127,,0,0,4.82,1561,1561,73,73,,,1,1.8,0.67,,,247,338,,,,,,,34.91,,1,,,,,,,,,,,,,,32,82,11.33,11.29,11.6,,,,,,,,,,,,,,,,,"6,6,34,38,13,3,1,0,0",,,,,,,113,,,,,,,,,,,,,,,,,,,,,,,,,,,,,,,,,,,,,4,7,270,79,,,3,,0,5,3,,1,0,,,,,"Balve Laufen",,"Polar BEAT",,0,,0,168070,250480,30378,,,,,,,,,,,,,,,,,,,,,,,,,,,,,,,,,,,,,,,,,,4,
5963443,16d3fe31-488b-442b-861d-77d204359eaa,1415006901,60,1548678127,,0,0,5.54,1681,2094,72,73,,,1,1.1,0.36,,,316,370,,,,,,,38.02,,1,,,,,,,,,,,,,,34,82,12,12.35,13.15,,,,,,,,,,,,,,,,,"11,8,13,20,26,11,6,3,0",,,,,,,121,,,,,,,,,,,,,,,,,,,,,,,,,,,,,,,,,,,,,13,10,199,79,,1004,0,,0,5,3,,1,0,,,,,"Auslaufen + Dehnen",,"Polar BEAT",,0,,0,168070,250480,30378,,,,,,,,,,,,,,,,,,,,,,,,,,,,,,,,,,,,,,,,,,5,
5963444,347093ca-0ce1-4c9f-b0f1-4aee7697deeb,1504731135,120,1548678127,,0,0,5.62,1704,1705,61,73,,,1,0.7,0.5,1.03,1.05,,376,143,168,,,,59.83,38.09,60.48,1,,,,,,,,,,,,,,36,79,11.98,12.06,12.25,4.5,,,,,,,,,,,,,,,,"4,5,13,32,30,15,1,0,0","1,39,45,14,0",,,,,,125,,,,,,,,,,,,,,,,,,,,,,,,,,,,,,,,,,,,37.7,14,5,252,70,,1019,0,,1,5,3,,1,0,I1.742|9:05-I2.320|11:02-I1.562|8:18,,Running,,,,"Polar M430",43,0,,0,168070,250480,30378,,,,,,,,,,,,,,,,,,,,,,,,,,,,,,,,,,,,,,,,,,,
5963445,15515d84-bb07-48e9-bfe1-6f1f29b75662,1546507826,60,1548678128,,0,0,20.54,5512,5520,489,489,,,1,4.5,0.84,1.09,0.99,512,1404,154,170,,,,63.03,48.16,64.89,1,,,,,,,,,,,,,,152,83,14.13,13.76,14.38,1.9,,,,,,,,,,,,,,,,"2,2,4,20,21,24,25,2,0","0,11,62,27,0",,,,,,135,,,,,,,,,,,,,,,,,,,,,,,,,,,,,,,,,,,,55.2,-1,7,251,84,,1038,0,302,0,5,3,,1,0,I1.000|5:41-I1.000|4:09-I1.000|4:12-I1.000|5:07-I1.000|4:36-I1.000|4:02-I1.000|4:31-I1.000|4:40-I1.000|4:39-I1.000|5:06-I1.000|5:09-I1.000|4:58-I1.000|5:26-I1.000|4:14-I1.000|3:55-I1.000|3:43-I1.000|3:46-I1.000|3:50-I1.000|4:19-I1.000|3:48-I0.546|2:10,,Running,,,,"Polar M430",43,0,,0,168070,250480,30378,,,,,,,,,,,,,,,,,,,,,,,,,,,,,,,,,,,,,,,,,,"3,4,5",
5963446,b4adf184-d169-42d4-b544-714c3d366227,1515180055,60,1548678128,,0,0,11.2,2040,2134,56,42,,,1,0,0.09,1.89,,,260,110,129,,,,,,,1,,,,,,,,,,,,,,17,,,21.58,,13.8,-34.9,103,83,,1,121,106,,,,,,,,,"13,22,59,6,0,0,0","15,85,0,0,0","85,0,8,6,2",,,,,,,,,,,,,,,,,,,,,,,,,,,,,,,,,,,,,,,,,6.9,9,4,212,91,,1002,0,,1,5,3,,1,0,,,Cycling,,,,"Polar M430",43,0,,0,168072,,30378,,,,,,,,,,,,,,,,,,,,,,,,,,,,,,,,,,,,,,,,,,,
5963447,f78cb989-9399-4a26-b70d-937f24d88bc5,1407681350,120,1548678129,,0,0,14.21,3695,3710,156,167,,,1,1.1,0.5,0.99,1.01,441,630,140,162,,,,74.35,48.51,75.3,1,,,,,,,,,,,,,,73,83,14.01,14.03,14.23,1.1,,,,,,,,,,,,,,,,"0,1,2,9,20,49,17,1,0","0,53,46,1,0",,,,,,139,,,,,,,,,,,,,,,,,,,,,,,,,,,,,,,,,,,,32.2,21,12,186,81,,1005,5,,0,5,3,,1,0,,,,,"Lockerer DL",,"Polar BEAT",,0,,0,168070,250480,30378,,,,,,,,,,,,,,,,,,,,,,,,,,,,,,,,,,,,,,,,,,5,
5963448,037f6bb2-eaf5-4030-8958-76dd266bce5a,1527526707,120,1548678130,,0,0,12.12,3307,3309,44,45,,,1,0,0.13,1.06,0.88,,807,152,175,,,,62.86,45.32,63.14,1,,,,,,,,,,,,,,87,83,13.25,13.53,13.61,8,,,,,,,,,,,,,,,,"2,4,9,14,22,30,18,2,0","1,8,81,10,0",,,,,,132,,,,,,,,,,,,,,,,,,,,,,,,,,,,,,,,,,,,54.5,27,13,63,55,,1014,,,0,4,3,,1,0,I1.000|4:45-I1.000|4:24-I1.000|4:08-I1.000|4:28-I1.000|4:25-I1.000|4:41-I1.000|4:38-I1.000|4:08-I1.000|4:05-I1.000|3:45-I1.000|5:34-I1.000|5:32-I0.119|0:38,,Running,,,,"Polar M430",43,0,,0,168070,250480,30378,,,,,,,,,,,,,,,,,,,,,,,,,,,,,,,,,,,,,,,,,,,
5963449,b5e35d49-db9e-43e6-9faa-85aef8e7237b,1538128705,120,1548678130,,0,0,10.72,1805,1807,30,37,,,1,0,0.13,,0.55,,345,130,150,,,,,,,1,,,,,,,,,,,,,,28,,,22.64,,19.7,-3.6,102,87,,1,121,111,,,,,,,,,"10,13,54,24,0,0,0","5,58,37,0,0","91,0,0,0,9",,,,,,,,,,,,,,,,,,,,,,,,,,,,,,,,,,,,,,,,,21.7,14,5,210,82,,,,,0,3,3,,1,0,,,Cycling,,,,"Polar M430",43,0,,0,168072,,30378,,,,,,,,,,,,,,,,,,,,,,,,,,,,,,,,,,,,,,,,,,,
5963450,eb962900-7e2c-4115-9344-08dd6e8dac2b,1423316703,60,1548678130,,0,0,3.25,956,978,66,63,,,1,1.6,0.56,,,482,215,,,,,,,38.11,,1,,,,,,,,,,,,,,19,84,12.57,12.56,13.68,,,,,,,,,,,,,,,,,"8,2,4,24,34,24,3,0,0",,,,,,,121,,,,,,,,,,,,,,,,,,,,,,,,,,,,,,,,,,,,,2,10,20,57,,1032,,,0,3,3,,1,0,,,,,"Aachen Laufen",,"Polar BEAT",,0,,0,168070,250480,30378,,,,,,,,,,,,,,,,,,,,,,,,,,,,,,,,,,,,,,,,,,4,
5963451,6dbd36d1-88dd-4348-8b2e-621b1633fbb2,1547625625,60,1548678131,,0,0,9.7,1702,1740,36,41,,,1,0,0.13,,0.48,,278,118,130,,,,,,,1,,,,,,,,,,,,,,17,,,21.67,,12.5,-20.3,98,83,,1,116,106,,,,,,,,,"9,4,87,0,0,0,0","0,100,0,0,0","90,0,0,0,9",,,,,,,,,,,,,,,,,,,,,,,,,,,,,,,,,,,,,,,,,6.7,1,11,221,93,,1017,0,291,0,5,3,,1,0,,,Cycling,,,,"Polar M430",43,0,,0,168072,,30378,,,,,,,,,,,,,,,,,,,,,,,,,,,,,,,,,,,,,,,,,,,
5963452,4711c3a9-37c9-4db1-a648-76ea9630c1f2,1395257311,60,1548678131,,0,0,5,1249,1249,54,29,,,1,0,0.23,1.07,0.85,,265,155,173,,,,68.25,47.53,69.59,1,,,,,,,,,,,,,,35,85,14.73,14.61,15.01,-8.5,,,,,,,,,,,,,,,,"3,0,2,1,12,33,49,0,0","0,6,65,29,0",,,,,,141,,,,,,,,,,,,,,,,,,,,,,,,,,,,,,,,,,,,40.3,12,10,236,66,,1024,0,,1,5,3,,1,0,,,,,"Zügiger DL",,"Polar BEAT",,0,,0,168070,250480,30378,,,,,,,,,,,,,,,,,,,,,,,,,,,,,,,,,,,,,,,,,,,
5963453,7dd87e4d-6c2d-421e-b2f4-00f1258c0bf3,1491762752,120,1548678132,,0,0,2.29,835,953,10,4,,,1,0,0,,,,95,,,,,,,,,1,,,,,,,,,,,,,,9,,,11.86,,,,35,34,,1,45,44,,,,,,,,,"81,17,2,0,0,0,0",,"97,0,0,0,3",,,,,,,,,,,,,,,,,,,,,,,,,,,,,,,,,,,,,,,,,,23,1,0,33,,,,,0,3,3,,1,0,,,,,"Karlsruhe Radfahren",,"Polar BEAT",,0,,0,168072,,30378,,,,,,,,,,,,,,,,,,,,,,,,,,,,,,,,,,,,,,,,,,,
5963454,d554830b-8f6f-40e4-bf46-b9236ecfe202,1543664249,60,1548678132,,0,0,2.06,692,692,12,9,,,1,0,0.02,1.17,0.9,,152,139,148,,,,54.65,31.41,55.14,1,,,,,,,,,,,,,,13,83,10.8,10.78,10.89,-4.1,,,,,,,,,,,,,,,,"5,12,42,34,7,0,0,0,0","2,43,54,0,0",,,,,,108,,,,,,,,,,,,,,,,,,,,,,,,,,,,,,,,,,,,19,9,15,211,86,,1019,1,289,0,5,3,,1,0,I1.000|5:50-I1.000|5:24-I0.060|0:19,,Running,,,,"Polar M430",43,0,,0,168070,250480,30378,,,,,,,,,,,,,,,,,,,,,,,,,,,,,,,,,,,,,,,,,,,
5963455,91328d4c-a9b8-4f7e-ba9a-aaa44d40ffec,1446666198,60,1548678132,,0,0,10,2447,2448,88,97,,,1,0.5,0.35,,,,676,,,,,,,50.78,,1,,,,,,,,,,,,,,50,84,14.8,14.86,14.97,,,,,,,,,,,,,,,,,"1,0,0,2,11,42,37,7,0",,,,,,,146,,,,,,,,,,,,,,,,,,,,,,,,,,,,,,,,,,,,,13,11,194,89,,1019,,,1,5,3,,1,0,,,,,"Aachen Laufen",,"Polar BEAT",,0,,0,168070,250480,30378,,,,,,,,,,,,,,,,,,,,,,,,,,,,,,,,,,,,,,,,,,,
5963456,c5a949db-1dc1-4edb-bc25-053168e29a32,1478852066,60,1548678133,,0,0,13.47,3949,3990,205,200,,,1,2.5,0.64,,,328,911,,,,,,,42.03,,1,,,,,,,,,,,,,,82,81,12.58,12.67,13.02,,,,,,,,,,,,,,,,,"5,2,3,13,51,25,1,1,0",,,,,,,126,,,,,,,,,,,,,,,,,,,,,,,,,,,,,,,,,,,,,3,7,335,98,,,0,,0,6,3,,1,0,,,,,"Aachen Laufen",,"Polar BEAT",,0,,0,168070,250480,30378,,,,,,,,,,,,,,,,,,,,,,,,,,,,,,,,,,,,,,,,,,"4,5",
5963457,440f2769-d733-40d9-b97b-aab1e4a6bd96,1447182908,60,1548678133,,0,0,2.15,658,658,20,20,,,1,0.8,0.53,,,,148,,,,,,,35.11,,1,,,,,,,,,,,,,,13,81,11.89,11.83,11.98,,,,,,,,,,,,,,,,,"0,4,16,48,27,4,0,0,0",,,,,,,121,,,,,,,,,,,,,,,,,,,,,,,,,,,,,,,,,,,,,12,18,225,92,,1026,,,1,4,3,,1,0,,,,,"Aachen Laufen",,"Polar BEAT",,0,,0,168070,250480,30378,,,,,,,,,,,,,,,,,,,,,,,,,,,,,,,,,,,,,,,,,,,
5963458,534d6d52-d714-4048-a73d-20444bf8fa8f,1435696302,120,1548678133,,0,0,6.73,1965,2101,0,1,,,1,0,0,,,,408,,,,,,,40.26,,1,,,,,,,,,,,,,,40,78,12.32,15.51,15.58,,,,,,,,,,,,,,,,,"39,1,1,1,1,2,5,42,8",,,,,,,132,,,,,,,,,,,,,,,,,,,,,,,,,,,,,,,,,,,,,26,10,71,35,,1018,,,0,3,3,,1,0,,,,,"Aachen Laufen",,"Polar BEAT",,0,,0,168070,250480,30378,,,,,,,,,,,,,,,,,,,,,,,,,,,,,,,,,,,,,,,,,,,
5963459,4ed19f18-d2ad-4328-a97b-492a91801aae,1532027959,120,1548678134,,0,0,11.47,3803,3803,164,168,,,1,1.7,0.56,1.11,0.94,270,841,140,167,,,,55.04,35.95,55.99,1,,,,,,,,,,,,,,75,81,11.11,10.98,11.46,-1.8,,,,,,,,,,,,,,,,"7,15,40,27,6,5,1,0,0","0,46,51,2,0",,,,,,112,,,,,,,,,,,,,,,,,,,,,,,,,,,,,,,,,,,,32.9,25,7,47,35,,1017,,,0,3,3,,1,0,I6.741|37:30-I0.242|1:00-I0.153|1:01-I0.243|1:01-I0.142|1:02-I0.258|1:01-I3.687|20:50,,Running,,,,"Polar M430",43,0,,0,168070,250480,30378,,,,,,,,,,,,,,,,,,,,,,,,,,,,,,,,,,,,,,,,,,"4,4",
5963460,d6d56295-4b0d-45db-80d4-7c76123e5eb8,1376138215,120,1548678134,,0,0,2.14,509,509,74,52,,,1,1.1,0.34,,,1142,144,,,,,,,46.69,,1,,,,,,,,,,,,,,10,,16.01,15.13,16.3,,,,,,,,,,,,,,,,,"0,0,0,0,0,39,61,0,0",,,,,,,,,,,,,,,,,,,,,,,,,,,,,,,,,,,,,,,,,,,,20,12,253,69,,,5,,0,5,3,,1,0,,,,,,,"Polar BEAT",,0,,0,168070,250480,30378,,,,,,,,,,,,,,,,,,,,,,,,,,,,,,,,,,,,,,,,,,5,
5963461,9d4b3eaa-345d-4d12-8662-9fd297a4f4f2,1448367982,60,1548678135,,0,0,12.32,3239,3424,265,259,,,1,3,0.61,,,453,838,,,,,,,47.38,,1,,,,,,,,,,,,,,67,82,14.18,13.81,14.59,,,,,,,,,,,,,,,,,"2,1,2,3,23,57,12,0,0",,,,,,,139,,,,,,,,,,,,,,,,,,,,,,,,,,,,,,,,,,,,,3,24,193,73,,1014,,,0,6,3,,1,0,,,,,"Balve Laufen",,"Polar BEAT",,0,,0,168070,250480,30378,,,,,,,,,,,,,,,,,,,,,,,,,,,,,,,,,,,,,,,,,,"4,4",
5963462,f66ef586-53b1-4042-9dee-c410962c9bf3,1404851713,120,1548678135,,0,0,8.8,2092,2150,1,0,,,1,0,0,,,,566,,,,,,,52.1,,1,,,,,,,,,,,,,,43,86,15.15,16.71,16.72,,,,,,,,,,,,,,,,,"18,3,7,3,3,2,4,56,4",,,,,,,147,,,,,,,,,,,,,,,,,,,,,,,,,,,,,,,,,,,,,12,8,306,99,,1013,0,,0,6,3,,1,0,,,,,"1000,2000,1000,2000,1000",,"Polar BEAT",,0,,0,168070,250480,30378,,,,,,,,,,,,,,,,,,,,,,,,,,,,,,,,,,,,,,,,,,,
5963463,3aeb85e0-a377-4272-8fde-23d2deba6978,1517389589,60,1548678136,,0,0,12.13,1786,1786,24,34,,,1,0,0.05,,,,334,130,147,,,,,,,1,,,,,,,,,,,,,,27,,,25.32,,-1.9,-17.5,123,106,,1,136,122,,,,,,,,,"8,6,20,66,0,0,0","2,83,15,0,0","78,12,0,1,9",,,,,,,,,,,,,,,,,,,,,,,,,,,,,,,,,,,,,,,,,18.3,8,6,203,82,,,0,,0,5,3,,1,0,I2.135|6:45-I9.998|23:27,,Cycling,,,,"Polar M430",43,0,,0,168072,,30378,,,,,,,,,,,,,,,,,,,,,,,,,,,,,,,,,,,,,,,,,,,
5963464,a56d2230-2c14-4f9e-89dd-5cea25f41fb5,1516005957,60,1548678136,,0,0,11.5,1934,1942,36,44,,,1,0,0.09,,,,328,124,155,,,,,,,1,,,,,,,,,,,,,,26,,,23.65,,10.3,-10.7,109,90,,1,125,113,,,,,,,,,"15,11,28,46,0,0,0","7,83,10,0,0","89,3,0,0,8",,,,,,,,,,,,,,,,,,,,,,,,,,,,,,,,,,,,,,,,,17.5,0,2,190,89,,,0,,0,5,3,,1,0,,,Cycling,,,,"Polar M430",43,0,,0,168072,,30378,,,,,,,,,,,,,,,,,,,,,,,,,,,,,,,,,,,,,,,,,,,
5963465,41976846-26ec-45fd-91ca-5b44ad755c82,1406385054,120,1548678137,,0,0,3.45,1122,1132,24,56,,,1,0.6,0.47,,,,232,,,,,,,34.02,,1,,,,,,,,,,,,,,23,83,10.92,11.16,11.15,,,,,,,,,,,,,,,,,"3,8,30,47,12,0,0,0,0",,,,,,,111,,,,,,,,,,,,,,,,,,,,,,,,,,,,,,,,,,,,,23,4,298,64,,1014,5,,0,5,3,,1,0,,,,,Auslaufen,,"Polar BEAT",,0,,0,168070,250480,30378,,,,,,,,,,,,,,,,,,,,,,,,,,,,,,,,,,,,,,,,,,,
5963466,90f6b706-f049-4c01-b9c6-0bf4e77ae874,1416336383,60,1548678138,,0,0,5.79,1876,2213,82,60,,,1,1.1,0.51,,,,394,,,,,,,35.26,,1,,,,,,,,,,,,,,38,81,11.38,11.44,11.78,,,,,,,,,,,,,,,,,"6,7,16,41,27,3,0,0,0",,,,,,,114,,,,,,,,,,,,,,,,,,,,,,,,,,,,,,,,,,,,,8,8,18,94,,1011,,,1,4,3,,1,0,,,,,Einlaufen,,"Polar BEAT",,0,,0,168070,250480,30378,,,,,,,,,,,,,,,,,,,,,,,,,,,,,,,,,,,,,,,,,,,
5963467,c5b57fd0-7274-43c5-92d8-3326dfa7be4e,1426422640,60,1548678139,,0,0,20.06,4485,4485,254,254,,,1,2,0.54,,,374,1353,,,,,,,59.34,,1,,,,,,,,,,,,,,93,88,16.43,16.21,16.55,,,,,,,,,,,,,,,,,"0,0,0,0,1,21,56,23,0",,,,,,,152,,,,,,,,,,,,,,,,,,,,,,,,,,,,,,,,,,,,,5,7,78,85,,1026,3,,0,5,3,,1,0,,,,,"Eschweiler Laufen",,"Polar BEAT",,0,,0,168070,250480,30378,,,,,,,,,,,,,,,,,,,,,,,,,,,,,,,,,,,,,,,,,,"5,5",
5963468,67633d91-7b33-4582-aced-a5079ce63ce5,1400427025,120,1548678140,,0,0,2.85,1172,1178,4,5,,,1,0,0,,,,189,,,,,,,25.36,,1,,,,,,,,,,,,,,24,78,8.8,10.74,10.82,,,,,,,,,,,,,,,,,"28,3,10,37,19,3,0,0,0",,,,,,,94,,,,,,,,,,,,,,,,,,,,,,,,,,,,,,,,,,,,,21,5,81,48,,1013,5,,0,5,3,,1,0,,,,,Einlaufen,,"Polar BEAT",,0,,0,168070,250480,30378,,,,,,,,,,,,,,,,,,,,,,,,,,,,,,,,,,,,,,,,,,,
5963469,09dc2625-48b5-4b1d-b8e4-e9e190cb2cbb,1403555843,120,1548678140,,0,0,2.06,629,639,18,16,,,1,0.2,0.29,,,,136,,,,,,,35.05,,1,,,,,,,,,,,,,,13,81,12.05,11.9,12.18,,,,,,,,,,,,,,,,,"5,13,13,17,36,16,0,0,0",,,,,,,121,,,,,,,,,,,,,,,,,,,,,,,,,,,,,,,,,,,,,19,5,52,58,,1020,0,,0,3,3,,1,0,,,,,Einlaufen,,"Polar BEAT",,0,,0,168070,250480,30378,,,,,,,,,,,,,,,,,,,,,,,,,,,,,,,,,,,,,,,,,,,
5963470,10cb5d84-b4b2-4122-a894-701083f13d61,1500379681,120,1548678140,,0,0,3.02,958,974,23,32,,,1,0.2,0.33,,,,207,,,,,,,34.7,,1,,,,,,,,,,,,,,19,78,11.42,11.43,11.52,,,,,,,,,,,,,,,,,"5,4,13,56,22,0,0,0,0",,,,,,,121,,,,,,,,,,,,,,,,,,,,,,,,,,,,,,,,,,,,,29,9,177,34,,1019,9,,0,3,3,,1,0,,,,,"Aix-en-Provence Laufen",,"Polar BEAT",,0,,0,168070,250480,30378,,,,,,,,,,,,,,,,,,,,,,,,,,,,,,,,,,,,,,,,,,,
5963471,a22ebbe8-baee-437a-98e2-a4e6f540184b,1472493323,120,1548678141,,0,0,20,5301,5694,279,273,,,1,2.6,0.48,,,716,1376,,,,,,,48.75,,1,,,,,,,,,,,,,,110,81,13.84,13.87,14.37,,,,,,,,,,,,,,,,,"4,1,2,9,17,50,18,1,0",,,,,,,140,,,,,,,,,,,,,,,,,,,,,,,,,,,,,,,,,,,,,20,3,244,79,,1022,1,,0,5,3,,1,0,,,,,"Aachen Laufen",,"Polar BEAT",,0,,0,168070,250480,30378,,,,,,,,,,,,,,,,,,,,,,,,,,,,,,,,,,,,,,,,,,4,
5963472,112c1d21-0310-450a-adc0-3f95bec7d7a5,1401324780,120,1548678142,1707427418,0,1,5,939,939,2,0,,,1,0,0,,,,326,,,,,,,66.26,,1,,,,,,,,,,,,,,19,90,19.61,19.56,19.61,,,,,,,,,,,,,,,,,"0,0,0,0,0,0,0,82,18",,,,,,,177,,,,,,,,,,,,,,,,,,,,,,,,,,,,,,,,,,,,,13,1,112,79,,,0,,1,5,3,,1,0,,,,,"WK 5.000m Koblenz",,"Polar BEAT",,0,,0,168070,250480,30378,,,,,,,,,,,,,,,,,,,,,,,,5,939,,,0,,,,,,,,0,0,30378,5963472,,,,
5963473,14158adf-d0f7-45f8-a073-5263e3322014,1477819426,60,1548678142,,0,0,4.02,1219,1254,102,102,,,1,2.2,0.6,,,905,281,,,,,,,37.32,,1,,,,,,,,,,,,,,25,80,12.7,12.1,13.16,,,,,,,,,,,,,,,,,"7,13,6,18,40,15,0,0,0",,,,,,,124,,,,,,,,,,,,,,,,,,,,,,,,,,,,,,,,,,,,,6,1,178,97,,,0,,0,5,3,,1,0,,,,,"Balve Laufen",,"Polar BEAT",,0,,0,168070,250480,30378,,,,,,,,,,,,,,,,,,,,,,,,,,,,,,,,,,,,,,,,,,4,
5963474,4851c026-470a-4990-a946-bd97a43c17dd,1402751622,120,1548678142,,0,0,3.3,950,950,61,60,,,1,1.6,0.63,,,428,217,,,,,,,39.13,,1,,,,,,,,,,,,,,19,83,12.89,12.61,13.3,,,,,,,,,,,,,,,,,"1,2,11,30,24,25,7,0,0",,,,,,,126,,,,,,,,,,,,,,,,,,,,,,,,,,,,,,,,,,,,,16,5,348,67,,1022,5,,0,5,3,,1,0,,,,,Einlaufen,,"Polar BEAT",,0,,0,168070,250480,30378,,,,,,,,,,,,,,,,,,,,,,,,,,,,,,,,,,,,,,,,,,5,
5963475,9ee7606b-acf4-45e9-95f2-8de29129f34c,1460309046,120,1548678143,,0,0,21.68,5945,7674,308,309,,,1,2.7,0.55,,,478,1498,,,,,,,47.17,,1,,,,,,,,,,,,,,123,83,13.44,13.45,13.79,,,,,,,,,,,,,,,,,"5,2,4,12,27,34,14,2,0",,,,,,,132,,,,,,,,,,,,,,,,,,,,,,,,,,,,,,,,,,,,,17,9,98,46,,1009,2,,0,5,3,,1,0,,,,,"Aachen Laufen",,"Polar BEAT",,0,,0,168070,250480,30378,,,,,,,,,,,,,,,,,,,,,,,,,,,,,,,,,,,,,,,,,,"4,5",
5963476,0d3e1ff2-3e74-441d-bb27-aea2f9c7dfe9,1509217994,120,1548678144,,0,0,5.77,1508,1508,13,12,,,1,0,0.03,,,,334,143,159,,,,71.91,45.46,72.13,1,,,,,,,,,,,,,,32,81,13.81,13.8,13.85,10.9,,,,,,,,,,,,,,,,"0,0,0,3,20,75,2,0,0","0,27,73,0,0",,,,,,142,,,,,,,,,,,,,,,,,,,,,,,,,,,,,,,,,,,,35.5,11,12,216,69,,,0,,1,5,3,,1,0,I1.000|4:31-I1.000|4:21-I1.000|4:26-I1.000|4:16-I1.000|4:10-I0.771|3:25,,Running,,,,"Polar M430",43,0,,0,168070,250480,30378,,,,,,,,,,,,,,,,,,,,,,,,,,,,,,,,,,,,,,,,,,,
5963477,7618a949-a479-4ffc-b4f4-91053ffe5e43,1529236290,120,1548678144,,0,0,7.89,2709,2709,29,32,,,1,0,0.08,1.14,0.89,,580,137,152,,,,54.16,33.57,54.38,1,,,,,,,,,,,,,,48,79,10.5,10.61,10.69,0.9,,,,,,,,,,,,,,,,"9,25,38,20,6,2,0,0,0","1,80,19,0,0",,,,,,111,,,,,,,,,,,,,,,,,,,,,,,,,,,,,,,,,,,,21.1,21,9,259,60,,,,,0,3,3,,1,0,I1.000|6:11-I1.000|5:32-I1.000|5:32-I1.000|5:29-I1.000|6:14-I1.000|5:54-I1.000|5:26-I0.893|4:51,,Running,,,,"Polar M430",43,0,,0,168070,250480,30378,,,,,,,,,,,,,,,,,,,,,,,,,,,,,,,,,,,,,,,,,,,
5963478,7a9ebac0-c851-4434-b589-98a1605d7c0e,1448482036,60,1548678145,,0,0,16.38,4531,4681,217,215,,,1,2.2,0.52,,,363,1128,,,,,,,45.66,,1,,,,,,,,,,,,,,94,82,13.25,13.18,13.44,,,,,,,,,,,,,,,,,"3,2,3,8,39,42,4,0,0",,,,,,,132,,,,,,,,,,,,,,,,,,,,,,,,,,,,,,,,,,,,,4,10,282,95,,1009,,,1,5,3,,1,0,,,,,"Aachen Laufen",,"Polar BEAT",,0,,0,168070,250480,30378,,,,,,,,,,,,,,,,,,,,,,,,,,,,,,,,,,,,,,,,,,"4,5",
5963479,c7b322c9-0cb9-470e-9740-c02f753c8974,1396808143,120,1548678146,,0,0,22.9,6313,6351,365,377,,,1,2.7,0.62,,,350,1533,,,,,,,47.08,,1,,,,,,,,,,,,,,131,82,13.35,13.19,13.64,,,,,,,,,,,,,,,,,"1,1,3,12,36,44,3,0,0",,,,,,,133,,,,,,,,,,,,,,,,,,,,,,,,,,,,,,,,,,,,,17,16,217,64,,1017,,,0,5,3,,1,0,,,,,"Langer lockerer DL ",,"Polar BEAT",,0,,0,168070,250480,30378,,,,,,,,,,,,,,,,,,,,,,,,,,,,,,,,,,,,,,,,,,"4,5",
5963480,323d7b7d-7998-4b4f-9f04-cd824b5f8b8c,1481271695,60,1548678146,,0,0,12.62,3736,3895,180,184,,,1,2,0.58,,,380,868,,,,,,,41.34,,1,,,,,,,,,,,,,,77,81,12.38,12.27,12.59,,,,,,,,,,,,,,,,,"2,3,3,31,50,10,0,0,0",,,,,,,125,,,,,,,,,,,,,,,,,,,,,,,,,,,,,,,,,,,,,8,12,215,86,,1030,,,0,5,3,,1,0,,,,,"Aachen Laufen",,"Polar BEAT",,0,,0,168070,250480,30378,,,,,,,,,,,,,,,,,,,,,,,,,,,,,,,,,,,,,,,,,,4,
5963481,51e75fea-8d0f-47d6-9ab0-3aa098b4407d,1443645575,120,1548678147,,0,0,14,3843,3843,182,186,,,1,2.2,0.57,,,347,958,,,,,,,45.5,,1,,,,,,,,,,,,,,79,84,13.35,13.25,13.5,,,,,,,,,,,,,,,,,"1,1,4,9,35,50,0,0,0",,,,,,,130,,,,,,,,,,,,,,,,,,,,,,,,,,,,,,,,,,,,,11,13,65,66,,1032,,,1,3,3,,1,0,,,,,"Aachen Laufen",,"Polar BEAT",,0,,0,168070,250480,30378,,,,,,,,,,,,,,,,,,,,,,,,,,,,,,,,,,,,,,,,,,4,
5963482,ca693d72-0020-4213-8459-3cf9a0c2b7b9,1405026997,120,1548678147,,0,0,2.49,757,757,36,35,,,1,0.8,0.51,,,,166,,,,,,,35.87,,1,,,,,,,,,,,,,,15,83,12.04,11.85,12.05,,,,,,,,,,,,,,,,,"0,6,15,38,32,8,1,0,0",,,,,,,119,,,,,,,,,,,,,,,,,,,,,,,,,,,,,,,,,,,,,19,13,282,92,,1013,,,0,5,3,,1,0,,,,,Auslaufen,,"Polar BEAT",,0,,0,168070,250480,30378,,,,,,,,,,,,,,,,,,,,,,,,,,,,,,,,,,,,,,,,,,,
5963483,47512cba-b552-448b-a4a3-1d633d45f193,1516197648,60,1548678148,,0,0,17.23,3555,3751,72,58,,,1,0,0.06,0.94,,,522,114,148,,,,,,,1,,,,,,,,,,,,,,37,,,21.64,,33.4,-33.5,117,77,,1,147,114,,,,,,,,,"36,9,24,27,3,1,0","28,69,3,0,0","78,6,12,1,3",,,,,,,,,,,,,,,,,,,,,,,,,,,,,,,,,,,,,,,,,16.1,5,11,262,65,,,1,,0,5,3,,1,0,,,Cycling,,,,"Polar M430",43,0,,0,168072,,30378,,,,,,,,,,,,,,,,,,,,,,,,,,,,,,,,,,,,,,,,,,,
5963484,ad0e4e19-6a42-43dc-82c6-28bd4f542c2a,1406492905,120,1548678148,,0,0,2.93,889,889,41,20,,,1,1,0.52,1.04,1.02,,163,142,157,,,,60.32,36.46,61.9,1,,,,,,,,,,,,,,18,80,12.27,11.98,12.43,-1.6,,,,,,,,,,,,,,,,"0,10,16,21,50,4,0,0,0","0,42,58,0,0",,,,,,124,,,,,,,,,,,,,,,,,,,,,,,,,,,,,,,,,,,,23.6,23,2,6,66,,1015,0,,0,5,3,,1,0,,,,,Einlaufen,,"Polar BEAT",,0,,0,168070,250480,30378,,,,,,,,,,,,,,,,,,,,,,,,,,,,,,,,,,,,,,,,,,,
5963485,6161bb04-e83b-4588-adae-a82843a8f442,1484999270,60,1548678148,,0,0,3.47,691,705,59,21,,,1,0.8,0.47,,,,156,,,,,,,,,1,,,,,,,,,,,,,,7,,,20.28,,,,118,114,,1,137,134,,,,,,,,,"35,25,27,8,4,0,0",,"83,9,0,0,9",,,,,,,,,,,,,,,,,,,,,,,,,,,,,,,,,,,,,,,,,,2,10,133,56,,1030,,,0,3,3,,1,0,,,,,Radfahren,,"Polar BEAT",,0,,0,168072,,30378,,,,,,,,,,,,,,,,,,,,,,,,,,,,,,,,,,,,,,,,,,,
5963486,21adabb7-2b87-45cd-bc61-4a0c49e668b5,1505158552,120,1548678149,,0,0,0.76,246,246,14,17,,,1,0.6,0.47,1.09,0.87,,47,134,147,,,,59.84,29.38,60.91,1,,,,,,,,,,,,,,4,82,11.33,11.45,11.63,-16.2,,,,,,,,,,,,,,,,"17,20,11,13,20,10,9,0,0","3,68,29,0,0",,,,,,113,,,,,,,,,,,,,,,,,,,,,,,,,,,,,,,,,,,,8.3,14,14,222,80,,1001,0,,0,6,3,,1,0,,,Running,,,,"Polar M430",43,0,,0,168070,250480,30378,,,,,,,,,,,,,,,,,,,,,,,,,,,,,,,,,,,,,,,,,,,
5963487,600e9caf-b8cd-4c3d-90c7-0382ff1cda66,1545206708,60,1548678149,,0,0,11.16,2149,2171,44,59,,,1,0,0.11,,0.48,,385,126,154,,,,,,,1,,,,,,,,,,,,,,30,,,20.93,,9.3,-9,95,72,,1,123,104,,,,,,,,,"19,13,60,7,1,0,0","6,81,12,0,0","86,1,5,5,2",,,,,,,,,,,,,,,,,,,,,,,,,,,,,,,,,,,,,,,,,18.2,1,5,80,100,,,0,,0,5,3,,1,0,,,Cycling,,,,"Polar M430",43,0,,0,168072,,30378,,,,,,,,,,,,,,,,,,,,,,,,,,,,,,,,,,,,,,,,,,,
5963488,2c5bcfa4-c7a3-4895-bae5-b0ff171c85ea,1539418745,120,1548678150,,0,0,14.91,3998,4000,48,53,,,1,0,0.01,,0.84,,852,136,161,,,,74.2,46.99,74.47,1,,,,,,,,,,,,,,73,82,13.44,13.58,13.63,-1.1,,,,,,,,,,,,,,,,"2,2,2,4,26,56,7,0,0","2,55,43,0,0",,,,,,136,,,,,,,,,,,,,,,,,,,,,,,,,,,,,,,,,,,,28.4,8,2,191,100,,,0,,0,3,3,,1,0,I1.000|4:41-I1.000|4:19-I1.000|4:23-I1.000|4:12-I1.000|4:14-I1.000|4:11-I1.000|4:13-I1.000|4:15-I1.000|4:13-I1.000|4:18-I1.000|4:27-I1.000|4:33-I1.000|4:29-I1.000|4:48-I0.921|5:25,,Running,,,,"Polar M430",43,0,,0,168070,250480,30378,,,,,,,,,,,,,,,,,,,,,,,,,,,,,,,,,,,,,,,,,,,
5963489,61bab82d-d453-4801-b0b2-325b464248fa,1503087189,120,1548678150,,0,0,7.3,2228,2230,87,85,,,1,0.4,0.25,1.06,0.89,264,494,145,163,,,,58.29,38.39,59.17,1,,,,,,,,,,,,,,50,80,11.97,11.91,12.17,9,,,,,,,,,,,,,,,,"4,3,14,41,30,6,2,0,0","2,23,73,2,0",,,,,,123,,,,,,,,,,,,,,,,,,,,,,,,,,,,,,,,,,,,38.9,16,7,221,89,,1014,0,,0,5,3,,1,0,I1.000|5:09-I1.000|4:49-I1.000|4:45-I1.000|5:28-I1.000|4:59-I1.000|5:20-I1.000|5:09-I0.304|1:32,,Running,,,,"Polar M430",43,0,,0,168070,250480,30378,,,,,,,,,,,,,,,,,,,,,,,,,,,,,,,,,,,,,,,,,,5,
5963490,6d7d241d-2234-4ae4-ada7-463de137c524,1404590490,120,1548678151,,0,0,7.16,2020,2087,90,66,,,1,1.2,0.52,,,,488,,,,,,,42.08,,1,,,,,,,,,,,,,,41,80,13.02,12.88,13.28,,,,,,,,,,,,,,,,,"3,1,2,21,38,32,3,0,0",,,,,,,133,,,,,,,,,,,,,,,,,,,,,,,,,,,,,,,,,,,,,19,6,219,92,,1008,0,,0,6,3,,1,0,,,,,"Regenerativer DL + Dehnen",,"Polar BEAT",,0,,0,168070,250480,30378,,,,,,,,,,,,,,,,,,,,,,,,,,,,,,,,,,,,,,,,,,,
5963491,8a53c2d2-9257-421e-826e-37a589097b4e,1531334253,120,1548678153,,0,0,11.1,1687,1688,59,45,,,1,0,0.1,,,,302,126,149,,,,,,,1,,,,,,,,,,,,,,23,,,25,,6.3,-16.4,128,111,,1,148,131,,,,,,,,,"7,16,20,54,3,0,0","4,91,5,0,0","77,12,0,1,10",,,,,,,,,,,,,,,,,,,,,,,,,,,,,,,,,,,,,,,,,13.3,21,8,338,46,,1017,,,0,5,3,,1,0,,,Cycling,,,,"Polar M430",43,0,,0,168072,,30378,,,,,,,,,,,,,,,,,,,,,,,,,,,,,,,,,,,,,,,,,,,
5963492,9eec896c-3055-4a8e-bfb9-1e72f6279546,1418326310,60,1548678153,,0,0,3.39,1006,2539,38,61,,,1,1.1,0.48,,,,220,,,,,,,37.84,,1,,,,,,,,,,,,,,20,82,12.19,12.54,12.56,,,,,,,,,,,,,,,,,"12,8,6,11,26,37,0,0,0",,,,,,,123,,,,,,,,,,,,,,,,,,,,,,,,,,,,,,,,,,,,,5,14,240,92,,1011,0,,1,5,3,,1,0,,,,,Auslaufen,,"Polar BEAT",,0,,0,168070,250480,30378,,,,,,,,,,,,,,,,,,,,,,,,,,,,,,,,,,,,,,,,,,,
5963493,579efa8c-cc8a-4296-80f4-2d8f30ab6e70,1465849956,120,1548678154,,0,0,7.49,1738,1837,62,60,,,1,0.3,0.32,,,,513,,,,,,,53.09,,1,,,,,,,,,,,,,,36,84,15.64,15.66,15.81,,,,,,,,,,,,,,,,,"2,1,1,1,2,14,74,6,0",,,,,,,154,,,,,,,,,,,,,,,,,,,,,,,,,,,,,,,,,,,,,15,4,254,90,,1002,0,,0,6,3,,1,0,,,,,"Aachen Laufen",,"Polar BEAT",,0,,0,168070,250480,30378,,,,,,,,,,,,,,,,,,,,,,,,,,,,,,,,,,,,,,,,,,,
5963494,1e88f99b-bea0-4371-8935-ad29de284690,1419680178,60,1548678155,,0,0,16.57,4875,4880,448,449,,,1,4.6,0.77,,,556,1115,,,,,,,42.55,,1,,,,,,,,,,,,,,101,84,12.91,12.65,13.54,,,,,,,,,,,,,,,,,"3,7,13,22,28,16,10,0,0",,,,,,,121,,,,,,,,,,,,,,,,,,,,,,,,,,,,,,,,,,,,,0,6,87,98,,,0,,0,9,3,,1,0,,,,,"Langsamer DL",,"Polar BEAT",,0,,0,168070,250480,30378,,,,,,,,,,,,,,,,,,,,,,,,,,,,,,,,,,,,,,,,,,"3,4,5",
5963495,e20bb154-32b2-448a-912b-5fa175a3df58,1429554722,120,1548678155,,0,0,10.82,2794,3320,115,120,,,1,0.6,0.36,,,,731,,,,,,,47.94,,1,,,,,,,,,,,,,,58,84,14.1,14.07,14.29,,,,,,,,,,,,,,,,,"2,1,1,6,16,52,22,0,0",,,,,,,138,,,,,,,,,,,,,,,,,,,,,,,,,,,,,,,,,,,,,17,15,22,34,,1027,,,0,3,3,,1,0,,,,,"Aachen Laufen",,"Polar BEAT",,0,,0,168070,250480,30378,,,,,,,,,,,,,,,,,,,,,,,,,,,,,,,,,,,,,,,,,,,
5963496,2194fae2-e0ca-4d38-9f4b-33374dae6773,1402405158,120,1548678156,,0,0,5,1429,1562,86,62,,,1,1.3,0.47,,,1964,338,,,,,,,40.57,,1,,,,,,,,,,,,,,29,83,13.05,12.71,13.3,,,,,,,,,,,,,,,,,"3,2,8,18,42,23,3,1,1",,,,,,,126,,,,,,,,,,,,,,,,,,,,,,,,,,,,,,,,,,,,,27,5,256,59,,1018,8,,0,3,3,,1,0,,,,,"Lauf ABC + Sprints",,"Polar BEAT",,0,,0,168070,250480,30378,,,,,,,,,,,,,,,,,,,,,,,,,,,,,,,,,,,,,,,,,,5,
5963497,120ccf50-14e2-4fe8-a0c9-4eac4ca92119,1413322123,120,1548678156,,0,0,1.78,582,582,24,24,,,1,0.7,0.43,1,0.94,,115,139,157,,,,56.51,31.92,57.45,1,,,,,,,,,,,,,,11,83,11.18,11.03,11.44,-2.8,,,,,,,,,,,,,,,,"5,18,24,32,21,0,0,0,0","0,52,48,0,0",,,,,,111,,,,,,,,,,,,,,,,,,,,,,,,,,,,,,,,,,,,17.4,13,5,223,76,,1009,0,,1,5,3,,1,0,,,,,Auslaufen,,"Polar BEAT",,0,,0,168070,250480,30378,,,,,,,,,,,,,,,,,,,,,,,,,,,,,,,,,,,,,,,,,,,
5963498,040d137f-8875-4463-a320-c1c4ee0e7145,1522779268,120,1548678156,,0,0,13.82,3744,3746,24,24,,,1,0,0.03,1.08,0.97,,1009,161,184,,,,58.49,46.16,58.62,1,,,,,,,,,,,,,,125,83,13.33,13.57,13.62,8.4,,,,,,,,,,,,,,,,"1,2,6,16,21,37,17,0,0","0,9,36,48,6",,,,,,133,,,,,,,,,,,,,,,,,,,,,,,,,,,,,,,,,,,,104.8,19,13,227,37,,1004,,,0,5,3,,1,0,I7.694|34:03-I6.132|28:27,,Running,,,,"Polar M430",43,0,,0,168070,250480,30378,,,,,,,,,,,,,,,,,,,,,,,,,,,,,,,,,,,,,,,,,,,
5963499,5aa6c815-c267-44bf-b60d-3e68af3e3a4f,1468535499,120,1548678157,,0,0,12.77,3678,3762,194,194,,,1,2.2,0.56,,,334,880,,,,,,,42.73,,1,,,,,,,,,,,,,,76,79,12.78,12.67,12.95,,,,,,,,,,,,,,,,,"3,3,7,20,36,27,2,0,0",,,,,,,132,,,,,,,,,,,,,,,,,,,,,,,,,,,,,,,,,,,,,14,4,316,74,,1024,0,,1,5,3,,1,0,,,,,"Aachen Laufen",,"Polar BEAT",,0,,0,168070,250480,30378,,,,,,,,,,,,,,,,,,,,,,,,,,,,,,,,,,,,,,,,,,4,
5963500,138dae9e-6a86-480c-9e51-21a5240d0a84,1511370460,60,1548678158,,0,0,14.62,2989,3197,60,58,,,1,0,0.1,,,,362,101,126,,,,,,,1,,,,,,,,,,,,,,18,,,19.34,,5.5,-29.9,84,67,,1,105,92,,,,,,,,,"19,50,23,7,0,0,0","45,55,0,0,0","88,0,8,2,2",,,,,,,,,,,,,,,,,,,,,,,,,,,,,,,,,,,,,,,,,5.3,12,1,181,67,,,0,,1,3,3,,1,0,,,Cycling,,,,"Polar M430",43,0,,0,168072,,30378,,,,,,,,,,,,,,,,,,,,,,,,,,,,,,,,,,,,,,,,,,,
5963501,b9a1cdab-915b-4250-bfc1-f9625d423b1a,1474738266,120,1548678158,,0,0,7.89,2348,2348,90,87,,,1,0.7,0.41,,,,539,,,,,,,39.75,,1,,,,,,,,,,,,,,48,80,12.27,12.19,12.41,,,,,,,,,,,,,,,,,"4,4,4,28,51,10,0,0,0",,,,,,,126,,,,,,,,,,,,,,,,,,,,,,,,,,,,,,,,,,,,,23,6,169,42,,1021,1,,0,3,3,,1,0,,,,,"Aachen Laufen",,"Polar BEAT",,0,,0,168070,250480,30378,,,,,,,,,,,,,,,,,,,,,,,,,,,,,,,,,,,,,,,,,,,
5963502,47a48def-e4a7-41a5-ab52-478407240f3d,1442952178,120,1548678159,,0,0,16.88,4069,4169,51,49,,,1,0,0.07,,,,1143,,,,,,,53.67,,1,,,,,,,,,,,,,,84,84,14.96,15.08,15.13,,,,,,,,,,,,,,,,,"2,0,0,1,3,30,61,2,0",,,,,,,148,,,,,,,,,,,,,,,,,,,,,,,,,,,,,,,,,,,,,12,6,191,91,,1000,,,1,6,3,,1,0,,,,,"Münster Laufen",,"Polar BEAT",,0,,0,168070,250480,30378,,,,,,,,,,,,,,,,,,,,,,,,,,,,,,,,,,,,,,,,,,,
5963503,e58998e5-6485-44b9-b917-432a8451ff64,1542132468,60,1548678159,,0,0,15.28,4035,4038,65,65,,,1,0,0.07,,0.95,,1026,154,186,,,,64.29,47.92,64.63,1,,,,,,,,,,,,,,111,82,13.67,13.96,14.02,4,,,,,,,,,,,,,,,,"2,2,5,5,20,53,9,3,2","0,11,62,27,0",,,,,,139,,,,,,,,,,,,,,,,,,,,,,,,,,,,,,,,,,,,67.8,10,5,222,90,,1031,0,283,1,5,3,,1,0,I1.000|4:51-I1.000|4:29-I1.000|4:22-I1.000|4:23-I1.000|4:05-I1.000|4:21-I1.000|4:25-I1.000|4:16-I1.000|4:22-I1.000|4:16-I1.000|4:14-I1.000|4:18-I1.000|3:51-I1.000|3:47-I1.000|4:58-I0.282|2:22,,Running,,,,"Polar M430",43,0,,0,168070,250480,30378,,,,,,,,,,,,,,,,,,,,,,,,,,,,,,,,,,,,,,,,,,,
5963504,bfa9fbb7-afa9-4044-98ec-c16d92277796,1427307503,60,1548678160,,0,0,27.22,7507,8215,339,338,,,1,2.5,0.53,,,420,1857,,,,,,,47.68,,1,,,,,,,,,,,,,,155,83,13.29,13.18,13.48,,,,,,,,,,,,,,,,,"2,1,4,11,33,46,4,0,0",,,,,,,131,,,,,,,,,,,,,,,,,,,,,,,,,,,,,,,,,,,,,5,4,290,95,,1009,0,,1,5,3,,1,0,,,,,"Aachen Laufen",,"Polar BEAT",,0,,0,168070,250480,30378,,,,,,,,,,,,,,,,,,,,,,,,,,,,,,,,,,,,,,,,,,"4,5",
5963505,a1fbb06f-e8c5-4994-a1ac-8328b5534330,1406839061,120,1548678161,,0,0,2.41,523,544,24,25,,,1,0,0.08,,,,145,,,,,,,52.43,,1,,,,,,,,,,,,,,10,90,16.57,17.49,17.55,,,,,,,,,,,,,,,,,"6,4,5,3,4,5,10,51,12",,,,,,,154,,,,,,,,,,,,,,,,,,,,,,,,,,,,,,,,,,,,,19,1,7,70,,1014,,,0,5,3,,1,0,,,,,"1000, 500, 200, 300 Renntempo",,"Polar BEAT",,0,,0,168070,250480,30378,,,,,,,,,,,,,,,,,,,,,,,,,,,,,,,,,,,,,,,,,,,
5963506,4274ef94-010c-4401-b61e-e1f5fb4b9f7e,1490375843,60,1548678161,,0,0,13.82,3689,3741,206,199,,,1,1.8,0.39,,,279,983,,,,,,,46.96,,1,,,,,,,,,,,,,,76,82,13.81,13.69,14.13,,,,,,,,,,,,,,,,,"3,1,2,8,24,45,17,0,0",,,,,,,137,,,,,,,,,,,,,,,,,,,,,,,,,,,,,,,,,,,,,13,10,60,58,,1027,0,,0,5,3,,1,0,,,,,"Aachen Laufen",,"Polar BEAT",,0,,0,168070,250480,30378,,,,,,,,,,,,,,,,,,,,,,,,,,,,,,,,,,,,,,,,,,4,
5963507,d033ff20-7b0b-4b1a-9a1a-ee45dc30eef6,1407870971,120,1548678161,,0,0,3,983,1083,67,48,,,1,0.8,0.34,,,247,204,,,,,,,33.39,,1,,,,,,,,,,,,,,20,81,11.54,11.09,11.81,,,,,,,,,,,,,,,,,"4,10,25,49,12,0,0,0,0",,,,,,,113,,,,,,,,,,,,,,,,,,,,,,,,,,,,,,,,,,,,,14,8,217,89,,1011,0,,0,6,3,,1,0,,,,,Einlaufen,,"Polar BEAT",,0,,0,168070,250480,30378,,,,,,,,,,,,,,,,,,,,,,,,,,,,,,,,,,,,,,,,,,5,
5963508,32ce7d1f-377c-4320-8e8d-c8fe638f5628,1411675910,120,1548678162,,0,0,3.38,994,994,66,66,,,1,1.7,0.64,1.09,1,448,179,141,164,,,,63.26,38.23,64.79,1,,,,,,,,,,,,,,20,80,12.64,12.34,13.17,2.4,,,,,,,,,,,,,,,,"2,2,11,23,43,19,0,0,0","1,46,51,2,0",,,,,,128,,,,,,,,,,,,,,,,,,,,,,,,,,,,,,,,,,,,23.6,13,6,238,79,,1022,0,,1,5,3,,1,0,,,,,Einlaufen,,"Polar BEAT",,0,,0,168070,250480,30378,,,,,,,,,,,,,,,,,,,,,,,,,,,,,,,,,,,,,,,,,,4,
5963509,cf667dab-5d41-45be-8798-c29a01d5e6db,1460715628,120,1548678162,,0,0,5.61,1849,1916,108,102,,,1,1.7,0.46,,,507,389,,,,,,,34.49,,1,,,,,,,,,,,,,,38,82,11.35,11.15,11.79,,,,,,,,,,,,,,,,,"13,10,16,45,11,4,0,0,0",,,,,,,111,,,,,,,,,,,,,,,,,,,,,,,,,,,,,,,,,,,,,11,13,234,83,,1005,2,,0,5,3,,1,0,,,,,"Aachen Laufen",,"Polar BEAT",,0,,0,168070,250480,30378,,,,,,,,,,,,,,,,,,,,,,,,,,,,,,,,,,,,,,,,,,4,
5963510,4c93c098-3c0b-4507-8411-da68163cd681,1528735970,120,1548678163,,0,0,7.4,2437,2438,29,32,,,1,0,0.11,1.06,0.85,,496,135,172,,,,58.05,35.12,58.31,1,,,,,,,,,,,,,,42,80,10.96,11.16,11.24,3.3,,,,,,,,,,,,,,,,"13,15,26,27,10,6,3,0,0","1,70,29,1,0",,,,,,114,,,,,,,,,,,,,,,,,,,,,,,,,,,,,,,,,,,,26.1,23,5,22,79,,1016,,,0,5,3,,1,0,I5.981|32:12-I1.417|8:29,,Running,,,,"Polar M430",43,0,,0,168070,250480,30378,,,,,,,,,,,,,,,,,,,,,,,,,,,,,,,,,,,,,,,,,,,
5963511,,1413646560,120,1548678163,,0,0,3,0,0,,,,,0,,,,,,199,,,,,,,,,1,,,,,,,,,,,,,,0,,,,,,,,,,,,,,,,,,,,,,,,,,,,,,,,,,,,,,,,,,,,,,,,,,,,,,,,,,,,,,,,,,,,,,,,,,1,,,0,0,,,,,Samstagstraining,,"Polar BEAT",,0,,0,168070,250480,30378,,,,,,,,,,,,,,,,,,,,,,,,,,,,,,,,,,,,,,,,,,,
5963512,4610c14d-8f51-409e-afac-3d6ab253ab68,1533233192,120,1548678163,,0,0,15.97,4159,4159,52,53,,,1,0,0.1,1.16,0.98,,1142,160,174,,,,61.97,48.87,62.21,1,,,,,,,,,,,,,,134,82,13.86,13.89,13.97,11,,,,,,,,,,,,,,,,"0,0,1,3,24,63,9,0,0","0,8,29,63,0",,,,,,140,,,,,,,,,,,,,,,,,,,,,,,,,,,,,,,,,,,,77.7,32,13,17,38,,,,,0,3,3,,1,0,I1.000|4:29-I1.000|4:14-I1.000|4:05-I1.000|4:16-I1.000|4:19-I1.000|4:08-I1.000|4:08-I1.000|4:25-I1.000|4:22-I1.000|4:13-I1.000|4:13-I1.000|4:19-I1.000|4:20-I1.000|4:32-I1.000|4:41-I0.969|4:37,,Running,,,,"Polar M430",43,0,,0,168070,250480,30378,,,,,,,,,,,,,,,,,,,,,,,,,,,,,,,,,,,,,,,,,,,
5963513,33e4d4a6-2828-4674-812c-274ece34d4b4,1398197437,120,1548678164,,0,0,2.52,748,748,25,14,,,1,0,0.24,1.25,1.02,,159,154,170,,,,55.65,36.92,56.63,1,,,,,,,,,,,,,,20,81,12.39,12.53,13.17,13.3,,,,,,,,,,,,,,,,"14,4,11,17,19,27,9,0,0","0,2,69,29,0",,,,,,125,,,,,,,,,,,,,,,,,,,,,,,,,,,,,,,,,,,,36.5,12,0,119,86,,1015,0,,0,6,3,,1,0,,,,,Einlaufen,,"Polar BEAT",,0,,0,168070,250480,30378,,,,,,,,,,,,,,,,,,,,,,,,,,,,,,,,,,,,,,,,,,,
5963514,,1427625000,120,1548678164,,0,0,8,0,0,,,,,0,,,,,,526,,,,,,,,,1,,,,,,,,,,,,,,0,,,,,,,,,,,,,,,,,,,,,,,,,,,,,,,,,,,,,,,,,,,,,,,,,,,,,,,,,,,,,,,,,,,,,,,,,,1,,,0,0,,,,,"Lockerer DL",,"Polar BEAT",,0,,0,168070,250480,30378,,,,,,,,,,,,,,,,,,,,,,,,,,,,,,,,,,,,,,,,,,,
5963515,9b8c8dea-8222-4c6a-b721-9b825a2b6b41,1510680148,60,1548678164,,0,0,11.38,1931,2020,50,43,,,1,0,0.09,2.08,,,379,132,161,,,,,,,1,,,,,,,,,,,,,,32,,,23.94,,30.6,0.6,114,98,,1,145,132,,,,,,,,,"15,11,26,47,1,0,0","6,67,26,1,0","81,9,0,1,9",,,,,,,,,,,,,,,,,,,,,,,,,,,,,,,,,,,,,,,,,21.9,6,4,195,82,,1027,,,1,3,3,,1,0,,,Cycling,,,,"Polar M430",43,0,,0,168072,,30378,,,,,,,,,,,,,,,,,,,,,,,,,,,,,,,,,,,,,,,,,,,
5963516,71030f7e-a597-4900-a9ff-80197a4d47a5,1348403274,120,1548678167,,0,0,47.03,5579,5663,172,175,,,1,0,0.11,,,,1703,140,210,,,,,,,1,,,,,,,,,,,,,,121,,,33.24,,-7,-28.4,245,202,,1,293,260,,,,,,,,,"9,9,12,16,19,14,22","1,67,26,1,6","44,12,12,18,13",,,,,,,,,,,,,,,,,,,,,,,,,,,,,,,,,,,,,,,,,202,15,13,86,70,,1017,4,,0,5,3,,1,0,,,,,,,"Polar BEAT",,0,,0,168072,,30378,,,,,,,,,,,,,,,,,,,,,,,,,,,,,,,,,,,,,,,,,,,
5963517,724d6460-2e72-4af8-a8be-ce51b1cb6121,1507570966,120,1548678168,,0,0,13.03,3752,3754,194,188,,,1,2.5,0.62,1.01,1.04,442,868,147,164,,,,61.52,42.81,62.69,1,,,,,,,,,,,,,,86,81,12.82,12.66,12.93,4,,,,,,,,,,,,,,,,"2,5,4,21,39,28,0,0,0","0,26,72,2,0",,,,,,129,,,,,,,,,,,,,,,,,,,,,,,,,,,,,,,,,,,,39.8,14,10,261,82,,1019,,,0,3,3,,1,0,I1.000|5:03-I1.000|4:26-I1.000|4:37-I1.000|4:38-I1.000|4:21-I1.000|4:36-I1.000|5:47-I1.000|4:56-I1.000|5:15-I1.000|4:20-I1.000|4:34-I1.000|5:07-I1.000|4:44-I0.037|0:10,,Running,,,,"Polar M430",43,0,,0,168070,250480,30378,,,,,,,,,,,,,,,,,,,,,,,,,,,,,,,,,,,,,,,,,,4,
5963518,9dd35805-5ea1-4c71-be39-911587fef25b,1475005877,120,1548678168,,0,0,3.32,1010,1019,66,65,,,1,1.6,0.57,,,422,223,,,,,,,36.7,,1,,,,,,,,,,,,,,20,80,12.23,11.95,12.69,,,,,,,,,,,,,,,,,"1,7,24,28,28,12,1,0,0",,,,,,,123,,,,,,,,,,,,,,,,,,,,,,,,,,,,,,,,,,,,,15,1,216,71,,1027,0,,1,5,3,,1,0,,,,,"Aachen Laufen",,"Polar BEAT",,0,,0,168070,250480,30378,,,,,,,,,,,,,,,,,,,,,,,,,,,,,,,,,,,,,,,,,,5,
5963519,,1463592960,120,1548678168,,0,0,,0,0,,,,,0,,,,,,377,,,,,,,,,1,,,,,,,,,,,,,,0,,,,,,,,,,,,,,,,,,,,,,,,,,,,,,,,,,,,,,,,,,,,,,,,,,,,,,,,,,,,,,,,,,,,,,,,,,1,,,0,0,,,,,Gym,,"Polar BEAT",,0,,0,168075,,30378,,,,,,,,,,,,,,,,,,,,,,,,,,,,,,,,,,,,,,,,,,,
5963520,815761a9-3411-4e57-96e1-48a82aef0d2c,1439554886,120,1548678168,,0,0,9.86,2983,3619,137,136,,,1,1.6,0.51,,,342,677,,,,,,,39.58,,1,,,,,,,,,,,,,,61,84,12.2,12.04,12.41,,,,,,,,,,,,,,,,,"3,3,9,32,49,2,0,1,0",,,,,,,118,,,,,,,,,,,,,,,,,,,,,,,,,,,,,,,,,,,,,23,14,207,69,,1009,,,0,5,3,,1,0,,,,,"Aachen Laufen",,"Polar BEAT",,0,,0,168070,250480,30378,,,,,,,,,,,,,,,,,,,,,,,,,,,,,,,,,,,,,,,,,,"5,5",
5963521,36d2a9e4-5b54-4438-bdd6-1333a5e5de57,1541934718,60,1548678169,,0,0,0.98,1425,1535,115,53,,,1,2.8,0.59,,,313,288,98,122,,,,,,,1,,,,,,,,,,,,,,8,,,3.47,,-14.1,,,,,,,,,,,,,,,,"89,11,0,0,0,0","48,52,0,0,0",,,,,,,,,,,,,,,,,,,,,,,,,,,,,,,,,,,,,,,,,,3.8,13,24,210,79,,1013,1,278,0,5,3,,1,0,,,Hiking,,,,"Polar M430",43,0,,0,168075,,30378,,,,,,,,,,,,,,,,,,,,,,,,,,,,,,,,,,,,,,,,,,4,
5963522,bda5325e-bfe2-4bce-ab03-adbd734a1886,1452193779,60,1548678169,,0,0,14.92,4645,5135,154,153,,,1,1.4,0.47,,,,949,,,,,,,39.51,,1,,,,,,,,,,,,,,96,80,11.67,13.07,13.26,,,,,,,,,,,,,,,,,"25,4,8,19,13,7,5,15,4",,,,,,,120,,,,,,,,,,,,,,,,,,,,,,,,,,,,,,,,,,,,,6,31,255,87,,993,,,1,6,3,,1,0,,,,,"2x 5x Hoch Runter am Hangeweiher",,"Polar BEAT",,0,,0,168070,250480,30378,,,,,,,,,,,,,,,,,,,,,,,,,,,,,,,,,,,,,,,,,,,
5963523,370cb9b9-9ffb-4eea-b909-70131325aa74,1476738143,120,1548678169,,0,0,1.75,496,513,25,24,,,1,1.1,0.58,,,,117,,,,,,,37.48,,1,,,,,,,,,,,,,,10,79,12.93,12.84,12.96,,,,,,,,,,,,,,,,,"2,4,17,16,19,31,11,0,0",,,,,,,134,,,,,,,,,,,,,,,,,,,,,,,,,,,,,,,,,,,,,11,1,195,91,,1024,0,,1,5,3,,1,0,,,,,"Aachen Laufen",,"Polar BEAT",,0,,0,168070,250480,30378,,,,,,,,,,,,,,,,,,,,,,,,,,,,,,,,,,,,,,,,,,,
5963524,df572f05-f982-4a25-b2e3-4960e0d6a02f,1538908179,120,1548678170,,0,0,16.8,4599,4601,69,65,,,1,0,0.11,1.08,0.94,,1288,162,172,,,,57.23,46.31,57.54,1,,,,,,,,,,,,,,150,82,13.2,13.18,13.27,4.4,,,,,,,,,,,,,,,,"0,0,1,8,45,46,0,0,0","0,1,33,66,0",,,,,,134,,,,,,,,,,,,,,,,,,,,,,,,,,,,,,,,,,,,67.6,15,3,200,85,,1014,1,286,0,5,3,,1,0,I1.000|4:51-I1.000|4:35-I1.000|4:30-I1.000|4:34-I1.000|4:30-I1.000|4:29-I1.000|4:28-I1.000|4:29-I1.000|4:29-I1.000|4:31-I1.000|4:39-I1.000|4:33-I1.000|4:33-I1.000|4:32-I1.000|4:33-I1.000|4:41-I0.804|3:43,,Running,,,,"Polar M430",43,0,,0,168070,250480,30378,,,,,,,,,,,,,,,,,,,,,,,,,,,,,,,,,,,,,,,,,,,
5963525,a8a444c9-6ef4-4bd2-9406-cc8f3c9cc56e,1529749345,120,1548678171,,0,0,15.61,4507,4508,44,48,,,1,0,0.05,,0.93,,1144,152,166,,,,58.62,43.28,58.81,1,,,,,,,,,,,,,,117,81,12.48,12.53,12.58,3.8,,,,,,,,,,,,,,,,"0,1,3,25,56,15,0,0,0","0,3,93,5,0",,,,,,128,,,,,,,,,,,,,,,,,,,,,,,,,,,,,,,,,,,,44,15,13,11,61,,,,,0,3,3,,1,0,I1.000|4:53-I1.000|4:37-I1.000|4:33-I1.000|4:42-I1.000|4:33-I1.000|4:47-I1.000|4:42-I1.000|4:38-I1.000|4:54-I1.000|4:59-I1.000|5:09-I1.000|4:53-I1.000|4:39-I1.000|5:00-I1.000|4:55-I0.613|3:16,,Running,,,,"Polar M430",43,0,,0,168070,250480,30378,,,,,,,,,,,,,,,,,,,,,,,,,,,,,,,,,,,,,,,,,,,
5963526,8ec5641a-9426-4966-b5ae-a1c8e9d29483,1368137717,120,1548678171,,0,0,0.24,51,51,12,0,,,1,1.3,0.89,,,,15,,,,,,,44.44,,1,,,,,,,,,,,,,,1,,19.92,19.96,24.49,,,,,,,,,,,,,,,,,"24,4,4,2,4,6,6,8,43",,,,,,,,,,,,,,,,,,,,,,,,,,,,,,,,,,,,,,,,,,,,12,5,242,71,,1013,0,,1,5,3,,1,0,,,,,,,"Polar BEAT",,0,,0,168070,250480,30378,,,,,,,,,,,,,,,,,,,,,,,,,,,,,,,,,,,,,,,,,,,
5963528,1f7b9c6f-0ffb-4044-82db-08fbcd26782c,1411386412,120,1548678171,,0,0,15.33,4276,4291,392,393,,,1,4.3,0.7,,,733,1029,,,,,,,44.99,,1,,,,,,,,,,,,,,88,82,13.37,13.05,14.19,,,,,,,,,,,,,,,,,"3,2,5,12,46,25,5,3,0",,,,,,,131,,,,,,,,,,,,,,,,,,,,,,,,,,,,,,,,,,,,,11,9,267,87,,,3,,0,5,3,,1,0,,,,,"Regenerativer DL",,"Polar BEAT",,0,,0,168070,250480,30378,,,,,,,,,,,,,,,,,,,,,,,,,,,,,,,,,,,,,,,,,,"4,4,4,5,5",
5963529,0ca188bf-762f-48ae-94e0-2b6426075f3a,1510821067,60,1548678172,,0,0,3.99,864,865,12,6,,,1,0,0.05,,,,146,128,151,,,,,,,1,,,,,,,,,,,,,,12,,,18.25,,11,6.6,75,63,,1,92,84,,,,,,,,,"31,30,33,5,0,0,0","6,76,18,0,0","96,0,0,0,4",,,,,,,,,,,,,,,,,,,,,,,,,,,,,,,,,,,,,,,,,13.2,2,2,62,93,,,0,,0,4,3,,1,0,,,Cycling,,,,"Polar M430",43,0,,0,168072,,30378,,,,,,,,,,,,,,,,,,,,,,,,,,,,,,,,,,,,,,,,,,,
5963530,6393385b-0673-41e2-a8bc-d36936a3ed7d,1476133205,120,1548678172,,0,0,12.79,3671,3720,181,185,,,1,2.2,0.59,,,388,871,,,,,,,42.91,,1,,,,,,,,,,,,,,76,79,12.78,12.66,13.01,,,,,,,,,,,,,,,,,"2,1,4,21,48,21,2,0,0",,,,,,,132,,,,,,,,,,,,,,,,,,,,,,,,,,,,,,,,,,,,,8,1,4,92,,1023,0,,1,5,3,,1,0,,,,,"Aachen Laufen",,"Polar BEAT",,0,,0,168070,250480,30378,,,,,,,,,,,,,,,,,,,,,,,,,,,,,,,,,,,,,,,,,,4,
5963531,68b66d54-2f93-42bd-93a8-4a8aeb9ae612,1398951341,120,1548678173,,0,0,4.81,1523,1544,59,59,,,1,0,0.04,0.6,0.64,,296,157,191,,,,50.02,35.85,50.78,1,,,,,,,,,,,,,,49,80,11.47,13.92,13.98,7.5,,,,,,,,,,,,,,,,"35,14,8,4,3,4,5,16,11","0,19,32,31,18",,,,,,118,,,,,,,,,,,,,,,,,,,,,,,,,,,,,,,,,,,,75.7,17,1,295,60,,1011,5,,0,5,3,,1,0,,,,,"Pyramide 2,3,4,5,5,4,3,2",,"Polar BEAT",,0,,0,168070,250480,30378,,,,,,,,,,,,,,,,,,,,,,,,,,,,,,,,,,,,,,,,,,,
5963532,3b582637-7963-4d13-9780-13a54a4489ba,1400928909,120,1548678174,,0,0,13.2,3776,3802,151,151,,,1,1.6,0.54,,,397,899,,,,,,,43.18,,1,,,,,,,,,,,,,,78,83,12.77,12.7,12.93,,,,,,,,,,,,,,,,,"1,2,5,18,57,15,2,0,0",,,,,,,126,,,,,,,,,,,,,,,,,,,,,,,,,,,,,,,,,,,,,15,9,199,71,,1015,4,,0,5,3,,1,0,,,,,"Langsamer DL",,"Polar BEAT",,0,,0,168070,250480,30378,,,,,,,,,,,,,,,,,,,,,,,,,,,,,,,,,,,,,,,,,,5,
5963533,4623543b-6009-4b72-b2a7-1aec82bb9ce6,1366549883,120,1548678175,,0,0,31.03,9717,9895,356,355,,,1,2.1,0.39,,,291,2158,,,,,,,41.43,,1,,,,,,,,,,,,,,201,,11.67,12.92,13.25,,,,,,,,,,,,,,,,,"16,5,9,15,23,18,10,3,1",,,,,,,,,,,,,,,,,,,,,,,,,,,,,,,,,,,,,,,,,,,,10,4,329,59,,1020,4,,0,5,3,,1,0,,,,,,,"Polar BEAT",,0,,0,168070,250480,30378,,,,,,,,,,,,,,,,,,,,,,,,,,,,,,,,,,,,,,,,,,"4,4",
5963534,ef8dd3d5-c935-45ba-a750-96d9ccaa2c53,1397584556,120,1548678175,,0,0,4.48,1380,1419,28,23,,,1,0,0.23,1,0.86,,216,143,174,,,,58.68,36.88,59.21,1,,,,,,,,,,,,,,29,83,11.8,11.8,11.94,-9.4,,,,,,,,,,,,,,,,"3,7,16,24,50,0,0,0,0","1,42,49,7,0",,,,,,117,,,,,,,,,,,,,,,,,,,,,,,,,,,,,,,,,,,,24.5,9,20,353,62,,1029,1,,0,5,3,,1,0,,,,,Einlaufen,,"Polar BEAT",,0,,0,168070,250480,30378,,,,,,,,,,,,,,,,,,,,,,,,,,,,,,,,,,,,,,,,,,,
5963535,4e438597-3218-4519-9cd0-34a0f6aa2128,1435437415,120,1548678176,,0,0,11.42,3334,3335,133,137,,,1,1.5,0.65,,,,780,,,,,,,41.71,,1,,,,,,,,,,,,,,69,82,12.51,12.49,12.78,,,,,,,,,,,,,,,,,"2,0,2,16,76,5,0,0,0",,,,,,,125,,,,,,,,,,,,,,,,,,,,,,,,,,,,,,,,,,,,,18,10,327,55,,1021,,,0,3,3,,1,0,,,,,"Aachen Laufen",,"Polar BEAT",,0,,0,168070,250480,30378,,,,,,,,,,,,,,,,,,,,,,,,,,,,,,,,,,,,,,,,,,,
5963536,c414e450-4fb8-4781-82e7-3f08272c491c,1496576918,120,1548678176,,0,0,1.8,575,575,8,40,,,1,0.8,0.55,,,,119,,,,,,,32.82,,1,,,,,,,,,,,,,,11,79,10.88,11.48,10.99,,,,,,,,,,,,,,,,,"6,15,31,19,13,16,0,0,0",,,,,,,119,,,,,,,,,,,,,,,,,,,,,,,,,,,,,,,,,,,,,17,5,275,77,,,5,,0,5,3,,1,0,,,,,"Balve Laufen",,"Polar BEAT",,0,,0,168070,250480,30378,,,,,,,,,,,,,,,,,,,,,,,,,,,,,,,,,,,,,,,,,,,
5963537,4321ca0a-86df-4888-9eb5-7394957a6d18,1348335231,120,1548678177,,0,0,13.08,3792,3895,70,72,,,1,0,0.23,,,,917,,,,,,,42.48,,1,,,,,,,,,,,,,,78,,12.48,12.68,12.83,,,,,,,,,,,,,,,,,"5,5,8,17,34,25,4,1,1",,,,,,,,,,,,,,,,,,,,,,,,,,,,,,,,,,,,,,,,,,,,15,12,280,66,,1017,0,,0,5,3,,1,0,,,,,,,"Polar BEAT",,0,,0,168070,250480,30378,,,,,,,,,,,,,,,,,,,,,,,,,,,,,,,,,,,,,,,,,,,
5963538,1413f629-ad24-4fa1-9580-77d81164eb1d,1410901463,120,1548678177,,0,0,6,1704,1803,0,1,,,1,0,0,,0.21,,458,174,191,,,,49.11,41.31,49.1,1,,,,,,,,,,,,,,74,87,12.52,14.74,14.73,4.2,,,,,,,,,,,,,,,,"38,2,2,3,3,4,5,18,25","0,3,16,39,43",,,,,,121,,,,,,,,,,,,,,,,,,,,,,,,,,,,,,,,,,,,115.3,16,5,71,86,,1014,,,1,3,3,,1,0,,,,,"Paarlauf - 10.370 Meter",,"Polar BEAT",,0,,0,168070,250480,30378,,,,,,,,,,,,,,,,,,,,,,,,,,,,,,,,,,,,,,,,,,,
5963539,c5cf252c-8c22-4c7b-bfc5-75870d65dcf6,1446797928,60,1548678177,,0,0,0.72,277,277,,,,,0,,,,,,48,,,,,,,23.93,,1,,,,,,,,,,,,,,5,82,,9.36,,,,,,,,,,,,,,,,,,"43,51,6,0,0,0,0,0,0",,,,,,,95,,,,,,,,,,,,,,,,,,,,,,,,,,,,,,,,,,,,,,,,,,,,,,1,,,1,0,,,,,,,"Polar BEAT",,0,,0,168070,250480,30378,,,,,,,,,,,,,,,,,,,,,,,,,,,,,,,,,,,,,,,,,,,
5963540,637525da-d8a4-4f39-b6e6-4ea58ebbfea2,1398108371,120,1548678177,,0,0,8.27,2268,2276,221,224,,,1,3.6,0.73,1.07,1.01,616,467,153,177,,,,61.91,43.89,63.93,1,,,,,,,,,,,,,,62,84,14,13.88,14.66,-4.8,,,,,,,,,,,,,,,,"1,8,10,12,41,9,4,15,0","0,13,63,24,0",,,,,,130,,,,,,,,,,,,,,,,,,,,,,,,,,,,,,,,,,,,58.8,11,2,77,84,,,0,,0,6,3,,1,0,,,,,"Regenerativer DL mit rauslaufen",,"Polar BEAT",,0,,0,168070,250480,30378,,,,,,,,,,,,,,,,,,,,,,,,,,,,,,,,,,,,,,,,,,"4,4",
5963541,c3e08860-8326-4e5d-95e5-424756eb1644,1368136154,120,1548678178,,0,0,3.22,976,977,59,60,,,1,0.7,0.31,,,,228,,,,,,,36.77,,1,,,,,,,,,,,,,,20,,12.12,12.49,13.05,,,,,,,,,,,,,,,,,"15,2,3,12,37,27,4,0,0",,,,,,,,,,,,,,,,,,,,,,,,,,,,,,,,,,,,,,,,,,,,13,6,245,68,,1013,0,,1,5,3,,1,0,,,,,,,"Polar BEAT",,0,,0,168070,250480,30378,,,,,,,,,,,,,,,,,,,,,,,,,,,,,,,,,,,,,,,,,,,
5963542,66a72dc8-b33f-42f7-9278-316026bc769a,1479157905,60,1548678180,,0,0,2.24,576,576,,,,,0,,,,,,150,,,,,,,42.97,,1,,,,,,,,,,,,,,11,83,,14.17,,,,,,,,,,,,,,,,,,"0,0,7,5,27,20,41,0,0",,,,,,,141,,,,,,,,,,,,,,,,,,,,,,,,,,,,,,,,,,,,,,,,,,,,,,1,,,1,0,,,,,Laufen,,"Polar BEAT",,0,,0,168070,250480,30378,,,,,,,,,,,,,,,,,,,,,,,,,,,,,,,,,,,,,,,,,,,
5963543,c0761971-4d52-4613-a76a-ebaa72fb0071,1438720654,120,1548678180,,0,0,9.82,2885,3073,1,0,,,1,0,0,,,,617,,,,,,,40.95,,1,,,,,,,,,,,,,,59,76,12.29,15.28,15.29,,,,,,,,,,,,,,,,,"40,2,1,1,2,2,5,44,4",,,,,,,134,,,,,,,,,,,,,,,,,,,,,,,,,,,,,,,,,,,,,17,6,231,75,,1018,,,0,3,3,,1,0,,,,,"Aachen Laufen",,"Polar BEAT",,0,,0,168070,250480,30378,,,,,,,,,,,,,,,,,,,,,,,,,,,,,,,,,,,,,,,,,,,
5963544,b0b66a90-8ef3-4fdf-96de-1a43ff84bf99,1420893226,60,1548678180,,0,0,7.11,2231,2468,127,182,,,1,1.7,0.43,,,627,452,,,,,,,37.09,,1,,,,,,,,,,,,,,46,82,12.02,12.64,12.82,,,,,,,,,,,,,,,,,"25,3,6,8,20,20,12,5,0",,,,,,,117,,,,,,,,,,,,,,,,,,,,,,,,,,,,,,,,,,,,,12,41,240,81,,1013,,,0,11,3,,1,0,,,,,Crosstraining,,"Polar BEAT",,0,,0,168070,250480,30378,,,,,,,,,,,,,,,,,,,,,,,,,,,,,,,,,,,,,,,,,,5,
5963545,271daf0c-6c68-4693-9cec-354f4deee256,1464270005,120,1548678181,,0,0,6.87,2102,2777,49,50,,,1,0,0.06,,,,409,,,,,,,38.14,,1,,,,,,,,,,,,,,43,80,11.85,14,14.01,,,,,,,,,,,,,,,,,"40,7,3,4,4,5,7,26,3",,,,,,,123,,,,,,,,,,,,,,,,,,,,,,,,,,,,,,,,,,,,,20,1,166,51,,1016,7,,0,5,3,,1,0,,,,,"Aachen Laufen",,"Polar BEAT",,0,,0,168070,250480,30378,,,,,,,,,,,,,,,,,,,,,,,,,,,,,,,,,,,,,,,,,,,
5963546,,1432817719,120,1548678181,,0,0,5,0,0,,,,,0,,,,,,331,,,,,,,,,1,,,,,,,,,,,,,,0,,,,,,,,,,,,,,,,,,,,,,,,,,,,,,,,,,,,,,,,,,,,,,,,,,,,,,,,,,,,,,,,,,,,,,,,,,1,,,0,0,,,,,Laufen,,"Polar BEAT",,0,,0,168070,250480,30378,,,,,,,,,,,,,,,,,,,,,,,,,,,,,,,,,,,,,,,,,,,
5963547,a01a6af9-0527-4b4d-8f6b-7dac8a4dba22,1512808649,60,1548678181,,0,0,5.96,1814,1815,28,28,,,1,0,0.12,1.11,0.97,,414,146,158,,,,57.97,38.05,58.3,1,,,,,,,,,,,,,,40,82,11.86,11.85,11.92,2.3,,,,,,,,,,,,,,,,"1,0,7,56,36,1,0,0,0","1,6,93,0,0",,,,,,120,,,,,,,,,,,,,,,,,,,,,,,,,,,,,,,,,,,,31,0,7,233,83,,1018,,,0,5,3,,1,0,I1.000|5:04-I1.000|5:07-I1.000|5:02-I1.000|5:03-I1.000|5:08-I0.962|4:52,,Running,,,,"Polar M430",43,0,,0,168070,250480,30378,,,,,,,,,,,,,,,,,,,,,,,,,,,,,,,,,,,,,,,,,,,
5963548,634c6ef9-b24e-49c4-a200-c04efd639c1c,1461264266,120,1548678182,,0,0,5.03,1372,1504,112,118,,,1,1.6,0.72,,,,343,,,,,,,42.88,,1,,,,,,,,,,,,,,28,82,13.42,13.43,13.84,,,,,,,,,,,,,,,,,"5,1,3,8,24,52,7,0,0",,,,,,,134,,,,,,,,,,,,,,,,,,,,,,,,,,,,,,,,,,,,,18,6,50,42,,1019,1,,0,5,3,,1,0,,,,,"Aachen Laufen",,"Polar BEAT",,0,,0,168070,250480,30378,,,,,,,,,,,,,,,,,,,,,,,,,,,,,,,,,,,,,,,,,,,
5963549,16a0b173-c8ad-4d5d-8c7f-b89a675c5775,1400969089,120,1548678182,,0,0,4.3,1618,1967,82,81,,,1,1.1,0.66,,,208,278,,,,,,,28.96,,1,,,,,,,,,,,,,,33,81,9.92,10.54,11.11,,,,,,,,,,,,,,,,,"29,14,22,15,12,6,2,0,0",,,,,,,98,,,,,,,,,,,,,,,,,,,,,,,,,,,,,,,,,,,,,14,4,177,61,,1018,0,,1,5,3,,1,0,,,,,Auslaufen,,"Polar BEAT",,0,,0,168070,250480,30378,,,,,,,,,,,,,,,,,,,,,,,,,,,,,,,,,,,,,,,,,,5,
5963550,82b10c95-13c3-4da8-b583-472e83da6581,1547666109,60,1548678183,,0,0,0.62,200,203,0,2,,,1,0,0,1.19,1.08,,39,131,143,,,,61.74,28.89,61.49,1,,,,,,,,,,,,,,3,84,11.05,11.21,11.21,9.6,,,,,,,,,,,,,,,,"12,3,7,71,8,0,0,0,0","12,61,28,0,0",,,,,,111,,,,,,,,,,,,,,,,,,,,,,,,,,,,,,,,,,,,6.6,5,10,198,70,,1010,0,288,1,5,3,,1,0,,,Running,,,,"Polar M430",43,0,,0,168070,250480,30378,,,,,,,,,,,,,,,,,,,,,,,,,,,,,,,,,,,,,,,,,,,
5963551,42b503ea-7000-4bc1-af69-f2d1d0d950dc,1497474399,120,1548678183,,0,0,1.22,490,560,4,10,,,1,0,0,,,,78,,,,,,,24.17,,1,,,,,,,,,,,,,,10,80,8.83,9.1,9.01,,,,,,,,,,,,,,,,,"68,10,7,16,0,0,0,0,0",,,,,,,93,,,,,,,,,,,,,,,,,,,,,,,,,,,,,,,,,,,,,22,4,57,52,,1015,0,,0,3,3,,1,0,,,,,"Aachen Laufen",,"Polar BEAT",,0,,0,168070,250480,30378,,,,,,,,,,,,,,,,,,,,,,,,,,,,,,,,,,,,,,,,,,,
5963552,8ac0975d-3c5d-4513-be86-984513314fe4,1406558599,120,1548678184,,0,0,17.27,4295,4314,230,229,,,1,2.2,0.59,1.03,0.97,749,789,150,165,,,,71.79,51.86,72.99,1,,,,,,,,,,,,,,107,83,14.73,14.69,15.04,-1.4,,,,,,,,,,,,,,,,"1,1,2,5,13,36,38,5,0","0,15,78,6,0",,,,,,145,,,,,,,,,,,,,,,,,,,,,,,,,,,,,,,,,,,,43,21,5,258,88,,1011,5,,0,6,3,,1,0,,,,,"Zügiger DL",,"Polar BEAT",,0,,0,168070,250480,30378,,,,,,,,,,,,,,,,,,,,,,,,,,,,,,,,,,,,,,,,,,4,
5963553,ed14d60a-5033-4975-9b6d-c2759e6c9716,1483286035,60,1548678184,,0,0,0.35,135,135,0,0,,,1,0,0,,,,25,,,,,,,22.31,,1,,,,,,,,,,,,,,2,77,9.37,9.62,9.72,,,,,,,,,,,,,,,,,"63,11,16,10,0,0,0,0,0",,,,,,,101,,,,,,,,,,,,,,,,,,,,,,,,,,,,,,,,,,,,,-1,10,192,95,,,0,,0,5,3,,1,0,,,,,"Bruxelles Etterbeek Laufen",,"Polar BEAT",,0,,0,168070,250480,30378,,,,,,,,,,,,,,,,,,,,,,,,,,,,,,,,,,,,,,,,,,,
5963554,07ac5102-38d3-4784-924f-6fe3ee83ef0a,1466334997,120,1548678185,,0,0,18.48,5530,5683,318,316,,,1,2.5,0.5,,,294,1289,,,,,,,42.09,,1,,,,,,,,,,,,,,114,81,12.41,12.23,12.67,,,,,,,,,,,,,,,,,"5,7,12,22,33,20,1,0,0",,,,,,,124,,,,,,,,,,,,,,,,,,,,,,,,,,,,,,,,,,,,,13,5,298,82,,1026,4,,0,5,3,,1,0,,,,,"Aachen Laufen",,"Polar BEAT",,0,,0,168070,250480,30378,,,,,,,,,,,,,,,,,,,,,,,,,,,,,,,,,,,,,,,,,,"4,4,5",
5963555,7a047709-449e-421f-89a6-bc085dd2c5d7,1404334890,120,1548678185,,0,0,5.36,1132,1132,,,,,0,,,,,,361,,,,,,,58.09,,1,,,,,,,,,,,,,,23,87,,17.05,,,,,,,,,,,,,,,,,,"0,0,0,0,1,0,50,49,0",,,,,,,163,,,,,,,,,,,,,,,,,,,,,,,,,,,,,,,,,,,,,,,,,,,,,,1,,,1,0,,,,,"WK Lousberglauf",,"Polar BEAT",,0,,0,168070,250480,30378,,,,,,,,,,,,,,,,,,,,,,,,,,,,,,,,,,,,,,,,,,,
5963556,06ea7b10-48e0-43e0-9102-38624bdfd5c0,1364122695,60,1548678187,,0,0,22.37,9277,11689,652,647,,,1,5.3,0.71,,,530,1717,,,,,,,28.98,,1,,,,,,,,,,,,,,192,,9.24,11.35,12.32,,,,,,,,,,,,,,,,,"42,5,10,11,13,9,5,2,1",,,,,,,,,,,,,,,,,,,,,,,,,,,,,,,,,,,,,,,,,,,,-2,22,73,41,,,,,0,3,3,,1,0,,,,,,,"Polar BEAT",,0,,0,168070,250480,30378,,,,,,,,,,,,,,,,,,,,,,,,,,,,,,,,,,,,,,,,,,"4,4,4",
5963557,21f8a852-12aa-43f8-ac86-2cb81b8198d1,1393838890,60,1548678187,,0,0,11.15,3363,3382,332,333,,,1,4.2,0.73,1.12,0.99,632,570,146,167,,,,58.62,40.08,60.78,1,,,,,,,,,,,,,,77,83,12.73,12.14,13.43,-6.3,,,,,,,,,,,,,,,,"4,8,12,23,39,14,1,0,0","2,39,46,13,0",,,,,,120,,,,,,,,,,,,,,,,,,,,,,,,,,,,,,,,,,,,45.3,5,9,151,73,,,,,0,3,3,,1,0,,,,,"Regenerativer DL",,"Polar BEAT",,0,,0,168070,250480,30378,,,,,,,,,,,,,,,,,,,,,,,,,,,,,,,,,,,,,,,,,,3,
5963558,33e71837-1d2f-443a-815e-6709ba6fff82,1544345131,60,1548678189,,0,0,30.01,10475,10509,1108,1017,,,1,7.1,0.71,1.27,0.95,523,2425,145,173,,,,49.4,36.33,51.84,1,,,,,,,,,,,,,,240,82,11.3,10.76,13.43,0,,,,,,,,,,,,,,,,"22,10,21,33,10,2,1,0,0","0,32,56,12,0",,,,,,105,,,,,,,,,,,,,,,,,,,,,,,,,,,,,,,,,,,,47.1,8,24,243,77,,,0,,0,5,3,,1,0,I28.010|2:45:44-I2.003|9:30,,Running,,,,"Polar M430",43,0,,0,168070,250480,30378,,,,,,,,,,,,,,,,,,,,,,,,,,,,,,,,,,,,,,,,,,"2,2,3,4,4,4,5",
5963559,e05faac2-2a0c-4711-9766-1d0d170fcd59,1514025848,60,1548678189,,0,0,15.18,3801,3802,372,372,,,1,3.6,0.67,1.19,0.87,517,957,155,174,,,,68.05,50.94,70.12,1,,,,,,,,,,,,,,110,84,14.88,14.43,15.5,13.3,,,,,,,,,,,,,,,,"0,0,0,1,10,65,25,0,0","0,26,12,62,0",,,,,,143,,,,,,,,,,,,,,,,,,,,,,,,,,,,,,,,,,,,74.2,7,10,234,100,,,0,,0,4,3,,1,0,I1.000|4:24-I1.000|4:09-I1.000|4:04-I1.000|4:10-I1.000|4:10-I1.000|4:08-I1.000|4:13-I1.000|4:12-I1.000|4:07-I1.000|3:59-I1.000|4:21-I1.000|4:17-I1.000|4:07-I1.000|4:10-I1.000|3:59-I0.185|0:53,,Running,,,,"Polar M430",43,0,,0,168070,250480,30378,,,,,,,,,,,,,,,,,,,,,,,,,,,,,,,,,,,,,,,,,,"4,5,5,5,5",
5963560,e971da95-edb2-497a-8ae7-0c776d145bc7,1450726950,60,1548678190,,0,0,0.97,276,276,10,13,,,1,0.3,0.37,,,,68,,,,,,,34.91,,1,,,,,,,,,,,,,,5,83,12.86,12.82,12.97,,,,,,,,,,,,,,,,,"0,2,3,27,42,24,1,0,0",,,,,,,127,,,,,,,,,,,,,,,,,,,,,,,,,,,,,,,,,,,,,10,35,219,82,,1021,,,1,11,3,,1,0,,,,,"Aachen Laufen",,"Polar BEAT",,0,,0,168070,250480,30378,,,,,,,,,,,,,,,,,,,,,,,,,,,,,,,,,,,,,,,,,,,
5963561,3b06b4c2-cb47-4db1-a760-0f207e56dd93,1417724190,60,1548678190,,0,0,1.45,552,553,11,35,,,1,0.1,0.3,,,,94,,,,,,,26.21,,1,,,,,,,,,,,,,,11,80,9.33,10.18,10.04,,,,,,,,,,,,,,,,,"29,14,20,36,0,0,0,0,0",,,,,,,99,,,,,,,,,,,,,,,,,,,,,,,,,,,,,,,,,,,,,1,1,157,98,,1016,0,,1,5,3,,1,0,,,,,Auslaufen,,"Polar BEAT",,0,,0,168070,250480,30378,,,,,,,,,,,,,,,,,,,,,,,,,,,,,,,,,,,,,,,,,,,
5963562,d03b493d-4be4-42c3-81df-0f5a98ff0ecf,1409223432,120,1548678191,,0,0,10.17,3220,3222,112,112,,,1,0.9,0.42,,,,678,,,,,,,37.6,,1,,,,,,,,,,,,,,66,82,11.53,11.46,11.67,,,,,,,,,,,,,,,,,"2,6,22,45,22,3,0,0,0",,,,,,,116,,,,,,,,,,,,,,,,,,,,,,,,,,,,,,,,,,,,,19,8,184,77,,1016,3,,0,5,3,,1,0,,,,,"Langsamer DL ",,"Polar BEAT",,0,,0,168070,250480,30378,,,,,,,,,,,,,,,,,,,,,,,,,,,,,,,,,,,,,,,,,,,
5963563,5144cbd6-f3d0-4ff8-b10f-6c07aa344243,1397936102,120,1548678191,,0,0,5.26,1418,1423,0,0,,,1,0,0,,,,318,165,185,,,,56.77,43.59,56.77,1,,,,,,,,,,,,,,51,85,13.38,14.74,14.73,6.5,,,,,,,,,,,,,,,,"31,3,3,4,5,6,8,38,3","0,14,16,62,8",,,,,,131,,,,,,,,,,,,,,,,,,,,,,,,,,,,,,,,,,,,77.4,14,11,46,63,,,,,0,3,3,,1,0,,,,,"2x 5x ( 400m in 80s 100m Trab)",,"Polar BEAT",,0,,0,168070,250480,30378,,,,,,,,,,,,,,,,,,,,,,,,,,,,,,,,,,,,,,,,,,,
5963564,32f021e8-478d-41e2-ab8e-3765a704b3ac,1408480995,120,1548678191,,0,0,3.72,1015,1022,0,1,,,1,0,0,,,,207,,,,,,,42.02,,1,,,,,,,,,,,,,,21,80,13.26,15.84,15.81,,,,,,,,,,,,,,,,,"39,1,1,2,2,3,4,34,14",,,,,,,137,,,,,,,,,,,,,,,,,,,,,,,,,,,,,,,,,,,,,12,4,262,78,,1015,0,,1,5,3,,1,0,,,,,"2x 1000m, 500m, 300m, 200m",,"Polar BEAT",,0,,0,168070,250480,30378,,,,,,,,,,,,,,,,,,,,,,,,,,,,,,,,,,,,,,,,,,,
5963565,e52dea6e-9f54-431a-9665-bbc1faeb6bb7,1424199989,60,1548678192,,0,0,15.69,4273,5189,169,171,,,1,0.8,0.38,,,,1044,,,,,,,46.33,,1,,,,,,,,,,,,,,88,84,13.34,14.76,14.92,,,,,,,,,,,,,,,,,"15,5,7,11,13,7,18,23,2",,,,,,,131,,,,,,,,,,,,,,,,,,,,,,,,,,,,,,,,,,,,,4,5,318,94,,1038,,,1,5,3,,1,0,,,,,"Aachen Laufen",,"Polar BEAT",,0,,0,168070,250480,30378,,,,,,,,,,,,,,,,,,,,,,,,,,,,,,,,,,,,,,,,,,,
5963566,2a07a679-7929-4bdf-94d4-edac994d9cb8,1454243198,60,1548678192,,0,0,4.9,1362,1363,67,68,,,1,1.6,0.59,,,287,345,,,,,,,41.87,,1,,,,,,,,,,,,,,28,79,13.21,13.15,13.43,,,,,,,,,,,,,,,,,"0,3,3,20,36,28,10,0,0",,,,,,,137,,,,,,,,,,,,,,,,,,,,,,,,,,,,,,,,,,,,,5,22,232,79,,1009,,,0,5,3,,1,0,,,,,"Balve Laufen",,"Polar BEAT",,0,,0,168070,250480,30378,,,,,,,,,,,,,,,,,,,,,,,,,,,,,,,,,,,,,,,,,,5,
5963567,8957bf5d-5e29-497a-8fec-449fa79f7aba,1459195192,120,1548678195,,0,0,14.54,4568,4808,202,201,,,1,2.4,0.61,,,379,1009,,,,,,,39.01,,1,,,,,,,,,,,,,,94,81,11.7,12.45,12.74,,,,,,,,,,,,,,,,,"13,1,4,16,34,31,1,0,0",,,,,,,118,,,,,,,,,,,,,,,,,,,,,,,,,,,,,,,,,,,,,9,9,230,73,,1000,0,,1,5,3,,1,0,,,,,"Aachen Laufen",,"Polar BEAT",,0,,0,168070,250480,30378,,,,,,,,,,,,,,,,,,,,,,,,,,,,,,,,,,,,,,,,,,"5,5,5",
5963568,97ec12c7-37ce-4bc4-9961-b916f9ec355d,1443780781,120,1548678195,,0,0,6.44,2159,2172,96,116,,,1,1.4,0.44,,,731,439,,,,,,,34.08,,1,,,,,,,,,,,,,,44,84,11.07,10.92,11.35,,,,,,,,,,,,,,,,,"10,9,22,51,8,0,0,0,0",,,,,,,107,,,,,,,,,,,,,,,,,,,,,,,,,,,,,,,,,,,,,11,7,58,70,,1026,,,0,3,3,,1,0,,,,,"Aachen Laufen",,"Polar BEAT",,0,,0,168070,250480,30378,,,,,,,,,,,,,,,,,,,,,,,,,,,,,,,,,,,,,,,,,,5,
5963569,f8623f14-d2a0-45f7-8a96-e0654a2c4517,1514647854,60,1548678195,,0,0,4.86,1414,1417,70,69,,,1,1.4,0.54,0.96,1.04,249,365,158,173,,,,55.03,39.66,56.02,1,,,,,,,,,,,,,,42,81,12.71,12.98,12.91,-14.5,,,,,,,,,,,,,,,,"4,10,24,18,7,13,22,1,0","1,4,47,49,0",,,,,,127,,,,,,,,,,,,,,,,,,,,,,,,,,,,,,,,,,,,58.3,10,18,246,90,,,0,,0,4,3,,1,0,I1.000|5:35-I1.000|5:35-I1.000|5:06-I1.000|3:56-I0.865|3:27,,Running,,,,"Polar M430",43,0,,0,168070,250480,30378,,,,,,,,,,,,,,,,,,,,,,,,,,,,,,,,,,,,,,,,,,5,
5963570,2aea29f6-c7e8-461c-a1eb-b06089b0ff2c,1538411223,120,1548678196,,0,0,11.02,2222,2228,53,40,,,1,0,0.13,2.47,0.54,,213,95,119,,,,,,,1,,,,,,,,,,,,,,11,,,19.25,,16.8,-13,91,72,,1,112,98,,,,,,,,,"17,31,52,0,0,0,0","61,39,0,0,0","85,1,9,3,2",,,,,,,,,,,,,,,,,,,,,,,,,,,,,,,,,,,,,,,,,3.9,15,13,267,50,,,1,,0,5,3,,1,0,,,Cycling,,,,"Polar M430",43,0,,0,168072,,30378,,,,,,,,,,,,,,,,,,,,,,,,,,,,,,,,,,,,,,,,,,,
5963571,2d033575-d2af-4b31-9bbf-4fb6fb6b9ac5,1395344165,60,1548678196,,0,0,6.96,2156,2190,28,29,,,1,0,0.01,0.41,0.45,,415,155,180,,,,52.32,37.61,52.57,1,,,,,,,,,,,,,,65,77,11.78,14.2,14.28,13.4,,,,,,,,,,,,,,,,"46,2,2,3,3,3,5,16,20","0,27,20,53,0",,,,,,126,,,,,,,,,,,,,,,,,,,,,,,,,,,,,,,,,,,,66.9,17,11,221,43,,1010,0,,1,3,3,,1,0,,,,,"15x 400m",,"Polar BEAT",,0,,0,168070,250480,30378,,,,,,,,,,,,,,,,,,,,,,,,,,,,,,,,,,,,,,,,,,,
5963572,fc3f8a7a-9499-4fd3-9680-f1677499e363,1469821922,120,1548678197,,0,0,1.46,511,1231,30,31,,,1,1.3,0.72,,,,102,,,,,,,28.9,,1,,,,,,,,,,,,,,10,81,10.49,10.39,10.65,,,,,,,,,,,,,,,,,"22,14,33,19,7,4,0,0,0",,,,,,,106,,,,,,,,,,,,,,,,,,,,,,,,,,,,,,,,,,,,,22,6,261,70,,1012,0,,0,5,3,,1,0,,,,,"Aachen Laufen",,"Polar BEAT",,0,,0,168070,250480,30378,,,,,,,,,,,,,,,,,,,,,,,,,,,,,,,,,,,,,,,,,,,
5963573,1eb36e6e-f78c-4b4a-a03d-b70e331f1202,1516608928,60,1548678197,,0,0,11.35,1758,1758,24,30,,,1,0,0.05,1.69,,,322,128,146,,,,,,,1,,,,,,,,,,,,,,26,,,24.72,,-13.1,-43,115,100,,1,131,118,,,,,,,,,"11,10,18,58,2,0,0","1,85,14,0,0","86,4,1,1,9",,,,,,,,,,,,,,,,,,,,,,,,,,,,,,,,,,,,,,,,,17.3,3,1,222,92,,,0,,0,6,3,,1,0,,,Cycling,,,,"Polar M430",43,0,,0,168072,,30378,,,,,,,,,,,,,,,,,,,,,,,,,,,,,,,,,,,,,,,,,,,
5963574,c5f25f9e-211f-432c-927d-f42b53f556f5,1401369235,120,1548678197,,0,0,3.33,990,990,67,65,,,1,1.7,0.64,,,440,221,,,,,,,37.71,,1,,,,,,,,,,,,,,20,82,12.6,12.31,13.12,,,,,,,,,,,,,,,,,"6,4,18,25,18,21,7,0,0",,,,,,,123,,,,,,,,,,,,,,,,,,,,,,,,,,,,,,,,,,,,,17,5,313,69,,1016,6,,0,5,3,,1,0,,,,,Einlaufen,,"Polar BEAT",,0,,0,168070,250480,30378,,,,,,,,,,,,,,,,,,,,,,,,,,,,,,,,,,,,,,,,,,4,
5963575,d5a1375c-92ce-42dc-a7da-19a37fdbe045,1349463846,120,1548678199,,0,0,19.08,6289,6626,75,74,,,1,0,0.15,,,,1318,,,,,,,37.69,,1,,,,,,,,,,,,,,130,,11.01,11.75,11.85,,,,,,,,,,,,,,,,,"16,4,10,24,33,12,2,0,0",,,,,,,,,,,,,,,,,,,,,,,,,,,,,,,,,,,,,,,,,,,,18,8,240,68,,1015,0,,1,5,3,,1,0,,,,,,,"Polar BEAT",,0,,0,168070,250480,30378,,,,,,,,,,,,,,,,,,,,,,,,,,,,,,,,,,,,,,,,,,,
5963576,f565e072-646e-4d23-85ef-08221a23d528,1393355591,60,1548678199,,0,0,3.26,987,990,62,61,,,1,1.8,0.75,1.11,1.01,460,203,149,165,,,,56.8,36.86,58.15,1,,,,,,,,,,,,,,24,81,12.26,12.11,12.78,0.3,,,,,,,,,,,,,,,,"6,9,18,21,29,14,3,1,0","0,15,72,13,0",,,,,,122,,,,,,,,,,,,,,,,,,,,,,,,,,,,,,,,,,,,32.8,9,9,159,77,,1009,0,,1,5,3,,1,0,,,,,"Einlaufen Klosterrunde",,"Polar BEAT",,0,,0,168070,250480,30378,,,,,,,,,,,,,,,,,,,,,,,,,,,,,,,,,,,,,,,,,,5,
5963577,,1500930460,120,1548678199,,0,0,,0,0,,,,,0,,,,,,,,,,,,,,,1,,,,,,,,,,,,,,0,,,,,,,,,,,,,,,,,,,,,,,,,,,,,,,,,,,,,,,,,,,,,,,,,,,,,,,,,,,,,,,,,,,,,,,,,,1,,,0,0,,,,,"Aachen Laufen",,"Polar BEAT",,0,,0,168070,250480,30378,,,,,,,,,,,,,,,,,,,,,,,,,,,,,,,,,,,,,,,,,,,
5963578,f7e4bb2c-d458-4cf5-820f-797281cf0d1d,1410724964,120,1548678199,,0,0,10,2342,2342,87,94,,,1,0.7,0.4,1.05,1.02,,533,164,180,,,,68.17,53.45,68.84,1,,,,,,,,,,,,,,80,84,15.47,15.45,15.61,-2.6,,,,,,,,,,,,,,,,"1,0,0,0,0,38,54,7,0","0,0,32,68,0",,,,,,152,,,,,,,,,,,,,,,,,,,,,,,,,,,,,,,,,,,,77.7,15,5,35,83,,1019,,,1,3,3,,1,0,,,,,TDL,,"Polar BEAT",,0,,0,168070,250480,30378,,,,,,,,,,,,,,,,,,,,,,,,,,,,,,,,,,,,,,,,,,,
5963579,456c335e-04a7-4aed-b458-52906151092d,1449170029,60,1548678199,,0,0,3.33,989,989,61,61,,,1,1.6,0.64,,,411,227,,,,,,,37.75,,1,,,,,,,,,,,,,,20,80,12.53,12.34,12.88,,,,,,,,,,,,,,,,,"3,3,10,27,38,17,2,0,0",,,,,,,126,,,,,,,,,,,,,,,,,,,,,,,,,,,,,,,,,,,,,7,12,171,80,,1025,,,1,5,3,,1,0,,,,,"Aachen Laufen",,"Polar BEAT",,0,,0,168070,250480,30378,,,,,,,,,,,,,,,,,,,,,,,,,,,,,,,,,,,,,,,,,,5,
5963580,bf7f9f72-486a-4492-9bb8-e2464047e585,1440619452,120,1548678200,,0,0,63.73,9061,9101,705,706,,,1,2.8,0.41,,,650,2317,,,,,,,,,1,,,,,,,,,,,,,,101,,,28.62,,,,151,118,,1,194,169,,,,,,,,,"15,13,17,25,18,6,6",,"51,28,14,5,2",,,,,,,,,,,,,,,,,,,,,,,,,,,,,,,,,,,,,,,,,,24,17,156,49,,1008,,,1,5,3,,1,0,,,,,"Aachen Radfahren",,"Polar BEAT",,0,,0,168072,,30378,,,,,,,,,,,,,,,,,,,,,,,,,,,,,,,,,,,,,,,,,,"4,4,5,5,5",
5963581,16c65f3a-e498-4bc7-bb5c-4a078316ab84,1413732205,120,1548678201,,0,0,1.85,651,651,0,0,,,1,0,0,,,,126,,,,,,,29.45,,1,,,,,,,,,,,,,,13,81,10.24,10.28,10.35,,,,,,,,,,,,,,,,,"12,25,46,17,0,0,0,0,0",,,,,,,105,,,,,,,,,,,,,,,,,,,,,,,,,,,,,,,,,,,,,22,10,235,71,,1016,1,,0,5,3,,1,0,,,,,Auslaufen,,"Polar BEAT",,0,,0,168070,250480,30378,,,,,,,,,,,,,,,,,,,,,,,,,,,,,,,,,,,,,,,,,,,
5963582,e3c1e154-a3a5-4bff-a666-cb33b0118a8c,1412436117,120,1548678202,,0,0,15.21,4216,4247,407,408,,,1,4.1,0.76,,,633,1021,,,,,,,45.29,,1,,,,,,,,,,,,,,87,81,13.5,13.54,14.66,,,,,,,,,,,,,,,,,"5,0,0,5,31,49,9,0,0",,,,,,,134,,,,,,,,,,,,,,,,,,,,,,,,,,,,,,,,,,,,,20,6,167,56,,,,,0,3,3,,1,0,,,,,"Lockerer DL",,"Polar BEAT",,0,,0,168070,250480,30378,,,,,,,,,,,,,,,,,,,,,,,,,,,,,,,,,,,,,,,,,,"4,5,5,5,5",
5963583,5f5bc755-4406-4264-9c2e-5cdff733ed30,1528569943,120,1548678202,,0,0,6.01,1804,1807,63,63,,,1,0.8,0.37,1.05,1.1,403,402,143,170,,,,60.58,38.7,61.37,1,,,,,,,,,,,,,,39,80,12.19,13.05,13.01,-17.6,,,,,,,,,,,,,,,,"30,4,6,22,4,4,25,3,0","1,38,45,15,0",,,,,,125,,,,,,,,,,,,,,,,,,,,,,,,,,,,,,,,,,,,50.6,26,9,20,54,,,,,0,3,3,,1,0,I1.000|6:52-I1.000|6:07-I1.000|5:15-I1.000|4:15-I1.000|3:46-I1.000|3:50-I0.011|0:03,,Running,,,,"Polar M430",43,0,,0,168070,250480,30378,,,,,,,,,,,,,,,,,,,,,,,,,,,,,,,,,,,,,,,,,,5,
5963584,005a9d1f-9033-4626-abb0-fa832be15831,1400318830,120,1548678203,,0,0,14,3816,3816,168,168,,,1,1.4,0.56,,,397,946,,,,,,,45.88,,1,,,,,,,,,,,,,,79,83,13.43,13.45,13.54,,,,,,,,,,,,,,,,,"0,0,6,18,33,25,16,1,0",,,,,,,133,,,,,,,,,,,,,,,,,,,,,,,,,,,,,,,,,,,,,13,4,5,79,,1025,3,,0,3,3,,1,0,,,,,"Lockerer DL",,"Polar BEAT",,0,,0,168070,250480,30378,,,,,,,,,,,,,,,,,,,,,,,,,,,,,,,,,,,,,,,,,,5,
5963585,f018b7c3-3990-4f16-bb85-06cf4edb3d77,1501610999,120,1548678203,,0,0,3.39,971,972,70,70,,,1,1.7,0.64,1.11,1.04,433,213,144,156,,,,63.62,39.44,65.25,1,,,,,,,,,,,,,,21,81,13.02,12.75,13.47,-5.6,,,,,,,,,,,,,,,,"2,5,18,12,28,27,9,0,0","2,21,77,0,0",,,,,,129,,,,,,,,,,,,,,,,,,,,,,,,,,,,,,,,,,,,26,20,5,335,74,,1016,,,0,5,3,,1,0,I1.000|5:22-I1.000|4:53-I1.000|4:23-I0.395|1:35,,Running,,,,"Polar M430",43,0,,0,168070,250480,30378,,,,,,,,,,,,,,,,,,,,,,,,,,,,,,,,,,,,,,,,,,4,
5963586,8827e779-0684-4c32-b69a-a2eabd10d5e7,1475351025,120,1548678203,,0,0,0.73,221,221,14,19,,,1,1.4,1,,,,44,,,,,,,31.58,,1,,,,,,,,,,,,,,4,81,11.73,12.1,12.9,,,,,,,,,,,,,,,,,"13,10,16,24,8,19,7,5,0",,,,,,,122,,,,,,,,,,,,,,,,,,,,,,,,,,,,,,,,,,,,,14,5,212,81,,1009,0,,1,6,3,,1,0,,,,,"Aachen Laufen",,"Polar BEAT",,0,,0,168070,250480,30378,,,,,,,,,,,,,,,,,,,,,,,,,,,,,,,,,,,,,,,,,,,
5963587,f5cf6165-7bd2-450e-b899-a6053dd28244,1429993375,120,1548678203,,0,0,2.02,497,497,29,43,,,1,0.8,0.6,,,,137,,,,,,,44.66,,1,,,,,,,,,,,,,,10,83,14.72,14.66,15.19,,,,,,,,,,,,,,,,,"0,0,0,0,7,54,38,0,0",,,,,,,147,,,,,,,,,,,,,,,,,,,,,,,,,,,,,,,,,,,,,13,7,210,83,,1007,,,0,5,3,,1,0,,,,,"Essen Laufen",,"Polar BEAT",,0,,0,168070,250480,30378,,,,,,,,,,,,,,,,,,,,,,,,,,,,,,,,,,,,,,,,,,,
5963588,c2ac32b4-606e-49de-a5d2-2bd70e0b5392,1536741864,120,1548678204,,0,0,11.11,3290,3296,307,308,,,1,4,0.67,1.04,1.04,592,796,149,167,,,,58.37,40.93,60.36,1,,,,,,,,,,,,,,80,82,13.07,12.88,13.62,-19.4,,,,,,,,,,,,,,,,"15,7,16,17,9,14,18,2,0","0,13,81,6,0",,,,,,124,,,,,,,,,,,,,,,,,,,,,,,,,,,,,,,,,,,,43.9,19,16,230,67,,1020,,,0,3,3,,1,0,I1.000|5:35-I1.000|6:06-I1.000|6:31-I1.000|5:20-I1.000|5:53-I1.000|4:59-I1.000|4:12-I1.000|3:48-I1.000|4:00-I1.000|3:49-I1.000|4:13-I0.107|0:31,,Running,,,,"Polar M430",43,0,,0,168070,250480,30378,,,,,,,,,,,,,,,,,,,,,,,,,,,,,,,,,,,,,,,,,,3,
5963589,4a0314d0-6153-4533-8d18-ff4324b1e0d3,1406285936,120,1548678205,,0,0,28,8278,8304,424,423,,,1,2.9,0.58,1.03,1,393,1362,152,174,,,,56.93,44.05,58,1,,,,,,,,,,,,,,215,82,12.45,12.39,12.72,2.4,,,,,,,,,,,,,,,,"6,4,10,24,31,19,5,0,0","0,12,73,15,0",,,,,,124,,,,,,,,,,,,,,,,,,,,,,,,,,,,,,,,,,,,49.2,20,5,42,80,,1015,4,,0,5,3,,1,0,,,,,"Langsamer langer DL ",,"Polar BEAT",,0,,0,168070,250480,30378,,,,,,,,,,,,,,,,,,,,,,,,,,,,,,,,,,,,,,,,,,"4,5,5",
5963590,8d14066f-5bf5-4c70-be2d-da049a93ea61,1448801126,60,1548678205,,0,0,7.93,1897,1897,174,170,,,1,2.5,0.8,,,,552,,,,,,,51.4,,1,,,,,,,,,,,,,,39,88,15.73,15.32,16.04,,,,,,,,,,,,,,,,,"0,2,3,6,13,23,32,20,1",,,,,,,143,,,,,,,,,,,,,,,,,,,,,,,,,,,,,,,,,,,,,10,28,228,89,,1011,,,0,6,3,,1,0,,,,,"Wassenberg Laufen",,"Polar BEAT",,0,,0,168070,250480,30378,,,,,,,,,,,,,,,,,,,,,,,,,,,,,,,,,,,,,,,,,,,
5963591,6eefec8f-d819-4c28-8741-230d458e47c5,1435263737,120,1548678206,,0,0,6.93,2202,2202,85,81,,,1,1.2,0.48,,,,472,,,,,,,36.49,,1,,,,,,,,,,,,,,45,81,11.49,11.37,11.68,,,,,,,,,,,,,,,,,"2,4,15,64,15,0,0,0,0",,,,,,,117,,,,,,,,,,,,,,,,,,,,,,,,,,,,,,,,,,,,,21,9,266,51,,1022,,,0,5,3,,1,0,,,,,"Aachen Laufen",,"Polar BEAT",,0,,0,168070,250480,30378,,,,,,,,,,,,,,,,,,,,,,,,,,,,,,,,,,,,,,,,,,,
5963592,ebe9f144-b689-41ae-8955-a4a604276d8e,1459625006,120,1548678208,,0,0,47.58,6181,6228,626,624,,,1,2.8,0.47,,,764,1802,,,,,,,,,1,,,,,,,,,,,,,,69,,,31.61,,,,184,151,,1,222,199,,,,,,,,,"7,17,23,16,11,11,14",,"42,27,17,8,6",,,,,,,,,,,,,,,,,,,,,,,,,,,,,,,,,,,,,,,,,,14,7,99,71,,1012,0,,1,5,3,,1,0,,,,,"Aachen Radfahren",,"Polar BEAT",,0,,0,168072,,30378,,,,,,,,,,,,,,,,,,,,,,,,,,,,,,,,,,,,,,,,,,"4,4,4",
5963594,effb3675-3c26-4e87-a958-7e4b9dc673e2,1417633650,60,1548678209,,0,0,15.22,3889,3890,169,186,,,1,1.8,0.52,,,437,1011,,,,,,,49.77,,1,,,,,,,,,,,,,,80,83,14.26,14.21,14.44,,,,,,,,,,,,,,,,,"0,0,1,8,14,49,28,0,0",,,,,,,141,,,,,,,,,,,,,,,,,,,,,,,,,,,,,,,,,,,,,-1,6,52,95,,1021,0,,1,4,3,,1,0,,,,,"Zügiger DL",,"Polar BEAT",,0,,0,168070,250480,30378,,,,,,,,,,,,,,,,,,,,,,,,,,,,,,,,,,,,,,,,,,4,
5963595,33c25eca-dc1c-4243-8cb0-54bf856e2efd,1480446796,60,1548678210,,0,0,12.49,3529,3905,128,130,,,1,1.2,0.52,,,,847,,,,,,,43.62,,1,,,,,,,,,,,,,,73,81,12.88,13.26,13.4,,,,,,,,,,,,,,,,,"7,2,4,16,22,35,14,0,0",,,,,,,131,,,,,,,,,,,,,,,,,,,,,,,,,,,,,,,,,,,,,-2,1,110,80,,1035,0,,1,3,3,,1,0,,,,,"Aachen Laufen",,"Polar BEAT",,0,,0,168070,250480,30378,,,,,,,,,,,,,,,,,,,,,,,,,,,,,,,,,,,,,,,,,,,
5963596,572ac15b-b4d1-4e34-a817-fdd86c188c6e,1431769894,120,1548678210,,0,0,4.87,1418,1418,67,69,,,1,1.6,0.58,,,259,452,,,,,,,39.62,,1,,,,,,,,,,,,,,29,82,12.59,12.72,12.97,,,,,,,,,,,,,,,,,"3,3,2,31,32,23,5,0,0",,,,,,,126,,,,,,,,,,,,,,,,,,,,,,,,,,,,,,,,,,,,,10,8,250,78,,,,,0,3,3,,1,0,,,,,"Balve Laufen",,"Polar BEAT",,0,,0,168070,250480,30378,,,,,,,,,,,,,,,,,,,,,,,,,,,,,,,,,,,,,,,,,,5,
5963597,d2175f0b-5807-4dc2-ab7d-f29d8bc27f61,1447963116,60,1548678210,,0,0,1.7,586,599,1,0,,,1,0,0,,,,115,,,,,,,29.9,,1,,,,,,,,,,,,,,12,79,10.43,10.87,10.88,,,,,,,,,,,,,,,,,"11,12,26,52,0,0,0,0,0",,,,,,,110,,,,,,,,,,,,,,,,,,,,,,,,,,,,,,,,,,,,,8,9,282,98,,1010,,,1,6,3,,1,0,,,,,"Aachen Laufen",,"Polar BEAT",,0,,0,168070,250480,30378,,,,,,,,,,,,,,,,,,,,,,,,,,,,,,,,,,,,,,,,,,,
5963598,b948fd66-5387-4f3e-95e7-27625e505c5f,1489317781,60,1548678211,,0,0,17.83,5129,5298,283,283,,,1,2.9,0.59,,,486,1255,,,,,,,43.93,,1,,,,,,,,,,,,,,106,81,12.79,12.76,13.18,,,,,,,,,,,,,,,,,"6,2,5,18,34,30,5,1,0",,,,,,,129,,,,,,,,,,,,,,,,,,,,,,,,,,,,,,,,,,,,,11,17,139,39,,1014,,,0,5,3,,1,0,,,,,"Aachen Laufen",,"Polar BEAT",,0,,0,168070,250480,30378,,,,,,,,,,,,,,,,,,,,,,,,,,,,,,,,,,,,,,,,,,4,
5963599,a3d2a7a9-3582-4a76-b936-6ebbaee88a35,1499460017,120,1548678212,,0,0,12.14,4144,4667,194,193,,,1,2.8,0.45,,,1288,809,,,,,,,34.89,,1,,,,,,,,,,,,,,86,78,10.96,10.86,11.95,,,,,,,,,,,,,,,,,"21,8,19,34,18,1,0,0,0",,,,,,,113,,,,,,,,,,,,,,,,,,,,,,,,,,,,,,,,,,,,,25,7,271,62,,1017,,,0,3,3,,1,0,,,,,"Aix-en-Provence Laufen",,"Polar BEAT",,0,,0,168070,250480,30378,,,,,,,,,,,,,,,,,,,,,,,,,,,,,,,,,,,,,,,,,,4,
5963600,26a1f349-dc9c-4932-977c-6aa7d41e5c3d,1400704465,120,1548678212,,0,0,3.61,1147,1204,32,26,,,1,0.3,0.33,,,,242,,,,,,,35.08,,1,,,,,,,,,,,,,,23,81,11.42,11.58,11.82,,,,,,,,,,,,,,,,,"8,5,19,39,22,5,2,0,0",,,,,,,117,,,,,,,,,,,,,,,,,,,,,,,,,,,,,,,,,,,,,22,9,111,52,,1007,,,0,4,3,,1,0,,,,,Einlaufen,,"Polar BEAT",,0,,0,168070,250480,30378,,,,,,,,,,,,,,,,,,,,,,,,,,,,,,,,,,,,,,,,,,,
5963601,79866523-b2b4-4eaf-aaf9-d6e27373770c,1392459510,60,1548678213,,0,0,5.08,1404,2483,68,69,,,1,1.6,0.64,1.05,0.97,247,293,158,178,,,,58.63,42.24,59.58,1,,,,,,,,,,,,,,43,82,13.32,14.03,13.99,-12.9,,,,,,,,,,,,,,,,"9,3,3,10,40,17,6,12,2","1,9,35,55,0",,,,,,132,,,,,,,,,,,,,,,,,,,,,,,,,,,,,,,,,,,,62.3,9,18,231,72,,,1,,0,5,3,,1,0,,,,,Regeneration,,"Polar BEAT",,0,,0,168070,250480,30378,,,,,,,,,,,,,,,,,,,,,,,,,,,,,,,,,,,,,,,,,,5,
5963602,50295a77-fda6-45b4-9ea4-648289df1266,1365024172,120,1548678213,,0,0,8.43,2681,2697,61,61,,,1,0,0.22,,,,589,,,,,,,36.92,,1,,,,,,,,,,,,,,55,,11.47,11.78,11.93,,,,,,,,,,,,,,,,,"9,6,9,27,42,6,1,0,0",,,,,,,,,,,,,,,,,,,,,,,,,,,,,,,,,,,,,,,,,,,,2,10,27,67,,1013,0,,1,5,3,,1,0,,,,,,,"Polar BEAT",,0,,0,168070,250480,30378,,,,,,,,,,,,,,,,,,,,,,,,,,,,,,,,,,,,,,,,,,,
5963603,9ae38b2d-63ac-47b4-a0ad-ce51075e202d,1527419501,120,1548678214,,0,0,5.96,5263,5373,165,155,,,1,2.7,0.63,,,252,555,95,120,,,,,,,1,,,,,,,,,,,,,,26,,,4.36,,-29.8,,,,,,,,,,,,,,,,"90,10,0,0,0,0","66,34,0,0,0",,,,,,,,,,,,,,,,,,,,,,,,,,,,,,,,,,,,,,,,,,4.8,,,,,,,,,0,1,3,,1,0,I1.000|15:21-I1.000|15:49-I1.000|15:54-I1.000|13:15-I1.000|14:10-I1.000|15:04,,Hiking,,,,"Polar M430",43,0,,0,168075,,30378,,,,,,,,,,,,,,,,,,,,,,,,,,,,,,,,,,,,,,,,,,"4,5",
5963604,10d5c608-ebf9-4298-a127-99c4a93a9210,1408802659,120,1548678214,,0,0,3.56,967,979,0,2,,,1,0,0.09,,,,202,,,,,,,42.1,,1,,,,,,,,,,,,,,20,85,13.29,14.44,14.5,,,,,,,,,,,,,,,,,"19,2,8,8,8,17,12,16,10",,,,,,,130,,,,,,,,,,,,,,,,,,,,,,,,,,,,,,,,,,,,,15,5,281,72,,1015,5,,0,5,3,,1,0,,,,,Samstagstraining,,"Polar BEAT",,0,,0,168070,250480,30378,,,,,,,,,,,,,,,,,,,,,,,,,,,,,,,,,,,,,,,,,,,
5963605,5a35601e-58bf-4481-b8c0-13f5de366214,1525515596,120,1548678215,,0,0,15.11,4647,4647,80,80,,,1,0,0.21,1.1,0.91,,1083,147,165,,,,56.72,40.11,57.09,1,,,,,,,,,,,,,,109,80,11.75,11.79,11.92,5.2,,,,,,,,,,,,,,,,"2,4,11,46,35,3,0,0,0","0,7,92,1,0",,,,,,122,,,,,,,,,,,,,,,,,,,,,,,,,,,,,,,,,,,,36.4,17,7,46,55,,,,,0,3,3,,1,0,I14.571|1:14:24-I0.539|3:03,,Running,,,,"Polar M430",43,0,,0,168070,250480,30378,,,,,,,,,,,,,,,,,,,,,,,,,,,,,,,,,,,,,,,,,,,
5963606,3b78f513-5205-4325-9066-6a51215589f8,1499120318,120,1548678215,,0,0,1.35,364,364,0,0,,,1,0,0,,,,81,,,,,,,38.49,,1,,,,,,,,,,,,,,7,85,13.36,14.8,14.8,,,,,,,,,,,,,,,,,"32,3,3,4,6,7,9,35,0",,,,,,,131,,,,,,,,,,,,,,,,,,,,,,,,,,,,,,,,,,,,,23,8,279,48,,1018,0,,1,3,3,,1,0,,,,,"Aix-en-Provence Laufen",,"Polar BEAT",,0,,0,168070,250480,30378,,,,,,,,,,,,,,,,,,,,,,,,,,,,,,,,,,,,,,,,,,,
5963607,c6610e82-080c-4af7-8ddf-e4fb18d52ca0,1497471918,120,1548678215,,0,0,6.4,1529,1529,109,107,,,1,1.6,0.43,,,302,418,,,,,,,50.83,,1,,,,,,,,,,,,,,31,83,15.39,15.3,15.62,,,,,,,,,,,,,,,,,"0,1,2,5,7,32,38,15,1",,,,,,,151,,,,,,,,,,,,,,,,,,,,,,,,,,,,,,,,,,,,,24,8,52,52,,1016,,,0,3,3,,1,0,,,,,"Aachen Laufen",,"Polar BEAT",,0,,0,168070,250480,30378,,,,,,,,,,,,,,,,,,,,,,,,,,,,,,,,,,,,,,,,,,4,
5963608,5298be03-8051-4fed-8e73-2c8d73eca04b,1432067894,120,1548678216,,0,0,5.37,1460,1460,114,112,,,1,1.8,0.53,,,487,374,,,,,,,43.21,,1,,,,,,,,,,,,,,30,82,13.72,13.42,14.37,,,,,,,,,,,,,,,,,"2,2,5,17,25,31,16,1,0",,,,,,,135,,,,,,,,,,,,,,,,,,,,,,,,,,,,,,,,,,,,,11,10,225,71,,1010,0,,0,5,3,,1,0,,,,,"Aachen Laufen",,"Polar BEAT",,0,,0,168070,250480,30378,,,,,,,,,,,,,,,,,,,,,,,,,,,,,,,,,,,,,,,,,,4,
5963609,63eb46b9-b850-4e6a-9c79-db669086dce5,1405022950,120,1548678216,,0,0,3.22,958,959,62,61,,,1,1.8,0.75,,,424,210,,,,,,,37.58,,1,,,,,,,,,,,,,,19,82,12.5,12.38,13.12,,,,,,,,,,,,,,,,,"9,7,12,18,26,21,8,0,0",,,,,,,123,,,,,,,,,,,,,,,,,,,,,,,,,,,,,,,,,,,,,21,8,286,87,,1012,0,,0,5,3,,1,0,,,,,Einlaufen,,"Polar BEAT",,0,,0,168070,250480,30378,,,,,,,,,,,,,,,,,,,,,,,,,,,,,,,,,,,,,,,,,,5,
5963610,d882084a-71a7-4b71-b31c-2f0f2182b2ec,1474659386,120,1548678216,,0,0,0.55,239,240,12,8,,,1,1.2,0.74,,,,36,,,,,,,20.16,,1,,,,,,,,,,,,,,4,74,8.51,10.31,11.1,,,,,,,,,,,,,,,,,"32,5,28,20,14,0,0,0,0",,,,,,,93,,,,,,,,,,,,,,,,,,,,,,,,,,,,,,,,,,,,,17,1,337,72,,1026,0,,1,3,3,,1,0,,,,,"Aachen Laufen",,"Polar BEAT",,0,,0,168070,250480,30378,,,,,,,,,,,,,,,,,,,,,,,,,,,,,,,,,,,,,,,,,,,
5963611,08169816-d14a-4dc7-b12e-76eb2e73bbee,1517335857,60,1548678217,,0,0,13.7,3908,3910,53,54,,,1,0,0.07,1.09,0.93,,985,154,180,,,,58.44,43.44,58.72,1,,,,,,,,,,,,,,109,81,12.66,12.87,12.95,10.9,,,,,,,,,,,,,,,,"0,3,13,27,23,28,7,0,0","0,6,68,26,0",,,,,,130,,,,,,,,,,,,,,,,,,,,,,,,,,,,,,,,,,,,80.5,9,5,203,82,,1028,,,1,5,3,,1,0,I1.000|4:58-I1.000|4:52-I1.000|4:41-I1.000|4:28-I1.000|4:17-I1.000|4:18-I1.000|4:04-I1.000|4:04-I1.000|4:26-I1.000|5:03-I1.000|5:21-I1.000|5:18-I1.000|5:14-I0.697|4:06,,Running,,,,"Polar M430",43,0,,0,168070,250480,30378,,,,,,,,,,,,,,,,,,,,,,,,,,,,,,,,,,,,,,,,,,,
5963612,33c32ab4-4702-487d-956f-35c845ab652d,1510682981,60,1548678217,,0,0,11.82,2942,2943,32,32,,,1,0,0.05,,0.96,,750,157,179,,,,67.33,50.35,67.56,1,,,,,,,,,,,,,,86,84,14.5,14.63,14.69,-10.4,,,,,,,,,,,,,,,,"0,0,1,3,11,59,22,4,0","0,4,67,29,0",,,,,,143,,,,,,,,,,,,,,,,,,,,,,,,,,,,,,,,,,,,56.4,4,5,186,81,,1028,,,1,3,3,,1,0,I1.000|4:49-I1.000|4:22-I1.000|4:16-I1.000|4:11-I1.000|4:12-I1.000|4:11-I1.000|4:10-I1.000|4:00-I1.000|3:35-I1.000|3:40-I1.000|4:08-I0.826|3:30,,Running,,,,"Polar M430",43,0,,0,168070,250480,30378,,,,,,,,,,,,,,,,,,,,,,,,,,,,,,,,,,,,,,,,,,,
5963613,46a2a88c-0e19-4130-bdb9-3328f3f69ad4,1421176435,60,1548678218,,0,0,2.14,694,695,,,,,0,,,,,,145,,,,,,,32.83,,1,,,,,,,,,,,,,,14,80,,11.18,,,,,,,,,,,,,,,,,,"9,1,10,67,14,0,0,0,0",,,,,,,116,,,,,,,,,,,,,,,,,,,,,,,,,,,,,,,,,,,,,,,,,,,,,,1,,,1,0,,,,,Einlaufen,,"Polar BEAT",,0,,0,168070,250480,30378,,,,,,,,,,,,,,,,,,,,,,,,,,,,,,,,,,,,,,,,,,,
5963614,a2b1d348-2942-4f7d-9fce-e86fb0e38cb2,1470341640,120,1548678218,,0,0,12.24,3480,3581,272,270,,,1,3.3,0.7,,,469,838,,,,,,,43.24,,1,,,,,,,,,,,,,,72,80,13.17,12.82,13.61,,,,,,,,,,,,,,,,,"2,2,8,20,33,28,7,0,0",,,,,,,132,,,,,,,,,,,,,,,,,,,,,,,,,,,,,,,,,,,,,17,5,213,79,,1013,0,,0,5,3,,1,0,,,,,"Aachen Laufen",,"Polar BEAT",,0,,0,168070,250480,30378,,,,,,,,,,,,,,,,,,,,,,,,,,,,,,,,,,,,,,,,,,"4,5,5",
5963615,0b3e15cd-78c9-4164-b8c8-e6ef321f7dd2,1412085288,120,1548678219,,0,0,10.61,3143,3634,189,199,,,1,0.9,0.29,1.11,0.9,682,567,149,178,,,,58.35,40.78,59.56,1,,,,,,,,,,,,,,77,82,12.61,12.29,13.21,-1.8,,,,,,,,,,,,,,,,"5,4,7,22,44,16,2,1,0","0,26,57,17,0",,,,,,124,,,,,,,,,,,,,,,,,,,,,,,,,,,,,,,,,,,,58,19,5,252,75,,1026,3,,0,5,3,,1,0,,,,,"Regenerativer DL ",,"Polar BEAT",,0,,0,168070,250480,30378,,,,,,,,,,,,,,,,,,,,,,,,,,,,,,,,,,,,,,,,,,4,
5963616,d1b8e262-e13b-40a0-9134-0de8a6922c51,1402951834,120,1548678219,,0,0,1.65,396,396,8,22,,,1,0,0.14,,,,108,,,,,,,44.88,,1,,,,,,,,,,,,,,8,81,14.73,14.93,14.67,,,,,,,,,,,,,,,,,"0,0,0,1,8,42,42,7,0",,,,,,,154,,,,,,,,,,,,,,,,,,,,,,,,,,,,,,,,,,,,,15,7,336,77,,1022,0,,0,5,3,,1,0,,,,,Einlaufen,,"Polar BEAT",,0,,0,168070,250480,30378,,,,,,,,,,,,,,,,,,,,,,,,,,,,,,,,,,,,,,,,,,,
5963617,023b6521-6fb9-481e-b59e-82d32081a899,1487876646,60,1548678220,,0,0,12.82,3542,3543,185,192,,,1,2.1,0.61,,,424,893,,,,,,,44.86,,1,,,,,,,,,,,,,,73,81,13.26,13.13,13.49,,,,,,,,,,,,,,,,,"1,1,2,13,39,41,3,0,0",,,,,,,134,,,,,,,,,,,,,,,,,,,,,,,,,,,,,,,,,,,,,8,25,250,73,,997,0,,1,5,3,,1,0,,,,,"Aachen Laufen",,"Polar BEAT",,0,,0,168070,250480,30378,,,,,,,,,,,,,,,,,,,,,,,,,,,,,,,,,,,,,,,,,,4,
5963618,4f8ca60e-baf8-41e9-9d45-fe880737acfc,1474806184,120,1548678221,,0,0,3.27,989,989,65,65,,,1,1.7,0.63,,,416,216,,,,,,,36.91,,1,,,,,,,,,,,,,,20,80,12.29,12.07,12.84,,,,,,,,,,,,,,,,,"6,7,16,23,28,16,4,0,0",,,,,,,124,,,,,,,,,,,,,,,,,,,,,,,,,,,,,,,,,,,,,22,15,182,49,,1016,,,0,3,3,,1,0,,,,,"Aachen Laufen",,"Polar BEAT",,0,,0,168070,250480,30378,,,,,,,,,,,,,,,,,,,,,,,,,,,,,,,,,,,,,,,,,,5,
5963619,3c493f1c-f221-4b78-b436-cec2a73abea5,1406060010,120,1548678222,,0,0,2.92,831,831,24,21,,,1,0.6,0.42,,,,192,,,,,,,39.26,,1,,,,,,,,,,,,,,17,81,12.77,12.78,13.15,,,,,,,,,,,,,,,,,"5,3,5,20,27,41,0,0,0",,,,,,,130,,,,,,,,,,,,,,,,,,,,,,,,,,,,,,,,,,,,,24,6,14,72,,1018,0,,0,5,3,,1,0,,,,,Einlaufen,,"Polar BEAT",,0,,0,168070,250480,30378,,,,,,,,,,,,,,,,,,,,,,,,,,,,,,,,,,,,,,,,,,,
5963621,0fb7c947-06b3-42ec-a853-c80047042ebb,1539798094,120,1548678223,,0,0,7.86,2285,2289,48,48,,,1,0,0.13,1.1,0.93,,463,132,145,,,,69.59,40.85,70.12,1,,,,,,,,,,,,,,36,80,12.43,12.41,12.52,11.2,,,,,,,,,,,,,,,,"0,0,1,29,62,7,0,0,0","1,90,9,0,0",,,,,,129,,,,,,,,,,,,,,,,,,,,,,,,,,,,,,,,,,,,18.6,21,10,1,52,,,,,0,3,3,,1,0,I1.000|4:49-I1.000|4:41-I1.000|4:39-I1.000|4:46-I1.000|4:59-I1.000|4:58-I1.000|5:02-I0.859|4:15,,Running,,,,"Polar M430",43,0,,0,168070,250480,30378,,,,,,,,,,,,,,,,,,,,,,,,,,,,,,,,,,,,,,,,,,,
5963622,ab8d02eb-76ac-4b91-8a65-05c12095d3c6,1411503152,120,1548678223,,0,0,3.39,985,985,64,64,,,1,1.7,0.64,,,439,225,,,,,,,38.78,,1,,,,,,,,,,,,,,20,80,12.79,12.49,13.25,,,,,,,,,,,,,,,,,"3,2,8,31,28,26,2,0,0",,,,,,,129,,,,,,,,,,,,,,,,,,,,,,,,,,,,,,,,,,,,,11,1,103,82,,1020,0,,1,5,3,,1,0,,,,,Einlaufen,,"Polar BEAT",,0,,0,168070,250480,30378,,,,,,,,,,,,,,,,,,,,,,,,,,,,,,,,,,,,,,,,,,5,
5963623,0b0db259-8d34-4343-9f8b-30c53c4c0338,1501332115,120,1548678223,,0,0,1.8,444,445,21,21,,,1,0,0.11,,1.1,,104,153,175,,,,70.59,43.96,71.61,1,,,,,,,,,,,,,,12,87,14.59,15.12,15.2,5.4,,,,,,,,,,,,,,,,"12,5,4,7,6,6,12,46,2","0,14,46,40,0",,,,,,140,,,,,,,,,,,,,,,,,,,,,,,,,,,,,,,,,,,,31.5,22,12,233,68,,1013,5,,0,5,3,,1,0,I0.046|0:37-I0.305|0:59-I0.050|0:23-I0.304|1:00-I0.047|0:25-I0.304|1:00-I0.050|0:21-I0.303|1:02-I0.048|0:33-I0.307|0:58-I0.033|0:12,,Running,,,,"Polar M430",43,0,,0,168070,250480,30378,,,,,,,,,,,,,,,,,,,,,,,,,,,,,,,,,,,,,,,,,,,
5963624,d28667be-0316-4af2-807a-4ea8ddae2c09,1448566510,60,1548678223,,0,0,5.98,1837,1944,16,20,,,1,0,0.12,,,,371,,,,,,,37.64,,1,,,,,,,,,,,,,,38,80,11.77,13.61,13.66,,,,,,,,,,,,,,,,,"25,5,16,13,4,5,8,23,1",,,,,,,122,,,,,,,,,,,,,,,,,,,,,,,,,,,,,,,,,,,,,2,4,197,93,,1022,,,1,3,3,,1,0,,,,,"Aachen Laufen",,"Polar BEAT",,0,,0,168070,250480,30378,,,,,,,,,,,,,,,,,,,,,,,,,,,,,,,,,,,,,,,,,,,
5963625,dfa58a88-b0c5-4118-b463-a365b8ab33aa,1537686787,120,1548678224,,0,0,15.06,4371,4378,45,48,,,1,0,0.06,1.12,0.92,,1080,150,162,,,,59.3,42.9,59.51,1,,,,,,,,,,,,,,109,82,12.43,12.46,12.51,4.3,,,,,,,,,,,,,,,,"0,0,3,30,55,11,0,0,0","0,8,91,1,0",,,,,,126,,,,,,,,,,,,,,,,,,,,,,,,,,,,,,,,,,,,41.7,16,17,207,80,,,0,,0,4,3,,1,0,I1.000|5:03-I1.000|5:03-I1.000|4:51-I1.000|4:38-I1.000|4:34-I1.000|4:45-I1.000|4:39-I1.000|4:43-I1.000|4:40-I1.000|4:51-I1.000|4:51-I1.000|4:46-I1.000|5:00-I1.000|5:10-I1.000|5:03-I0.072|0:23,,Running,,,,"Polar M430",43,0,,0,168070,250480,30378,,,,,,,,,,,,,,,,,,,,,,,,,,,,,,,,,,,,,,,,,,,
5963627,ad158430-76e3-4fe5-a7d5-f01b09c507e7,1513274330,60,1548678225,,0,0,14.53,3905,3905,49,53,,,1,0,0.06,,0.86,,939,150,170,,,,65.21,46.77,65.46,1,,,,,,,,,,,,,,98,84,13.41,13.48,13.55,1.5,,,,,,,,,,,,,,,,"1,1,2,8,26,59,4,0,0","0,10,88,3,0",,,,,,133,,,,,,,,,,,,,,,,,,,,,,,,,,,,,,,,,,,,43.7,5,7,224,79,,,0,,1,6,3,,1,0,I1.000|4:38-I1.000|4:45-I1.000|4:37-I1.000|4:30-I1.000|4:15-I1.000|4:19-I1.000|4:25-I1.000|4:21-I1.000|4:24-I1.000|4:17-I1.000|4:21-I1.000|4:16-I1.000|4:16-I1.000|5:01-I0.535|2:41,,Running,,,,"Polar M430",43,0,,0,168070,250480,30378,,,,,,,,,,,,,,,,,,,,,,,,,,,,,,,,,,,,,,,,,,,
5963628,640ffc9a-d96b-4559-bb72-208474b8532e,1508610128,120,1548678225,,0,0,0.71,256,257,14,12,,,1,1,0.57,1.09,1.04,,50,134,153,,,,52.38,25.76,53.84,1,,,,,,,,,,,,,,4,80,10.33,10.04,10.46,-3.5,,,,,,,,,,,,,,,,"31,18,18,34,0,0,0,0,0","9,48,43,0,0",,,,,,104,,,,,,,,,,,,,,,,,,,,,,,,,,,,,,,,,,,,9.6,14,10,212,76,,1012,0,,0,5,3,,1,0,,,Running,,,,"Polar M430",43,0,,0,168070,250480,30378,,,,,,,,,,,,,,,,,,,,,,,,,,,,,,,,,,,,,,,,,,,
5963629,bcdf050c-7dde-4fa4-9657-bd5c2d61c424,1401741318,120,1548678225,,0,0,2.14,631,670,24,24,,,1,0.2,0.28,,,,147,,,,,,,36.62,,1,,,,,,,,,,,,,,13,80,12.46,12.59,12.74,,,,,,,,,,,,,,,,,"7,1,8,31,28,14,11,0,0",,,,,,,127,,,,,,,,,,,,,,,,,,,,,,,,,,,,,,,,,,,,,18,1,350,52,,1018,0,,0,3,3,,1,0,,,,,Einlaufen,,"Polar BEAT",,0,,0,168070,250480,30378,,,,,,,,,,,,,,,,,,,,,,,,,,,,,,,,,,,,,,,,,,,
5963630,02905439-4a4d-4d53-a61e-4c7955afbed9,1467920534,120,1548678226,,0,0,6.42,1869,2850,123,122,,,1,2.3,0.59,,,438,433,,,,,,,40.28,,1,,,,,,,,,,,,,,38,80,12.77,12.54,13.36,,,,,,,,,,,,,,,,,"3,4,9,26,35,16,7,0,0",,,,,,,129,,,,,,,,,,,,,,,,,,,,,,,,,,,,,,,,,,,,,21,3,13,64,,1019,,,0,5,3,,1,0,,,,,"Aachen Laufen",,"Polar BEAT",,0,,0,168070,250480,30378,,,,,,,,,,,,,,,,,,,,,,,,,,,,,,,,,,,,,,,,,,"4,4",
5963631,a6d450ae-2626-4968-a6d5-4c49d3870d56,1365023927,120,1548678226,,0,0,0.16,166,235,1,0,,,1,0,0,,,,10,,,,,,,,,1,,,,,,,,,,,,,,3,,3.56,5.39,5.47,,,,,,,,,,,,,,,,,"82,1,1,1,12,2,0,0,0",,,,,,,,,,,,,,,,,,,,,,,,,,,,,,,,,,,,,,,,,,,,2,10,27,67,,1013,0,,1,5,3,,1,0,,,,,,,"Polar BEAT",,0,,0,168070,250480,30378,,,,,,,,,,,,,,,,,,,,,,,,,,,,,,,,,,,,,,,,,,,
5963632,c39f40bb-80c4-4226-98cb-810fbc0961ef,1455956823,60,1548678226,,0,0,4.52,1501,1501,85,81,,,1,1.6,0.6,,,269,315,,,,,,,33.75,,1,,,,,,,,,,,,,,31,82,11.18,10.94,11.58,,,,,,,,,,,,,,,,,"12,11,28,36,13,1,0,0,0",,,,,,,110,,,,,,,,,,,,,,,,,,,,,,,,,,,,,,,,,,,,,5,24,206,94,,1013,,,0,4,3,,1,0,,,,,"Aachen Laufen",,"Polar BEAT",,0,,0,168070,250480,30378,,,,,,,,,,,,,,,,,,,,,,,,,,,,,,,,,,,,,,,,,,5,
5963633,9958d023-c183-492e-b0aa-b595ec376f52,1464726573,120,1548678226,,0,0,8.33,2317,2346,0,2,,,1,0,0,,,,518,,,,,,,43.19,,1,,,,,,,,,,,,,,48,81,12.95,15.07,15.12,,,,,,,,,,,,,,,,,"34,2,2,2,2,3,10,39,6",,,,,,,133,,,,,,,,,,,,,,,,,,,,,,,,,,,,,,,,,,,,,17,1,109,81,,1012,0,,0,5,3,,1,0,,,,,"Aachen Laufen",,"Polar BEAT",,0,,0,168070,250480,30378,,,,,,,,,,,,,,,,,,,,,,,,,,,,,,,,,,,,,,,,,,,
5963634,490ee469-2cb5-4498-90d4-5a6f49ffdfb6,1410952504,120,1548678227,,0,0,5.46,1733,2028,61,61,,,1,0.8,0.37,,,,367,,,,,,,36.01,,1,,,,,,,,,,,,,,35,81,11.53,11.53,11.73,,,,,,,,,,,,,,,,,"8,8,14,35,31,3,0,0,0",,,,,,,117,,,,,,,,,,,,,,,,,,,,,,,,,,,,,,,,,,,,,20,4,99,75,,1013,3,,0,3,3,,1,0,,,,,Auslaufen,,"Polar BEAT",,0,,0,168070,250480,30378,,,,,,,,,,,,,,,,,,,,,,,,,,,,,,,,,,,,,,,,,,,
5963635,ba05a863-1621-4663-bdad-711c4ab67052,1432239056,120,1548678227,,0,0,10.78,2991,3015,257,257,,,1,3.3,0.76,,,519,728,,,,,,,44.07,,1,,,,,,,,,,,,,,62,83,13.51,13.07,14.06,,,,,,,,,,,,,,,,,"0,1,4,20,34,34,6,1,0",,,,,,,130,,,,,,,,,,,,,,,,,,,,,,,,,,,,,,,,,,,,,14,5,312,60,,1026,0,,0,5,3,,1,0,,,,,"Aachen Laufen",,"Polar BEAT",,0,,0,168070,250480,30378,,,,,,,,,,,,,,,,,,,,,,,,,,,,,,,,,,,,,,,,,,"4,4,5",
5963636,af0cada2-f9db-4cd1-9e6c-88746f614efe,1480621961,60,1548678228,,0,0,2.39,818,840,31,29,,,1,0.7,0.41,,,,163,,,,,,,31.15,,1,,,,,,,,,,,,,,16,79,10.67,10.62,11.09,,,,,,,,,,,,,,,,,"10,24,39,17,7,3,0,0,0",,,,,,,111,,,,,,,,,,,,,,,,,,,,,,,,,,,,,,,,,,,,,4,9,251,96,,1026,0,,1,9,3,,1,0,,,,,"Aachen Laufen",,"Polar BEAT",,0,,0,168070,250480,30378,,,,,,,,,,,,,,,,,,,,,,,,,,,,,,,,,,,,,,,,,,,
5963637,5cee1374-6421-443c-a3be-53d4cdabfb66,1493650922,120,1548678228,,0,0,4.44,1398,1425,52,53,,,1,1,0.55,,,,309,,,,,,,35.92,,1,,,,,,,,,,,,,,29,79,11.63,11.58,11.72,,,,,,,,,,,,,,,,,"8,7,21,29,24,10,0,0,0",,,,,,,121,,,,,,,,,,,,,,,,,,,,,,,,,,,,,,,,,,,,,10,8,110,87,,1012,,,0,6,1,,1,0,,,,,"Aachen Laufen",,"Polar BEAT",,0,,0,168070,250480,30378,,,,,,,,,,,,,,,,,,,,,,,,,,,,,,,,,,,,,,,,,,,
5963638,8838d03c-bf4f-4f36-a2bb-38d57553afe7,1426620913,60,1548678228,,0,0,8.08,2093,2344,0,0,,,1,0,0,,,,530,,,,,,,46.87,,1,,,,,,,,,,,,,,43,79,13.94,15.65,15.68,,,,,,,,,,,,,,,,,"22,1,1,1,1,2,36,36,0",,,,,,,147,,,,,,,,,,,,,,,,,,,,,,,,,,,,,,,,,,,,,12,2,72,63,,1024,0,,1,5,3,,1,0,,,,,"Aachen Laufen",,"Polar BEAT",,0,,0,168070,250480,30378,,,,,,,,,,,,,,,,,,,,,,,,,,,,,,,,,,,,,,,,,,,
5963639,132b433f-ae8d-4491-ac29-37391fb3c1e0,1409687473,120,1548678229,,0,0,8.16,2397,2397,98,97,,,1,0.7,0.44,1.03,1.02,,411,141,156,,,,63.35,40.45,64.3,1,,,,,,,,,,,,,,48,80,12.43,12.34,12.6,1.3,,,,,,,,,,,,,,,,"0,2,5,29,55,9,0,0,0","1,40,60,0,0",,,,,,128,,,,,,,,,,,,,,,,,,,,,,,,,,,,,,,,,,,,26.1,18,4,44,78,,1022,0,,0,5,3,,1,0,,,,,"Regenerativer DL",,"Polar BEAT",,0,,0,168070,250480,30378,,,,,,,,,,,,,,,,,,,,,,,,,,,,,,,,,,,,,,,,,,,
5963640,72f66ffc-b04c-4f72-a15c-3d9c90891e84,1531927678,120,1548678229,,0,0,11.29,3056,3057,325,324,,,1,4,0.68,1.05,1.02,681,782,154,171,,,,62.36,45.51,64.59,1,,,,,,,,,,,,,,85,83,14.26,14.24,14.98,-9.8,,,,,,,,,,,,,,,,"5,5,16,12,22,10,14,15,1","1,9,55,35,0",,,,,,134,,,,,,,,,,,,,,,,,,,,,,,,,,,,,,,,,,,,57.5,24,8,2,41,,,5,,0,5,3,,1,0,I1.000|5:02-I1.000|5:02-I1.000|5:39-I1.000|4:45-I1.000|4:43-I1.000|5:10-I1.000|4:37-I1.000|3:31-I1.000|3:27-I1.000|3:16-I1.000|3:37-I0.285|2:10,,Running,,,,"Polar M430",43,0,,0,168070,250480,30378,,,,,,,,,,,,,,,,,,,,,,,,,,,,,,,,,,,,,,,,,,3,
5963641,2fd27dcf-4a44-4eb5-b3ee-a229ae266912,1426501340,60,1548678230,,0,0,8.81,2810,4243,135,134,,,1,1.6,0.48,,,,608,,,,,,,36.9,,1,,,,,,,,,,,,,,58,82,11.49,11.4,11.74,,,,,,,,,,,,,,,,,"4,6,19,48,16,7,0,0,0",,,,,,,115,,,,,,,,,,,,,,,,,,,,,,,,,,,,,,,,,,,,,5,6,93,85,,1023,2,,0,5,3,,1,0,,,,,"Lauf ABC",,"Polar BEAT",,0,,0,168070,250480,30378,,,,,,,,,,,,,,,,,,,,,,,,,,,,,,,,,,,,,,,,,,,
5963642,3e79e77c-6f21-40ae-a022-51b68152f7a4,1410816393,120,1548678230,,0,0,3.19,1048,1091,20,53,,,1,0.5,0.43,1.15,0.99,,177,132,150,,,,59.82,33.43,59.52,1,,,,,,,,,,,,,,16,81,10.76,11.16,11.17,-0.1,,,,,,,,,,,,,,,,"6,9,20,57,7,0,0,0,0","0,85,15,0,0",,,,,,113,,,,,,,,,,,,,,,,,,,,,,,,,,,,,,,,,,,,15.4,16,2,88,88,,1016,0,,1,5,3,,1,0,,,,,Auslaufen,,"Polar BEAT",,0,,0,168070,250480,30378,,,,,,,,,,,,,,,,,,,,,,,,,,,,,,,,,,,,,,,,,,,
5963643,f2979981-21dc-4c5b-be6f-5cf6460ac4d8,1459542157,120,1548678231,,0,0,2.15,576,576,26,32,,,1,0.7,0.44,,,,148,,,,,,,40.85,,1,,,,,,,,,,,,,,11,81,13.62,13.66,13.74,,,,,,,,,,,,,,,,,"1,1,1,10,32,38,18,0,0",,,,,,,138,,,,,,,,,,,,,,,,,,,,,,,,,,,,,,,,,,,,,9,3,127,67,,1020,0,,1,5,3,,1,0,,,,,"Aachen Laufen",,"Polar BEAT",,0,,0,168070,250480,30378,,,,,,,,,,,,,,,,,,,,,,,,,,,,,,,,,,,,,,,,,,,
5963644,586f9b51-2828-4f33-8b90-f09a21ef792f,1534274198,120,1548678231,,0,0,1.65,398,398,0,0,,,1,0,0,,,,102,159,173,,,,68.75,44.63,68.75,1,,,,,,,,,,,,,,12,86,14.96,15.42,15.41,7,,,,,,,,,,,,,,,,"11,5,6,6,5,6,15,46,0","0,3,54,43,0",,,,,,145,,,,,,,,,,,,,,,,,,,,,,,,,,,,,,,,,,,,34.5,24,7,288,49,,1016,,,0,5,3,,1,0,I0.402|1:25-I0.212|1:13-I0.417|1:22-I0.204|1:15-I0.407|1:23-I0.011|0:02,,Running,,,,"Polar M430",43,0,,0,168070,250480,30378,,,,,,,,,,,,,,,,,,,,,,,,,,,,,,,,,,,,,,,,,,,
5963648,6729f7a2-38a4-4c31-a109-740eb55a9d9b,1472912587,120,1548678232,,0,0,0.91,397,501,0,2,,,1,0,0,,,,63,,,,,,,21.22,,1,,,,,,,,,,,,,,8,74,8.21,9.17,9.14,,,,,,,,,,,,,,,,,"51,25,20,4,0,0,0,0,0",,,,,,,93,,,,,,,,,,,,,,,,,,,,,,,,,,,,,,,,,,,,,23,5,242,58,,1017,4,,0,5,3,,1,0,,,,,"Aachen Laufen",,"Polar BEAT",,0,,0,168070,250480,30378,,,,,,,,,,,,,,,,,,,,,,,,,,,,,,,,,,,,,,,,,,,
5963649,47d21462-e8cb-490e-b5d5-a8c52aa4be42,1528395134,120,1548678233,,0,0,8.68,2504,2653,308,297,,,1,4.3,0.79,1.28,0.82,605,609,152,186,,,,58.68,41.49,61.36,1,,,,,,,,,,,,,,70,82,13.33,13.16,15.2,7.8,,,,,,,,,,,,,,,,"10,8,9,20,19,8,19,7,0","2,24,35,36,3",,,,,,127,,,,,,,,,,,,,,,,,,,,,,,,,,,,,,,,,,,,70.3,23,10,271,66,,1014,,,0,5,3,,1,0,I1.866|12:49-I0.317|1:11-I0.248|1:23-I0.322|1:11-I0.243|1:18-I0.323|1:12-I0.246|1:18-I0.321|1:13-I0.242|1:20-I0.323|1:13-I0.246|1:19-I0.325|1:13-I0.250|1:24-I0.319|1:13-I0.241|1:19-I0.332|1:11-I0.247|1:25-I0.333|1:14-I0.238|1:23-I0.323|1:17-I0.246|1:23-I0.326|1:18-I0.240|1:18-I0.328|1:05-I0.229|2:10,,Running,,,,"Polar M430",43,0,,0,168070,250480,30378,,,,,,,,,,,,,,,,,,,,,,,,,,,,,,,,,,,,,,,,,,"5,5,5,5,5,5,5,5,5",
5963650,eacd4e42-e792-4573-9b89-bbdd93ef8b5c,1433514094,120,1548678234,,0,0,15.01,3522,3552,385,391,,,1,3.6,0.76,,,495,1013,,,,,,,54.87,,1,,,,,,,,,,,,,,73,84,15.83,15.41,16.3,,,,,,,,,,,,,,,,,"1,1,0,1,4,21,68,5,0",,,,,,,152,,,,,,,,,,,,,,,,,,,,,,,,,,,,,,,,,,,,,29,4,175,38,,,,,0,3,3,,1,0,,,,,"Balve Laufen",,"Polar BEAT",,0,,0,168070,250480,30378,,,,,,,,,,,,,,,,,,,,,,,,,,,,,,,,,,,,,,,,,,"4,5,5,5",
5963651,33d2b201-e3c1-4f3b-855e-c46c7f842ad2,1496694610,120,1548678234,,0,0,8.6,2402,2444,127,122,,,1,2.2,0.55,,,285,578,,,,,,,43.07,,1,,,,,,,,,,,,,,49,80,13.12,13.01,13.43,,,,,,,,,,,,,,,,,"1,2,5,14,38,33,6,0,0",,,,,,,134,,,,,,,,,,,,,,,,,,,,,,,,,,,,,,,,,,,,,20,5,194,47,,1009,0,,0,5,3,,1,0,,,,,"Aachen Laufen",,"Polar BEAT",,0,,0,168070,250480,30378,,,,,,,,,,,,,,,,,,,,,,,,,,,,,,,,,,,,,,,,,,4,
5963652,ccfd0f78-bc22-422b-a26e-6fb83eefb164,1457377156,60,1548678235,,0,0,11.94,3381,3469,125,121,,,1,0.8,0.39,,,,827,,,,,,,43.36,,1,,,,,,,,,,,,,,70,82,12.86,12.89,13.12,,,,,,,,,,,,,,,,,"3,1,2,9,51,32,1,0,0",,,,,,,129,,,,,,,,,,,,,,,,,,,,,,,,,,,,,,,,,,,,,1,3,355,88,,1008,,,1,5,3,,1,0,,,,,"Aachen Laufen",,"Polar BEAT",,0,,0,168070,250480,30378,,,,,,,,,,,,,,,,,,,,,,,,,,,,,,,,,,,,,,,,,,,
5963653,588b3935-a68f-4e68-a148-cbdbd6059831,1430302829,120,1548678235,,0,0,10.67,3158,3158,160,160,,,1,2.3,0.57,,,323,731,,,,,,,40.84,,1,,,,,,,,,,,,,,65,83,12.48,12.28,12.69,,,,,,,,,,,,,,,,,"2,1,11,25,51,9,2,0,0",,,,,,,122,,,,,,,,,,,,,,,,,,,,,,,,,,,,,,,,,,,,,10,15,177,49,,1019,,,0,5,3,,1,0,,,,,"Aachen Laufen",,"Polar BEAT",,0,,0,168070,250480,30378,,,,,,,,,,,,,,,,,,,,,,,,,,,,,,,,,,,,,,,,,,4,
5963654,756925f0-fc31-471b-bf20-873f5b297dcb,1473105971,120,1548678236,,0,0,9.1,2908,3705,80,111,,,1,1,0.45,,,,620,,,,,,,36.9,,1,,,,,,,,,,,,,,60,80,11.32,11.39,11.46,,,,,,,,,,,,,,,,,"8,8,11,47,23,2,0,0,0",,,,,,,117,,,,,,,,,,,,,,,,,,,,,,,,,,,,,,,,,,,,,19,1,246,73,,1023,0,,1,5,3,,1,0,,,,,"Aachen Laufen",,"Polar BEAT",,0,,0,168070,250480,30378,,,,,,,,,,,,,,,,,,,,,,,,,,,,,,,,,,,,,,,,,,,
5963655,7a3a4dd0-2943-495b-807b-da5a5e0296d8,1547818613,60,1548678236,,0,0,5.3,1517,1517,4,3,,,1,0,0,,,,345,142,154,,,,64.83,40.64,64.91,1,,,,,,,,,,,,,,30,82,12.58,12.61,12.63,3.1,,,,,,,,,,,,,,,,"1,0,1,12,76,10,0,0,0","0,27,73,0,0",,,,,,128,,,,,,,,,,,,,,,,,,,,,,,,,,,,,,,,,,,,25.9,4,3,194,68,,1021,1,333,0,5,3,,1,0,,,Running,,,,"Polar M430",43,0,,0,168070,250480,30378,,,,,,,,,,,,,,,,,,,,,,,,,,,,,,,,,,,,,,,,,,,
5963656,db955d29-bc4f-4e7c-9bf2-50afec2d1e2c,1516781800,60,1548678237,,0,0,10.08,1394,1434,29,34,,,1,0,0.08,,,,327,149,178,,,,,,,1,,,,,,,,,,,,,,37,,,27.77,,20.8,-10.4,143,123,,1,160,144,,,,,,,,,"8,3,17,33,39,1,0","10,11,31,47,0","52,37,1,0,9",,,,,,,,,,,,,,,,,,,,,,,,,,,,,,,,,,,,,,,,,63,8,5,205,88,,,0,,0,5,3,,1,0,,,Cycling,,,,"Polar M430",43,0,,0,168072,,30378,,,,,,,,,,,,,,,,,,,,,,,,,,,,,,,,,,,,,,,,,,,
5963657,8c9f8f3a-6cd4-456b-9012-7a683c56ca5a,1394283415,60,1548678237,,0,0,1.36,352,353,0,2,,,1,0,0,,0.6,,74,157,181,,,,64.15,40.34,64.04,1,,,,,,,,,,,,,,10,87,14.03,14.44,14.52,-3.8,,,,,,,,,,,,,,,,"16,5,3,5,9,20,16,17,11","0,17,35,46,2",,,,,,133,,,,,,,,,,,,,,,,,,,,,,,,,,,,,,,,,,,,32,16,7,143,54,,1030,3,,0,3,3,,1,0,,,,,"4x 300m",,"Polar BEAT",,0,,0,168070,250480,30378,,,,,,,,,,,,,,,,,,,,,,,,,,,,,,,,,,,,,,,,,,,
5963658,9b96b7e8-a044-4dc8-8d70-001b10da095a,1464643113,120,1548678237,,0,0,13,2978,2978,191,196,,,1,2.3,0.66,,,500,887,,,,,,,55.83,,1,,,,,,,,,,,,,,61,84,16.01,15.84,16.21,,,,,,,,,,,,,,,,,"0,0,1,1,3,22,60,13,0",,,,,,,156,,,,,,,,,,,,,,,,,,,,,,,,,,,,,,,,,,,,,16,5,320,98,,1003,0,,1,6,3,,1,0,,,,,"Aachen Laufen",,"Polar BEAT",,0,,0,168070,250480,30378,,,,,,,,,,,,,,,,,,,,,,,,,,,,,,,,,,,,,,,,,,4,
5963659,b4d1892f-2d42-43ad-aaa6-610900bbcd7e,1415610220,60,1548678238,,0,0,7.3,2261,2261,96,72,,,1,1.1,0.48,,,,504,,,,,,,37.73,,1,,,,,,,,,,,,,,46,82,11.88,11.75,12.06,,,,,,,,,,,,,,,,,"3,5,15,38,34,5,0,0,0",,,,,,,118,,,,,,,,,,,,,,,,,,,,,,,,,,,,,,,,,,,,,9,11,194,92,,1011,,,0,5,3,,1,0,,,,,"Regenerativer DL",,"Polar BEAT",,0,,0,168070,250480,30378,,,,,,,,,,,,,,,,,,,,,,,,,,,,,,,,,,,,,,,,,,,
5963660,82767d2a-aea9-48bb-8250-981221749697,1408653576,120,1548678238,,0,0,8.53,2232,2257,20,21,,,1,0,0,,,,498,,,,,,,46.47,,1,,,,,,,,,,,,,,46,85,13.86,15.38,15.4,,,,,,,,,,,,,,,,,"34,4,3,3,4,5,7,18,22",,,,,,,135,,,,,,,,,,,,,,,,,,,,,,,,,,,,,,,,,,,,,14,5,224,74,,1016,0,,1,5,3,,1,0,,,,,"10x 400m + 500 300 500 300 200",,"Polar BEAT",,0,,0,168070,250480,30378,,,,,,,,,,,,,,,,,,,,,,,,,,,,,,,,,,,,,,,,,,,
5963661,3b6d5548-3faf-4388-b225-c558c77292cd,1403087806,120,1548678239,,0,0,7.11,2053,2061,104,79,,,1,1.3,0.55,,,,482,,,,,,,40.92,,1,,,,,,,,,,,,,,42,82,12.76,12.52,12.86,,,,,,,,,,,,,,,,,"2,2,4,22,55,16,0,0,0",,,,,,,127,,,,,,,,,,,,,,,,,,,,,,,,,,,,,,,,,,,,,16,5,11,74,,1024,4,,0,5,3,,1,0,,,,,"Regenerativer DL + Lauf ABC",,"Polar BEAT",,0,,0,168070,250480,30378,,,,,,,,,,,,,,,,,,,,,,,,,,,,,,,,,,,,,,,,,,,
5963662,b4bea2a5-2526-427a-b124-35464085dd86,1406061401,120,1548678239,,0,0,7.28,1772,1789,0,0,,,1,0,0,,,,468,,,,,,,50.11,,1,,,,,,,,,,,,,,36,82,14.81,16.3,16.3,,,,,,,,,,,,,,,,,"22,1,1,1,1,2,15,52,5",,,,,,,150,,,,,,,,,,,,,,,,,,,,,,,,,,,,,,,,,,,,,24,6,14,72,,1018,0,,0,5,3,,1,0,,,,,"2000,1000,2000,1000,500",,"Polar BEAT",,0,,0,168070,250480,30378,,,,,,,,,,,,,,,,,,,,,,,,,,,,,,,,,,,,,,,,,,,
5963663,df6e5909-6364-4dad-a0ae-ce82ea31874c,1495487807,120,1548678239,,0,0,3.37,1330,1438,21,84,,,1,1,0.7,,,,219,,,,,,,26.94,,1,,,,,,,,,,,,,,27,75,8.79,10.34,10.25,,,,,,,,,,,,,,,,,"63,14,5,3,3,2,7,3,0",,,,,,,101,,,,,,,,,,,,,,,,,,,,,,,,,,,,,,,,,,,,,20,2,112,54,,1016,0,,0,5,3,,1,0,,,,,"Aachen Laufen",,"Polar BEAT",,0,,0,168070,250480,30378,,,,,,,,,,,,,,,,,,,,,,,,,,,,,,,,,,,,,,,,,,,
5963664,5524fc11-c032-43f7-b026-04062e9cf64e,1448716159,60,1548678240,,0,0,1.84,552,552,28,28,,,1,0.8,0.56,,,,127,,,,,,,35.34,,1,,,,,,,,,,,,,,11,83,12.21,12.09,12.3,,,,,,,,,,,,,,,,,"3,1,17,20,48,10,1,0,0",,,,,,,120,,,,,,,,,,,,,,,,,,,,,,,,,,,,,,,,,,,,,5,20,254,77,,1016,,,0,5,3,,1,0,,,,,"Aachen Laufen",,"Polar BEAT",,0,,0,168070,250480,30378,,,,,,,,,,,,,,,,,,,,,,,,,,,,,,,,,,,,,,,,,,,
5963665,,1463130000,120,1548678240,,0,0,,0,0,,,,,0,,,,,,377,,,,,,,,,1,,,,,,,,,,,,,,0,,,,,,,,,,,,,,,,,,,,,,,,,,,,,,,,,,,,,,,,,,,,,,,,,,,,,,,,,,,,,,,,,,,,,,,,,,1,,,0,0,,,,,Gym,,"Polar BEAT",,0,,0,168075,,30378,,,,,,,,,,,,,,,,,,,,,,,,,,,,,,,,,,,,,,,,,,,
5963666,7ed01aa5-d9f2-42a2-8626-277f9be9565b,1540489977,120,1548678240,,0,0,16.89,4375,4376,57,57,,,1,0,0.09,1.09,0.95,,1121,154,177,,,,65.84,49.39,66.12,1,,,,,,,,,,,,,,122,82,13.94,14.09,14.17,4.7,,,,,,,,,,,,,,,,"1,1,3,9,14,47,25,0,0","0,16,44,40,0",,,,,,141,,,,,,,,,,,,,,,,,,,,,,,,,,,,,,,,,,,,67.9,14,7,255,64,,1018,0,268,1,5,3,,1,0,I1.000|4:58-I1.000|4:39-I1.000|4:12-I1.000|4:12-I1.000|4:16-I1.000|4:22-I1.000|4:08-I1.000|4:04-I1.000|4:01-I1.000|4:03-I1.000|4:06-I1.000|3:58-I1.000|4:02-I1.000|4:01-I1.000|4:03-I1.000|5:00-I0.892|4:51,,Running,,,,"Polar M430",43,0,,0,168070,250480,30378,,,,,,,,,,,,,,,,,,,,,,,,,,,,,,,,,,,,,,,,,,,
5963667,33b1c032-9d49-4f6d-97b3-0ce57c230aa3,1477425409,120,1548678241,,0,0,5.91,1647,1722,64,57,,,1,0.8,0.56,,,,397,,,,,,,42.21,,1,,,,,,,,,,,,,,34,81,13.14,13.06,13.41,,,,,,,,,,,,,,,,,"0,3,7,12,40,32,5,1,0",,,,,,,133,,,,,,,,,,,,,,,,,,,,,,,,,,,,,,,,,,,,,9,0,38,97,,1026,0,,1,5,3,,1,0,,,,,"Aachen Laufen",,"Polar BEAT",,0,,0,168070,250480,30378,,,,,,,,,,,,,,,,,,,,,,,,,,,,,,,,,,,,,,,,,,,
5963668,dc461947-16ac-4c61-b044-f660f416b593,1509470076,60,1548678241,,0,0,11.37,3259,3260,33,33,,,1,0,0.04,1.02,0.97,,750,146,156,,,,62.43,42.6,62.65,1,,,,,,,,,,,,,,73,81,12.6,12.63,12.68,-1.7,,,,,,,,,,,,,,,,"1,0,0,20,61,18,0,0,0","0,9,91,0,0",,,,,,129,,,,,,,,,,,,,,,,,,,,,,,,,,,,,,,,,,,,30.1,9,0,90,66,,,0,,1,3,3,,1,0,I1.000|5:04-I1.000|4:48-I1.000|4:54-I1.000|4:40-I1.000|4:44-I1.000|4:45-I1.000|4:31-I1.000|4:41-I1.000|4:45-I1.000|4:58-I1.000|4:41-I0.374|1:50,,Running,,,,"Polar M430",43,0,,0,168070,250480,30378,,,,,,,,,,,,,,,,,,,,,,,,,,,,,,,,,,,,,,,,,,,
5963669,191eee1f-4a96-4eed-a852-fbb19b61dc1d,1439498345,120,1548678242,,0,0,3.07,860,868,0,3,,,1,0,0.01,,,,171,,,,,,,40.15,,1,,,,,,,,,,,,,,17,82,12.85,15.2,15.19,,,,,,,,,,,,,,,,,"32,3,3,5,4,5,7,32,9",,,,,,,131,,,,,,,,,,,,,,,,,,,,,,,,,,,,,,,,,,,,,26,5,67,65,,1009,,,0,5,3,,1,0,,,,,"Aachen Laufen",,"Polar BEAT",,0,,0,168070,250480,30378,,,,,,,,,,,,,,,,,,,,,,,,,,,,,,,,,,,,,,,,,,,
5963670,bd8f157f-06ec-4ccf-aa47-3416935d93cd,1519763785,60,1548678242,,0,0,11.06,2088,2178,56,43,,,1,0,0.07,2.11,,,380,128,147,,,,,,,1,,,,,,,,,,,,,,30,,,21.46,,23.3,-10.8,109,82,,1,130,111,,,,,,,,,"19,7,70,3,0,0,0","3,88,9,0,0","86,0,5,7,2",,,,,,,,,,,,,,,,,,,,,,,,,,,,,,,,,,,,,,,,,16.7,-7,0,76,52,,,0,,1,3,3,,1,0,,,Cycling,,,,"Polar M430",43,0,,0,168072,,30378,,,,,,,,,,,,,,,,,,,,,,,,,,,,,,,,,,,,,,,,,,,
5963671,b563daa4-60d0-458f-94fa-2c89d133c96c,1422306075,60,1548678243,,0,0,11.69,3291,3333,120,120,,,1,1.1,0.48,,,165,788,,,,,,,43.59,,1,,,,,,,,,,,,,,68,84,12.94,13.14,13.37,,,,,,,,,,,,,,,,,"4,0,4,12,32,42,5,0,0",,,,,,,127,,,,,,,,,,,,,,,,,,,,,,,,,,,,,,,,,,,,,4,8,297,94,,1021,0,,1,5,3,,1,0,,,,,"Aachen Laufen",,"Polar BEAT",,0,,0,168070,250480,30378,,,,,,,,,,,,,,,,,,,,,,,,,,,,,,,,,,,,,,,,,,5,
5963672,c2632ce2-631e-4c30-ba1f-151ba6c70363,1392145731,60,1548678244,,0,0,2.45,924,943,32,15,,,1,0.2,0.34,1.7,1.39,,139,155,178,,,,41.03,27.84,42.05,1,,,,,,,,,,,,,,26,75,9.77,12.34,12.81,38.6,,,,,,,,,,,,,,,,"34,2,1,3,20,35,6,0,0","0,14,48,37,0",,,,,,106,,,,,,,,,,,,,,,,,,,,,,,,,,,,,,,,,,,,47.7,5,24,206,73,,1002,,,1,5,3,,1,0,,,,,Einlaufen,,"Polar BEAT",,0,,0,168070,250480,30378,,,,,,,,,,,,,,,,,,,,,,,,,,,,,,,,,,,,,,,,,,,
5963673,a7b2f5d7-758e-4476-8dc9-8a316a452720,1366916651,120,1548678246,,0,0,47.64,6310,6362,655,666,,,1,2.9,0.48,1.05,1.22,642,1926,129,210,,,,,,,1,,,,,,,,,,,,,,102,,,32.16,,-3.3,-47.1,322,240,,1,431,353,,,,,,,,,"17,17,14,14,13,7,17","8,60,29,1,1","49,14,10,6,21",,,,,,,,,,,,,,,,,,,,,,,,,,,,,,,,,,,,,,,,,40.8,24,6,239,42,,1018,0,,0,3,3,,1,0,,,,,,,"Polar BEAT",,0,,0,168072,,30378,,,,,,,,,,,,,,,,,,,,,,,,,,,,,,,,,,,,,,,,,,"4,4,4,5",
5963674,2c35e79c-99bc-4d78-8159-07b4cfded350,1494067671,120,1548678247,,0,0,2.14,683,1037,40,30,,,1,1.5,0.62,,,706,147,,,,,,,33.44,,1,,,,,,,,,,,,,,14,81,11.73,11.62,12.15,,,,,,,,,,,,,,,,,"13,7,17,12,46,5,0,0,0",,,,,,,116,,,,,,,,,,,,,,,,,,,,,,,,,,,,,,,,,,,,,14,8,92,76,,1010,4,,0,3,3,,1,0,,,,,"Aachen Laufen",,"Polar BEAT",,0,,0,168070,250480,30378,,,,,,,,,,,,,,,,,,,,,,,,,,,,,,,,,,,,,,,,,,5,
5963675,d7314317-a338-44c0-a712-7f79eab6bc4e,1428572454,120,1548678247,,0,0,3.09,1009,1009,62,47,,,1,1.8,0.61,,,345,208,,,,,,,33.6,,1,,,,,,,,,,,,,,20,82,11.61,11.06,12,,,,,,,,,,,,,,,,,"5,11,26,43,14,1,0,0,0",,,,,,,112,,,,,,,,,,,,,,,,,,,,,,,,,,,,,,,,,,,,,10,7,160,73,,1029,,,0,3,3,,1,0,,,,,"Aachen Laufen",,"Polar BEAT",,0,,0,168070,250480,30378,,,,,,,,,,,,,,,,,,,,,,,,,,,,,,,,,,,,,,,,,,4,
5963676,a783cb12-f247-45ce-a06c-0cae0f841afd,1424373205,60,1548678247,,0,0,11.66,3519,3635,73,72,,,1,0.3,0.2,,,445,701,,,,,,,40.18,,1,,,,,,,,,,,,,,73,82,12.04,14.05,14.25,,,,,,,,,,,,,,,,,"25,5,5,8,12,12,8,17,6",,,,,,,121,,,,,,,,,,,,,,,,,,,,,,,,,,,,,,,,,,,,,1,16,190,82,,1025,,,1,5,3,,1,0,,,,,"2x 4x (500,200)",,"Polar BEAT",,0,,0,168070,250480,30378,,,,,,,,,,,,,,,,,,,,,,,,,,,,,,,,,,,,,,,,,,5,
5963677,83d4f695-c41b-48cb-aada-596162dbc07a,1443642501,120,1548678247,,0,0,2.51,847,848,47,45,,,1,1,0.44,,,,172,,,,,,,31.8,,1,,,,,,,,,,,,,,17,79,10.99,11.39,11.92,,,,,,,,,,,,,,,,,"12,3,9,49,18,8,0,0,0",,,,,,,113,,,,,,,,,,,,,,,,,,,,,,,,,,,,,,,,,,,,,12,12,62,62,,1031,,,1,3,3,,1,0,,,,,"Aachen Laufen",,"Polar BEAT",,0,,0,168070,250480,30378,,,,,,,,,,,,,,,,,,,,,,,,,,,,,,,,,,,,,,,,,,,
5963678,059e27e0-9d69-42bb-a446-f1d0b7167789,1397478199,120,1548678248,,0,0,11.53,3514,3548,40,43,,,1,0,0.11,1.03,1.02,,577,146,165,,,,57.87,39.69,58.1,1,,,,,,,,,,,,,,79,82,11.87,12.64,12.7,-15.6,,,,,,,,,,,,,,,,"9,2,4,15,40,29,3,0,0","1,13,85,1,0",,,,,,120,,,,,,,,,,,,,,,,,,,,,,,,,,,,,,,,,,,,32.6,10,32,315,71,,1018,4,,0,5,3,,1,0,,,,,"Regenerativer DL",,"Polar BEAT",,0,,0,168070,250480,30378,,,,,,,,,,,,,,,,,,,,,,,,,,,,,,,,,,,,,,,,,,,
5963679,ad461847-70b9-48ec-8d8d-5b1c0cbbe558,1401798390,120,1548678249,,0,0,8.26,2247,2534,125,125,,,1,1.7,0.59,,,410,549,,,,,,,44.31,,1,,,,,,,,,,,,,,46,83,13.66,13.35,13.87,,,,,,,,,,,,,,,,,"3,2,4,10,26,49,5,1,1",,,,,,,133,,,,,,,,,,,,,,,,,,,,,,,,,,,,,,,,,,,,,21,3,276,47,,1015,6,,0,5,3,,1,0,,,,,"Regenerativer DL ",,"Polar BEAT",,0,,0,168070,250480,30378,,,,,,,,,,,,,,,,,,,,,,,,,,,,,,,,,,,,,,,,,,5,
5963681,92a603f4-3d31-4542-9650-f7fc7fefdaf3,1510766102,60,1548678249,,0,0,11.79,3468,3472,49,48,,,1,0,0.1,1.13,0.96,,774,143,160,,,,62.12,41.44,62.44,1,,,,,,,,,,,,,,73,82,12.29,12.42,12.51,5.1,,,,,,,,,,,,,,,,"2,1,12,27,36,19,1,0,0","0,42,57,0,0",,,,,,124,,,,,,,,,,,,,,,,,,,,,,,,,,,,,,,,,,,,37.7,4,2,41,83,,,0,,1,9,3,,1,0,I1.000|5:01-I1.000|4:47-I1.000|4:23-I1.000|4:24-I1.000|4:28-I1.000|4:32-I1.000|4:42-I1.000|5:19-I1.000|5:16-I1.000|5:17-I1.000|5:19-I0.790|4:25,,Running,,,,"Polar M430",43,0,,0,168070,250480,30378,,,,,,,,,,,,,,,,,,,,,,,,,,,,,,,,,,,,,,,,,,,
5963682,9f38c7b5-7b38-4a09-bd2e-c1247f037e56,1490905686,120,1548678250,,0,0,4.19,1203,1303,81,85,,,1,1.7,0.95,,,,259,,,,,,,39.91,,1,,,,,,,,,,,,,,24,80,12.81,14.4,14.9,,,,,,,,,,,,,,,,,"33,7,5,4,4,5,8,33,1",,,,,,,131,,,,,,,,,,,,,,,,,,,,,,,,,,,,,,,,,,,,,18,3,152,54,,1021,0,,1,5,3,,1,0,,,,,"Aachen Laufen",,"Polar BEAT",,0,,0,168070,250480,30378,,,,,,,,,,,,,,,,,,,,,,,,,,,,,,,,,,,,,,,,,,,
5963683,aa8f739a-e7a5-45bc-957a-6a327203c8b1,1416214964,60,1548678250,,0,0,13.26,4036,4047,169,169,,,1,1.8,0.58,,,363,886,,,,,,,40.18,,1,,,,,,,,,,,,,,83,83,12.03,12.03,12.24,,,,,,,,,,,,,,,,,"6,5,11,28,35,15,0,0,0",,,,,,,119,,,,,,,,,,,,,,,,,,,,,,,,,,,,,,,,,,,,,7,5,142,93,,1004,0,,0,5,3,,1,0,,,,,"Langsamer DL",,"Polar BEAT",,0,,0,168070,250480,30378,,,,,,,,,,,,,,,,,,,,,,,,,,,,,,,,,,,,,,,,,,"5,5",
5963684,f84f92b1-50ea-4b10-9c77-8b6c4981cd2b,1363429609,60,1548678251,,0,0,1.3,633,633,4,4,,,1,0,0.16,,,,89,,,,,,,19.35,,1,,,,,,,,,,,,,,13,,7.46,10.26,10.44,,,,,,,,,,,,,,,,,"48,3,4,13,21,10,0,0,0",,,,,,,,,,,,,,,,,,,,,,,,,,,,,,,,,,,,,,,,,,,,1,5,141,54,,1020,3,,0,3,3,,1,0,,,,,,,"Polar BEAT",,0,,0,168070,250480,30378,,,,,,,,,,,,,,,,,,,,,,,,,,,,,,,,,,,,,,,,,,,
5963685,4adb1741-6d12-4879-a6bd-feed5b54f5da,1526757067,120,1548678251,,0,0,12.69,3531,3538,28,29,,,1,0,0,,,,859,150,159,,,,62.47,44.46,62.64,1,,,,,,,,,,,,,,88,83,12.96,13,13.04,1,,,,,,,,,,,,,,,,"1,0,2,11,50,33,2,0,0","1,2,97,0,0",,,,,,130,,,,,,,,,,,,,,,,,,,,,,,,,,,,,,,,,,,,39.3,20,15,11,47,,,,,0,3,3,,1,0,I1.000|4:59-I1.000|4:41-I1.000|4:34-I1.000|4:38-I1.000|4:37-I1.000|4:32-I1.000|4:42-I1.000|4:27-I1.000|4:33-I1.000|4:30-I1.000|4:29-I1.000|4:52-I0.694|3:25,,Running,,,,"Polar M430",43,0,,0,168070,250480,30378,,,,,,,,,,,,,,,,,,,,,,,,,,,,,,,,,,,,,,,,,,,
5963686,c233a211-1986-440f-b48d-9906b7377af6,1500419144,120,1548678252,,0,0,12.63,3800,3801,232,231,,,1,2.5,0.49,,,430,865,,,,,,,40.57,,1,,,,,,,,,,,,,,78,80,12.29,12.6,13.19,,,,,,,,,,,,,,,,,"7,1,6,27,30,25,3,1,0",,,,,,,125,,,,,,,,,,,,,,,,,,,,,,,,,,,,,,,,,,,,,21,4,107,56,,1017,0,,1,3,3,,1,0,,,,,"Aix-en-Provence Laufen",,"Polar BEAT",,0,,0,168070,250480,30378,,,,,,,,,,,,,,,,,,,,,,,,,,,,,,,,,,,,,,,,,,"4,5,5",
5963687,ed0b9684-cf64-474c-b652-992ad634d154,1471726854,120,1548678252,,0,0,2.45,989,1036,16,17,,,1,0.1,0.33,,,,158,,,,,,,25.66,,1,,,,,,,,,,,,,,20,72,9.04,10.85,10.8,,,,,,,,,,,,,,,,,"47,15,9,7,7,7,3,3,3",,,,,,,103,,,,,,,,,,,,,,,,,,,,,,,,,,,,,,,,,,,,,19,2,258,79,,,0,,1,3,3,,1,0,,,,,"Naujac-sur-Mer Laufen",,"Polar BEAT",,0,,0,168070,250480,30378,,,,,,,,,,,,,,,,,,,,,,,,,,,,,,,,,,,,,,,,,,,
5963688,3029e127-0fcc-4d34-b815-cc3adb443ebf,1462529739,120,1548678253,,0,0,23.01,6289,6665,406,409,,,1,3.5,0.61,,,389,1607,,,,,,,47.57,,1,,,,,,,,,,,,,,130,82,13.54,13.51,14.05,,,,,,,,,,,,,,,,,"4,1,3,7,32,39,12,1,0",,,,,,,134,,,,,,,,,,,,,,,,,,,,,,,,,,,,,,,,,,,,,17,13,136,55,,1014,,,0,3,3,,1,0,,,,,"Aachen Laufen",,"Polar BEAT",,0,,0,168070,250480,30378,,,,,,,,,,,,,,,,,,,,,,,,,,,,,,,,,,,,,,,,,,"4,4,4,5",
5963689,82353326-5114-425e-ab0c-e37435be3a0a,1532005135,120,1548678254,,0,0,10.89,3285,3285,328,329,,,1,4.1,0.78,1.05,1.08,724,824,152,173,,,,55.54,40,57.6,1,,,,,,,,,,,,,,86,82,13.01,12.51,13.38,-8.9,,,,,,,,,,,,,,,,"16,12,7,17,12,26,9,0,0","1,13,65,21,0",,,,,,121,,,,,,,,,,,,,,,,,,,,,,,,,,,,,,,,,,,,57.2,24,7,50,38,,,,,0,3,3,,1,0,I2.237|12:05-I2.696|17:01-I0.541|2:43-I4.411|18:44-I1.008|4:13,,Running,,,,"Polar M430",43,0,,0,168070,250480,30378,,,,,,,,,,,,,,,,,,,,,,,,,,,,,,,,,,,,,,,,,,3,
5963690,221c2133-9093-4990-a98e-b77af0559247,1505154827,120,1548678254,,0,0,13.03,3326,3326,181,190,,,1,2.2,0.57,1.02,1.03,382,856,157,179,,,,65.26,49.24,66.33,1,,,,,,,,,,,,,,99,82,14.36,14.24,14.55,2.8,,,,,,,,,,,,,,,,"0,0,2,3,20,50,25,0,0","0,6,49,45,0",,,,,,143,,,,,,,,,,,,,,,,,,,,,,,,,,,,,,,,,,,,69.1,14,25,225,71,,1000,,,0,6,3,,1,0,I1.000|4:35-I1.000|4:13-I1.000|4:25-I1.000|4:04-I1.000|3:47-I1.000|4:14-I1.000|4:41-I1.000|4:04-I1.000|4:19-I1.000|3:47-I1.000|4:08-I1.000|4:32-I1.000|4:29-I0.036|0:09,,Running,,,,"Polar M430",43,0,,0,168070,250480,30378,,,,,,,,,,,,,,,,,,,,,,,,,,,,,,,,,,,,,,,,,,4,
5963691,efd311e1-da5c-45cf-8e36-c929fdcd2f25,1529602558,120,1548678255,,0,0,1.66,577,581,11,9,,,1,0.4,0.39,0.96,0.93,,108,132,152,,,,55.8,29.54,56.34,1,,,,,,,,,,,,,,9,78,10.58,11,11.12,18.6,,,,,,,,,,,,,,,,"23,8,18,23,19,9,0,0,0","3,70,27,0,0",,,,,,111,,,,,,,,,,,,,,,,,,,,,,,,,,,,,,,,,,,,12.4,20,21,7,41,,1016,,,0,3,3,,1,0,I1.000|5:10-I0.666|4:32,,Running,,,,"Polar M430",43,0,,0,168070,250480,30378,,,,,,,,,,,,,,,,,,,,,,,,,,,,,,,,,,,,,,,,,,,
5963692,9c975065-c3fb-4094-b7c1-1e72caa92edc,1545329234,60,1548678255,,0,0,2,888,892,13,12,,,1,0,0.2,1.01,1.01,,152,122,160,,,,45.13,22.52,45.52,1,,,,,,,,,,,,,,11,73,8.23,10.86,10.95,49.6,,,,,,,,,,,,,,,,"72,0,0,1,3,12,10,1,0","15,65,20,0,0",,,,,,93,,,,,,,,,,,,,,,,,,,,,,,,,,,,,,,,,,,,15.7,8,27,200,81,,1019,0,361,1,4,3,,1,0,I1.000|4:05-I1.000|10:45-I0.003|0:03,,Running,,,,"Polar M430",43,0,,0,168070,250480,30378,,,,,,,,,,,,,,,,,,,,,,,,,,,,,,,,,,,,,,,,,,,
5963693,78f06ac1-af0a-4740-a12e-26c8ef586860,1512065572,60,1548678255,,0,0,14.69,4031,4032,55,56,,,1,0,0.08,1.16,0.94,,959,149,172,,,,64.13,45.69,64.42,1,,,,,,,,,,,,,,98,81,13.16,13.25,13.34,-0.6,,,,,,,,,,,,,,,,"1,0,1,14,39,40,4,0,0","0,12,81,7,0",,,,,,135,,,,,,,,,,,,,,,,,,,,,,,,,,,,,,,,,,,,50.7,2,5,209,93,,1008,,,1,6,3,,1,0,I1.000|5:05-I1.000|4:48-I1.000|4:45-I1.000|4:37-I1.000|4:40-I1.000|4:44-I1.000|4:36-I1.000|4:32-I1.000|4:24-I1.000|4:12-I1.000|4:15-I1.000|4:16-I1.000|4:16-I1.000|4:33-I0.690|3:30,,Running,,,,"Polar M430",43,0,,0,168070,250480,30378,,,,,,,,,,,,,,,,,,,,,,,,,,,,,,,,,,,,,,,,,,,
5963694,bb9fe7b4-6b02-456e-92f8-167c9ac8cde8,1413494530,120,1548678256,,0,0,2.21,777,777,23,24,,,1,0.5,0.37,,,,146,,,,,,,29.98,,1,,,,,,,,,,,,,,16,81,10.35,10.35,10.59,,,,,,,,,,,,,,,,,"16,25,26,33,0,0,0,0,0",,,,,,,105,,,,,,,,,,,,,,,,,,,,,,,,,,,,,,,,,,,,,13,6,205,89,,1009,0,,1,5,3,,1,0,,,,,Auslaufen,,"Polar BEAT",,0,,0,168070,250480,30378,,,,,,,,,,,,,,,,,,,,,,,,,,,,,,,,,,,,,,,,,,,
5963695,78bfb44e-e367-45bf-a042-2f3347fd0ae4,1538567898,120,1548678256,,0,0,6.07,1834,1834,39,36,,,1,0,0.2,1.17,0.91,,397,138,158,,,,62.86,38.42,63.39,1,,,,,,,,,,,,,,34,81,11.97,11.95,12.13,-4.2,,,,,,,,,,,,,,,,"0,1,5,56,36,3,0,0,0","2,45,53,0,0",,,,,,123,,,,,,,,,,,,,,,,,,,,,,,,,,,,,,,,,,,,22.7,14,19,210,70,,1026,,,0,4,3,,1,0,I1.000|5:06-I1.000|4:48-I1.000|5:11-I1.000|5:20-I1.000|5:01-I1.000|4:51-I0.071|0:19,,Running,,,,"Polar M430",43,0,,0,168070,250480,30378,,,,,,,,,,,,,,,,,,,,,,,,,,,,,,,,,,,,,,,,,,,
5963696,5cf12a99-f4c0-4292-bafc-d187a738a7ee,1398946796,120,1548678257,,0,0,7.65,3352,3500,85,54,,,1,0.7,0.4,1.77,1.67,,423,150,197,,,,35.64,24.99,36.32,1,,,,,,,,,,,,,,84,76,8.34,10.57,10.81,42.5,,,,,,,,,,,,,,,,"35,5,18,23,10,7,2,0,0","0,22,70,7,1",,,,,,90,,,,,,,,,,,,,,,,,,,,,,,,,,,,,,,,,,,,57.4,16,2,258,64,,1012,5,,0,5,3,,1,0,,,,,Einlaufen,,"Polar BEAT",,0,,0,168070,250480,30378,,,,,,,,,,,,,,,,,,,,,,,,,,,,,,,,,,,,,,,,,,,
5963697,2be3ac27-fd59-4220-9906-ec463d8a2853,1449256732,60,1548678257,,0,0,8.54,2136,2136,92,90,,,1,0.7,0.43,,,,572,,,,,,,49,,1,,,,,,,,,,,,,,44,84,14.57,14.86,14.99,,,,,,,,,,,,,,,,,"0,1,2,7,33,28,9,18,2",,,,,,,143,,,,,,,,,,,,,,,,,,,,,,,,,,,,,,,,,,,,,6,14,213,85,,1033,,,1,3,3,,1,0,,,,,"Aachen Laufen",,"Polar BEAT",,0,,0,168070,250480,30378,,,,,,,,,,,,,,,,,,,,,,,,,,,,,,,,,,,,,,,,,,,
5963698,f3446d88-18b1-4ad9-9340-6773cbb18cbf,1429647071,120,1548678257,,0,0,3.36,937,937,66,66,,,1,1.6,0.58,,,461,229,,,,,,,40.66,,1,,,,,,,,,,,,,,19,81,13.32,13.02,13.8,,,,,,,,,,,,,,,,,"0,0,6,26,32,28,9,0,0",,,,,,,133,,,,,,,,,,,,,,,,,,,,,,,,,,,,,,,,,,,,,14,11,350,45,,1030,,,0,3,3,,1,0,,,,,"Aachen Laufen",,"Polar BEAT",,0,,0,168070,250480,30378,,,,,,,,,,,,,,,,,,,,,,,,,,,,,,,,,,,,,,,,,,4,
5963699,76f007f0-c840-42c6-a3cb-b4845ea0a0de,1443119825,120,1548678259,,0,0,1.93,468,468,0,3,,,1,0,0,,,,119,,,,,,,45.16,,1,,,,,,,,,,,,,,9,88,14.73,15.73,15.69,,,,,,,,,,,,,,,,,"21,3,3,3,4,5,11,41,9",,,,,,,141,,,,,,,,,,,,,,,,,,,,,,,,,,,,,,,,,,,,,15,14,211,72,,1016,,,0,4,3,,1,0,,,,,"Münster Laufen",,"Polar BEAT",,0,,0,168070,250480,30378,,,,,,,,,,,,,,,,,,,,,,,,,,,,,,,,,,,,,,,,,,,
5963700,b914ad28-0a1c-495e-8237-56afe9b2ca4a,1396639977,120,1548678259,,0,0,0.86,247,247,0,26,,,1,0.6,0.47,,1.08,,42,128,144,,,,73.24,34.1,70.5,1,,,,,,,,,,,,,,3,82,11.92,12.73,11.91,-7.1,,,,,,,,,,,,,,,,"5,9,10,19,13,29,15,0,0","0,84,15,0,0",,,,,,127,,,,,,,,,,,,,,,,,,,,,,,,,,,,,,,,,,,,6.3,13,8,320,82,,1010,,,0,5,3,,1,0,,,,,"Steigerungen + Auslaufen",,"Polar BEAT",,0,,0,168070,250480,30378,,,,,,,,,,,,,,,,,,,,,,,,,,,,,,,,,,,,,,,,,,,
5963701,3f02eb0e-c5c1-43f1-a5be-ca46c82f3412,1539108324,120,1548678259,,0,0,17.6,4334,4335,56,56,,,1,0,0.07,1.06,0.9,,759,121,153,,,,94.59,52.53,94.97,1,,,,,,,,,,,,,,52,83,14.66,14.69,14.77,-1.3,,,,,,,,,,,,,,,,"0,0,0,0,12,49,39,1,0","3,88,10,0,0",,,,,,147,,,,,,,,,,,,,,,,,,,,,,,,,,,,,,,,,,,,20.8,19,11,28,65,,1020,0,278,0,5,3,,1,0,I1.000|4:27-I1.000|4:30-I1.000|4:23-I1.000|4:21-I1.000|4:23-I1.000|4:07-I1.000|3:59-I1.000|4:04-I1.000|4:02-I1.000|3:53-I1.000|3:59-I1.000|3:57-I1.000|4:00-I1.000|4:01-I1.000|3:52-I1.000|3:54-I1.000|3:54-I0.603|2:32,,Running,,"Puls falsch ",,"Polar M430",43,0,,0,168070,250480,30378,,,,,,,,,,,,,,,,,,,,,,,,,,,,,,,,,,,,,,,,,,,
5963702,6fa0d1c7-d525-4e80-87ea-6bd9fb8626e7,1531556201,120,1548678260,,0,0,8.22,2603,2604,46,46,,,1,0,0.1,1.17,0.92,,604,144,155,,,,56.2,37.04,56.59,1,,,,,,,,,,,,,,55,81,11.41,11.41,11.55,-0.2,,,,,,,,,,,,,,,,"1,5,19,56,19,1,0,0,0","1,13,87,0,0",,,,,,117,,,,,,,,,,,,,,,,,,,,,,,,,,,,,,,,,,,,28.9,20,8,74,70,,,,,0,3,3,,1,0,I1.000|5:39-I1.000|5:15-I1.000|5:22-I1.000|5:08-I1.000|5:13-I1.000|5:16-I1.000|5:20-I1.000|5:06-I0.223|1:06,,Running,,,,"Polar M430",43,0,,0,168070,250480,30378,,,,,,,,,,,,,,,,,,,,,,,,,,,,,,,,,,,,,,,,,,,
5963703,3185a0ba-90a9-4f9a-bc4b-6ebe014563e1,1426663699,60,1548678261,,0,0,10.49,3602,3827,142,142,,,1,1.7,0.56,,,307,727,,,,,,,34.26,,1,,,,,,,,,,,,,,74,81,10.68,10.77,11.08,,,,,,,,,,,,,,,,,"14,10,27,39,8,2,0,0,0",,,,,,,108,,,,,,,,,,,,,,,,,,,,,,,,,,,,,,,,,,,,,3,0,301,91,,1026,0,,0,5,3,,1,0,,,,,"Aachen Laufen",,"Polar BEAT",,0,,0,168070,250480,30378,,,,,,,,,,,,,,,,,,,,,,,,,,,,,,,,,,,,,,,,,,"5,5",
5963704,e8dba07a-8e29-4e34-a7bd-098f0966c41d,1501418459,120,1548678262,,0,0,9.76,2247,2247,102,92,,,1,0.2,0.35,0.95,0.99,,568,178,190,,,,61.38,54.45,62.25,1,,,,,,,,,,,,,,106,85,15.87,15.8,15.98,9.2,,,,,,,,,,,,,,,,"0,0,1,2,4,20,58,14,1","0,0,5,40,55",,,,,,153,,,,,,,,,,,,,,,,,,,,,,,,,,,,,,,,,,,,141.8,23,19,225,57,,1009,5,,0,5,3,,1,0,I4.760|17:55-I5.011|19:33,,Running,,,,"Polar M430",43,0,,0,168070,250480,30378,,,,,,,,,,,,,,,,,,,,,,,,,,,,,,,,,,,,,,,,,,,
5963705,1691f30f-31ef-4363-aada-e63b1c7c56be,1413319214,120,1548678262,,0,0,11.19,2860,2898,108,109,,,1,0,0.06,,0.44,,597,162,186,,,,62.29,48.63,63.03,1,,,,,,,,,,,,,,101,84,14.16,16.22,16.27,14,,,,,,,,,,,,,,,,"26,1,1,1,1,1,10,60,0","0,19,10,65,6",,,,,,140,,,,,,,,,,,,,,,,,,,,,,,,,,,,,,,,,,,,103,13,9,207,72,,1008,,,1,5,3,,1,0,,,,,5x2000m,,"Polar BEAT",,0,,0,168070,250480,30378,,,,,,,,,,,,,,,,,,,,,,,,,,,,,,,,,,,,,,,,,,,
5963706,7d0e7856-c0a0-4c75-ba91-81d7aa2257fd,1368104905,120,1548678262,,0,0,3.37,1011,1013,65,63,,,1,1.8,0.64,,,453,231,,,,,,,37.35,,1,,,,,,,,,,,,,,20,,12.54,12.53,13.3,,,,,,,,,,,,,,,,,"7,2,6,26,31,25,4,0,0",,,,,,,,,,,,,,,,,,,,,,,,,,,,,,,,,,,,,,,,,,,,15,12,247,61,,1014,6,,0,5,3,,1,0,,,,,,,"Polar BEAT",,0,,0,168070,250480,30378,,,,,,,,,,,,,,,,,,,,,,,,,,,,,,,,,,,,,,,,,,4,
5963707,b44ec8e2-862f-449b-99f8-f2491b8633cf,1444640813,120,1548678263,,0,0,9.89,3251,3252,162,159,,,1,2.1,0.47,,,517,683,,,,,,,35.91,,1,,,,,,,,,,,,,,67,84,11.33,11.08,11.58,,,,,,,,,,,,,,,,,"10,13,18,43,14,0,0,0,0",,,,,,,109,,,,,,,,,,,,,,,,,,,,,,,,,,,,,,,,,,,,,4,7,95,84,,1018,,,0,5,3,,1,0,,,,,"Aachen Laufen",,"Polar BEAT",,0,,0,168070,250480,30378,,,,,,,,,,,,,,,,,,,,,,,,,,,,,,,,,,,,,,,,,,"5,5,5",
5963708,756dd014-6309-4983-bedf-78aa264ae04d,1458069898,60,1548678263,,0,0,0.8,251,278,9,7,,,1,0,0,,,,56,,,,,,,30.61,,1,,,,,,,,,,,,,,5,81,11.73,11.49,11.81,,,,,,,,,,,,,,,,,"8,2,6,51,32,0,0,0,0",,,,,,,118,,,,,,,,,,,,,,,,,,,,,,,,,,,,,,,,,,,,,4,11,38,86,,1026,,,1,5,3,,1,0,,,,,"Aachen Laufen",,"Polar BEAT",,0,,0,168070,250480,30378,,,,,,,,,,,,,,,,,,,,,,,,,,,,,,,,,,,,,,,,,,,
5963709,b46f0099-3fbd-4fea-9533-e26a84f0d5bc,1480237737,60,1548678264,,0,0,6.4,2015,2126,20,22,,,1,0,0.03,,,,441,,,,,,,36.71,,1,,,,,,,,,,,,,,41,80,11.48,12.18,12.21,,,,,,,,,,,,,,,,,"13,1,6,17,45,16,2,1,0",,,,,,,119,,,,,,,,,,,,,,,,,,,,,,,,,,,,,,,,,,,,,8,5,27,85,,1022,0,,0,4,3,,1,0,,,,,"'s-Gravenhage Laufen",,"Polar BEAT",,0,,0,168070,250480,30378,,,,,,,,,,,,,,,,,,,,,,,,,,,,,,,,,,,,,,,,,,,
5963710,ac0767c8-21a6-4d28-836f-caf7dfb14381,1446923040,60,1548678264,,0,0,3.94,1003,1004,91,81,,,1,2.1,0.95,,,,259,,,,,,,45.74,,1,,,,,,,,,,,,,,20,79,14.55,15.94,16.58,,,,,,,,,,,,,,,,,"24,1,1,1,2,2,4,65,0",,,,,,,149,,,,,,,,,,,,,,,,,,,,,,,,,,,,,,,,,,,,,17,20,210,85,,1023,,,1,5,3,,1,0,,,,,"Aachen Laufen",,"Polar BEAT",,0,,0,168070,250480,30378,,,,,,,,,,,,,,,,,,,,,,,,,,,,,,,,,,,,,,,,,,,
5963711,19e33540-aabb-48a7-8a18-925dc56246f7,1496154018,120,1548678264,,0,0,10.38,2770,2800,174,181,,,1,2.5,0.55,,,517,687,,,,,,,46,,1,,,,,,,,,,,,,,57,80,13.88,13.76,14.16,,,,,,,,,,,,,,,,,"2,2,5,12,26,29,24,1,0",,,,,,,141,,,,,,,,,,,,,,,,,,,,,,,,,,,,,,,,,,,,,23,11,257,68,,1015,6,,0,5,3,,1,0,,,,,"Aachen Laufen",,"Polar BEAT",,0,,0,168070,250480,30378,,,,,,,,,,,,,,,,,,,,,,,,,,,,,,,,,,,,,,,,,,4,
5963712,613c4d4e-787f-42da-8559-1b1bb508b34c,1404566039,120,1548678264,,0,0,2.51,885,886,90,36,,,1,2.2,0.84,,,447,166,,,,,,,30.21,,1,,,,,,,,,,,,,,18,79,11.46,10.43,12.03,,,,,,,,,,,,,,,,,"20,20,30,25,6,0,0,0,0",,,,,,,108,,,,,,,,,,,,,,,,,,,,,,,,,,,,,,,,,,,,,19,11,206,88,,1008,5,,0,6,3,,1,0,,,,,"Einlaufen + Lauf ABC + Bergsprints",,"Polar BEAT",,0,,0,168070,250480,30378,,,,,,,,,,,,,,,,,,,,,,,,,,,,,,,,,,,,,,,,,,4,
5963713,04b97df0-d642-4b0e-af9d-d03ef6649d27,1466521776,120,1548678265,,0,0,9.6,2199,2467,159,158,,,1,2.1,0.63,,,635,660,,,,,,,54.71,,1,,,,,,,,,,,,,,45,84,16.11,15.9,16.28,,,,,,,,,,,,,,,,,"0,1,1,1,4,22,53,19,0",,,,,,,156,,,,,,,,,,,,,,,,,,,,,,,,,,,,,,,,,,,,,21,9,202,76,,1020,5,,0,5,3,,1,0,,,,,"Voeren Sint-Martens-Voeren Laufen",,"Polar BEAT",,0,,0,168070,250480,30378,,,,,,,,,,,,,,,,,,,,,,,,,,,,,,,,,,,,,,,,,,4,
5963714,8e5fc071-72b0-4500-b85b-7ae517907ebe,1511252774,60,1548678265,,0,0,13.7,2101,2122,33,34,,,1,0,0.04,,,,400,133,159,,,,,,,1,,,,,,,,,,,,,,36,,,26.01,,8,-11.9,142,106,,1,159,132,,,,,,,,,"15,8,10,51,16,0,0","16,40,44,0,0","63,23,1,10,3",,,,,,,,,,,,,,,,,,,,,,,,,,,,,,,,,,,,,,,,,30.3,7,6,210,91,,,0,,0,6,3,,1,0,,,Cycling,,,,"Polar M430",43,0,,0,168072,,30378,,,,,,,,,,,,,,,,,,,,,,,,,,,,,,,,,,,,,,,,,,,
5963715,345e1502-f2d0-44f0-b482-fa3c5b0cee3f,1445118546,120,1548678266,,0,0,1.38,589,589,18,20,,,1,0,0.15,,,,99,,,,,,,22.8,,1,,,,,,,,,,,,,,12,84,8.46,8.45,8.56,,,,,,,,,,,,,,,,,"96,3,1,0,0,0,0,0,0",,,,,,,84,,,,,,,,,,,,,,,,,,,,,,,,,,,,,,,,,,,,,5,5,147,92,,1019,,,1,4,3,,1,0,,,,,"Simmerath Laufen",,"Polar BEAT",,0,,0,168070,250480,30378,,,,,,,,,,,,,,,,,,,,,,,,,,,,,,,,,,,,,,,,,,,
5963716,4570f95b-232f-4909-a750-124300710b46,1449689638,60,1548678266,,0,0,14.91,4084,5100,174,173,,,1,1,0.38,,,247,1019,,,,,,,45.84,,1,,,,,,,,,,,,,,84,83,13.34,13.38,13.61,,,,,,,,,,,,,,,,,"3,2,3,13,31,39,8,2,0",,,,,,,132,,,,,,,,,,,,,,,,,,,,,,,,,,,,,,,,,,,,,5,13,192,91,,1039,,,1,5,3,,1,0,,,,,"Aachen Laufen",,"Polar BEAT",,0,,0,168070,250480,30378,,,,,,,,,,,,,,,,,,,,,,,,,,,,,,,,,,,,,,,,,,5,
5963717,ad7ef548-1940-406d-b413-9c2050773da5,1409085086,120,1548678267,,0,0,11.6,2752,2762,101,101,,,1,0.9,0.45,,,,766,,,,,,,53.17,,1,,,,,,,,,,,,,,57,85,15.26,16.33,16.49,,,,,,,,,,,,,,,,,"12,0,0,0,0,10,37,38,2",,,,,,,149,,,,,,,,,,,,,,,,,,,,,,,,,,,,,,,,,,,,,13,4,54,100,,1007,0,,1,6,3,,1,0,,,,,"2x Doppel 1x Einzel",,"Polar BEAT",,0,,0,168070,250480,30378,,,,,,,,,,,,,,,,,,,,,,,,,,,,,,,,,,,,,,,,,,,
5963718,dc616a51-eaf4-4bc0-9ede-7749693d4c78,1501018239,120,1548678267,,0,0,0.98,313,313,10,16,,,1,1,0.62,,,,68,,,,,,,30.66,,1,,,,,,,,,,,,,,6,82,11.26,11.58,11.42,,,,,,,,,,,,,,,,,"18,10,10,14,48,0,0,0,0",,,,,,,115,,,,,,,,,,,,,,,,,,,,,,,,,,,,,,,,,,,,,14,10,297,96,,1011,0,,1,6,3,,1,0,,,,,,,"Polar BEAT",,0,,0,168070,250480,30378,,,,,,,,,,,,,,,,,,,,,,,,,,,,,,,,,,,,,,,,,,,
5963719,43204b75-61e2-4669-acea-1e73fee297c1,1429608677,120,1548678267,,0,0,6.59,2223,2290,124,121,,,1,2.3,0.55,,,428,448,,,,,,,33.88,,1,,,,,,,,,,,,,,46,82,11.07,10.86,11.32,,,,,,,,,,,,,,,,,"17,9,24,35,14,1,0,0,0",,,,,,,108,,,,,,,,,,,,,,,,,,,,,,,,,,,,,,,,,,,,,11,5,16,64,,1031,,,0,5,3,,1,0,,,,,"Aachen Laufen",,"Polar BEAT",,0,,0,168070,250480,30378,,,,,,,,,,,,,,,,,,,,,,,,,,,,,,,,,,,,,,,,,,"4,5",
5963720,075dda8b-d5cd-4501-9840-8a5ec32710d7,1509550416,60,1548678268,,0,0,16.12,3764,3766,60,57,,,1,0,0.08,,0.92,,1055,165,179,,,,67.81,55.48,68.14,1,,,,,,,,,,,,,,136,85,15.47,15.45,15.52,8.1,,,,,,,,,,,,,,,,"0,0,0,0,1,24,74,1,0","1,7,1,91,0",,,,,,151,,,,,,,,,,,,,,,,,,,,,,,,,,,,,,,,,,,,85.6,15,1,227,52,,1022,,,0,3,3,,1,0,I1.000|4:02-I1.000|3:48-I1.000|3:53-I1.000|3:51-I1.000|3:53-I1.000|3:51-I1.000|3:55-I1.000|3:45-I1.000|3:49-I1.000|3:55-I1.000|3:51-I1.000|3:59-I1.000|3:53-I1.000|3:50-I1.000|4:00-I1.000|3:57-I0.129|0:33,,Running,,,,"Polar M430",43,0,,0,168070,250480,30378,,,,,,,,,,,,,,,,,,,,,,,,,,,,,,,,,,,,,,,,,,,
5963721,,1344703789,120,1548678268,,0,0,21.08,0,0,,,,,0,,,,,,,,,,,,,,,1,,,,,,,,,,,,,,0,,,,,,,,,,,,,,,,,,,,,,,,,,,,,,,,,,,,,,,,,,,,,,,,,,,,,,,,,,,,,,,,,,,,,,,,,,1,,,0,0,,,,,"Half-Marathon Personal Record",,"Polar BEAT",,0,,0,168070,250480,30378,,,,,,,,,,,,,,,,,,,,,,,,,,,,,,,,,,,,,,,,,,,
5963722,,1333485213,120,1548678268,,0,0,10.34,0,0,,,,,0,,,,,,697,,,,,,,,,1,,,,,,,,,,,,,,0,,,,,,,,,,,,,,,,,,,,,,,,,,,,,,,,,,,,,,,,,,,,,,,,,,,,,,,,,,,,,,,,,,,,,,,,,,1,,,0,0,,,,,,,"Polar BEAT",,0,,0,168070,250480,30378,,,,,,,,,,,,,,,,,,,,,,,,,,,,,,,,,,,,,,,,,,,
5963723,9dd1d0db-952c-4819-9c52-2f95b8f71008,1483820254,60,1548678268,,0,0,1.39,422,423,33,34,,,1,1.5,1,,,,102,,,,,,,33.79,,1,,,,,,,,,,,,,,8,80,12.39,12.26,12.75,,,,,,,,,,,,,,,,,"19,5,8,18,25,20,5,1,0",,,,,,,124,,,,,,,,,,,,,,,,,,,,,,,,,,,,,,,,,,,,,0,5,242,97,,1031,0,,1,9,3,,1,0,,,,,"Aachen Laufen",,"Polar BEAT",,0,,0,168070,250480,30378,,,,,,,,,,,,,,,,,,,,,,,,,,,,,,,,,,,,,,,,,,,
5963724,72b66f85-047b-4576-9f9c-39e30db4a6e9,1482925087,60,1548678270,,0,0,4.88,1345,1512,69,69,,,1,1.7,0.55,,,296,332,,,,,,,42.28,,1,,,,,,,,,,,,,,27,81,13.48,13.39,13.64,,,,,,,,,,,,,,,,,"5,1,3,12,39,20,21,0,0",,,,,,,134,,,,,,,,,,,,,,,,,,,,,,,,,,,,,,,,,,,,,4,4,268,95,,,0,,0,5,3,,1,0,,,,,"Balve Laufen",,"Polar BEAT",,0,,0,168070,250480,30378,,,,,,,,,,,,,,,,,,,,,,,,,,,,,,,,,,,,,,,,,,4,
5963725,7f3ad5b6-a4b8-446c-96d7-cd79e452ef55,1458482427,60,1548678270,,0,0,1.39,443,443,20,20,,,1,0.9,0.56,,,,94,,,,,,,31.99,,1,,,,,,,,,,,,,,9,84,11.49,11.39,11.65,,,,,,,,,,,,,,,,,"9,5,24,26,36,0,0,0,0",,,,,,,112,,,,,,,,,,,,,,,,,,,,,,,,,,,,,,,,,,,,,7,8,351,69,,1021,,,0,5,3,,1,0,,,,,"Eschweiler Laufen",,"Polar BEAT",,0,,0,168070,250480,30378,,,,,,,,,,,,,,,,,,,,,,,,,,,,,,,,,,,,,,,,,,,
5963726,78dceb19-2b32-469e-bd94-5fcca1e877ae,1453232132,60,1548678271,,0,0,14.23,3676,3914,146,133,,,1,1.2,0.42,,,,965,,,,,,,48.88,,1,,,,,,,,,,,,,,76,85,14.06,14.56,14.98,,,,,,,,,,,,,,,,,"3,3,6,11,31,12,16,17,2",,,,,,,137,,,,,,,,,,,,,,,,,,,,,,,,,,,,,,,,,,,,,-4,4,203,81,,1018,,,1,5,3,,1,0,,,,,"Aachen Laufen",,"Polar BEAT",,0,,0,168070,250480,30378,,,,,,,,,,,,,,,,,,,,,,,,,,,,,,,,,,,,,,,,,,,
5963727,d1d6ed07-5052-4836-a369-3c84b32876de,1447509185,60,1548678271,,0,0,3.25,918,918,7,37,,,1,0,0.13,,,,225,,,,,,,39.95,,1,,,,,,,,,,,,,,19,81,12.49,12.86,12.69,,,,,,,,,,,,,,,,,"2,1,4,12,49,31,0,0,0",,,,,,,131,,,,,,,,,,,,,,,,,,,,,,,,,,,,,,,,,,,,,9,24,243,72,,1023,,,0,5,3,,1,0,,,,,"Menden Laufen",,"Polar BEAT",,0,,0,168070,250480,30378,,,,,,,,,,,,,,,,,,,,,,,,,,,,,,,,,,,,,,,,,,,
5963728,,1463754780,120,1548678271,,0,0,3,0,0,,,,,0,,,,,,189,,,,,,,,,1,,,,,,,,,,,,,,0,,,,,,,,,,,,,,,,,,,,,,,,,,,,,,,,,,,,,,,,,,,,,,,,,,,,,,,,,,,,,,,,,,,,,,,,,,1,,,0,0,,,,,Laufen,,"Polar BEAT",,0,,0,168070,250480,30378,,,,,,,,,,,,,,,,,,,,,,,,,,,,,,,,,,,,,,,,,,,
5963729,06f4994e-4bda-49b9-95d9-911f88d8c33c,1418932520,60,1548678272,,0,0,6.02,1714,1714,90,91,,,1,1.4,0.47,1.02,0.92,249,366,155,174,,,,58.06,41.2,59.12,1,,,,,,,,,,,,,,49,83,12.94,12.8,13.29,-4.9,,,,,,,,,,,,,,,,"2,2,7,20,37,27,6,0,0","1,15,48,36,0",,,,,,127,,,,,,,,,,,,,,,,,,,,,,,,,,,,,,,,,,,,60.3,11,14,232,94,,,0,,1,5,3,,1,0,,,,,Auslaufen,,"Polar BEAT",,0,,0,168070,250480,30378,,,,,,,,,,,,,,,,,,,,,,,,,,,,,,,,,,,,,,,,,,4,
5963730,6bcdc2a9-4cad-400e-b0f5-98619467481c,1514726979,60,1548678272,,0,0,15.08,3405,3406,24,18,,,1,0,0.01,,,,1104,182,189,,,,60.65,57.39,60.8,1,,,,,,,,,,,,,,174,86,15.98,15.99,16.04,8.4,,,,,,,,,,,,,,,,"0,0,0,0,1,6,89,4,0","0,1,1,13,86",,,,,,154,,,,,,,,,,,,,,,,,,,,,,,,,,,,,,,,,,,,153.1,13,19,209,78,,1002,,,0,5,3,,1,0,I1.000|3:38-I1.000|3:39-I1.000|3:38-I1.000|3:40-I1.000|3:42-I1.000|3:41-I1.000|3:50-I1.000|3:42-I1.000|3:42-I1.000|3:46-I1.000|3:46-I1.000|3:51-I1.000|3:55-I1.000|3:57-I1.000|3:56-I0.083|0:24,,Running,,,,"Polar M430",43,0,,0,168070,250480,30378,,,,,,,,,,,,,,,,,,,,,,,,15,3405,,,0,"36. Internationaler Silvesterlauf Werl Soest",,,,,,,0,0,30378,5963730,245,,,
5963731,89510a23-eaa6-4aad-b1c6-4ce863e69cbb,1395746236,60,1548678272,,0,0,1.07,345,345,4,28,,,1,0.3,0.38,1.04,1.02,,62,131,147,,,,61.77,30.64,60.35,1,,,,,,,,,,,,,,5,84,10.78,11.32,10.84,-17.8,,,,,,,,,,,,,,,,"13,23,6,16,38,3,0,0,0","3,73,24,0,0",,,,,,111,,,,,,,,,,,,,,,,,,,,,,,,,,,,,,,,,,,,8.7,8,3,112,66,,1010,3,,0,5,3,,1,0,,,,,Auslaufen,,"Polar BEAT",,0,,0,168070,250480,30378,,,,,,,,,,,,,,,,,,,,,,,,,,,,,,,,,,,,,,,,,,,
5963732,245a8ef0-30ed-4603-b8dd-55d2beeff335,1541700467,60,1548678273,,0,0,9.95,2674,2675,31,32,,,1,0,0.1,1.21,0.88,,716,157,174,,,,61.24,45.49,61.47,1,,,,,,,,,,,,,,79,83,13.43,13.57,13.7,12.2,,,,,,,,,,,,,,,,"1,0,3,7,42,32,16,0,0","0,6,60,34,0",,,,,,134,,,,,,,,,,,,,,,,,,,,,,,,,,,,,,,,,,,,69.7,12,13,50,76,,,0,,1,3,3,,1,0,I0.419|1:57-I9.537|42:41,,Running,,,,"Polar M430",43,0,,0,168070,250480,30378,,,,,,,,,,,,,,,,,,,,,,,,,,,,,,,,,,,,,,,,,,,
5963733,7f2241b8-4451-45c5-b714-87190c327750,1548092672,60,1548678273,,0,0,7.36,2343,2348,28,29,,,1,0,0.03,1.11,0.88,,550,144,167,,,,55.84,36.54,56.09,1,,,,,,,,,,,,,,53,80,11.34,11.34,11.43,15.1,,,,,,,,,,,,,,,,"0,2,24,65,9,0,0,0,0","0,36,55,9,0",,,,,,118,,,,,,,,,,,,,,,,,,,,,,,,,,,,,,,,,,,,43.1,-2,3,30,76,,1021,0,359,1,3,3,,1,0,I7.356|39:07-I0.002|0:02,,Running,,,,"Polar M430",43,0,,0,168070,250480,30378,,,,,,,,,,,,,,,,,,,,,,,,,,,,,,,,,,,,,,,,,,,
5963734,9d2ef067-5e3e-480b-b8e0-eb8931c4e4ef,1425642729,60,1548678274,,0,0,9.86,2950,2950,97,97,,,1,0.9,0.37,,,,689,,,,,,,40.1,,1,,,,,,,,,,,,,,61,82,12.16,12.09,12.34,,,,,,,,,,,,,,,,,"1,1,8,33,55,2,0,0,0",,,,,,,122,,,,,,,,,,,,,,,,,,,,,,,,,,,,,,,,,,,,,7,8,241,75,,1038,2,,0,5,3,,1,0,,,,,"Aachen Laufen",,"Polar BEAT",,0,,0,168070,250480,30378,,,,,,,,,,,,,,,,,,,,,,,,,,,,,,,,,,,,,,,,,,,
5963735,f8fc41d3-946c-4b48-9162-6e8336a199e6,1496261614,120,1548678274,,0,0,1.18,448,521,16,10,,,1,0,0.14,,,,77,,,,,,,25.7,,1,,,,,,,,,,,,,,9,79,9.72,9.55,9.81,,,,,,,,,,,,,,,,,"48,23,14,10,4,0,0,0,0",,,,,,,100,,,,,,,,,,,,,,,,,,,,,,,,,,,,,,,,,,,,,22,4,348,55,,1021,0,,0,5,3,,1,0,,,,,"Aachen Laufen",,"Polar BEAT",,0,,0,168070,250480,30378,,,,,,,,,,,,,,,,,,,,,,,,,,,,,,,,,,,,,,,,,,,
5963736,24b1aca6-97fb-4cd2-9f12-f9d06038d9d0,1392147482,60,1548678274,,0,0,6.97,1706,1733,68,67,,,1,0.9,0.45,1.28,1.28,,381,168,183,,,,62.26,49.66,63.03,1,,,,,,,,,,,,,,67,84,14.8,16.02,16.18,3.7,,,,,,,,,,,,,,,,"14,0,1,0,1,5,47,30,1","0,12,9,70,10",,,,,,146,,,,,,,,,,,,,,,,,,,,,,,,,,,,,,,,,,,,95.8,5,24,206,73,,1002,,,1,5,3,,1,0,,,,,"3 Einzel HW",,"Polar BEAT",,0,,0,168070,250480,30378,,,,,,,,,,,,,,,,,,,,,,,,,,,,,,,,,,,,,,,,,,,
5963737,cb656a28-b967-4957-b6e5-abd6d01ec6e4,1446578034,60,1548678275,,0,0,2.27,694,696,23,30,,,1,0.9,0.62,,,,156,,,,,,,35.34,,1,,,,,,,,,,,,,,14,83,11.78,11.88,11.97,,,,,,,,,,,,,,,,,"3,4,12,39,35,7,0,0,0",,,,,,,118,,,,,,,,,,,,,,,,,,,,,,,,,,,,,,,,,,,,,10,6,121,79,,1019,,,1,5,3,,1,0,,,,,"Aachen Laufen",,"Polar BEAT",,0,,0,168070,250480,30378,,,,,,,,,,,,,,,,,,,,,,,,,,,,,,,,,,,,,,,,,,,
5963738,28c87717-5ad3-4cef-a1a8-7568755e3cc6,1474492440,120,1548678275,,0,0,10.72,2879,2879,94,98,,,1,0.9,0.45,,,,729,,,,,,,45.76,,1,,,,,,,,,,,,,,59,80,13.54,13.57,13.77,,,,,,,,,,,,,,,,,"1,1,4,6,23,56,9,0,0",,,,,,,140,,,,,,,,,,,,,,,,,,,,,,,,,,,,,,,,,,,,,13,5,99,71,,1020,,,1,5,3,,1,0,,,,,"Aachen Laufen",,"Polar BEAT",,0,,0,168070,250480,30378,,,,,,,,,,,,,,,,,,,,,,,,,,,,,,,,,,,,,,,,,,,
5963739,e0e0e1d3-b1f7-466e-a724-9eb2a7676e9f,1505039435,120,1548678275,,0,0,4.13,1007,1054,65,28,,,1,0.6,0.39,1.78,0.95,,174,127,150,,,,,,,1,,,,,,,,,,,,,,14,,,20.34,,32.3,-6.5,113,89,,1,143,129,,,,,,,,,"49,23,13,8,6,2,0","0,81,19,0,0","78,8,1,5,7",,,,,,,,,,,,,,,,,,,,,,,,,,,,,,,,,,,,,,,,,13.8,13,15,220,93,,1006,,,0,2,1,,1,0,,,Cycling,,,,"Polar M430",43,0,,0,168072,,30378,,,,,,,,,,,,,,,,,,,,,,,,,,,,,,,,,,,,,,,,,,,
5963740,,1402610957,120,1548678275,,0,0,2,0,0,,,,,0,,,,,,,,,,,,,,,1,,,,,,,,,,,,,,0,,,,,,,,,,,,,,,,,,,,,,,,,,,,,,,,,,,,,,,,,,,,,,,,,,,,,,,,,,,,,,,,,,,,,,,,,,1,,,0,0,,,,,Auslaufen,,"Polar BEAT",,0,,0,168070,250480,30378,,,,,,,,,,,,,,,,,,,,,,,,,,,,,,,,,,,,,,,,,,,
5963741,0db04295-7442-46a8-a67a-0d16b9aa242d,1415039685,60,1548678276,,0,0,12,2875,2875,92,86,,,1,0.5,0.36,,,,799,,,,,,,52.69,,1,,,,,,,,,,,,,,59,85,15.17,15.13,15.29,,,,,,,,,,,,,,,,,"0,0,0,0,7,40,50,4,0",,,,,,,147,,,,,,,,,,,,,,,,,,,,,,,,,,,,,,,,,,,,,13,12,189,82,,996,0,,1,5,3,,1,0,,,,,"Gesteigerter DL",,"Polar BEAT",,0,,0,168070,250480,30378,,,,,,,,,,,,,,,,,,,,,,,,,,,,,,,,,,,,,,,,,,,
5963742,18c8205d-bf0e-4e3a-adf8-0838a8751e9f,1396262493,120,1548678276,,0,0,3.86,1182,1270,44,44,,,1,0.4,0.31,1.11,0.95,,221,146,173,,,,57.54,36.8,58.35,1,,,,,,,,,,,,,,28,82,11.89,11.9,12.32,2.4,,,,,,,,,,,,,,,,"9,3,7,30,44,7,1,0,0","1,34,46,20,0",,,,,,119,,,,,,,,,,,,,,,,,,,,,,,,,,,,,,,,,,,,38.3,15,1,127,58,,1015,2,,0,5,3,,1,0,,,,,Auslaufen,,"Polar BEAT",,0,,0,168070,250480,30378,,,,,,,,,,,,,,,,,,,,,,,,,,,,,,,,,,,,,,,,,,,
5963743,e9f4b6ec-6ed2-411a-9bfb-182e0f01b87f,1548422464,60,1548678277,,0,0,11.86,3111,3111,47,48,,,1,0,0.07,1,0.93,,812,155,161,,,,64.25,47.38,64.55,1,,,,,,,,,,,,,,85,83,13.76,13.78,13.83,3.9,,,,,,,,,,,,,,,,"1,1,0,1,18,73,5,0,0","0,1,99,0,0",,,,,,138,,,,,,,,,,,,,,,,,,,,,,,,,,,,,,,,,,,,43.7,-1,19,205,83,,1018,1,353,0,4,3,,1,0,,,Running,,,,"Polar M430",43,0,,0,168070,250480,30378,,,,,,,,,,,,,,,,,,,,,,,,,,,,,,,,,,,,,,,,,,,
5963744,d4d131a6-1806-4284-90be-ea796a92c972,1544955728,60,1548678277,,0,0,3.39,1018,1018,46,40,,,1,0.6,0.48,1.19,0.91,134,249,150,161,,,,56.86,37.32,57.94,1,,,,,,,,,,,,,,25,81,12.27,12.14,12.62,-5.9,,,,,,,,,,,,,,,,"2,5,7,41,26,19,0,0,0","1,7,91,1,0",,,,,,123,,,,,,,,,,,,,,,,,,,,,,,,,,,,,,,,,,,,35.2,-1,8,190,92,,1012,0,314,0,4,3,,1,0,I1.000|5:21-I1.000|5:21-I1.000|4:31-I0.390|1:50,,Running,,,,"Polar M430",43,0,,0,168070,250480,30378,,,,,,,,,,,,,,,,,,,,,,,,,,,,,,,,,,,,,,,,,,5,
5963745,b615a6e9-7d09-433a-af93-f239057caafb,1436473058,120,1548678277,,0,0,11,3315,3885,219,216,,,1,2.1,0.47,,,340,752,,,,,,,40.08,,1,,,,,,,,,,,,,,68,83,12.44,12.24,13.01,,,,,,,,,,,,,,,,,"5,4,11,19,43,16,1,0,0",,,,,,,120,,,,,,,,,,,,,,,,,,,,,,,,,,,,,,,,,,,,,15,12,325,53,,1024,,,0,5,3,,1,0,,,,,"Aachen Laufen",,"Polar BEAT",,0,,0,168070,250480,30378,,,,,,,,,,,,,,,,,,,,,,,,,,,,,,,,,,,,,,,,,,"4,5,5",
5963746,d1b6a71a-5cfe-4461-8f99-677ad4626a72,1542619483,60,1548678278,,0,0,16.59,4802,4810,397,395,,,1,4.8,0.72,1.11,0.99,648,1262,156,177,,,,56.38,43.37,58.06,1,,,,,,,,,,,,,,141,83,13.07,12.71,13.59,-1.7,,,,,,,,,,,,,,,,"4,6,8,21,30,28,4,0,0","0,7,53,39,0",,,,,,125,,,,,,,,,,,,,,,,,,,,,,,,,,,,,,,,,,,,73.3,3,14,41,90,,,0,,0,5,3,,1,0,I1.000|4:21-I1.000|5:49-I1.000|5:43-I1.000|4:45-I1.000|5:00-I1.000|4:57-I1.000|4:55-I1.000|4:42-I1.000|4:17-I1.000|4:25-I1.000|4:09-I1.000|4:32-I1.000|4:37-I1.000|5:14-I1.000|4:27-I1.000|5:22-I0.597|2:58,,Running,,,,"Polar M430",43,0,,0,168070,250480,30378,,,,,,,,,,,,,,,,,,,,,,,,,,,,,,,,,,,,,,,,,,"4,4,4",
5963747,77bbc234-efd0-4759-b53f-1f069ccb32ed,1541527725,60,1548678278,,0,0,11.55,2947,2949,40,41,,,1,0,0.04,,0.91,,840,164,185,,,,61.31,48.84,61.57,1,,,,,,,,,,,,,,104,84,14.14,14.29,14.34,4,,,,,,,,,,,,,,,,"0,0,1,5,22,45,22,3,0","1,5,29,53,12",,,,,,140,,,,,,,,,,,,,,,,,,,,,,,,,,,,,,,,,,,,109.2,8,15,228,93,,1009,0,290,1,5,3,,1,0,I6.241|27:48-I0.285|1:01-I0.521|2:01-I0.236|1:01-I0.028|0:06-I0.482|2:00-I0.826|3:01-I0.211|1:02-I0.818|3:01-I0.215|1:01-I0.280|1:02-I0.215|1:03-I0.286|1:02-I0.211|1:02-I0.294|1:04-I0.395|1:56,,Running,,,,"Polar M430",43,0,,0,168070,250480,30378,,,,,,,,,,,,,,,,,,,,,,,,,,,,,,,,,,,,,,,,,,,
5963748,89d4662c-92e4-447a-9d65-0338041bfce5,1524384524,120,1548678279,,0,0,16.22,4656,4659,253,248,,,1,2.4,0.46,1.06,1.05,592,1298,166,180,,,,52.07,43.71,53.09,1,,,,,,,,,,,,,,167,83,12.91,12.73,13.12,9,,,,,,,,,,,,,,,,"2,5,10,17,33,30,4,0,0","0,1,26,73,0",,,,,,126,,,,,,,,,,,,,,,,,,,,,,,,,,,,,,,,,,,,91.5,15,11,166,75,,1014,,,0,5,3,,1,0,I1.000|4:51-I1.000|4:46-I1.000|4:20-I1.000|4:32-I1.000|4:49-I1.000|4:42-I1.000|4:19-I1.000|4:29-I1.000|4:52-I1.000|5:12-I1.000|4:45-I1.000|4:43-I1.000|4:23-I1.000|5:10-I1.000|5:30-I1.000|4:50-I0.227|1:24,,Running,,,,"Polar M430",43,0,,0,168070,250480,30378,,,,,,,,,,,,,,,,,,,,,,,,,,,,,,,,,,,,,,,,,,"5,5,5",
5963749,eab7a375-aa01-4146-a0c5-20ab71960401,1525785417,120,1548678281,,0,0,7.12,2258,2258,38,37,,,1,0,0.08,1.13,0.89,,482,140,157,,,,58.15,36.63,58.54,1,,,,,,,,,,,,,,43,80,11.41,11.39,11.52,0.4,,,,,,,,,,,,,,,,"1,4,23,57,15,1,0,0,0","2,37,62,0,0",,,,,,118,,,,,,,,,,,,,,,,,,,,,,,,,,,,,,,,,,,,22.2,25,20,43,33,,1010,,,0,3,3,,1,0,I1.000|5:10-I1.000|5:11-I1.000|5:26-I1.000|5:15-I1.000|5:24-I1.000|5:23-I1.000|5:13-I0.125|0:37,,Running,,,,"Polar M430",43,0,,0,168070,250480,30378,,,,,,,,,,,,,,,,,,,,,,,,,,,,,,,,,,,,,,,,,,,
5963751,39f588b6-69ea-47bf-8f6f-23a9020d8321,1400013192,120,1548678282,,0,0,8.78,2880,3683,30,28,,,1,0,0.1,,,,574,,,,,,,35.69,,1,,,,,,,,,,,,,,59,79,11.07,11.52,11.62,,,,,,,,,,,,,,,,,"20,3,8,30,32,4,2,1,1",,,,,,,116,,,,,,,,,,,,,,,,,,,,,,,,,,,,,,,,,,,,,10,4,279,89,,1021,0,,0,5,3,,1,0,,,,,"Einlaufen + Steigerungen + Auslaufen",,"Polar BEAT",,0,,0,168070,250480,30378,,,,,,,,,,,,,,,,,,,,,,,,,,,,,,,,,,,,,,,,,,,
5963752,e585236c-b05a-43ff-83aa-fc606366751e,1404496862,120,1548678283,,0,0,13.2,3439,3439,124,137,,,1,1.2,0.49,,,435,889,,,,,,,48.13,,1,,,,,,,,,,,,,,71,82,13.9,13.9,14.1,,,,,,,,,,,,,,,,,"1,1,0,5,20,64,9,0,0",,,,,,,140,,,,,,,,,,,,,,,,,,,,,,,,,,,,,,,,,,,,,26,3,262,47,,1008,2,,0,5,3,,1,0,,,,,"Zügiger DL",,"Polar BEAT",,0,,0,168070,250480,30378,,,,,,,,,,,,,,,,,,,,,,,,,,,,,,,,,,,,,,,,,,5,
5963753,cc7d330b-d7a7-488e-90f6-21e58742f885,1368041831,120,1548678283,,0,0,11.64,3320,3364,204,217,,,1,2.4,0.62,,,474,810,,,,,,,42.92,,1,,,,,,,,,,,,,,68,,13.01,13.51,13.94,,,,,,,,,,,,,,,,,"15,4,6,10,20,22,16,6,2",,,,,,,,,,,,,,,,,,,,,,,,,,,,,,,,,,,,,,,,,,,,16,16,196,81,,1010,,,0,5,3,,1,0,,,,,,,"Polar BEAT",,0,,0,168070,250480,30378,,,,,,,,,,,,,,,,,,,,,,,,,,,,,,,,,,,,,,,,,,4,
5963754,6ca1a213-bca7-41e9-891b-248a7ac0962f,1536945080,120,1548678284,,0,0,15.2,3955,3957,52,52,,,1,0,0.08,,0.87,,753,127,156,,,,83.58,48.73,83.94,1,,,,,,,,,,,,,,56,83,13.86,13.96,14.03,14.7,,,,,,,,,,,,,,,,"0,1,3,7,16,61,14,0,0","2,81,16,0,0",,,,,,139,,,,,,,,,,,,,,,,,,,,,,,,,,,,,,,,,,,,22.6,21,6,354,68,,1019,,,0,5,3,,1,0,I1.000|4:12-I1.000|4:14-I1.000|4:13-I1.000|4:10-I1.000|4:07-I1.000|4:07-I1.000|4:17-I1.000|4:09-I1.000|4:20-I1.000|4:17-I1.000|4:13-I1.000|4:11-I1.000|4:18-I1.000|5:09-I1.000|4:55-I0.203|1:06,,Running,,,,"Polar M430",43,0,,0,168070,250480,30378,,,,,,,,,,,,,,,,,,,,,,,,,,,,,,,,,,,,,,,,,,,
5963755,de17fc82-19d1-45ee-a3dc-ba0e00a7f9fa,1469390473,120,1548678284,,0,0,20.01,5031,5091,105,104,,,1,0,0.11,,,,1385,,,,,,,51.82,,1,,,,,,,,,,,,,,104,81,14.37,14.49,14.55,,,,,,,,,,,,,,,,,"1,0,1,3,12,54,27,1,1",,,,,,,147,,,,,,,,,,,,,,,,,,,,,,,,,,,,,,,,,,,,,25,2,284,65,,1019,0,,0,5,3,,1,0,,,,,"Aachen Laufen",,"Polar BEAT",,0,,0,168070,250480,30378,,,,,,,,,,,,,,,,,,,,,,,,,,,,,,,,,,,,,,,,,,,
5963756,15e5e79a-557d-4f58-8423-34f7ee346ad8,1536259494,120,1548678285,,0,0,3.78,1057,1059,4,8,,,1,0,0,,0.85,,283,158,168,,,,57.79,40.88,57.79,1,,,,,,,,,,,,,,32,83,12.85,12.91,12.93,3.1,,,,,,,,,,,,,,,,"0,1,2,14,51,31,0,0,0","2,1,50,47,0",,,,,,129,,,,,,,,,,,,,,,,,,,,,,,,,,,,,,,,,,,,47.9,19,7,225,89,,,0,,0,5,3,,1,0,I1.000|4:45-I1.000|4:37-I1.000|4:38-I0.778|3:41,,Running,,,,"Polar M430",43,0,,0,168070,250480,30378,,,,,,,,,,,,,,,,,,,,,,,,,,,,,,,,,,,,,,,,,,,
5963757,d15349d1-fa6b-4d58-a1aa-b465507e3ec6,1405986685,120,1548678285,,0,0,2.01,685,685,0,0,,,1,0,0,,,,135,,,,,,,30.81,,1,,,,,,,,,,,,,,14,80,10.54,10.64,10.68,,,,,,,,,,,,,,,,,"5,19,44,32,0,0,0,0,0",,,,,,,110,,,,,,,,,,,,,,,,,,,,,,,,,,,,,,,,,,,,,18,11,339,88,,1018,0,,1,4,3,,1,0,,,,,Auslaufen,,"Polar BEAT",,0,,0,168070,250480,30378,,,,,,,,,,,,,,,,,,,,,,,,,,,,,,,,,,,,,,,,,,,
5963758,695f662e-30d8-468b-8fb1-87eb7728b875,1406322812,120,1548678286,,0,0,14.09,4616,4737,54,55,,,1,0,0.09,,,,935,,,,,,,37.05,,1,,,,,,,,,,,,,,95,81,11.04,11.04,11.13,,,,,,,,,,,,,,,,,"3,4,40,45,7,0,0,0,0",,,,,,,113,,,,,,,,,,,,,,,,,,,,,,,,,,,,,,,,,,,,,19,8,1,81,,1014,,,1,5,3,,1,0,,,,,"Langsamer DL",,"Polar BEAT",,0,,0,168070,250480,30378,,,,,,,,,,,,,,,,,,,,,,,,,,,,,,,,,,,,,,,,,,,
5963759,77857032-bd25-46b9-9a05-ca1c648c0994,1491748318,120,1548678286,,0,0,8.1,1117,1117,21,24,,,1,0,0.05,,,,286,,,,,,,,,1,,,,,,,,,,,,,,12,,,26.55,,,,130,116,,1,140,128,,,,,,,,,"3,2,20,74,1,0,0",,"70,20,0,0,10",,,,,,,,,,,,,,,,,,,,,,,,,,,,,,,,,,,,,,,,,,21,3,135,38,,1021,,,0,3,3,,1,0,,,,,"Karlsruhe Radfahren",,"Polar BEAT",,0,,0,168072,,30378,,,,,,,,,,,,,,,,,,,,,,,,,,,,,,,,,,,,,,,,,,,
5963760,248aa719-12b4-4a54-ad7b-2664ca185d51,1476739860,120,1548678286,,0,0,1.74,493,493,24,22,,,1,1,0.65,,,,117,,,,,,,37.47,,1,,,,,,,,,,,,,,10,79,13.01,12.86,13.16,,,,,,,,,,,,,,,,,"0,2,8,19,39,23,9,0,0",,,,,,,134,,,,,,,,,,,,,,,,,,,,,,,,,,,,,,,,,,,,,11,1,195,91,,1024,0,,1,5,3,,1,0,,,,,"Aachen Laufen",,"Polar BEAT",,0,,0,168070,250480,30378,,,,,,,,,,,,,,,,,,,,,,,,,,,,,,,,,,,,,,,,,,,
5963761,5ad9b900-fc80-45c4-ba2e-e645e6a58991,1397327465,120,1548678287,,0,0,8.06,2506,2689,0,0,,,1,0,0,,,,522,163,186,,,,48.47,37.8,48.47,1,,,,,,,,,,,,,,90,82,11.6,14.2,14.17,10.1,,,,,,,,,,,,,,,,"35,1,1,1,2,5,31,24,0","0,20,16,38,27",,,,,,118,,,,,,,,,,,,,,,,,,,,,,,,,,,,,,,,,,,,108.1,11,22,237,85,,1015,1,,0,5,3,,1,0,,,,,"2x 500, 2x 1000, 2000, 500, 1000, 2x 500",,"Polar BEAT",,0,,0,168070,250480,30378,,,,,,,,,,,,,,,,,,,,,,,,,,,,,,,,,,,,,,,,,,,
5963762,26e757f5-a80b-45c9-b86f-0da3dffabd10,1459545395,120,1548678287,,0,0,6.28,1913,1913,69,70,,,1,0.4,0.36,,,,427,,,,,,,38.13,,1,,,,,,,,,,,,,,39,81,11.96,11.92,12.07,,,,,,,,,,,,,,,,,"1,6,12,36,40,4,0,0,0",,,,,,,122,,,,,,,,,,,,,,,,,,,,,,,,,,,,,,,,,,,,,9,3,135,71,,1020,0,,1,5,3,,1,0,,,,,"Aachen Laufen",,"Polar BEAT",,0,,0,168070,250480,30378,,,,,,,,,,,,,,,,,,,,,,,,,,,,,,,,,,,,,,,,,,,
5963763,c0092218-bdab-4f6b-b760-62948b87286e,1410550880,120,1548678288,,0,0,7.2,2272,2272,97,71,,,1,1.1,0.45,1.03,1,,390,141,155,,,,57.99,36.88,59.21,1,,,,,,,,,,,,,,45,81,11.67,11.52,11.84,0.9,,,,,,,,,,,,,,,,"3,6,20,41,30,0,0,0,0","0,46,54,0,0",,,,,,117,,,,,,,,,,,,,,,,,,,,,,,,,,,,,,,,,,,,24.9,17,6,25,73,,1021,0,,1,5,3,,1,0,,,,,"Langsamer DL + Lauf ABC ",,"Polar BEAT",,0,,0,168070,250480,30378,,,,,,,,,,,,,,,,,,,,,,,,,,,,,,,,,,,,,,,,,,,
5963764,f19abf53-b4d3-4fa0-90d5-79071c295510,1475179991,120,1548678288,,0,0,1.88,590,590,51,34,,,1,1.5,0.57,,,416,127,,,,,,,33.65,,1,,,,,,,,,,,,,,12,79,12.43,11.5,12.98,,,,,,,,,,,,,,,,,"0,4,27,37,32,0,0,0,0",,,,,,,121,,,,,,,,,,,,,,,,,,,,,,,,,,,,,,,,,,,,,17,9,229,75,,1015,0,,1,5,3,,1,0,,,,,"Aachen Laufen",,"Polar BEAT",,0,,0,168070,250480,30378,,,,,,,,,,,,,,,,,,,,,,,,,,,,,,,,,,,,,,,,,,5,
5963765,bae7222d-5215-43ed-a74e-b74aa79747d7,1480152219,60,1548678288,,0,0,1.46,468,490,0,10,,,1,0,0.14,,,,102,,,,,,,31.95,,1,,,,,,,,,,,,,,9,79,11.03,11.31,11.12,,,,,,,,,,,,,,,,,"7,2,10,64,12,5,0,0,0",,,,,,,118,,,,,,,,,,,,,,,,,,,,,,,,,,,,,,,,,,,,,5,2,68,92,,1020,0,,0,5,3,,1,0,,,,,"Aachen Laufen",,"Polar BEAT",,0,,0,168070,250480,30378,,,,,,,,,,,,,,,,,,,,,,,,,,,,,,,,,,,,,,,,,,,
5963766,9f44a11d-efbf-4ab2-b765-fc22c6ecff82,1480620521,60,1548678288,,0,0,0.98,426,650,12,11,,,1,1.2,0.8,,,,61,,,,,,,21.49,,1,,,,,,,,,,,,,,8,72,8.29,13.3,13.88,,,,,,,,,,,,,,,,,"52,0,1,1,3,11,18,14,0",,,,,,,96,,,,,,,,,,,,,,,,,,,,,,,,,,,,,,,,,,,,,4,9,251,96,,1026,0,,1,9,3,,1,0,,,,,"Aachen Laufen",,"Polar BEAT",,0,,0,168070,250480,30378,,,,,,,,,,,,,,,,,,,,,,,,,,,,,,,,,,,,,,,,,,,
5963767,886028cf-5496-4d01-a3da-f642b382892e,1444162366,120,1548678288,,0,0,2.83,848,848,28,21,,,1,0.2,0.29,,,,194,,,,,,,36.89,,1,,,,,,,,,,,,,,17,85,12.24,12.09,12.47,,,,,,,,,,,,,,,,,"0,4,13,31,45,7,0,0,0",,,,,,,118,,,,,,,,,,,,,,,,,,,,,,,,,,,,,,,,,,,,,16,10,161,88,,1003,,,1,5,3,,1,0,,,,,"Aachen Laufen",,"Polar BEAT",,0,,0,168070,250480,30378,,,,,,,,,,,,,,,,,,,,,,,,,,,,,,,,,,,,,,,,,,,
5963769,6c16a527-6249-4135-8e69-43d2a4fc201a,1527759168,120,1548678289,,0,0,16,3965,3969,74,66,,,1,0,0.15,1.14,0.94,,1160,171,185,,,,59.69,51.76,60.06,1,,,,,,,,,,,,,,159,84,14.6,14.58,14.69,6.1,,,,,,,,,,,,,,,,"0,0,0,1,8,62,28,0,0","0,1,10,80,8",,,,,,144,,,,,,,,,,,,,,,,,,,,,,,,,,,,,,,,,,,,121.6,21,6,233,74,,1015,,,0,3,3,,1,0,I1.000|4:24-I1.000|4:13-I1.000|4:09-I1.000|4:12-I1.000|4:07-I1.000|4:02-I1.000|4:08-I1.000|4:06-I1.000|4:00-I1.000|4:13-I1.000|4:07-I1.000|4:04-I1.000|4:18-I1.000|3:55-I1.000|4:03-I1.000|4:01-I0.011|0:05,,Running,,,,"Polar M430",43,0,,0,168070,250480,30378,,,,,,,,,,,,,,,,,,,,,,,,,,,,,,,,,,,,,,,,,,,
5963770,dfa2427e-16d8-432f-81b9-3bd43637bd71,1481223711,60,1548678289,,0,0,4.19,1311,1470,53,53,,,1,0.9,0.62,,,,289,,,,,,,36.06,,1,,,,,,,,,,,,,,27,81,11.85,11.86,12.05,,,,,,,,,,,,,,,,,"6,5,16,40,22,7,2,2,0",,,,,,,118,,,,,,,,,,,,,,,,,,,,,,,,,,,,,,,,,,,,,6,14,201,75,,1030,,,1,3,3,,1,0,,,,,"Aachen Laufen",,"Polar BEAT",,0,,0,168070,250480,30378,,,,,,,,,,,,,,,,,,,,,,,,,,,,,,,,,,,,,,,,,,,
5963771,f487891c-2e55-430a-bb11-3e2b5c0e88e4,1368137980,120,1548678289,,0,0,0.84,446,499,21,21,,,1,1.3,1,,,,48,,,,,,,16.6,,1,,,,,,,,,,,,,,9,,6.65,10.84,12.97,,,,,,,,,,,,,,,,,"75,9,8,0,0,0,1,1,6",,,,,,,,,,,,,,,,,,,,,,,,,,,,,,,,,,,,,,,,,,,,12,5,242,71,,1013,0,,1,5,3,,1,0,,,,,,,"Polar BEAT",,0,,0,168070,250480,30378,,,,,,,,,,,,,,,,,,,,,,,,,,,,,,,,,,,,,,,,,,,
5963772,de1a5f76-57bb-41ca-b037-b13f891f377e,1476536948,120,1548678290,,0,0,4.87,1405,1425,75,76,,,1,1.6,0.59,,,264,336,,,,,,,40.06,,1,,,,,,,,,,,,,,29,79,12.75,12.72,13,,,,,,,,,,,,,,,,,"3,1,8,28,33,22,5,1,0",,,,,,,132,,,,,,,,,,,,,,,,,,,,,,,,,,,,,,,,,,,,,12,7,228,97,,,2,,0,5,3,,1,0,,,,,"Balve Laufen",,"Polar BEAT",,0,,0,168070,250480,30378,,,,,,,,,,,,,,,,,,,,,,,,,,,,,,,,,,,,,,,,,,4,
5963773,41bf49e1-69e1-4177-bb7d-a830e5a91d16,1425582515,60,1548678290,,0,0,3.33,949,949,70,70,,,1,1.6,0.58,,,454,229,,,,,,,39.62,,1,,,,,,,,,,,,,,19,83,13.02,12.73,13.5,,,,,,,,,,,,,,,,,"0,6,9,21,31,30,4,0,0",,,,,,,127,,,,,,,,,,,,,,,,,,,,,,,,,,,,,,,,,,,,,5,4,275,74,,1038,0,,1,5,3,,1,0,,,,,"Aachen Laufen",,"Polar BEAT",,0,,0,168070,250480,30378,,,,,,,,,,,,,,,,,,,,,,,,,,,,,,,,,,,,,,,,,,4,
5963774,c8e818a1-ea4a-43fb-ae2d-05a908e1339e,1393261906,60,1548678291,,0,0,2.26,706,706,56,61,,,1,1.3,0.64,1.22,0.9,,132,146,167,,,,56.14,34.46,57.7,1,,,,,,,,,,,,,,16,81,11.86,11.63,12.34,-17.5,,,,,,,,,,,,,,,,"2,0,8,70,19,0,0,0,0","1,52,17,30,0",,,,,,119,,,,,,,,,,,,,,,,,,,,,,,,,,,,,,,,,,,,27.5,12,9,199,55,,1012,0,,0,5,3,,1,0,,,,,Einlaufen,,"Polar BEAT",,0,,0,168070,250480,30378,,,,,,,,,,,,,,,,,,,,,,,,,,,,,,,,,,,,,,,,,,,
5963775,1c02855c-1a43-4067-8ada-3a41c018dbae,1397669060,120,1548678291,,0,0,3.85,1248,1571,32,25,,,1,0,0.27,1.03,0.91,,226,143,154,,,,55.1,34.4,55.79,1,,,,,,,,,,,,,,26,81,11.25,11.21,11.4,-0.6,,,,,,,,,,,,,,,,"8,9,22,38,23,0,0,0,0","0,25,75,0,0",,,,,,114,,,,,,,,,,,,,,,,,,,,,,,,,,,,,,,,,,,,25.3,12,4,214,59,,1029,2,,0,3,3,,1,0,,,,,Einlaufen,,"Polar BEAT",,0,,0,168070,250480,30378,,,,,,,,,,,,,,,,,,,,,,,,,,,,,,,,,,,,,,,,,,,
5963777,223e807a-c927-4274-874f-7056885e666f,1435611393,120,1548678293,,0,0,16.44,4127,4289,263,267,,,1,2.7,0.5,,,608,1111,,,,,,,51.1,,1,,,,,,,,,,,,,,85,83,14.69,14.52,15.12,,,,,,,,,,,,,,,,,"1,1,2,4,16,39,34,2,0",,,,,,,144,,,,,,,,,,,,,,,,,,,,,,,,,,,,,,,,,,,,,21,7,332,56,,1022,,,0,5,3,,1,0,,,,,"Aachen Laufen",,"Polar BEAT",,0,,0,168070,250480,30378,,,,,,,,,,,,,,,,,,,,,,,,,,,,,,,,,,,,,,,,,,"5,5,5",
5963778,2f784c5a-ba87-4bee-997f-6266d58d7203,1436000981,120,1548678294,,0,0,27.51,7581,7827,710,711,,,1,5.1,0.67,,,595,1870,,,,,,,47.76,,1,,,,,,,,,,,,,,157,83,13.65,13.29,14.45,,,,,,,,,,,,,,,,,"4,2,3,8,33,43,7,0,0",,,,,,,131,,,,,,,,,,,,,,,,,,,,,,,,,,,,,,,,,,,,,29,12,141,55,,,,,0,3,3,,1,0,,,,,"Balve Laufen",,"Polar BEAT",,0,,0,168070,250480,30378,,,,,,,,,,,,,,,,,,,,,,,,,,,,,,,,,,,,,,,,,,"4,4,4,4,5,5,5,5,5",
5963779,cf2a2d66-1203-440a-b927-27f0d7b68ab1,1396556867,120,1548678295,,0,0,7.87,2167,2182,0,2,,,1,0,0.03,,0.47,,459,162,183,,,,56.82,43.55,56.8,1,,,,,,,,,,,,,,75,84,13.1,14.96,15,11.7,,,,,,,,,,,,,,,,"28,4,3,3,6,9,11,24,12","0,17,13,65,4",,,,,,130,,,,,,,,,,,,,,,,,,,,,,,,,,,,,,,,,,,,86.2,17,2,202,55,,1005,0,,1,5,3,,1,0,,,,,"2x (6x 300m) + 10x 200m",,"Polar BEAT",,0,,0,168070,250480,30378,,,,,,,,,,,,,,,,,,,,,,,,,,,,,,,,,,,,,,,,,,,
5963780,12fda6c6-27fe-4fa5-a62b-44d84d0148ed,1409261722,120,1548678295,,0,0,2.06,688,688,23,24,,,1,0.2,0.32,,,,138,,,,,,,31.62,,1,,,,,,,,,,,,,,14,83,10.92,11.02,11.09,,,,,,,,,,,,,,,,,"10,7,32,43,5,3,0,0,0",,,,,,,108,,,,,,,,,,,,,,,,,,,,,,,,,,,,,,,,,,,,,17,8,208,92,,1015,,,1,5,3,,1,0,,,,,Auslaufen,,"Polar BEAT",,0,,0,168070,250480,30378,,,,,,,,,,,,,,,,,,,,,,,,,,,,,,,,,,,,,,,,,,,
5963781,f8ea8362-3ffc-41e0-956c-5e33c82ca97e,1463088743,120,1548678295,,0,0,0.73,289,307,19,8,,,1,1.2,0.72,,,,36,,,,,,,23.19,,1,,,,,,,,,,,,,,6,61,9.08,12.36,14.68,,,,,,,,,,,,,,,,,"70,1,1,1,1,2,3,3,18",,,,,,,124,,,,,,,,,,,,,,,,,,,,,,,,,,,,,,,,,,,,,18,0,191,68,,1000,0,,1,5,3,,1,0,,,,,"Aachen Laufen",,"Polar BEAT",,0,,0,168070,250480,30378,,,,,,,,,,,,,,,,,,,,,,,,,,,,,,,,,,,,,,,,,,,
5963782,9dd72267-bd85-4768-b0c7-65be0ccde9a2,1536134771,120,1548678296,,0,0,9.62,1654,1654,32,39,,,1,0,0.13,,0.56,,250,114,130,,,,,,,1,,,,,,,,,,,,,,15,,,22.01,,11.4,-19.2,101,85,,1,117,106,,,,,,,,,"8,6,85,1,0,0,0","0,100,0,0,0","90,0,0,0,10",,,,,,,,,,,,,,,,,,,,,,,,,,,,,,,,,,,,,,,,,6.2,13,1,30,99,,,,,0,3,3,,1,0,,,Cycling,,,,"Polar M430",43,0,,0,168072,,30378,,,,,,,,,,,,,,,,,,,,,,,,,,,,,,,,,,,,,,,,,,,
5963783,f85a832d-b55e-4c20-828b-54f560410a59,1478956266,60,1548678296,,0,0,4.33,1297,1348,83,135,,,1,1.8,0.53,,,688,294,,,,,,,38.05,,1,,,,,,,,,,,,,,26,82,12.35,12.2,12.71,,,,,,,,,,,,,,,,,"5,4,13,19,45,12,2,0,0",,,,,,,122,,,,,,,,,,,,,,,,,,,,,,,,,,,,,,,,,,,,,4,7,164,82,,1023,1,,0,5,3,,1,0,,,,,"Aachen Laufen",,"Polar BEAT",,0,,0,168070,250480,30378,,,,,,,,,,,,,,,,,,,,,,,,,,,,,,,,,,,,,,,,,,5,
5963784,2bb98b30-a114-4ce2-99c4-ea64c6d07d3f,1364227299,60,1548678297,,0,0,13.2,3576,3601,159,168,,,1,1.4,0.43,,,311,919,,,,,,,46,,1,,,,,,,,,,,,,,74,,13.54,13.71,14.03,,,,,,,,,,,,,,,,,"4,2,6,14,25,28,16,4,1",,,,,,,,,,,,,,,,,,,,,,,,,,,,,,,,,,,,,,,,,,,,3,18,62,46,,1011,2,,0,5,3,,1,0,,,,,,,"Polar BEAT",,0,,0,168070,250480,30378,,,,,,,,,,,,,,,,,,,,,,,,,,,,,,,,,,,,,,,,,,5,
5963785,016e8b98-2446-4e43-9c6f-e575fa279d89,1422613732,60,1548678297,,0,0,8.12,2410,2443,92,92,,,1,0.8,0.47,,,,546,,,,,,,39.95,,1,,,,,,,,,,,,,,50,84,12.32,12.27,12.44,,,,,,,,,,,,,,,,,"4,4,7,25,43,16,1,0,0",,,,,,,120,,,,,,,,,,,,,,,,,,,,,,,,,,,,,,,,,,,,,0,7,240,96,,979,0,,0,5,3,,1,0,,,,,"Aachen Laufen",,"Polar BEAT",,0,,0,168070,250480,30378,,,,,,,,,,,,,,,,,,,,,,,,,,,,,,,,,,,,,,,,,,,
5963786,a3ac4661-994e-4ed3-8870-24d28fc5df1a,1481581773,60,1548678298,,0,0,0.9,360,367,4,6,,,1,0,0.11,,,,61,,,,,,,23.45,,1,,,,,,,,,,,,,,7,77,9.02,9.06,9.09,,,,,,,,,,,,,,,,,"62,23,12,3,0,0,0,0,0",,,,,,,97,,,,,,,,,,,,,,,,,,,,,,,,,,,,,,,,,,,,,4,4,179,88,,1027,0,,1,5,3,,1,0,,,,,"Aachen Laufen",,"Polar BEAT",,0,,0,168070,250480,30378,,,,,,,,,,,,,,,,,,,,,,,,,,,,,,,,,,,,,,,,,,,
5963787,c338aa6e-0718-47e1-b823-e1ceade686c3,1519204369,60,1548678298,,0,0,10.8,1661,1662,44,51,,,1,0,0.15,,,,317,133,159,,,,,,,1,,,,,,,,,,,,,,29,,,24.11,,18.1,-0.6,116,101,,1,135,123,,,,,,,,,"6,6,41,47,0,0,0","19,27,54,0,0","90,0,0,0,10",,,,,,,,,,,,,,,,,,,,,,,,,,,,,,,,,,,,,,,,,26.4,0,3,31,80,,,0,,0,5,3,,1,0,,,Cycling,,,,"Polar M430",43,0,,0,168072,,30378,,,,,,,,,,,,,,,,,,,,,,,,,,,,,,,,,,,,,,,,,,,
5963788,46b3478f-c8a5-4d18-af65-97f221b99879,1398254834,120,1548678298,,0,0,0.99,306,306,0,26,,,1,0.4,0.41,0.74,1.01,,59,143,158,,,,58.43,31.86,56.54,1,,,,,,,,,,,,,,6,84,11.19,12.21,11.58,-25.5,,,,,,,,,,,,,,,,"25,12,2,3,19,34,6,0,0","0,31,69,0,0",,,,,,116,,,,,,,,,,,,,,,,,,,,,,,,,,,,,,,,,,,,14.6,17,1,202,63,,1020,5,,0,3,3,,1,0,,,,,Auslaufen,,"Polar BEAT",,0,,0,168070,250480,30378,,,,,,,,,,,,,,,,,,,,,,,,,,,,,,,,,,,,,,,,,,,
5963789,4456b776-3eb5-430c-8a7f-6a8f9b49fc25,1496669322,120,1548678299,,0,0,13.49,3847,3919,201,199,,,1,2.4,0.58,,,410,907,,,,,,,43.41,,1,,,,,,,,,,,,,,79,79,12.9,12.77,13.15,,,,,,,,,,,,,,,,,"2,2,3,14,49,27,1,0,0",,,,,,,133,,,,,,,,,,,,,,,,,,,,,,,,,,,,,,,,,,,,,21,6,239,45,,1013,7,,0,5,3,,1,0,,,,,"Aachen Laufen",,"Polar BEAT",,0,,0,168070,250480,30378,,,,,,,,,,,,,,,,,,,,,,,,,,,,,,,,,,,,,,,,,,4,
5963790,4765f4ab-b1af-4ec8-8fa8-67effcde1bf4,1544029650,60,1548678299,,0,0,7.84,1931,1932,45,45,,,1,0,0.13,1.11,0.98,,417,138,177,,,,81,49.63,81.58,1,,,,,,,,,,,,,,39,83,14.68,14.97,15.07,12.7,,,,,,,,,,,,,,,,"0,0,4,11,16,8,57,3,0","2,54,24,20,0",,,,,,147,,,,,,,,,,,,,,,,,,,,,,,,,,,,,,,,,,,,59,6,2,312,97,,1023,0,288,1,5,3,,1,0,I1.000|5:04-I1.000|4:08-I1.000|3:49-I1.000|3:46-I1.000|3:48-I1.000|3:42-I1.000|3:42-I0.844|4:15,,Running,,,,"Polar M430",43,0,,0,168070,250480,30378,,,,,,,,,,,,,,,,,,,,,,,,,,,,,,,,,,,,,,,,,,,
5963791,53990bb4-8364-4e3c-83e6-88215af3b81d,1463520418,120,1548678300,,0,0,4.56,1520,1545,50,68,,,1,1,0.53,,,,315,,,,,,,33.62,,1,,,,,,,,,,,,,,31,80,10.88,10.95,11.14,,,,,,,,,,,,,,,,,"12,8,34,29,15,2,0,0,0",,,,,,,113,,,,,,,,,,,,,,,,,,,,,,,,,,,,,,,,,,,,,14,3,224,65,,1016,0,,1,5,3,,1,0,,,,,"Aachen Laufen",,"Polar BEAT",,0,,0,168070,250480,30378,,,,,,,,,,,,,,,,,,,,,,,,,,,,,,,,,,,,,,,,,,,
5963792,77b69dbc-c490-4b3f-b3c1-e0d0498cb5e0,1401370855,120,1548678300,,0,0,2.01,600,620,0,3,,,1,0,0,,,,121,,,,,,,35.88,,1,,,,,,,,,,,,,,12,80,12.2,13.87,13.84,,,,,,,,,,,,,,,,,"39,2,2,3,3,4,23,27,0",,,,,,,126,,,,,,,,,,,,,,,,,,,,,,,,,,,,,,,,,,,,,17,5,313,69,,1016,6,,0,5,3,,1,0,,,,,"500,300,500,300",,"Polar BEAT",,0,,0,168070,250480,30378,,,,,,,,,,,,,,,,,,,,,,,,,,,,,,,,,,,,,,,,,,,
5963793,,1410115535,120,1548678300,,0,0,3,0,0,,,,,0,,,,,,201,,,,,,,,,1,,,,,,,,,,,,,,0,,,,,,,,,,,,,,,,,,,,,,,,,,,,,,,,,,,,,,,,,,,,,,,,,,,,,,,,,,,,,,,,,,,,,,,,,,1,,,0,0,,,,,Auslaufen,,"Polar BEAT",,0,,0,168070,250480,30378,,,,,,,,,,,,,,,,,,,,,,,,,,,,,,,,,,,,,,,,,,,
5963794,a8ce0f43-6bfb-401c-935c-dd84fd47ae30,1465502955,120,1548678300,,0,0,3.25,972,972,63,62,,,1,1.8,0.69,,,414,224,,,,,,,37.38,,1,,,,,,,,,,,,,,20,80,12.39,12.19,12.94,,,,,,,,,,,,,,,,,"6,7,14,21,32,13,7,0,0",,,,,,,125,,,,,,,,,,,,,,,,,,,,,,,,,,,,,,,,,,,,,19,3,351,54,,1017,0,,0,3,3,,1,0,,,,,"Aachen Laufen",,"Polar BEAT",,0,,0,168070,250480,30378,,,,,,,,,,,,,,,,,,,,,,,,,,,,,,,,,,,,,,,,,,5,
5963795,a5cd65b5-1404-483b-9b53-1e2a0f937322,1401569479,120,1548678301,,0,0,2.86,840,959,50,56,,,1,1.9,0.86,,,,199,,,,,,,37.79,,1,,,,,,,,,,,,,,17,81,12.64,12.52,13.04,,,,,,,,,,,,,,,,,"5,4,11,19,34,22,4,0,0",,,,,,,126,,,,,,,,,,,,,,,,,,,,,,,,,,,,,,,,,,,,,17,1,344,53,,,,,0,3,3,,1,0,,,,,Einlaufen,,"Polar BEAT",,0,,0,168070,250480,30378,,,,,,,,,,,,,,,,,,,,,,,,,,,,,,,,,,,,,,,,,,,
5963796,ae0d6270-4f2d-44dc-b1ab-840c1d3edef8,1408140892,120,1548678301,,0,0,4.83,977,980,29,29,,,1,0,0.17,,,,318,,,,,,,60.63,,1,,,,,,,,,,,,,,20,89,17.88,18.15,18.21,,,,,,,,,,,,,,,,,"1,0,0,0,0,7,28,49,14",,,,,,,167,,,,,,,,,,,,,,,,,,,,,,,,,,,,,,,,,,,,,13,4,270,93,,1017,0,,1,6,3,,1,0,,,,,"5k Nachtlauf Aachen",,"Polar BEAT",,0,,0,168070,250480,30378,,,,,,,,,,,,,,,,,,,,,,,,,,,,,,,,,,,,,,,,,,,
5963797,997fbac3-a08d-494b-8912-d6eac06e9da7,1412013359,120,1548678301,,0,0,3.01,916,916,41,24,,,1,0.7,0.4,1.08,1.01,,168,142,156,,,,60.1,36.41,61.53,1,,,,,,,,,,,,,,18,80,12.16,11.9,12.38,0.6,,,,,,,,,,,,,,,,"0,1,11,49,35,3,0,0,0","1,37,63,0,0",,,,,,123,,,,,,,,,,,,,,,,,,,,,,,,,,,,,,,,,,,,22.5,16,4,207,91,,1024,0,,0,6,3,,1,0,,,,,Einlaufen,,"Polar BEAT",,0,,0,168070,250480,30378,,,,,,,,,,,,,,,,,,,,,,,,,,,,,,,,,,,,,,,,,,,
5963798,3ae50e78-5b92-4617-a38b-40e43985e1db,1511375996,60,1548678301,,0,0,6.7,1518,1545,37,30,,,1,0,0.12,1.64,0.18,,192,107,135,,,,,,,1,,,,,,,,,,,,,,12,,,18.44,,6.7,-63.1,95,71,,1,118,101,,,,,,,,,"34,27,35,4,0,0,0","27,73,0,0,0","91,0,0,2,8",,,,,,,,,,,,,,,,,,,,,,,,,,,,,,,,,,,,,,,,,7.6,7,3,183,82,,1010,,,1,5,3,,1,0,,,Cycling,,,,"Polar M430",43,0,,0,168072,,30378,,,,,,,,,,,,,,,,,,,,,,,,,,,,,,,,,,,,,,,,,,,
5963799,285a1679-ee20-4c0c-a91d-f16359aed03e,1485000783,60,1548678302,,0,0,2.75,829,829,20,45,,,1,0.4,0.41,,,,185,,,,,,,36.54,,1,,,,,,,,,,,,,,17,80,11.75,12.11,11.95,,,,,,,,,,,,,,,,,"6,3,8,30,41,12,0,0,0",,,,,,,124,,,,,,,,,,,,,,,,,,,,,,,,,,,,,,,,,,,,,2,10,133,53,,1029,,,0,3,3,,1,0,,,,,Laufen,,"Polar BEAT",,0,,0,168070,250480,30378,,,,,,,,,,,,,,,,,,,,,,,,,,,,,,,,,,,,,,,,,,,
5963800,87e93d4a-860e-400e-b464-e3a2feb0a787,1391884289,60,1548678302,,0,0,6.16,1479,1479,127,139,,,1,2.3,0.8,1.11,0.97,,286,158,181,,,,69.77,50.42,71.39,1,,,,,,,,,,,,,,46,87,15.42,15.79,16.19,-0.6,,,,,,,,,,,,,,,,"3,2,10,18,8,2,6,48,2","0,18,29,52,1",,,,,,144,,,,,,,,,,,,,,,,,,,,,,,,,,,,,,,,,,,,60.4,6,23,192,85,,989,,,1,5,3,,1,0,,,,,"TWL locker",,"Polar BEAT",,0,,0,168070,250480,30378,,,,,,,,,,,,,,,,,,,,,,,,,,,,,,,,,,,,,,,,,,,
5963801,c7dc122e-a615-41c5-8458-eced5a67f5e8,1397589636,120,1548678302,,0,0,3.1,1028,1028,11,16,,,1,0,0.07,1.01,0.98,,178,131,138,,,,59.67,33,59.81,1,,,,,,,,,,,,,,15,86,10.85,11.03,11,-6.7,,,,,,,,,,,,,,,,"12,14,18,38,19,0,0,0,0","1,99,0,0,0",,,,,,105,,,,,,,,,,,,,,,,,,,,,,,,,,,,,,,,,,,,13.5,8,16,355,67,,1029,0,,0,5,3,,1,0,,,,,Auslaufen,,"Polar BEAT",,0,,0,168070,250480,30378,,,,,,,,,,,,,,,,,,,,,,,,,,,,,,,,,,,,,,,,,,,
5963802,1c65e28a-b107-4821-881e-c6c91cd48f8c,1446060824,60,1548678304,,0,0,15.9,4713,4715,234,243,,,1,2.2,0.58,,,417,1086,,,,,,,42.04,,1,,,,,,,,,,,,,,97,81,12.38,12.92,13.27,,,,,,,,,,,,,,,,,"9,1,3,11,33,39,4,0,0",,,,,,,125,,,,,,,,,,,,,,,,,,,,,,,,,,,,,,,,,,,,,11,7,182,93,,1011,,,1,5,3,,1,0,,,,,"Aachen Laufen",,"Polar BEAT",,0,,0,168070,250480,30378,,,,,,,,,,,,,,,,,,,,,,,,,,,,,,,,,,,,,,,,,,4,
5963803,e1fe6304-4b81-4211-aaaf-f93a461cae78,1444767053,120,1548678305,,0,0,2.84,780,780,30,21,,,1,0.1,0.28,,,,194,,,,,,,40.8,,1,,,,,,,,,,,,,,16,84,13.38,13.14,13.53,,,,,,,,,,,,,,,,,"0,3,2,7,44,39,5,0,0",,,,,,,130,,,,,,,,,,,,,,,,,,,,,,,,,,,,,,,,,,,,,3,13,10,86,,1020,,,1,4,3,,1,0,,,,,"Aachen Laufen",,"Polar BEAT",,0,,0,168070,250480,30378,,,,,,,,,,,,,,,,,,,,,,,,,,,,,,,,,,,,,,,,,,,
5963804,5dcac737-d88f-41c7-99b2-3b2adbb02f18,1399148104,120,1548678306,,0,0,10.22,2871,2899,105,105,,,1,1.2,0.45,,,,686,,,,,,,43.28,,1,,,,,,,,,,,,,,59,83,12.96,12.89,13.14,,,,,,,,,,,,,,,,,"2,1,4,11,47,34,2,0,0",,,,,,,129,,,,,,,,,,,,,,,,,,,,,,,,,,,,,,,,,,,,,11,3,20,57,,1025,0,,0,5,3,,1,0,,,,,"Regenerativer DL ",,"Polar BEAT",,0,,0,168070,250480,30378,,,,,,,,,,,,,,,,,,,,,,,,,,,,,,,,,,,,,,,,,,,
5963805,ab3a976c-4d92-4096-9236-0ffd0ad5f5b7,1401468893,120,1548678306,,0,0,8.76,2214,2315,129,114,,,1,1.6,0.51,,,441,594,,,,,,,48.48,,1,,,,,,,,,,,,,,45,84,14.6,14.51,14.97,,,,,,,,,,,,,,,,,"3,2,3,4,12,32,45,0,0",,,,,,,141,,,,,,,,,,,,,,,,,,,,,,,,,,,,,,,,,,,,,17,5,49,55,,1021,4,,0,5,3,,1,0,,,,,"Zügiger DL + Steigerungen",,"Polar BEAT",,0,,0,168070,250480,30378,,,,,,,,,,,,,,,,,,,,,,,,,,,,,,,,,,,,,,,,,,5,
5963806,45276d34-4898-40ef-bccb-c756aa414bf3,1401572324,120,1548678306,,0,0,3.03,564,564,32,38,,,1,1.5,1,,,,194,,,,,,,63.89,,1,,,,,,,,,,,,,,11,90,19.37,19.27,19.41,,,,,,,,,,,,,,,,,"0,0,0,0,0,0,0,80,20",,,,,,,179,,,,,,,,,,,,,,,,,,,,,,,,,,,,,,,,,,,,,16,0,342,58,,,0,,1,3,3,,1,0,,,,,"WK 3.000m Huckenol",,"Polar BEAT",,0,,0,168070,250480,30378,,,,,,,,,,,,,,,,,,,,,,,,,,,,,,,,,,,,,,,,,,,
5963807,9659eb08-a7b1-422f-8347-b7c2866a2b25,1465588981,120,1548678307,,0,0,21.61,6034,6676,252,258,,,1,2.2,0.4,,,317,1493,,,,,,,46.18,,1,,,,,,,,,,,,,,125,81,13.1,13.04,13.35,,,,,,,,,,,,,,,,,"4,1,3,10,41,39,3,0,0",,,,,,,133,,,,,,,,,,,,,,,,,,,,,,,,,,,,,,,,,,,,,18,5,31,61,,1012,,,0,5,3,,1,0,,,,,"Aachen Laufen",,"Polar BEAT",,0,,0,168070,250480,30378,,,,,,,,,,,,,,,,,,,,,,,,,,,,,,,,,,,,,,,,,,"4,5",
5963808,4c3fb305-b1b0-404a-9c08-497da119a3f3,1465852488,120,1548678307,,0,0,3,704,704,29,16,,,1,0,0.27,,,,206,,,,,,,49.09,,1,,,,,,,,,,,,,,14,84,15.62,15.45,15.82,,,,,,,,,,,,,,,,,"0,0,0,0,2,30,63,4,0",,,,,,,152,,,,,,,,,,,,,,,,,,,,,,,,,,,,,,,,,,,,,14,5,238,92,,1003,0,,0,6,3,,1,0,,,,,"Aachen Laufen",,"Polar BEAT",,0,,0,168070,250480,30378,,,,,,,,,,,,,,,,,,,,,,,,,,,,,,,,,,,,,,,,,,,
5963809,a8409490-2177-476e-b638-cc56cbe09ca0,1409342838,120,1548678308,,0,0,18.94,4958,4958,242,252,,,1,1.9,0.48,1.03,1.04,403,837,147,172,,,,69.22,49.24,70.27,1,,,,,,,,,,,,,,115,84,13.99,13.93,14.24,-3.8,,,,,,,,,,,,,,,,"3,0,0,4,22,51,19,0,0","0,26,67,7,0",,,,,,136,,,,,,,,,,,,,,,,,,,,,,,,,,,,,,,,,,,,49.9,17,9,216,77,,1016,,,1,5,3,,1,0,,,,,"Zügiger DL ",,"Polar BEAT",,0,,0,168070,250480,30378,,,,,,,,,,,,,,,,,,,,,,,,,,,,,,,,,,,,,,,,,,"4,5",
5963810,8a8abcbf-cd77-4d71-a129-bf964c3fa789,1500732434,120,1548678309,,0,0,4.42,1345,1345,0,2,,,1,0,0,,,,267,,,,,,,37.39,,1,,,,,,,,,,,,,,27,79,11.77,13.68,13.75,,,,,,,,,,,,,,,,,"31,2,4,5,11,9,14,24,0",,,,,,,125,,,,,,,,,,,,,,,,,,,,,,,,,,,,,,,,,,,,,26,11,206,50,,1011,6,,0,5,3,,1,0,,,,,"Aachen Laufen",,"Polar BEAT",,0,,0,168070,250480,30378,,,,,,,,,,,,,,,,,,,,,,,,,,,,,,,,,,,,,,,,,,,
5963811,43a23f4c-10cf-437f-80e3-bda1f15492d4,1547143659,60,1548678309,,0,0,14.81,3771,3773,61,61,,,1,0,0.12,,0.92,,984,155,177,,,,66.65,49.86,66.99,1,,,,,,,,,,,,,,105,82,14.18,14.27,14.36,1.8,,,,,,,,,,,,,,,,"0,0,1,3,20,60,12,4,0","0,4,70,26,0",,,,,,144,,,,,,,,,,,,,,,,,,,,,,,,,,,,,,,,,,,,60.8,1,7,77,92,,1026,0,379,1,4,3,,1,0,I11.372|48:50-I0.237|0:45-I0.180|0:47-I0.207|0:40-I0.202|0:51-I0.417|1:36-I0.218|0:44-I0.226|0:55-I0.208|0:44-I1.539|7:02,,Running,,,,"Polar M430",43,0,,0,168070,250480,30378,,,,,,,,,,,,,,,,,,,,,,,,,,,,,,,,,,,,,,,,,,,
5963812,f6aa5e46-394e-4a6a-8e5b-bf8b44f2504a,1482065683,60,1548678311,,0,0,20.73,5824,5954,356,348,,,1,3.2,0.59,,,569,1393,,,,,,,45.7,,1,,,,,,,,,,,,,,120,83,13.19,13.18,13.74,,,,,,,,,,,,,,,,,"8,3,6,15,27,24,15,1,1",,,,,,,129,,,,,,,,,,,,,,,,,,,,,,,,,,,,,,,,,,,,,6,3,290,89,,1036,1,,0,9,3,,1,0,,,,,"Aachen Laufen",,"Polar BEAT",,0,,0,168070,250480,30378,,,,,,,,,,,,,,,,,,,,,,,,,,,,,,,,,,,,,,,,,,"4,5,5,5",
5963814,a008e401-9ae6-4441-8471-3c45a7c48000,1426013524,60,1548678311,,0,0,5.36,1812,2079,90,53,,,1,1.1,0.55,,,,372,,,,,,,33.37,,1,,,,,,,,,,,,,,37,81,11.07,11.34,11.97,,,,,,,,,,,,,,,,,"24,10,17,19,16,9,5,0,0",,,,,,,110,,,,,,,,,,,,,,,,,,,,,,,,,,,,,,,,,,,,,8,8,344,70,,1030,,,1,5,3,,1,0,,,,,"Aachen Laufen",,"Polar BEAT",,0,,0,168070,250480,30378,,,,,,,,,,,,,,,,,,,,,,,,,,,,,,,,,,,,,,,,,,,
5963815,,1333299912,120,1548678311,,0,0,12.96,0,0,,,,,0,,,,,,888,,,,,,,,,1,,,,,,,,,,,,,,0,,,,,,,,,,,,,,,,,,,,,,,,,,,,,,,,,,,,,,,,,,,,,,,,,,,,,,,,,,,,,,,,,,,,,,,,,,1,,,0,0,,,,,,,"Polar BEAT",,0,,0,168070,250480,30378,,,,,,,,,,,,,,,,,,,,,,,,,,,,,,,,,,,,,,,,,,,
5963816,10f820ae-d948-4000-a321-187f35779e81,1399580047,120,1548678311,,0,0,3.55,1000,1000,33,42,,,1,0.5,0.45,,,,240,,,,,,,40.35,,1,,,,,,,,,,,,,,20,81,12.81,12.88,12.95,,,,,,,,,,,,,,,,,"0,0,3,18,51,28,1,0,0",,,,,,,131,,,,,,,,,,,,,,,,,,,,,,,,,,,,,,,,,,,,,11,13,218,94,,1010,0,,0,6,3,,1,0,,,,,Einlaufen,,"Polar BEAT",,0,,0,168070,250480,30378,,,,,,,,,,,,,,,,,,,,,,,,,,,,,,,,,,,,,,,,,,,
5963817,2a4854c5-3981-43ee-b392-a14c47614f2c,1481144979,60,1548678311,,0,0,2.58,787,792,24,32,,,1,0.8,0.47,,,,176,,,,,,,35.85,,1,,,,,,,,,,,,,,16,82,11.79,11.84,11.99,,,,,,,,,,,,,,,,,"4,4,3,37,53,0,0,0,0",,,,,,,120,,,,,,,,,,,,,,,,,,,,,,,,,,,,,,,,,,,,,7,7,205,62,,1033,0,,1,5,3,,1,0,,,,,"Aachen Laufen",,"Polar BEAT",,0,,0,168070,250480,30378,,,,,,,,,,,,,,,,,,,,,,,,,,,,,,,,,,,,,,,,,,,
5963819,60f4a4dc-eb1d-445d-aaac-2fcc9778df08,1528827197,120,1548678312,,0,0,14.57,3777,3779,35,36,,,1,0,0.04,,0.93,,943,151,194,,,,67.58,48.78,67.78,1,,,,,,,,,,,,,,99,82,13.92,14.24,14.3,3,,,,,,,,,,,,,,,,"2,0,3,9,27,39,12,8,0","1,11,70,17,3",,,,,,141,,,,,,,,,,,,,,,,,,,,,,,,,,,,,,,,,,,,86.1,18,14,2,91,,1010,,,0,6,3,,1,0,I9.338|41:25-I1.027|3:41-I0.418|1:51-I1.056|3:37-I0.429|1:56-I1.039|3:29-I1.260|7:01,,Running,,,,"Polar M430",43,0,,0,168070,250480,30378,,,,,,,,,,,,,,,,,,,,,,,,,,,,,,,,,,,,,,,,,,,
5963821,9f9c1fe7-8bfc-49dd-b828-ad77afe88a96,1473526415,120,1548678313,,0,0,8.48,2546,2546,136,136,,,1,1.7,0.57,,,320,577,,,,,,,39.52,,1,,,,,,,,,,,,,,52,82,12.31,12.06,12.47,,,,,,,,,,,,,,,,,"0,1,12,40,37,10,0,0,0",,,,,,,122,,,,,,,,,,,,,,,,,,,,,,,,,,,,,,,,,,,,,27,5,226,47,,,,,0,3,3,,1,0,,,,,"Balve Laufen",,"Polar BEAT",,0,,0,168070,250480,30378,,,,,,,,,,,,,,,,,,,,,,,,,,,,,,,,,,,,,,,,,,5,
5963822,45fcfbf9-ddbf-4539-8f77-57b1c674eeeb,1437077342,120,1548678313,,0,0,3.35,929,929,64,63,,,1,1.6,0.58,,,463,226,,,,,,,40.91,,1,,,,,,,,,,,,,,19,82,13.44,13.05,13.83,,,,,,,,,,,,,,,,,"0,1,4,22,35,31,7,0,0",,,,,,,132,,,,,,,,,,,,,,,,,,,,,,,,,,,,,,,,,,,,,26,9,59,58,,1014,,,0,3,3,,1,0,,,,,"Aachen Laufen",,"Polar BEAT",,0,,0,168070,250480,30378,,,,,,,,,,,,,,,,,,,,,,,,,,,,,,,,,,,,,,,,,,4,
5963824,103ec88f-6bbe-4e03-a6bb-19f49b534207,1396470766,120,1548678314,,0,0,17,4565,4716,240,258,,,1,2.5,0.5,1.07,0.98,495,865,150,210,,,,65.28,47.4,66.34,1,,,,,,,,,,,,,,117,83,13.64,13.6,14.03,-2.3,,,,,,,,,,,,,,,,"4,2,2,10,21,49,12,0,0","0,19,62,19,0",,,,,,135,,,,,,,,,,,,,,,,,,,,,,,,,,,,,,,,,,,,50.5,17,2,172,56,,1005,0,,1,5,3,,1,0,,,,,"Lockerer DL",,"Polar BEAT",,0,,0,168070,250480,30378,,,,,,,,,,,,,,,,,,,,,,,,,,,,,,,,,,,,,,,,,,"5,5,5",
5963825,a8f0d3e9-3d8a-43fc-b866-fcfc8cb85c42,1418844340,60,1548678314,,0,0,8.89,2623,2663,151,151,,,1,2.1,0.68,,,246,595,,,,,,,40.47,,1,,,,,,,,,,,,,,54,83,12.56,12.3,12.77,,,,,,,,,,,,,,,,,"2,2,8,31,42,16,0,0,0",,,,,,,123,,,,,,,,,,,,,,,,,,,,,,,,,,,,,,,,,,,,,7,6,241,97,,,0,,1,5,3,,1,0,,,,,"Langsamer DL",,"Polar BEAT",,0,,0,168070,250480,30378,,,,,,,,,,,,,,,,,,,,,,,,,,,,,,,,,,,,,,,,,,4,
5963827,39ef0e73-1357-434f-ac43-a626fd90f265,1411555715,120,1548678315,,0,0,15.12,4630,4634,215,213,,,1,2.3,0.56,,,413,1019,,,,,,,40.32,,1,,,,,,,,,,,,,,96,80,11.96,12.38,12.84,,,,,,,,,,,,,,,,,"8,1,5,21,47,16,2,0,0",,,,,,,122,,,,,,,,,,,,,,,,,,,,,,,,,,,,,,,,,,,,,12,7,225,81,,1014,2,,0,5,3,,1,0,,,,,"Regenerativer DL",,"Polar BEAT",,0,,0,168070,250480,30378,,,,,,,,,,,,,,,,,,,,,,,,,,,,,,,,,,,,,,,,,,4,
5963829,8f904a14-7eb1-4963-a089-3af558ec5d79,1391950825,60,1548678316,,0,0,17.13,4962,5508,297,295,,,1,3.1,0.55,0.99,0.93,567,703,143,171,,,,63.31,43.44,64.68,1,,,,,,,,,,,,,,109,83,12.82,12.72,13.34,0,,,,,,,,,,,,,,,,"7,4,5,14,38,27,5,0,0","0,39,48,13,0",,,,,,125,,,,,,,,,,,,,,,,,,,,,,,,,,,,,,,,,,,,48.9,6,37,221,63,,994,,,0,11,3,,1,0,,,,,"Sehr lockerer DL Aachener Wald",,"Polar BEAT",,0,,0,168070,250480,30378,,,,,,,,,,,,,,,,,,,,,,,,,,,,,,,,,,,,,,,,,,"4,4,5",
5963830,86d1c61f-dab5-43c0-8765-2e4d8eeea09e,1510600458,60,1548678316,,0,0,1.88,670,673,4,4,,,1,0,0.21,1.11,0.84,,118,126,142,,,,57.1,29.07,57.25,1,,,,,,,,,,,,,,9,79,10.15,10.08,10.18,0.3,,,,,,,,,,,,,,,,"18,23,49,7,1,2,1,0,0","2,96,3,0,0",,,,,,107,,,,,,,,,,,,,,,,,,,,,,,,,,,,,,,,,,,,9.2,4,1,310,88,,,0,,1,5,3,,1,0,I1.000|6:06-I0.887|5:09,,Running,,,,"Polar M430",43,0,,0,168070,250480,30378,,,,,,,,,,,,,,,,,,,,,,,,,,,,,,,,,,,,,,,,,,,
5963832,a8a979f5-82cc-473e-ba7d-b7acb85ff5b0,1420747804,60,1548678317,,0,0,6.86,2548,2863,51,77,,,1,0.5,0.29,1.32,1.23,,371,139,172,,,,48.28,30.27,48.5,1,,,,,,,,,,,,,,48,,9.7,10.83,10.85,13.9,,,,,,,,,,,,,,,,"21,7,21,30,20,2,0,0,0","0,65,34,2,0",,,,,,,,,,,,,,,,,,,,,,,,,,,,,,,,,,,,,,,,,,21,5,12,267,97,,1027,0,,1,5,3,,1,0,,,,,Auslaufen,,"Polar BEAT",,0,,0,168070,250480,30378,,,,,,,,,,,,,,,,,,,,,,,,,,,,,,,,,,,,,,,,,,,
5963834,73c0bcb7-c897-4ad6-9c38-524ad1af2101,1511098450,60,1548678317,,0,0,21.17,5744,5746,62,62,,,1,0,0.04,,0.91,,1399,151,173,,,,63.87,47.66,64.1,1,,,,,,,,,,,,,,149,83,13.3,13.39,13.46,-0.1,,,,,,,,,,,,,,,,"0,0,2,14,30,48,5,0,0","0,14,68,18,0",,,,,,133,,,,,,,,,,,,,,,,,,,,,,,,,,,,,,,,,,,,60.6,8,6,273,68,,1020,,,0,5,3,,1,0,I17.410|1:17:18-I3.770|18:29,,Running,,,,"Polar M430",43,0,,0,168070,250480,30378,,,,,,,,,,,,,,,,,,,,,,,,,,,,,,,,,,,,,,,,,,,
5963838,a39e9835-b29e-49ed-81dc-22b3af07eb87,1406808219,120,1548678320,,0,0,7.01,2012,2012,92,65,,,1,1.3,0.55,,,,472,,,,,,,41.18,,1,,,,,,,,,,,,,,41,81,12.84,12.69,13.05,,,,,,,,,,,,,,,,,"3,2,4,19,45,27,0,0,0",,,,,,,129,,,,,,,,,,,,,,,,,,,,,,,,,,,,,,,,,,,,,21,4,183,65,,1016,7,,0,3,3,,1,0,,,,,"Lockerer DL + Lauf ABC",,"Polar BEAT",,0,,0,168070,250480,30378,,,,,,,,,,,,,,,,,,,,,,,,,,,,,,,,,,,,,,,,,,,
5963839,00c1750b-150e-41e7-8aa2-b56c69e2281f,1510822606,60,1548678320,,0,0,8.31,1941,1994,21,20,,,1,0,0.1,1.43,0.66,,313,121,146,,,,,,,1,,,,,,,,,,,,,,23,,,18.02,,1.2,-25.7,89,62,,1,104,87,,,,,,,,,"38,18,43,1,0,0,0","4,93,3,0,0","92,0,0,1,7",,,,,,,,,,,,,,,,,,,,,,,,,,,,,,,,,,,,,,,,,12.2,2,3,72,90,,,0,,0,4,3,,1,0,,,Cycling,,,,"Polar M430",43,0,,0,168072,,30378,,,,,,,,,,,,,,,,,,,,,,,,,,,,,,,,,,,,,,,,,,,
5963841,7049a6e3-1a0e-4fed-b71d-0026e1981b27,1463915572,120,1548678320,,0,0,5.34,1969,2178,4,4,,,1,0,0,,,,358,,,,,,,30.06,,1,,,,,,,,,,,,,,40,77,9.79,11.36,11.36,,,,,,,,,,,,,,,,,"35,3,6,12,24,18,2,0,0",,,,,,,106,,,,,,,,,,,,,,,,,,,,,,,,,,,,,,,,,,,,,23,8,203,55,,,,,0,3,3,,1,0,,,,,"Menden Laufen",,"Polar BEAT",,0,,0,168070,250480,30378,,,,,,,,,,,,,,,,,,,,,,,,,,,,,,,,,,,,,,,,,,,
5963843,025e031c-c514-4746-bfce-41755214196f,1398890522,120,1548678321,,0,0,20,5170,5309,312,298,,,1,2.6,0.46,1.11,0.97,431,1090,162,210,,,,61.43,50.18,62.67,1,,,,,,,,,,,,,,174,83,14.2,14.11,14.58,-3,,,,,,,,,,,,,,,,"2,1,2,5,23,41,25,1,0","0,8,29,62,1",,,,,,140,,,,,,,,,,,,,,,,,,,,,,,,,,,,,,,,,,,,89.8,15,3,315,77,,1012,0,,1,5,3,,1,0,,,,,"Zügiger DL ",,"Polar BEAT",,0,,0,168070,250480,30378,,,,,,,,,,,,,,,,,,,,,,,,,,,,,,,,,,,,,,,,,,"5,5",
5963844,997f6b48-357b-47a2-a939-4a509a0d8f87,1529084086,120,1548678322,,0,0,2.6,994,994,21,20,,,1,0,0,1.07,0.85,,191,130,162,,,,50.51,27.51,51.04,1,,,,,,,,,,,,,,15,84,9.48,10.27,10.31,10.7,,,,,,,,,,,,,,,,"68,16,3,3,1,2,3,4,0","1,78,20,1,0",,,,,,93,,,,,,,,,,,,,,,,,,,,,,,,,,,,,,,,,,,,15.9,23,10,14,49,,1016,,,0,5,3,,1,0,I0.389|2:56-I0.304|0:59-I0.321|2:08-I1.590|10:34,,Running,,,,"Polar M430",43,0,,0,168070,250480,30378,,,,,,,,,,,,,,,,,,,,,,,,,,,,,,,,,,,,,,,,,,,
5963845,d3fa3499-f756-41fc-ab1d-85e03b4d8851,1417348859,60,1548678322,,0,0,3.6,1182,1196,52,55,,,1,1.7,0.78,,,,229,,,,,,,33.73,,1,,,,,,,,,,,,,,24,81,11.23,11.23,11.57,,,,,,,,,,,,,,,,,"14,5,22,29,28,3,0,0,0",,,,,,,113,,,,,,,,,,,,,,,,,,,,,,,,,,,,,,,,,,,,,3,5,156,92,,1013,,,0,5,3,,1,0,,,,,Einlaufen,,"Polar BEAT",,0,,0,168070,250480,30378,,,,,,,,,,,,,,,,,,,,,,,,,,,,,,,,,,,,,,,,,,,
5963847,a370d822-81a4-4c39-95cd-0dbb9c173f77,1397759673,120,1548678322,,0,0,5.01,1848,1920,0,0,,,1,0,0,,,,319,146,179,,,,45.73,29.94,45.73,1,,,,,,,,,,,,,,44,80,9.75,12.69,12.69,22.3,,,,,,,,,,,,,,,,"63,2,2,2,3,3,5,7,14","0,43,28,30,0",,,,,,102,,,,,,,,,,,,,,,,,,,,,,,,,,,,,,,,,,,,42,11,22,254,81,,1015,1,,0,5,3,,1,0,,,,,"6x (200m 300m)",,"Polar BEAT",,0,,0,168070,250480,30378,,,,,,,,,,,,,,,,,,,,,,,,,,,,,,,,,,,,,,,,,,,
5963848,876f34bc-ce24-415e-8010-716b2eb2fe2e,1434098393,120,1548678322,,0,0,4.03,1293,1382,66,63,,,1,1.5,0.65,,,,283,,,,,,,34.92,,1,,,,,,,,,,,,,,26,80,11.57,11.54,11.76,,,,,,,,,,,,,,,,,"15,6,10,29,33,7,0,0,0",,,,,,,117,,,,,,,,,,,,,,,,,,,,,,,,,,,,,,,,,,,,,20,12,102,63,,1012,,,0,3,3,,1,0,,,,,"Voeren Sint-Martens-Voeren Laufen",,"Polar BEAT",,0,,0,168070,250480,30378,,,,,,,,,,,,,,,,,,,,,,,,,,,,,,,,,,,,,,,,,,,
5963849,8fa6dd4b-baa3-41a4-a528-8f15999c4451,1515840397,60,1548678323,,0,0,5.66,1660,1661,27,28,,,1,0,0.11,1.12,0.88,,342,137,154,,,,65.8,39.64,66.17,1,,,,,,,,,,,,,,30,82,12.31,12.33,12.42,8.3,,,,,,,,,,,,,,,,"2,1,4,17,71,5,0,0,0","0,53,47,0,0",,,,,,125,,,,,,,,,,,,,,,,,,,,,,,,,,,,,,,,,,,,27.2,5,2,52,81,,,1,,0,5,3,,1,0,I1.000|5:05-I1.000|4:53-I1.000|4:54-I1.000|4:45-I1.000|4:51-I0.672|3:14,,Running,,,,"Polar M430",43,0,,0,168070,250480,30378,,,,,,,,,,,,,,,,,,,,,,,,,,,,,,,,,,,,,,,,,,,
5963851,40556be7-6e42-46ce-a814-22872e044000,1474402548,120,1548678323,,0,0,0.66,324,399,15,8,,,1,0.5,0.39,,,,43,,,,,,,17.77,,1,,,,,,,,,,,,,,6,71,8.03,8.68,9.02,,,,,,,,,,,,,,,,,"58,6,21,14,0,0,0,0,0",,,,,,,86,,,,,,,,,,,,,,,,,,,,,,,,,,,,,,,,,,,,,15,1,93,81,,1019,0,,1,5,3,,1,0,,,,,"Aachen Laufen",,"Polar BEAT",,0,,0,168070,250480,30378,,,,,,,,,,,,,,,,,,,,,,,,,,,,,,,,,,,,,,,,,,,
5963852,79c0abc1-f00a-4bca-8e55-ff034e67a0d6,1417721436,60,1548678324,,0,0,8.31,2329,2638,341,316,,,1,4.7,0.73,,,940,504,,,,,,,42.8,,1,,,,,,,,,,,,,,48,85,13.86,13.42,15.81,,,,,,,,,,,,,,,,,"11,11,14,11,7,9,29,7,0",,,,,,,126,,,,,,,,,,,,,,,,,,,,,,,,,,,,,,,,,,,,,2,4,149,91,,1016,,,1,4,3,,1,0,,,,,"15x Dreieck",,"Polar BEAT",,0,,0,168070,250480,30378,,,,,,,,,,,,,,,,,,,,,,,,,,,,,,,,,,,,,,,,,,"5,5,5,5,5,5,5,5,5,5,5,5",
5963854,41074aed-5efa-40b5-9a91-8cd5b000b238,1431599716,120,1548678325,,0,0,26.96,7660,7964,662,660,,,1,4.8,0.67,,,530,2470,,,,,,,46.02,,1,,,,,,,,,,,,,,159,83,13.26,13.35,14.3,,,,,,,,,,,,,,,,,"8,2,4,10,22,39,13,1,0",,,,,,,127,,,,,,,,,,,,,,,,,,,,,,,,,,,,,,,,,,,,,10,0,342,67,,,4,,0,5,3,,1,0,,,,,"Balve Laufen",,"Polar BEAT",,0,,0,168070,250480,30378,,,,,,,,,,,,,,,,,,,,,,,,,,,,,,,,,,,,,,,,,,"4,4,4,4,5,5,5,5,5,5,5",
5963856,413758a8-953b-446a-bd8a-3e4e419c2f53,1477600697,120,1548678325,,0,0,1,426,426,0,5,,,1,0,0,,,,60,,,,,,,22.06,,1,,,,,,,,,,,,,,8,65,8.37,13.6,13.5,,,,,,,,,,,,,,,,,"57,0,0,4,2,3,4,30,0",,,,,,,108,,,,,,,,,,,,,,,,,,,,,,,,,,,,,,,,,,,,,10,4,217,92,,1034,0,,1,5,3,,1,0,,,,,"Aachen Laufen",,"Polar BEAT",,0,,0,168070,250480,30378,,,,,,,,,,,,,,,,,,,,,,,,,,,,,,,,,,,,,,,,,,,
5963857,dcb1b4ac-9775-4639-8ff1-56416b20b937,1404251496,120,1548678325,,0,0,4.37,1201,1201,54,37,,,1,0.7,0.35,,,300,295,,,,,,,42.13,,1,,,,,,,,,,,,,,24,80,13.36,13.25,13.81,,,,,,,,,,,,,,,,,"2,1,4,13,24,52,4,0,0",,,,,,,136,,,,,,,,,,,,,,,,,,,,,,,,,,,,,,,,,,,,,16,2,9,62,,1020,0,,1,3,3,,1,0,,,,,"Einlaufen mit Steigerungen",,"Polar BEAT",,0,,0,168070,250480,30378,,,,,,,,,,,,,,,,,,,,,,,,,,,,,,,,,,,,,,,,,,5,
5963858,e473fee4-dfd9-4d50-9f7d-97ffae9c8dbf,1397160697,120,1548678326,,0,0,3.28,1071,1072,61,61,,,1,1.7,0.63,1.11,0.94,395,184,144,158,,,,54.12,33.74,55.36,1,,,,,,,,,,,,,,23,78,11.35,11.18,12.07,2.3,,,,,,,,,,,,,,,,"16,6,15,36,27,1,0,0,0","0,33,67,0,0",,,,,,118,,,,,,,,,,,,,,,,,,,,,,,,,,,,,,,,,,,,23.5,14,3,60,65,,1020,0,,0,5,3,,1,0,,,,,Einlaufen,,"Polar BEAT",,0,,0,168070,250480,30378,,,,,,,,,,,,,,,,,,,,,,,,,,,,,,,,,,,,,,,,,,4,
5963860,a8a1cfdf-c568-4c77-9ed3-31f51b596661,1466800755,120,1548678326,,0,0,6.39,2041,2079,96,62,,,1,1,0.44,,,,444,,,,,,,36.08,,1,,,,,,,,,,,,,,42,78,11.62,12.23,12.82,,,,,,,,,,,,,,,,,"15,2,4,13,42,23,2,0,0",,,,,,,120,,,,,,,,,,,,,,,,,,,,,,,,,,,,,,,,,,,,,21,3,311,80,,1018,0,,0,5,3,,1,0,,,,,"Aachen Laufen",,"Polar BEAT",,0,,0,168070,250480,30378,,,,,,,,,,,,,,,,,,,,,,,,,,,,,,,,,,,,,,,,,,,
5963861,70bfd7d9-f20f-4af2-a932-f48884d95b0d,1346672032,120,1548678328,,0,0,88.2,11027,11409,1917,1917,,,1,5.2,0.56,,,941,3261,,,,,,,,,1,,,,,,,,,,,,,,123,,,34.83,,,,442,296,,1,581,437,,,,,,,,,"16,13,14,14,11,10,22",,"48,11,8,6,26",,,,,,,,,,,,,,,,,,,,,,,,,,,,,,,,,,,,,,,,,,17,2,359,76,,1026,3,,0,5,3,,1,0,,,,,,,"Polar BEAT",,0,,0,168072,,30378,,,,,,,,,,,,,,,,,,,,,,,,,,,,,,,,,,,,,,,,,,"3,4,4,4,4,4,4,4,4,4,5,5,5,5",
5963862,8d462d2b-c08e-4428-a88b-4d13212a467f,1503833337,120,1548678329,,0,0,9.18,2576,2669,0,2,,,1,0,0,0.35,0.69,,629,158,185,,,,57.54,43.02,57.52,1,,,,,,,,,,,,,,81,79,12.92,14.86,14.93,7.3,,,,,,,,,,,,,,,,"30,1,2,2,2,3,22,39,0","1,19,28,45,7",,,,,,135,,,,,,,,,,,,,,,,,,,,,,,,,,,,,,,,,,,,83.3,19,3,42,79,,1018,4,,0,5,3,,1,0,I0.991|3:32-I0.177|2:04-I1.037|3:32-I0.152|2:02-I1.020|3:30-I0.108|2:03-I1.012|3:31-I0.116|2:05-I1.022|3:29-I0.069|2:06-I1.028|3:29-I0.213|2:51-I0.523|1:48-I0.051|0:59-I0.524|1:49-I0.029|1:01-I0.497|1:49-I0.093|0:59-I0.494|1:48-I0.021|0:05,,Running,,,,"Polar M430",43,0,,0,168070,250480,30378,,,,,,,,,,,,,,,,,,,,,,,,,,,,,,,,,,,,,,,,,,,
5963863,7429efa3-9029-41a0-88d7-28995aba973f,1364555964,60,1548678329,,0,0,10.29,3030,3144,88,91,,,1,0,0.1,,,3120,681,,,,,,,40.98,,1,,,,,,,,,,,,,,62,,12.44,14.39,14.64,,,,,,,,,,,,,,,,,"22,3,7,7,9,11,26,9,6",,,,,,,,,,,,,,,,,,,,,,,,,,,,,,,,,,,,,,,,,,,,0,4,269,74,,,3,,0,5,3,,1,0,,,,,,,"Polar BEAT",,0,,0,168070,250480,30378,,,,,,,,,,,,,,,,,,,,,,,,,,,,,,,,,,,,,,,,,,"4,5",
5963864,d51cf4c3-5511-490c-bea2-eca37e0ad5d2,1396384576,120,1548678329,,0,0,6.54,1775,1837,69,69,,,1,0,0.01,0.33,0.48,,364,158,183,,,,59.96,43.81,60.74,1,,,,,,,,,,,,,,58,78,13.45,15.91,15.97,13.7,,,,,,,,,,,,,,,,"31,1,1,1,1,2,3,53,7","0,26,12,56,7",,,,,,142,,,,,,,,,,,,,,,,,,,,,,,,,,,,,,,,,,,,81.9,16,1,50,57,,1010,0,,1,5,3,,1,0,,,,,"6x 1000m",,"Polar BEAT",,0,,0,168070,250480,30378,,,,,,,,,,,,,,,,,,,,,,,,,,,,,,,,,,,,,,,,,,,
5963865,c4d010bc-fc6f-4312-aac2-07d6d222827e,1481141105,60,1548678330,,0,0,13.04,3569,3616,182,185,,,1,2.2,0.56,,,419,889,,,,,,,45.41,,1,,,,,,,,,,,,,,74,81,13.4,13.25,13.64,,,,,,,,,,,,,,,,,"0,1,3,10,45,36,5,0,0",,,,,,,135,,,,,,,,,,,,,,,,,,,,,,,,,,,,,,,,,,,,,7,13,191,68,,1032,,,1,5,3,,1,0,,,,,"Aachen Laufen",,"Polar BEAT",,0,,0,168070,250480,30378,,,,,,,,,,,,,,,,,,,,,,,,,,,,,,,,,,,,,,,,,,4,
5963866,1bd210a6-ea5b-44fd-8a44-db6ccf662ec0,1468959150,120,1548678331,,0,0,13.63,4547,4989,32,31,,,1,0,0.1,,,,904,,,,,,,36.18,,1,,,,,,,,,,,,,,94,76,10.83,12.99,13.08,,,,,,,,,,,,,,,,,"28,2,6,11,10,17,21,5,1",,,,,,,118,,,,,,,,,,,,,,,,,,,,,,,,,,,,,,,,,,,,,28,4,83,48,,1017,0,,0,3,3,,1,0,,,,,"Aachen Laufen",,"Polar BEAT",,0,,0,168070,250480,30378,,,,,,,,,,,,,,,,,,,,,,,,,,,,,,,,,,,,,,,,,,,
5963867,3c5943dd-2948-46b6-b362-61e4cc55541c,1445091548,120,1548678331,,0,0,1.36,439,439,16,20,,,1,1,0.59,,,,92,,,,,,,31.45,,1,,,,,,,,,,,,,,9,80,11.22,11.18,11.31,,,,,,,,,,,,,,,,,"0,5,31,56,8,0,0,0,0",,,,,,,116,,,,,,,,,,,,,,,,,,,,,,,,,,,,,,,,,,,,,7,8,166,84,,1018,,,0,4,3,,1,0,,,,,"Aachen Laufen",,"Polar BEAT",,0,,0,168070,250480,30378,,,,,,,,,,,,,,,,,,,,,,,,,,,,,,,,,,,,,,,,,,,
5963868,9065c502-c15f-4353-b340-acff4849f5f4,1433362668,120,1548678332,,0,0,16.37,4404,4880,260,267,,,1,2.5,0.49,,,472,1113,,,,,,,47.15,,1,,,,,,,,,,,,,,91,83,13.74,13.84,14.29,,,,,,,,,,,,,,,,,"5,2,4,11,25,37,10,7,0",,,,,,,134,,,,,,,,,,,,,,,,,,,,,,,,,,,,,,,,,,,,,16,4,297,59,,1026,0,,0,5,3,,1,0,,,,,"Aachen Laufen",,"Polar BEAT",,0,,0,168070,250480,30378,,,,,,,,,,,,,,,,,,,,,,,,,,,,,,,,,,,,,,,,,,"5,5,5",
5963869,ad4323af-1226-4b64-9edc-4c2949646fa0,1409402417,120,1548678332,,0,0,7.11,2172,2855,115,86,,,1,1.5,0.49,1.03,0.99,442,382,138,164,,,,62.01,38.29,63.56,1,,,,,,,,,,,,,,40,82,12.14,11.89,12.6,0.2,,,,,,,,,,,,,,,,"4,3,13,41,29,11,0,0,0","0,55,44,1,0",,,,,,120,,,,,,,,,,,,,,,,,,,,,,,,,,,,,,,,,,,,25.4,16,19,222,81,,1018,,,0,4,3,,1,0,,,,,"Einlaufen + Lauf ABC ",,"Polar BEAT",,0,,0,168070,250480,30378,,,,,,,,,,,,,,,,,,,,,,,,,,,,,,,,,,,,,,,,,,4,
5963870,80915209-a61f-48d3-9dca-a06067b72039,1530036628,120,1548678334,,0,0,5.21,1448,1448,29,29,,,1,0,0.23,1.01,0.84,,302,134,154,,,,72.27,42.03,72.76,1,,,,,,,,,,,,,,24,81,13.03,13.16,13.3,22.7,,,,,,,,,,,,,,,,"0,0,3,29,31,25,12,0,0","2,62,36,0,0",,,,,,133,,,,,,,,,,,,,,,,,,,,,,,,,,,,,,,,,,,,25.8,25,12,35,47,,1022,,,0,5,3,,1,0,I1.000|4:24-I1.000|4:10-I1.000|4:26-I1.000|5:00-I1.000|5:03-I0.211|1:07,,Running,,,,"Polar M430",43,0,,0,168070,250480,30378,,,,,,,,,,,,,,,,,,,,,,,,,,,,,,,,,,,,,,,,,,,
5963871,9178d1f1-9d31-463a-8572-f6def4e56ea2,1539358675,120,1548678334,,0,0,4.4,1365,1366,29,29,,,1,0,0.14,1.11,0.9,,298,138,150,,,,60.84,36.54,61.33,1,,,,,,,,,,,,,,25,79,11.68,11.63,11.8,1.7,,,,,,,,,,,,,,,,"0,1,13,62,24,0,0,0,0","2,60,38,0,0",,,,,,122,,,,,,,,,,,,,,,,,,,,,,,,,,,,,,,,,,,,19.3,26,16,210,37,,1022,2,282,0,5,3,,1,0,I1.000|5:10-I1.000|5:09-I1.000|5:13-I1.000|5:14-I0.405|2:01,,Running,,,,"Polar M430",43,0,,0,168070,250480,30378,,,,,,,,,,,,,,,,,,,,,,,,,,,,,,,,,,,,,,,,,,,
5963872,28d1a132-01ce-4806-b3b4-7373582d7c8c,1504942594,120,1548678335,,0,0,5.88,1994,1994,21,21,,,1,0,0.14,1.1,0.88,,393,133,149,,,,57.01,33.43,57.26,1,,,,,,,,,,,,,,32,79,10.66,10.71,10.76,-6.2,,,,,,,,,,,,,,,,"12,16,31,32,6,2,0,0,0","2,95,3,0,0",,,,,,112,,,,,,,,,,,,,,,,,,,,,,,,,,,,,,,,,,,,16.3,15,3,197,78,,,0,,0,5,3,,1,0,I1.000|6:13-I1.000|5:30-I1.000|5:40-I1.000|5:36-I1.000|5:27-I0.890|4:49,,Running,,,,"Polar M430",43,0,,0,168070,250480,30378,,,,,,,,,,,,,,,,,,,,,,,,,,,,,,,,,,,,,,,,,,,
5963873,a38bb935-46b8-4299-9fc3-e888226c33a8,1363715517,60,1548678335,,0,0,2.03,541,541,1,4,,,1,0,0,,,,140,161,168,,,,59.69,40.84,59.62,1,,,,,,,,,,,,,,17,,13.44,13.49,13.43,1.1,,,,,,,,,,,,,,,,"0,0,0,6,31,57,5,1,0","0,0,45,55,0",,,,,,,,,,,,,,,,,,,,,,,,,,,,,,,,,,,,,,,,,,43.4,8,23,250,51,,1002,0,,0,5,3,,1,0,,,,,,,"Polar BEAT",,0,,0,168070,250480,30378,,,,,,,,,,,,,,,,,,,,,,,,,,,,,,,,,,,,,,,,,,,
5963874,,1413921600,120,1548678335,,0,0,2,0,0,,,,,0,,,,,,131,,,,,,,,,1,,,,,,,,,,,,,,0,,,,,,,,,,,,,,,,,,,,,,,,,,,,,,,,,,,,,,,,,,,,,,,,,,,,,,,,,,,,,,,,,,,,,,,,,,1,,,0,0,,,,,Einlaufen,,"Polar BEAT",,0,,0,168070,250480,30378,,,,,,,,,,,,,,,,,,,,,,,,,,,,,,,,,,,,,,,,,,,
5963875,1c5b814f-d880-4663-8b48-bbb65ec80340,1411822123,120,1548678336,,0,0,6.41,2494,2523,111,81,,,1,1.7,0.5,1.59,1.61,246,350,146,186,,,,42.81,28.5,43.98,1,,,,,,,,,,,,,,57,76,9.58,11.13,11.58,-54,,,,,,,,,,,,,,,,"27,12,10,14,26,9,1,0,0","0,31,63,4,1",,,,,,101,,,,,,,,,,,,,,,,,,,,,,,,,,,,,,,,,,,,40.6,19,2,66,76,,1029,3,,0,5,3,,1,0,,,,,"Einlaufen + Lauf ABC",,"Polar BEAT",,0,,0,168070,250480,30378,,,,,,,,,,,,,,,,,,,,,,,,,,,,,,,,,,,,,,,,,,4,
5963876,9c46f2b8-5ec2-4dea-b82f-0693609491e8,1435869218,120,1548678336,,0,0,4.89,2353,2380,8,62,,,1,0,0.22,,,,252,,,,,,,21.58,,1,,,,,,,,,,,,,,48,72,7.43,8.99,8.91,,,,,,,,,,,,,,,,,"61,8,8,13,7,3,0,0,0",,,,,,,87,,,,,,,,,,,,,,,,,,,,,,,,,,,,,,,,,,,,,28,8,330,57,,1018,,,0,5,3,,1,0,,,,,"Aachen Laufen",,"Polar BEAT",,0,,0,168070,250480,30378,,,,,,,,,,,,,,,,,,,,,,,,,,,,,,,,,,,,,,,,,,,
5963877,507b9cd4-37d9-4a0a-a411-ba9acd0f747b,1445287307,120,1548678337,,0,0,15.47,4430,4475,199,206,,,1,2,0.46,,,,1052,,,,,,,43.67,,1,,,,,,,,,,,,,,92,81,12.77,13.29,13.58,,,,,,,,,,,,,,,,,"8,1,2,11,28,38,13,0,0",,,,,,,129,,,,,,,,,,,,,,,,,,,,,,,,,,,,,,,,,,,,,9,2,323,97,,1023,,,1,5,3,,1,0,,,,,"Aachen Laufen",,"Polar BEAT",,0,,0,168070,250480,30378,,,,,,,,,,,,,,,,,,,,,,,,,,,,,,,,,,,,,,,,,,,
5963878,78e9ad5e-19a2-4e5e-8d0c-940e08dd7ee2,1524593278,120,1548678337,,0,0,15.45,3964,3966,77,78,,,1,0,0.13,1.14,0.95,,1043,158,181,,,,64.27,49.59,64.66,1,,,,,,,,,,,,,,125,82,14.07,14.21,14.3,5.8,,,,,,,,,,,,,,,,"0,0,1,10,22,35,29,1,0","1,13,30,56,0",,,,,,143,,,,,,,,,,,,,,,,,,,,,,,,,,,,,,,,,,,,88.4,21,10,232,50,,1016,,,0,4,3,,1,0,I1.769|8:51-I3.084|13:30-I1.028|4:04-I9.585|39:41,,Running,,,,"Polar M430",43,0,,0,168070,250480,30378,,,,,,,,,,,,,,,,,,,,,,,,,,,,,,,,,,,,,,,,,,,
5963879,618b3980-f112-4ae3-8463-9c2308b237d3,1533489335,120,1548678337,,0,0,5.32,1758,1758,24,24,,,1,0,0.13,1.16,0.9,,377,138,152,,,,56.27,34.27,56.59,1,,,,,,,,,,,,,,32,80,10.93,10.95,11.06,0.7,,,,,,,,,,,,,,,,"5,6,42,42,6,0,0,0,0","1,61,37,0,0",,,,,,113,,,,,,,,,,,,,,,,,,,,,,,,,,,,,,,,,,,,20.4,32,17,10,34,,1018,,,0,3,3,,1,0,I1.000|5:38-I1.000|5:19-I1.000|5:33-I1.000|5:49-I1.000|5:20-I0.323|1:42,,Running,,,,"Polar M430",43,0,,0,168070,250480,30378,,,,,,,,,,,,,,,,,,,,,,,,,,,,,,,,,,,,,,,,,,,
5963880,ebef1914-2c92-4ab8-95c4-1cf7c717980d,1541578296,60,1548678338,,0,0,10.57,3054,3058,32,45,,,1,0,0.11,1.13,0.91,,818,158,167,,,,55.5,41.98,55.62,1,,,,,,,,,,,,,,91,83,12.45,12.5,12.57,3.9,,,,,,,,,,,,,,,,"0,0,4,19,68,8,0,0,0","0,3,67,31,0",,,,,,125,,,,,,,,,,,,,,,,,,,,,,,,,,,,,,,,,,,,53.6,4,4,140,100,,,0,,0,5,3,,1,0,I1.000|4:51-I1.000|4:40-I1.000|4:41-I1.000|4:43-I1.000|4:45-I1.000|4:45-I1.000|4:54-I1.000|4:55-I1.000|4:53-I1.000|5:08-I0.574|2:46,,Running,,,,"Polar M430",43,0,,0,168070,250480,30378,,,,,,,,,,,,,,,,,,,,,,,,,,,,,,,,,,,,,,,,,,,
5963881,cea4141b-2687-40cf-bc38-56d9c64b3f31,1456510457,60,1548678338,,0,0,10.01,2312,2378,71,77,,,1,0.3,0.3,,,,682,,,,,,,54.33,,1,,,,,,,,,,,,,,48,86,15.67,15.72,15.82,,,,,,,,,,,,,,,,,"0,0,0,1,7,15,64,12,0",,,,,,,151,,,,,,,,,,,,,,,,,,,,,,,,,,,,,,,,,,,,,3,7,112,70,,1011,,,1,5,3,,1,0,,,,,"Aachen Laufen",,"Polar BEAT",,0,,0,168070,250480,30378,,,,,,,,,,,,,,,,,,,,,,,,,,,,,,,,,,,,,,,,,,,
5963882,99cc54b6-61a7-4a9e-b242-2019642b24f2,1439055024,120,1548678339,,0,0,19.77,4485,4485,323,388,,,1,3.8,0.57,,,625,1335,,,,,,,58.29,,1,,,,,,,,,,,,,,93,86,16.21,16.08,16.48,,,,,,,,,,,,,,,,,"0,0,1,3,8,18,45,26,0",,,,,,,154,,,,,,,,,,,,,,,,,,,,,,,,,,,,,,,,,,,,,21,13,334,75,,1023,,,0,5,3,,1,0,,,,,"Menden Laufen",,"Polar BEAT",,0,,0,168070,250480,30378,,,,,,,,,,,,,,,,,,,,,,,,,,,,,,,,,,,,,,,,,,"4,4,5,5,5,5",
5963883,ea70e496-8cf8-48c3-a9ae-46421e1ee65c,1349810862,120,1548678340,,0,0,14.05,6103,6340,61,62,,,1,0,0.06,0.81,1.32,,987,143,210,,,,38.38,26.49,38.58,1,,,,,,,,,,,,,,133,,8.36,11.91,11.91,43.7,,,,,,,,,,,,,,,,"39,4,8,13,17,12,3,2,3","1,33,64,1,1",,,,,,,,,,,,,,,,,,,,,,,,,,,,,,,,,,,,,,,,,,48.8,11,9,312,85,,1015,0,,1,5,3,,1,0,,,,,,,"Polar BEAT",,0,,0,168070,250480,30378,,,,,,,,,,,,,,,,,,,,,,,,,,,,,,,,,,,,,,,,,,,
5963884,24e76675-435f-40a5-9c52-fea59bdcf800,1430417711,120,1548678341,,0,0,6.52,1616,1616,100,99,,,1,1.4,0.4,,,303,442,,,,,,,48.74,,1,,,,,,,,,,,,,,33,85,14.74,14.7,15.25,,,,,,,,,,,,,,,,,"1,1,1,4,15,33,45,1,0",,,,,,,142,,,,,,,,,,,,,,,,,,,,,,,,,,,,,,,,,,,,,9,11,228,82,,1012,,,0,5,3,,1,0,,,,,"Aachen Laufen",,"Polar BEAT",,0,,0,168070,250480,30378,,,,,,,,,,,,,,,,,,,,,,,,,,,,,,,,,,,,,,,,,,4,
5963885,c44fc791-21c6-44c9-9a97-4f70ce198b29,1544549294,60,1548678341,,0,0,10.63,1905,1934,48,41,,,1,0,0.1,2.51,0.41,,363,129,143,,,,,,,1,,,,,,,,,,,,,,27,,,21.56,,-8.2,-31,105,87,,1,127,116,,,,,,,,,"13,9,73,4,0,0,0","0,98,1,0,0","89,2,0,0,9",,,,,,,,,,,,,,,,,,,,,,,,,,,,,,,,,,,,,,,,,13.6,4,5,277,84,,,0,,1,5,3,,1,0,,,Cycling,,,,"Polar M430",43,0,,0,168072,,30378,,,,,,,,,,,,,,,,,,,,,,,,,,,,,,,,,,,,,,,,,,,
5963886,388f1113-52e2-44fb-a402-f675d535431c,1458386999,60,1548678342,,0,0,7.89,2039,2039,165,167,,,1,2.4,0.85,,,,533,,,,,,,46.93,,1,,,,,,,,,,,,,,42,85,14.23,15.21,15.64,,,,,,,,,,,,,,,,,"17,8,6,7,2,2,20,37,0",,,,,,,137,,,,,,,,,,,,,,,,,,,,,,,,,,,,,,,,,,,,,4,9,2,87,,1024,,,0,5,3,,1,0,,,,,"Aachen Laufen",,"Polar BEAT",,0,,0,168070,250480,30378,,,,,,,,,,,,,,,,,,,,,,,,,,,,,,,,,,,,,,,,,,,
5963887,a9656a9f-8e1d-40c0-8766-d1da79a2aa8e,1430858244,120,1548678342,,0,0,5.7,2071,2212,21,16,,,1,0,0.08,,,,334,,,,,,,30.72,,1,,,,,,,,,,,,,,43,72,10.01,13.67,13.76,,,,,,,,,,,,,,,,,"50,4,4,8,2,2,3,18,9",,,,,,,115,,,,,,,,,,,,,,,,,,,,,,,,,,,,,,,,,,,,,14,8,229,63,,1009,0,,0,5,3,,1,0,,,,,"Aachen Laufen",,"Polar BEAT",,0,,0,168070,250480,30378,,,,,,,,,,,,,,,,,,,,,,,,,,,,,,,,,,,,,,,,,,,
5963888,985d7f20-c0ca-4242-8afe-7059f11cbb91,1523988537,120,1548678343,,0,0,15.07,3850,3850,48,48,,,1,0,0.03,1.11,0.91,,1144,172,189,,,,56.97,49.74,57.19,1,,,,,,,,,,,,,,160,83,14.12,14.26,14.32,8.8,,,,,,,,,,,,,,,,"0,0,2,9,10,53,26,0,0","0,1,10,70,20",,,,,,141,,,,,,,,,,,,,,,,,,,,,,,,,,,,,,,,,,,,137.8,25,1,224,34,,1013,1,,0,5,3,,1,0,I7.924|33:14-I1.034|4:12-I4.346|17:32-I1.768|9:13,,Running,,,,"Polar M430",43,0,,0,168070,250480,30378,,,,,,,,,,,,,,,,,,,,,,,,,,,,,,,,,,,,,,,,,,,
5963889,ec59f1cf-0a53-47ff-9fa7-00f5353a31a5,1537104454,120,1548678344,,0,0,33.47,9679,9679,152,148,,,1,0,0.13,1.07,0.87,,2511,155,171,,,,56.95,45.74,57.28,1,,,,,,,,,,,,,,272,83,12.5,12.6,12.7,13.6,,,,,,,,,,,,,,,,"1,3,10,23,36,27,1,0,0","0,7,66,27,0",,,,,,125,,,,,,,,,,,,,,,,,,,,,,,,,,,,,,,,,,,,57.4,21,7,346,46,,1022,,,0,5,3,,1,0,I21.108|1:35:45-I12.359|1:05:38,,Running,,,,"Polar M430",43,0,,0,168070,250480,30378,,,,,,,,,,,,,,,,,,,,,,,,,,,,,,,,,,,,,,,,,,,
5963890,bca51791-a8d0-4aba-8ca7-f31679cd7d63,1510646073,60,1548678345,,0,0,12.43,2456,2457,53,54,,,1,0,0.08,1.74,0.43,,377,118,147,,,,,,,1,,,,,,,,,,,,,,27,,,19.76,,-1.3,-19,86,69,,1,103,91,,,,,,,,,"20,32,46,3,0,0,0","11,88,2,0,0","87,0,8,4,1",,,,,,,,,,,,,,,,,,,,,,,,,,,,,,,,,,,,,,,,,12.5,2,0,300,93,,,0,,0,9,3,,1,0,,,Cycling,,,,"Polar M430",43,0,,0,168072,,30378,,,,,,,,,,,,,,,,,,,,,,,,,,,,,,,,,,,,,,,,,,,
5963891,5e2a2e72-34e1-413e-8cdf-2af136c79fc8,1421578397,60,1548678345,,0,0,21.51,5992,6236,337,337,,,1,3,0.6,,,768,1449,,,,,,,46.29,,1,,,,,,,,,,,,,,124,85,13.24,13.19,13.69,,,,,,,,,,,,,,,,,"5,2,4,8,32,41,7,0,0",,,,,,,127,,,,,,,,,,,,,,,,,,,,,,,,,,,,,,,,,,,,,2,18,192,84,,1014,,,0,5,3,,1,0,,,,,"Aachen Laufen",,"Polar BEAT",,0,,0,168070,250480,30378,,,,,,,,,,,,,,,,,,,,,,,,,,,,,,,,,,,,,,,,,,"4,4,5",
5963892,2c621bde-6aa2-4a1a-a3d0-ff21b9b9a4de,1365251308,120,1548678346,,0,0,12.08,3489,3518,8,8,,,1,0,0,,,,848,,,,,,,42.41,,1,,,,,,,,,,,,,,72,,12.47,12.59,12.6,,,,,,,,,,,,,,,,,"3,3,7,23,35,26,3,0,0",,,,,,,,,,,,,,,,,,,,,,,,,,,,,,,,,,,,,,,,,,,,3,5,345,78,,1017,4,,0,5,3,,1,0,,,,,,,"Polar BEAT",,0,,0,168070,250480,30378,,,,,,,,,,,,,,,,,,,,,,,,,,,,,,,,,,,,,,,,,,,
5963893,684f1d5b-9220-41db-b3df-81a997d2bcbf,1413198501,120,1548678347,,0,0,8,2383,2383,89,91,,,1,1.3,0.53,1.04,1.01,,419,142,159,,,,61.71,39.74,62.54,1,,,,,,,,,,,,,,48,83,12.23,12.15,12.44,3.5,,,,,,,,,,,,,,,,"3,3,8,28,49,8,1,0,0","0,39,61,0,0",,,,,,121,,,,,,,,,,,,,,,,,,,,,,,,,,,,,,,,,,,,30.3,17,10,205,81,,1005,1,,0,5,3,,1,0,,,,,"Regenerativer DL",,"Polar BEAT",,0,,0,168070,250480,30378,,,,,,,,,,,,,,,,,,,,,,,,,,,,,,,,,,,,,,,,,,,
5963894,6ff6dff3-9711-4da8-b402-ebda89a2807b,1506182348,120,1548678347,,0,0,7.32,2019,2020,98,91,,,1,1.1,0.5,1.07,1,,494,152,172,,,,62.03,43.27,63.13,1,,,,,,,,,,,,,,53,81,13.31,13.18,13.48,2.8,,,,,,,,,,,,,,,,"2,1,4,8,40,43,2,0,0","0,9,68,23,0",,,,,,134,,,,,,,,,,,,,,,,,,,,,,,,,,,,,,,,,,,,50,17,4,15,67,,1023,2,,0,5,3,,1,0,I1.000|5:05-I1.000|4:31-I1.000|4:36-I1.000|4:22-I1.000|4:29-I1.000|4:23-I1.000|4:40-I0.329|1:35,,Running,,,,"Polar M430",43,0,,0,168070,250480,30378,,,,,,,,,,,,,,,,,,,,,,,,,,,,,,,,,,,,,,,,,,,
5963895,da04cafa-1302-4b10-99b8-7d46a3774d3c,1399631691,120,1548678350,,0,0,18.59,5429,5509,306,305,,,1,2.8,0.48,1.06,0.98,348,950,153,172,,,,57.29,43.32,58.46,1,,,,,,,,,,,,,,145,83,12.67,12.49,12.96,-1.2,,,,,,,,,,,,,,,,"4,4,8,18,41,23,1,0,0","0,9,67,24,0",,,,,,124,,,,,,,,,,,,,,,,,,,,,,,,,,,,,,,,,,,,48.8,12,15,246,80,,1013,3,,0,5,3,,1,0,,,,,"Langsamer DL",,"Polar BEAT",,0,,0,168070,250480,30378,,,,,,,,,,,,,,,,,,,,,,,,,,,,,,,,,,,,,,,,,,"4,5,5,5",
5963896,dd8f5550-1277-4af0-bf74-e7895a9e8475,1473672316,120,1548678351,,0,0,13.01,4122,4123,187,187,,,1,2.4,0.64,,,347,883,,,,,,,38.29,,1,,,,,,,,,,,,,,85,81,11.62,11.49,11.75,,,,,,,,,,,,,,,,,"6,6,20,40,23,4,0,0,0",,,,,,,117,,,,,,,,,,,,,,,,,,,,,,,,,,,,,,,,,,,,,19,2,130,78,,1017,1,,0,3,3,,1,0,,,,,"Aachen Laufen",,"Polar BEAT",,0,,0,168070,250480,30378,,,,,,,,,,,,,,,,,,,,,,,,,,,,,,,,,,,,,,,,,,4,
5963897,806097f3-ce6b-4ece-80c2-788e1f326d05,1412285609,120,1548678351,,0,0,2.72,773,773,31,33,,,1,0.3,0.37,,,,191,,,,,,,39.08,,1,,,,,,,,,,,,,,16,81,12.8,12.85,13.07,,,,,,,,,,,,,,,,,"0,1,6,32,35,19,7,0,0",,,,,,,130,,,,,,,,,,,,,,,,,,,,,,,,,,,,,,,,,,,,,14,0,,90,,,0,,1,3,3,,1,0,,,,,Auslaufen,,"Polar BEAT",,0,,0,168070,250480,30378,,,,,,,,,,,,,,,,,,,,,,,,,,,,,,,,,,,,,,,,,,,
5963898,b6cd3e00-3319-4262-ae53-815577d74968,1483875082,60,1548678352,,0,0,25.01,7896,8204,430,425,,,1,3.5,0.64,,,394,1682,,,,,,,40.46,,1,,,,,,,,,,,,,,163,81,11.74,12.7,13.08,,,,,,,,,,,,,,,,,"17,4,7,14,21,21,14,0,0",,,,,,,117,,,,,,,,,,,,,,,,,,,,,,,,,,,,,,,,,,,,,2,1,272,98,,1032,0,,0,6,3,,1,0,,,,,"Aachen Laufen",,"Polar BEAT",,0,,0,168070,250480,30378,,,,,,,,,,,,,,,,,,,,,,,,,,,,,,,,,,,,,,,,,,"4,4",
5963899,965ea5db-22c0-4e82-a348-7119ffce456c,1547057500,60,1548678353,,0,0,11.18,1631,1633,51,38,,,1,0,0.12,1.95,,,308,128,156,,,,,,,1,,,,,,,,,,,,,,25,,,25.42,,20.5,-1,131,116,,1,149,136,,,,,,,,,"2,10,25,63,0,0,0","22,33,45,0,0","80,8,0,1,11",,,,,,,,,,,,,,,,,,,,,,,,,,,,,,,,,,,,,,,,,24.9,3,17,349,68,,1017,0,409,1,7,3,,1,0,,,Cycling,,,,"Polar M430",43,0,,0,168072,,30378,,,,,,,,,,,,,,,,,,,,,,,,,,,,,,,,,,,,,,,,,,,
5963900,25bc8611-438a-4396-8ce9-feac15cec794,1443471399,120,1548678353,,0,0,15.07,3528,3587,40,41,,,1,0,0.07,,,,1016,,,,,,,55.03,,1,,,,,,,,,,,,,,73,85,15.39,15.42,15.45,,,,,,,,,,,,,,,,,"0,0,0,0,3,26,67,3,0",,,,,,,151,,,,,,,,,,,,,,,,,,,,,,,,,,,,,,,,,,,,,11,7,56,81,,1038,,,1,3,3,,1,0,,,,,"Münster Laufen",,"Polar BEAT",,0,,0,168070,250480,30378,,,,,,,,,,,,,,,,,,,,,,,,,,,,,,,,,,,,,,,,,,,
5963901,419df194-e302-4914-a0fd-c28fcbfb5f78,1429088460,120,1548678353,,0,0,9.9,2896,2958,151,150,,,1,1.6,0.49,,,332,675,,,,,,,41.18,,1,,,,,,,,,,,,,,60,83,12.72,12.46,12.92,,,,,,,,,,,,,,,,,"2,3,13,25,32,25,0,0,0",,,,,,,124,,,,,,,,,,,,,,,,,,,,,,,,,,,,,,,,,,,,,15,9,222,60,,1020,,,0,3,3,,1,0,,,,,"Aachen Laufen",,"Polar BEAT",,0,,0,168070,250480,30378,,,,,,,,,,,,,,,,,,,,,,,,,,,,,,,,,,,,,,,,,,"5,5,5",
5963902,c6588fb3-02e7-4077-a986-2004ae2a11fa,1472763175,120,1548678354,,0,0,3.53,1429,1476,41,50,,,1,0.8,0.43,,,,241,,,,,,,26.2,,1,,,,,,,,,,,,,,29,71,9.01,11.64,11.72,,,,,,,,,,,,,,,,,"34,3,2,6,28,27,0,0,0",,,,,,,104,,,,,,,,,,,,,,,,,,,,,,,,,,,,,,,,,,,,,19,1,304,77,,1023,0,,1,5,3,,1,0,,,,,"Aachen Laufen",,"Polar BEAT",,0,,0,168070,250480,30378,,,,,,,,,,,,,,,,,,,,,,,,,,,,,,,,,,,,,,,,,,,
5963903,5a58eb89-8a0d-44c1-8a5d-b3a461781115,1539886131,120,1548678354,,0,0,13.75,3301,3302,53,54,,,1,0,0.07,,0.89,,862,155,177,,,,71.7,53.08,72.03,1,,,,,,,,,,,,,,93,83,15.04,15.03,15.11,-1,,,,,,,,,,,,,,,,"0,0,0,0,5,40,55,1,0","0,4,69,27,0",,,,,,151,,,,,,,,,,,,,,,,,,,,,,,,,,,,,,,,,,,,61.7,20,16,147,59,,1019,0,275,1,5,3,,1,0,I1.000|4:17-I1.000|4:05-I1.000|4:04-I1.000|4:06-I1.000|3:56-I1.000|3:59-I1.000|3:56-I1.000|3:58-I1.000|3:55-I1.000|3:55-I1.000|4:00-I1.000|3:55-I1.000|4:01-I0.753|2:57,,Running,,,,"Polar M430",43,0,,0,168070,250480,30378,,,,,,,,,,,,,,,,,,,,,,,,,,,,,,,,,,,,,,,,,,,
5963905,fb5a8743-1d0b-4c0f-b5c7-c646413e626c,1539762989,120,1548678355,,0,0,10.46,1769,1771,35,44,,,1,0,0.14,,,,294,122,144,,,,,,,1,,,,,,,,,,,,,,21,,,22.47,,7.2,-21.6,106,89,,1,124,113,,,,,,,,,"9,9,75,7,0,0,0","7,92,1,0,0","88,3,0,0,9",,,,,,,,,,,,,,,,,,,,,,,,,,,,,,,,,,,,,,,,,10.1,5,3,31,100,,,0,,0,3,3,,1,0,,,Cycling,,,,"Polar M430",43,0,,0,168072,,30378,,,,,,,,,,,,,,,,,,,,,,,,,,,,,,,,,,,,,,,,,,,
5963906,e7cc61b2-7121-45c0-a903-6c88368f9871,1427397323,60,1548678355,,0,0,3.6,1081,1410,70,69,,,1,1.4,0.55,,,511,250,,,,,,,37.48,,1,,,,,,,,,,,,,,22,82,12.38,12.14,12.94,,,,,,,,,,,,,,,,,"5,2,9,25,47,11,0,0,0",,,,,,,122,,,,,,,,,,,,,,,,,,,,,,,,,,,,,,,,,,,,,4,17,203,93,,1008,,,1,4,3,,1,0,,,,,"Aachen Laufen",,"Polar BEAT",,0,,0,168070,250480,30378,,,,,,,,,,,,,,,,,,,,,,,,,,,,,,,,,,,,,,,,,,5,
5963907,459fa6e5-18ea-47b5-9b9d-25d7b261de48,1510163280,60,1548678356,,0,0,11.83,3915,3920,53,52,,,1,0,0.09,1.12,0.94,,772,134,153,,,,58.23,36.11,58.55,1,,,,,,,,,,,,,,64,80,10.92,10.94,11.03,3.2,,,,,,,,,,,,,,,,"1,12,46,33,8,0,0,0,0","0,82,17,0,0",,,,,,113,,,,,,,,,,,,,,,,,,,,,,,,,,,,,,,,,,,,19.7,7,1,240,93,,,0,,1,5,3,,1,0,I1.000|5:15-I1.000|5:07-I1.000|5:13-I1.000|5:20-I1.000|5:19-I1.000|5:25-I1.000|5:34-I1.000|5:45-I1.000|5:51-I1.000|5:48-I1.000|5:53-I0.828|4:52,,Running,,,,"Polar M430",43,0,,0,168070,250480,30378,,,,,,,,,,,,,,,,,,,,,,,,,,,,,,,,,,,,,,,,,,,
5963908,8d89bb43-5e70-49f3-8486-ac406c0850c9,1419185309,60,1548678356,,0,0,2.82,1255,1259,49,50,,,1,1.1,0.5,,,332,192,,,,,,,23.01,,1,,,,,,,,,,,,,,26,76,8.31,9.07,9.55,,,,,,,,,,,,,,,,,"47,24,18,6,3,2,0,0,0",,,,,,,89,,,,,,,,,,,,,,,,,,,,,,,,,,,,,,,,,,,,,7,15,240,92,,1028,0,,1,4,3,,1,0,,,,,"Aachen Laufen",,"Polar BEAT",,0,,0,168070,250480,30378,,,,,,,,,,,,,,,,,,,,,,,,,,,,,,,,,,,,,,,,,,5,
5963909,a83ea6ed-00ee-4449-9dda-cf9792c20e38,1530980663,120,1548678357,,0,0,11.17,3271,3275,351,353,,,1,4.1,0.7,1.04,1.09,736,796,149,177,,,,59.18,41.49,61.47,1,,,,,,,,,,,,,,83,83,13.46,13.49,14.13,-13.2,,,,,,,,,,,,,,,,"23,16,8,8,8,7,23,8,0","2,19,56,23,0",,,,,,123,,,,,,,,,,,,,,,,,,,,,,,,,,,,,,,,,,,,63.6,23,14,321,37,,1023,,,0,3,3,,1,0,I1.000|6:41-I1.000|5:36-I1.000|6:06-I1.000|6:25-I1.000|5:50-I1.000|4:31-I1.000|4:18-I1.000|3:35-I1.000|3:35-I1.000|3:31-I1.000|3:37-I0.174|0:52,,Running,,,,"Polar M430",43,0,,0,168070,250480,30378,,,,,,,,,,,,,,,,,,,,,,,,,,,,,,,,,,,,,,,,,,3,
5963910,e2c971c1-a137-4987-abca-80d144857c5b,1448643943,60,1548678357,,0,0,14.41,3915,4603,205,187,,,1,1.9,0.45,,,424,990,,,,,,,46.15,,1,,,,,,,,,,,,,,81,82,13.56,13.55,13.93,,,,,,,,,,,,,,,,,"4,3,4,10,22,41,16,0,0",,,,,,,135,,,,,,,,,,,,,,,,,,,,,,,,,,,,,,,,,,,,,4,16,187,80,,1014,,,1,5,3,,1,0,,,,,"Aachen Laufen",,"Polar BEAT",,0,,0,168070,250480,30378,,,,,,,,,,,,,,,,,,,,,,,,,,,,,,,,,,,,,,,,,,"5,5",
5963911,de436aa6-38d1-40b6-90a7-72b88595d5ee,1510908073,60,1548678358,,0,0,11.83,3618,3624,40,41,,,1,0,0.07,1.08,0.93,,890,153,164,,,,54.11,39.61,54.33,1,,,,,,,,,,,,,,95,82,11.81,11.8,11.88,5.3,,,,,,,,,,,,,,,,"0,2,7,57,32,1,0,0,0","0,7,89,4,0",,,,,,120,,,,,,,,,,,,,,,,,,,,,,,,,,,,,,,,,,,,44.7,3,1,204,92,,,0,,0,4,3,,1,0,I1.000|5:28-I1.000|4:58-I1.000|5:04-I1.000|4:59-I1.000|4:58-I1.000|4:52-I1.000|5:10-I1.000|5:07-I1.000|5:00-I1.000|5:12-I1.000|5:12-I0.829|4:26,,Running,,,,"Polar M430",43,0,,0,168070,250480,30378,,,,,,,,,,,,,,,,,,,,,,,,,,,,,,,,,,,,,,,,,,,
5963913,02b820a3-ad90-41a0-a4bb-735180b151c8,1348857506,120,1548678359,,0,0,20.33,5609,5632,86,85,,,1,0,0.16,1.07,0.93,,1414,154,210,,,,60.9,46.6,61.22,1,,,,,,,,,,,,,,155,,13.11,13.2,13.3,3.7,,,,,,,,,,,,,,,,"3,1,4,16,31,33,11,1,0","0,2,91,5,1",,,,,,,,,,,,,,,,,,,,,,,,,,,,,,,,,,,,,,,,,,70.1,17,1,50,56,,1018,0,,1,5,3,,1,0,,,,,,,"Polar BEAT",,0,,0,168070,250480,30378,,,,,,,,,,,,,,,,,,,,,,,,,,,,,,,,,,,,,,,,,,,
5963914,f01b59eb-b456-4bb0-9101-348adcc44983,1466848715,120,1548678360,,0,0,5.23,1712,1712,106,102,,,1,1.8,0.46,,,521,362,,,,,,,34.63,,1,,,,,,,,,,,,,,35,82,11.41,11.16,11.95,,,,,,,,,,,,,,,,,"11,10,18,45,14,2,0,0,0",,,,,,,112,,,,,,,,,,,,,,,,,,,,,,,,,,,,,,,,,,,,,15,3,332,89,,1016,3,,0,4,3,,1,0,,,,,"Aachen Laufen",,"Polar BEAT",,0,,0,168070,250480,30378,,,,,,,,,,,,,,,,,,,,,,,,,,,,,,,,,,,,,,,,,,4,
5963915,1a1fd40a-9408-4e88-b5d5-44200378e663,1364326460,60,1548678361,,0,0,13.32,3627,3874,280,280,,,1,1.4,0.52,,,,907,,,,,,,45.76,,1,,,,,,,,,,,,,,75,,13.57,14.72,14.95,,,,,,,,,,,,,,,,,"15,0,0,1,4,29,43,7,1",,,,,,,,,,,,,,,,,,,,,,,,,,,,,,,,,,,,,,,,,,,,1,11,67,49,,1011,0,,1,3,3,,1,0,,,,,,,"Polar BEAT",,0,,0,168070,250480,30378,,,,,,,,,,,,,,,,,,,,,,,,,,,,,,,,,,,,,,,,,,,
5963916,2af6015e-e8cc-48f2-a774-777808858873,1452888779,60,1548678361,,0,0,10,2396,2397,74,83,,,1,0.4,0.3,,,,676,,,,,,,52.04,,1,,,,,,,,,,,,,,49,83,15.09,15.95,16.04,,,,,,,,,,,,,,,,,"9,0,0,0,1,10,57,23,0",,,,,,,151,,,,,,,,,,,,,,,,,,,,,,,,,,,,,,,,,,,,,1,8,342,93,,1017,,,1,7,3,,1,0,,,,,"Aachen Laufen",,"Polar BEAT",,0,,0,168070,250480,30378,,,,,,,,,,,,,,,,,,,,,,,,,,,,,,,,,,,,,,,,,,,
5963917,2ee480e5-2342-49fc-9691-d898571229d3,1485456747,60,1548678361,,0,0,2.01,590,590,31,41,,,1,1.2,0.7,,,,138,,,,,,,36.57,,1,,,,,,,,,,,,,,12,79,12.5,12.35,12.72,,,,,,,,,,,,,,,,,"3,2,13,27,31,17,7,0,0",,,,,,,129,,,,,,,,,,,,,,,,,,,,,,,,,,,,,,,,,,,,,-2,11,130,75,,1023,,,1,3,3,,1,0,,,,,Laufen,,"Polar BEAT",,0,,0,168070,250480,30378,,,,,,,,,,,,,,,,,,,,,,,,,,,,,,,,,,,,,,,,,,,
5963918,,1474911745,120,1548678361,,0,0,10,0,0,,,,,0,,,,,,,,,,,,,,,1,,,,,,,,,,,,,,0,,,,,,,,,,,,,,,,,,,,,,,,,,,,,,,,,,,,,,,,,,,,,,,,,,,,,,,,,,,,,,,,,,,,,,,,,,1,,,0,0,,,,,"laufen ",,"Polar BEAT",,0,,0,168070,250480,30378,,,,,,,,,,,,,,,,,,,,,,,,,,,,,,,,,,,,,,,,,,,
5963919,fbe8ecd7-a295-45b3-b0eb-da2e166304d6,1395259121,60,1548678362,,0,0,3.04,640,640,62,74,,,1,1.7,1,1.12,0.88,,151,165,173,,,,77.11,55.6,78.69,1,,,,,,,,,,,,,,22,89,17.23,17.15,17.51,6.4,,,,,,,,,,,,,,,,"0,0,0,0,0,0,58,42,0","0,3,6,91,0",,,,,,160,,,,,,,,,,,,,,,,,,,,,,,,,,,,,,,,,,,,57,12,10,238,68,,1024,0,,1,5,3,,1,0,,,,,"1x 3000m in 10:40",,"Polar BEAT",,0,,0,168070,250480,30378,,,,,,,,,,,,,,,,,,,,,,,,,,,,,,,,,,,,,,,,,,,
5963920,3c07a01f-19d2-4260-961a-53d37db62e55,1398198610,120,1548678362,,0,0,5.69,1775,1812,0,2,,,1,0,0,,,,341,157,186,,,,50.95,36.85,50.92,1,,,,,,,,,,,,,,59,77,11.55,15.09,15.09,4,,,,,,,,,,,,,,,,"43,1,1,1,1,1,12,31,7","0,33,9,31,27",,,,,,125,,,,,,,,,,,,,,,,,,,,,,,,,,,,,,,,,,,,83,12,0,119,86,,1015,0,,1,6,3,,1,0,,,,,"2x Doppelrunde, 2x 1000m, 600m",,"Polar BEAT",,0,,0,168070,250480,30378,,,,,,,,,,,,,,,,,,,,,,,,,,,,,,,,,,,,,,,,,,,
5963921,2d012a6d-be71-4de0-9012-ae59e473746d,1473510588,120,1548678363,,0,0,20.66,5367,5367,799,800,,,1,6.3,0.77,,,862,1390,,,,,,,50.03,,1,,,,,,,,,,,,,,111,85,15.09,14.32,16.11,,,,,,,,,,,,,,,,,"2,3,9,11,16,24,26,10,0",,,,,,,136,,,,,,,,,,,,,,,,,,,,,,,,,,,,,,,,,,,,,24,5,200,50,,,,,0,3,3,,1,0,,,,,"Plettenberg Laufen",,"Polar BEAT",,0,,0,168070,250480,30378,,,,,,,,,,,,,,,,,,,,,,,,,,,,,,,,,,,,,,,,,,"3,3,4,4,4,5,5",
5963922,89b4ea57-edcb-4108-8b50-357600ced800,1531123372,120,1548678365,,0,0,9.68,1450,1490,35,39,,,1,0,0.15,,0.54,,265,130,156,,,,,,,1,,,,,,,,,,,,,,22,,,25.39,,21.6,-4.7,131,111,,1,150,135,,,,,,,,,"8,5,20,66,2,0,0","11,58,31,0,0","78,11,0,1,11",,,,,,,,,,,,,,,,,,,,,,,,,,,,,,,,,,,,,,,,,21.2,17,8,13,67,,,,,0,3,3,,1,0,,,Cycling,,,,"Polar M430",43,0,,0,168072,,30378,,,,,,,,,,,,,,,,,,,,,,,,,,,,,,,,,,,,,,,,,,,
5963923,4201e07e-6ba1-44d4-bdc3-864c20cfb779,1361004250,60,1548678365,,0,0,7.99,2628,3559,36,36,,,1,0,0.13,,,,552,,,,,,,35.35,,1,,,,,,,,,,,,,,54,,11.03,11.2,11.33,,,,,,,,,,,,,,,,,"13,9,21,29,19,8,0,0,0",,,,,,,,,,,,,,,,,,,,,,,,,,,,,,,,,,,,,,,,,,,,1,2,267,94,,1025,0,,0,9,3,,1,0,,,,,,,"Polar BEAT",,0,,0,168070,250480,30378,,,,,,,,,,,,,,,,,,,,,,,,,,,,,,,,,,,,,,,,,,,
5963924,31c7558f-cc99-4f94-ae60-4e28e803209c,1532983854,120,1548678366,,0,0,7.04,2214,2214,32,32,,,1,0,0.11,1.12,0.93,,477,138,153,,,,59.82,36.97,60.16,1,,,,,,,,,,,,,,41,80,11.48,11.59,11.7,7.3,,,,,,,,,,,,,,,,"3,7,27,31,25,6,0,0,0","1,63,36,0,0",,,,,,119,,,,,,,,,,,,,,,,,,,,,,,,,,,,,,,,,,,,24.5,30,1,92,39,,1015,,,0,3,3,,1,0,I1.000|5:28-I1.000|5:21-I1.000|5:03-I1.000|4:45-I1.000|4:51-I1.000|5:33-I1.000|5:40-I0.039|0:14,,Running,,,,"Polar M430",43,0,,0,168070,250480,30378,,,,,,,,,,,,,,,,,,,,,,,,,,,,,,,,,,,,,,,,,,,
5963925,,1429129708,120,1548678366,,0,0,20,0,0,,,,,0,,,,,,,,,,,,,,,1,,,,,,,,,,,,,,0,,,,,,,,,,,,,,,,,,,,,,,,,,,,,,,,,,,,,,,,,,,,,,,,,,,,,,,,,,,,,,,,,,,,,,,,,,1,,,0,0,,,,,"laufen ",,"Polar BEAT",,0,,0,168070,250480,30378,,,,,,,,,,,,,,,,,,,,,,,,,,,,,,,,,,,,,,,,,,,
5963926,d03a7016-6a4d-4684-98a1-58a732cd93c4,1416338851,60,1548678366,,0,0,9.5,2525,2527,88,88,,,1,0.7,0.38,,,,618,,,,,,,45.94,,1,,,,,,,,,,,,,,52,83,13.6,15.06,15.29,,,,,,,,,,,,,,,,,"18,1,1,1,1,17,49,12,0",,,,,,,136,,,,,,,,,,,,,,,,,,,,,,,,,,,,,,,,,,,,,7,7,18,95,,1012,,,1,4,3,,1,0,,,,,"4x Einzel",,"Polar BEAT",,0,,0,168070,250480,30378,,,,,,,,,,,,,,,,,,,,,,,,,,,,,,,,,,,,,,,,,,,
5963927,fa3e8e21-f622-434e-b50d-673eda55e79a,1463514798,120,1548678367,,0,0,5.17,1736,2063,68,59,,,1,0.6,0.39,,,,357,,,,,,,33.57,,1,,,,,,,,,,,,,,36,75,10.97,11.74,12.09,,,,,,,,,,,,,,,,,"17,2,7,24,42,9,0,0,0",,,,,,,119,,,,,,,,,,,,,,,,,,,,,,,,,,,,,,,,,,,,,16,6,244,59,,1016,0,,0,5,3,,1,0,,,,,"Aachen Laufen",,"Polar BEAT",,0,,0,168070,250480,30378,,,,,,,,,,,,,,,,,,,,,,,,,,,,,,,,,,,,,,,,,,,
5963928,d74ff42f-1f6c-4fa1-b26d-7218edea8953,1476698559,120,1548678367,,0,0,4.43,1325,1325,52,51,,,1,1.1,0.59,,,,305,,,,,,,38.17,,1,,,,,,,,,,,,,,27,81,12.21,12.14,12.35,,,,,,,,,,,,,,,,,"2,4,10,28,45,10,0,0,0",,,,,,,124,,,,,,,,,,,,,,,,,,,,,,,,,,,,,,,,,,,,,11,3,214,91,,1022,1,,0,5,3,,1,0,,,,,"Aachen Laufen",,"Polar BEAT",,0,,0,168070,250480,30378,,,,,,,,,,,,,,,,,,,,,,,,,,,,,,,,,,,,,,,,,,,
5963929,5f57d5e9-d4e1-4e3b-be3b-ab59940ca02d,1528013119,120,1548678368,,0,0,24,6531,6533,73,76,,,1,0,0.07,1.12,0.92,,1572,150,169,,,,64.22,47.97,64.45,1,,,,,,,,,,,,,,164,82,13.26,13.27,13.33,-1.3,,,,,,,,,,,,,,,,"0,0,1,5,51,42,1,0,0","0,12,83,5,0",,,,,,134,,,,,,,,,,,,,,,,,,,,,,,,,,,,,,,,,,,,45.3,19,11,29,78,,1018,,,0,3,3,,1,0,I1.000|4:42-I1.000|4:28-I1.000|4:28-I1.000|4:41-I1.000|4:33-I1.000|4:35-I1.000|4:35-I1.000|4:48-I1.000|4:42-I1.000|4:35-I1.000|4:51-I1.000|4:27-I1.000|4:37-I1.000|4:34-I1.000|4:29-I1.000|4:24-I1.000|4:34-I1.000|4:33-I1.000|4:35-I1.000|4:31-I1.000|4:18-I1.000|4:18-I1.000|4:16-I1.000|4:18-I0.008|0:02,,Running,,,,"Polar M430",43,0,,0,168070,250480,30378,,,,,,,,,,,,,,,,,,,,,,,,,,,,,,,,,,,,,,,,,,,
5963930,f7ce3ddf-c0e1-43ae-8ac7-b8558064f796,1483556215,60,1548678368,,0,0,0.77,236,236,17,14,,,1,1.4,1,,,,61,,,,,,,31.31,,1,,,,,,,,,,,,,,4,80,12.29,11.88,12.38,,,,,,,,,,,,,,,,,"11,5,10,23,31,20,0,0,0",,,,,,,122,,,,,,,,,,,,,,,,,,,,,,,,,,,,,,,,,,,,,2,15,303,90,,1020,,,1,5,3,,1,0,,,,,"Aachen Laufen",,"Polar BEAT",,0,,0,168070,250480,30378,,,,,,,,,,,,,,,,,,,,,,,,,,,,,,,,,,,,,,,,,,,
5963931,d96fe728-6e61-46df-91bb-50d4dc4c1475,1451933366,60,1548678368,,0,0,3.69,1075,1075,58,61,,,1,0.8,0.4,,,,252,,,,,,,38.9,,1,,,,,,,,,,,,,,22,81,12.63,12.46,12.88,,,,,,,,,,,,,,,,,"2,2,8,23,37,28,0,0,0",,,,,,,127,,,,,,,,,,,,,,,,,,,,,,,,,,,,,,,,,,,,,6,14,196,89,,991,,,1,5,3,,1,0,,,,,"Aachen Laufen",,"Polar BEAT",,0,,0,168070,250480,30378,,,,,,,,,,,,,,,,,,,,,,,,,,,,,,,,,,,,,,,,,,,
5963932,b7c5c643-8735-45e8-b9a7-96ad6218594d,1431030864,120,1548678368,,0,0,3.69,1246,1334,12,15,,,1,0,0.07,,,,196,,,,,,,32.68,,1,,,,,,,,,,,,,,25,76,10.78,13.96,13.94,,,,,,,,,,,,,,,,,"59,2,2,2,2,3,4,7,19",,,,,,,117,,,,,,,,,,,,,,,,,,,,,,,,,,,,,,,,,,,,,13,2,241,59,,1019,0,,0,5,3,,1,0,,,,,"Aachen Laufen",,"Polar BEAT",,0,,0,168070,250480,30378,,,,,,,,,,,,,,,,,,,,,,,,,,,,,,,,,,,,,,,,,,,
5963933,d368126d-c906-46c4-ae9b-8f6c2402de1e,1474057012,120,1548678369,,0,0,3.74,700,834,53,21,,,1,0,0.18,,,,152,,,,,,,,,1,,,,,,,,,,,,,,7,,,22.52,,,,140,123,,1,179,169,,,,,,,,,"33,11,25,17,13,2,0",,"74,18,2,0,7",,,,,,,,,,,,,,,,,,,,,,,,,,,,,,,,,,,,,,,,,,18,3,192,73,,1013,0,,1,5,3,,1,0,,,,,"Aachen Radfahren",,"Polar BEAT",,0,,0,168072,,30378,,,,,,,,,,,,,,,,,,,,,,,,,,,,,,,,,,,,,,,,,,,
5963934,6926b397-c47e-44b2-87c0-93dcfeeecb09,1467925893,120,1548678369,,0,0,1.84,459,459,0,3,,,1,0,0.01,,,,119,,,,,,,43.51,,1,,,,,,,,,,,,,,9,87,14.36,15.28,15.23,,,,,,,,,,,,,,,,,"21,3,3,3,4,6,17,42,0",,,,,,,138,,,,,,,,,,,,,,,,,,,,,,,,,,,,,,,,,,,,,19,1,72,72,,1019,0,,0,5,3,,1,0,,,,,"Aachen Laufen",,"Polar BEAT",,0,,0,168070,250480,30378,,,,,,,,,,,,,,,,,,,,,,,,,,,,,,,,,,,,,,,,,,,
5963935,7f004c9a-ba6f-43d2-83bb-c0af4715c3ca,1445591803,120,1548678369,,0,0,1.12,431,432,22,17,,,1,1.2,0.64,,,,84,,,,,,,25.15,,1,,,,,,,,,,,,,,8,83,9.75,9.51,10.18,,,,,,,,,,,,,,,,,"44,35,11,3,1,5,0,0,0",,,,,,,94,,,,,,,,,,,,,,,,,,,,,,,,,,,,,,,,,,,,,8,4,162,94,,1025,,,0,5,3,,1,0,,,,,"Aachen Laufen",,"Polar BEAT",,0,,0,168070,250480,30378,,,,,,,,,,,,,,,,,,,,,,,,,,,,,,,,,,,,,,,,,,,
5963936,fd18780d-0565-47dc-b915-b9f58754cc8f,1430253597,120,1548678369,,0,0,8.82,2470,2555,53,54,,,1,0,0.04,,,,542,,,,,,,43,,1,,,,,,,,,,,,,,51,82,12.98,15.53,15.57,,,,,,,,,,,,,,,,,"35,1,1,2,3,3,5,43,5",,,,,,,131,,,,,,,,,,,,,,,,,,,,,,,,,,,,,,,,,,,,,7,8,288,48,,1021,,,1,3,3,,1,0,,,,,"Aachen Laufen",,"Polar BEAT",,0,,0,168070,250480,30378,,,,,,,,,,,,,,,,,,,,,,,,,,,,,,,,,,,,,,,,,,,
5963937,f8b233e1-f756-4185-841a-c9b1d7927547,1402480645,120,1548678370,,0,0,25.33,7612,7652,370,358,,,1,3.1,0.57,,,499,1714,,,,,,,42.91,,1,,,,,,,,,,,,,,158,82,12.21,12.42,12.87,,,,,,,,,,,,,,,,,"9,4,9,18,35,20,4,1,0",,,,,,,122,,,,,,,,,,,,,,,,,,,,,,,,,,,,,,,,,,,,,16,2,320,86,,1026,3,,0,5,3,,1,0,,,,,"Langsamer langer DL ",,"Polar BEAT",,0,,0,168070,250480,30378,,,,,,,,,,,,,,,,,,,,,,,,,,,,,,,,,,,,,,,,,,"4,4",
5963938,2b214d07-4d05-4512-9cf1-9faca3cf9daf,1484328864,60,1548678371,,0,0,5.41,1628,1682,128,40,,,1,2,0.59,,,338,371,,,,,,,38.35,,1,,,,,,,,,,,,,,33,80,12.81,12.18,13.12,,,,,,,,,,,,,,,,,"7,6,9,21,38,19,0,0,0",,,,,,,125,,,,,,,,,,,,,,,,,,,,,,,,,,,,,,,,,,,,,1,22,229,89,,1005,,,1,5,3,,1,0,,,,,"Aachen Laufen",,"Polar BEAT",,0,,0,168070,250480,30378,,,,,,,,,,,,,,,,,,,,,,,,,,,,,,,,,,,,,,,,,,4,
5963939,86c1018d-ce47-4111-919e-2ee4d921091a,1435867706,120,1548678371,,0,0,3.08,909,909,100,60,,,1,2.2,0.74,,,470,212,,,,,,,37.81,,1,,,,,,,,,,,,,,18,81,13.29,12.34,13.76,,,,,,,,,,,,,,,,,"2,9,8,20,45,12,5,0,0",,,,,,,125,,,,,,,,,,,,,,,,,,,,,,,,,,,,,,,,,,,,,28,8,330,57,,1018,,,0,5,3,,1,0,,,,,"Aachen Laufen",,"Polar BEAT",,0,,0,168070,250480,30378,,,,,,,,,,,,,,,,,,,,,,,,,,,,,,,,,,,,,,,,,,4,
5963940,50556e6c-4737-439b-aab7-1acd1a001d53,1483725713,60,1548678371,,0,0,0.31,71,71,21,0,,,1,1.5,1,,,,21,,,,,,,41.07,,1,,,,,,,,,,,,,,1,80,20.39,17.73,23.75,,,,,,,,,,,,,,,,,"0,0,20,13,10,6,6,13,34",,,,,,,164,,,,,,,,,,,,,,,,,,,,,,,,,,,,,,,,,,,,,-4,2,159,79,,1040,0,,1,3,3,,1,0,,,,,"Aachen Laufen",,"Polar BEAT",,0,,0,168070,250480,30378,,,,,,,,,,,,,,,,,,,,,,,,,,,,,,,,,,,,,,,,,,,
5963941,6a8167ea-0c77-4698-8a99-df150d0b3b92,1449834358,60,1548678371,,0,0,15.87,4864,4865,364,365,,,1,4.3,0.67,,,458,1083,,,,,,,40.43,,1,,,,,,,,,,,,,,101,82,12.26,11.98,12.79,,,,,,,,,,,,,,,,,"6,8,15,27,32,9,3,0,0",,,,,,,119,,,,,,,,,,,,,,,,,,,,,,,,,,,,,,,,,,,,,6,23,216,91,,1021,,,0,4,3,,1,0,,,,,"Balve Laufen",,"Polar BEAT",,0,,0,168070,250480,30378,,,,,,,,,,,,,,,,,,,,,,,,,,,,,,,,,,,,,,,,,,"3,5",
5963942,840949b9-33a2-4195-a7bc-60818860d307,1431115516,120,1548678372,,0,0,9.95,2835,2841,153,160,,,1,2,0.65,,,323,700,,,,,,,42.49,,1,,,,,,,,,,,,,,58,82,12.98,12.83,13.18,,,,,,,,,,,,,,,,,"5,2,4,16,39,32,3,0,0",,,,,,,128,,,,,,,,,,,,,,,,,,,,,,,,,,,,,,,,,,,,,17,2,203,55,,1014,0,,0,5,3,,1,0,,,,,"Aachen Laufen",,"Polar BEAT",,0,,0,168070,250480,30378,,,,,,,,,,,,,,,,,,,,,,,,,,,,,,,,,,,,,,,,,,4,
5963943,,1522840740,120,1548678372,,0,0,11,1740,1740,,,,,0,,,,,,372,,,,,,,,,1,,,,,,,,,,,,,,19,,,,,,,,,,,,,,,,,,,,,,,,,,,,,,,,,,,,,,,,,,,,,,,,,,,,,,,,,,,,,,,,,,,,,,,,,,1,,,0,0,,,,,,,"no device name available",,0,,0,168072,,30378,,,,,,,,,,,,,,,,,,,,,,,,,,,,,,,,,,,,,,,,,,,
5963944,59e496e6-f9e9-4054-a31d-af908d186b54,1477082578,120,1548678372,,0,0,0.73,243,243,16,21,,,1,0.6,0.45,,,,43,,,,,,,28.33,,1,,,,,,,,,,,,,,5,76,10.93,10.93,11.06,,,,,,,,,,,,,,,,,"17,14,12,29,28,0,0,0,0",,,,,,,119,,,,,,,,,,,,,,,,,,,,,,,,,,,,,,,,,,,,,7,5,235,91,,1017,0,,1,5,3,,1,0,,,,,"Aachen Laufen",,"Polar BEAT",,0,,0,168070,250480,30378,,,,,,,,,,,,,,,,,,,,,,,,,,,,,,,,,,,,,,,,,,,
5963945,3a4b5a11-3714-4f29-b117-318b87a4abb5,1438531873,120,1548678373,,0,0,12.03,3364,3956,187,196,,,1,1.3,0.51,,,7076,812,,,,,,,44.02,,1,,,,,,,,,,,,,,69,82,13.07,13.1,13.68,,,,,,,,,,,,,,,,,"4,1,2,10,42,37,4,0,0",,,,,,,131,,,,,,,,,,,,,,,,,,,,,,,,,,,,,,,,,,,,,26,6,118,34,,1018,,,0,3,3,,1,0,,,,,"Aachen Laufen",,"Polar BEAT",,0,,0,168070,250480,30378,,,,,,,,,,,,,,,,,,,,,,,,,,,,,,,,,,,,,,,,,,4,
5963946,dda8af68-9548-46cf-80d0-7d04fccb1db8,1473896129,120,1548678373,,0,0,3.68,778,800,46,14,,,1,0.1,0.33,,,307,137,,,,,,,,,1,,,,,,,,,,,,,,8,,,19.08,,,,104,98,,1,133,130,,,,,,,,,"36,29,20,15,0,0,0",,"89,4,0,0,7",,,,,,,,,,,,,,,,,,,,,,,,,,,,,,,,,,,,,,,,,,21,1,110,67,,1012,0,,1,3,3,,1,0,,,,,"Aachen Radfahren",,"Polar BEAT",,0,,0,168072,,30378,,,,,,,,,,,,,,,,,,,,,,,,,,,,,,,,,,,,,,,,,,5,
5963947,522fd518-b4f4-4cca-bd90-5ea52e6efe3a,1513102059,60,1548678375,,0,0,12.78,3504,3531,24,26,,,1,0,0.09,,0.75,,876,154,178,,,,61.37,45.25,61.51,1,,,,,,,,,,,,,,100,82,13.13,14.05,14.1,9.9,,,,,,,,,,,,,,,,"11,2,1,2,15,43,24,1,1","0,12,55,33,0",,,,,,133,,,,,,,,,,,,,,,,,,,,,,,,,,,,,,,,,,,,81.7,3,2,233,76,,,0,,1,5,3,,1,0,I10.644|44:56-I1.021|3:48-I0.466|3:39-I0.646|6:28,,Running,,,,"Polar M430",43,0,,0,168070,250480,30378,,,,,,,,,,,,,,,,,,,,,,,,,,,,,,,,,,,,,,,,,,,
5963948,1d1b7e81-f81a-426a-9d44-351b38300488,1502993611,120,1548678376,,0,0,2.46,702,702,76,25,,,1,2,0.74,1.21,0.92,482,160,148,169,,,,61.65,38.54,65.61,1,,,,,,,,,,,,,,17,82,13.74,12.65,14.21,11.2,,,,,,,,,,,,,,,,"0,2,5,18,51,23,1,0,0","2,21,58,19,0",,,,,,128,,,,,,,,,,,,,,,,,,,,,,,,,,,,,,,,,,,,33.1,20,18,229,83,,1015,,,0,5,3,,1,0,I1.000|4:45-I1.000|4:48-I0.461|2:09,,Running,,,,"Polar M430",43,0,,0,168070,250480,30378,,,,,,,,,,,,,,,,,,,,,,,,,,,,,,,,,,,,,,,,,,5,
5963949,e8c8a45a-4d6e-4e34-9d4e-35bb009186cd,1466952002,120,1548678376,,0,0,2.31,742,742,25,24,,,1,0.9,0.48,,,,157,,,,,,,33.44,,1,,,,,,,,,,,,,,15,79,11.42,11.39,11.84,,,,,,,,,,,,,,,,,"6,8,29,32,18,6,0,0,0",,,,,,,118,,,,,,,,,,,,,,,,,,,,,,,,,,,,,,,,,,,,,18,8,253,70,,1018,6,,0,5,3,,1,0,,,,,"Aachen Laufen",,"Polar BEAT",,0,,0,168070,250480,30378,,,,,,,,,,,,,,,,,,,,,,,,,,,,,,,,,,,,,,,,,,,
5963951,936a4cf4-a041-4af5-9704-7c2282838309,1411067108,120,1548678377,,0,0,32.01,8937,9100,352,352,,,1,1.9,0.41,1.02,1.01,562,1470,150,186,,,,62.21,47.53,63.06,1,,,,,,,,,,,,,,225,81,13.07,13.07,13.32,5,,,,,,,,,,,,,,,,"2,1,3,10,48,33,2,2,0","0,22,60,16,2",,,,,,133,,,,,,,,,,,,,,,,,,,,,,,,,,,,,,,,,,,,93.3,20,1,88,92,,1010,0,,1,6,3,,1,0,,,,,"Sehr langer DL",,"Polar BEAT",,0,,0,168070,250480,30378,,,,,,,,,,,,,,,,,,,,,,,,,,,,,,,,,,,,,,,,,,"5,5",
5963952,040ae09f-d5c2-440e-8c1e-feeb0d3184e0,1431420635,120,1548678378,,0,0,9.61,2857,2957,156,155,,,1,1.9,0.46,,,601,657,,,,,,,40.32,,1,,,,,,,,,,,,,,59,82,12.51,12.32,12.85,,,,,,,,,,,,,,,,,"5,2,6,23,49,14,2,0,0",,,,,,,123,,,,,,,,,,,,,,,,,,,,,,,,,,,,,,,,,,,,,17,4,270,75,,1016,1,,0,5,3,,1,0,,,,,"Aachen Laufen",,"Polar BEAT",,0,,0,168070,250480,30378,,,,,,,,,,,,,,,,,,,,,,,,,,,,,,,,,,,,,,,,,,"5,5,5",
5963953,3ae63063-6703-403f-a2d1-bb24378768ad,1415129256,60,1548678379,,0,0,8.73,2001,2007,178,177,,,1,2.5,0.93,1.32,0.97,,486,172,187,,,,65.14,54.36,66.8,1,,,,,,,,,,,,,,85,87,15.9,17.14,17.62,-3.9,,,,,,,,,,,,,,,,"16,0,1,1,1,1,2,78,0","0,11,7,43,40",,,,,,150,,,,,,,,,,,,,,,,,,,,,,,,,,,,,,,,,,,,118,8,1,162,98,,997,0,,1,5,3,,1,0,,,,,"4x 2.000m",,"Polar BEAT",,0,,0,168070,250480,30378,,,,,,,,,,,,,,,,,,,,,,,,,,,,,,,,,,,,,,,,,,,
5963954,9cefee71-8d6a-414c-8d1a-ff219c500748,1460211035,120,1548678379,,0,0,4.64,1325,1391,36,71,,,1,0.8,0.48,,,,316,,,,,,,40.43,,1,,,,,,,,,,,,,,27,83,12.59,12.9,12.93,,,,,,,,,,,,,,,,,"5,4,5,11,36,36,4,0,0",,,,,,,127,,,,,,,,,,,,,,,,,,,,,,,,,,,,,,,,,,,,,12,12,177,41,,1007,,,0,5,3,,1,0,,,,,"Aachen Laufen",,"Polar BEAT",,0,,0,168070,250480,30378,,,,,,,,,,,,,,,,,,,,,,,,,,,,,,,,,,,,,,,,,,,
5963955,35bbbc1d-9794-4fe9-9ab1-90b75d3be8b5,1499544544,120,1548678379,,0,0,4.32,1454,1730,50,48,,,1,1.2,0.51,,,472,294,,,,,,,33.12,,1,,,,,,,,,,,,,,30,78,10.95,10.91,11.18,,,,,,,,,,,,,,,,,"11,11,31,35,10,3,0,0,0",,,,,,,114,,,,,,,,,,,,,,,,,,,,,,,,,,,,,,,,,,,,,26,6,149,50,,1015,0,,0,4,3,,1,0,,,,,"Aix-en-Provence Laufen",,"Polar BEAT",,0,,0,168070,250480,30378,,,,,,,,,,,,,,,,,,,,,,,,,,,,,,,,,,,,,,,,,,5,
5963956,888e7f3f-b268-4632-9181-cfd9d1e58e6d,1409084171,120,1548678379,,0,0,2.4,687,687,26,32,,,1,0.8,0.51,,,,163,,,,,,,38.31,,1,,,,,,,,,,,,,,14,81,12.66,12.68,12.77,,,,,,,,,,,,,,,,,"0,0,3,30,43,25,0,0,0",,,,,,,129,,,,,,,,,,,,,,,,,,,,,,,,,,,,,,,,,,,,,13,4,54,100,,1007,0,,0,6,3,,1,0,,,,,Einlaufen,,"Polar BEAT",,0,,0,168070,250480,30378,,,,,,,,,,,,,,,,,,,,,,,,,,,,,,,,,,,,,,,,,,,
5963957,f50e3b86-39bc-493d-8b73-a0806dfa22b2,1518954089,60,1548678379,,0,0,1.1,327,328,4,8,,,1,0,0.18,0.89,0.8,,58,127,149,,,,70.81,33.69,70.81,1,,,,,,,,,,,,,,4,83,12.07,12.21,12.16,6.7,,,,,,,,,,,,,,,,"5,1,1,27,67,0,0,0,0","2,82,16,0,0",,,,,,122,,,,,,,,,,,,,,,,,,,,,,,,,,,,,,,,,,,,7,1,6,45,88,,1027,,,0,5,3,,1,0,I1.000|4:56-I0.114|0:32,,Running,,,,"Polar M430",43,0,,0,168070,250480,30378,,,,,,,,,,,,,,,,,,,,,,,,,,,,,,,,,,,,,,,,,,,
5963958,58affa77-aeda-4f20-a1e4-ce7a375b91e9,1527011900,120,1548678380,,0,0,17.61,4670,4671,62,60,,,1,0,0.04,1.12,0.91,,1051,144,168,,,,69.99,48.22,70.3,1,,,,,,,,,,,,,,103,84,13.61,13.65,13.72,4,,,,,,,,,,,,,,,,"0,0,1,7,28,57,6,0,0","0,41,54,5,0",,,,,,135,,,,,,,,,,,,,,,,,,,,,,,,,,,,,,,,,,,,44.7,20,4,176,69,,1012,,,0,5,3,,1,0,I1.000|4:53-I1.000|4:27-I1.000|4:19-I1.000|4:31-I1.000|4:12-I1.000|4:09-I1.000|4:18-I1.000|4:25-I1.000|4:11-I1.000|4:24-I1.000|4:29-I1.000|4:21-I1.000|4:23-I1.000|4:24-I1.000|4:28-I1.000|4:27-I1.000|4:34-I0.615|2:58,,Running,,,,"Polar M430",43,0,,0,168070,250480,30378,,,,,,,,,,,,,,,,,,,,,,,,,,,,,,,,,,,,,,,,,,,
5963959,56b65780-9d16-4b50-88e7-aa05199113e9,1474020328,120,1548678381,,0,0,16.93,4686,4726,216,216,,,1,2.1,0.55,,,416,1160,,,,,,,45.75,,1,,,,,,,,,,,,,,97,81,13.25,13.16,13.41,,,,,,,,,,,,,,,,,"1,3,5,11,33,42,5,0,0",,,,,,,134,,,,,,,,,,,,,,,,,,,,,,,,,,,,,,,,,,,,,17,7,219,82,,1015,1,,0,5,3,,1,0,,,,,"Aachen Laufen",,"Polar BEAT",,0,,0,168070,250480,30378,,,,,,,,,,,,,,,,,,,,,,,,,,,,,,,,,,,,,,,,,,4,
5963960,33dca923-bd2a-4a64-9e0c-51064fef20a4,1365174254,120,1548678382,,0,0,14.61,4293,4372,20,21,,,1,0,0,,,,1020,,,,,,,42.18,,1,,,,,,,,,,,,,,89,,12.26,12.34,12.35,,,,,,,,,,,,,,,,,"2,2,8,28,44,13,2,0,0",,,,,,,,,,,,,,,,,,,,,,,,,,,,,,,,,,,,,,,,,,,,4,3,3,70,,1006,3,,0,4,3,,1,0,,,,,,,"Polar BEAT",,0,,0,168070,250480,30378,,,,,,,,,,,,,,,,,,,,,,,,,,,,,,,,,,,,,,,,,,,
5963961,27eaff55-411f-49fb-a47f-b8034776212a,1452020187,60,1548678382,,0,0,0.61,193,193,4,20,,,1,0.2,0.33,,,,38,,,,,,,29.5,,1,,,,,,,,,,,,,,4,80,10.86,11.81,11.65,,,,,,,,,,,,,,,,,"9,2,3,54,32,0,0,0,0",,,,,,,119,,,,,,,,,,,,,,,,,,,,,,,,,,,,,,,,,,,,,6,11,164,88,,994,,,1,4,3,,1,0,,,,,"Aachen Laufen",,"Polar BEAT",,0,,0,168070,250480,30378,,,,,,,,,,,,,,,,,,,,,,,,,,,,,,,,,,,,,,,,,,,
5963962,c3b5e246-2828-43fd-892c-815e1f206a15,1543232966,60,1548678382,,0,0,14.01,3708,3711,32,32,,,1,0,0.04,,,,895,148,165,,,,67.67,47.47,67.86,1,,,,,,,,,,,,,,89,82,13.64,13.71,13.77,10.8,,,,,,,,,,,,,,,,"1,0,2,5,24,63,6,0,0","1,17,73,9,0",,,,,,138,,,,,,,,,,,,,,,,,,,,,,,,,,,,,,,,,,,,46.7,6,19,30,81,,,1,,0,4,3,,1,0,I1.000|4:38-I1.000|4:27-I1.000|4:23-I1.000|4:19-I1.000|4:15-I1.000|4:21-I1.000|4:21-I1.000|4:11-I1.000|4:12-I1.000|4:18-I1.000|4:14-I1.000|4:22-I1.000|4:25-I1.000|5:18-I0.017|0:07,,Running,,,,"Polar M430",43,0,,0,168070,250480,30378,,,,,,,,,,,,,,,,,,,,,,,,,,,,,,,,,,,,,,,,,,,
5963963,05994330-218e-4c51-8e20-3617da827e25,1369859424,120,1548678383,,0,0,10.61,2687,2824,220,221,,,1,1,0.24,,,,388,,,,,,,48.97,,1,,,,,,,,,,,,,,55,,14.68,15.22,15.74,,,,,,,,,,,,,,,,,"11,1,1,1,1,7,75,4,0",,,,,,,,,,,,,,,,,,,,,,,,,,,,,,,,,,,,,,,,,,,,9,7,243,94,,1004,0,,0,6,3,,1,0,,,,,Untitled,,"Polar BEAT",,0,,0,168070,250480,30378,,,,,,,,,,,,,,,,,,,,,,,,,,,,,,,,,,,,,,,,,,,
5963964,0aa433e8-edf7-44cd-a2c2-f6da662a5070,1403731798,120,1548678383,,0,0,10.35,2102,2102,0,0,,,1,0,0,,,,703,,,,,,,63.29,,1,,,,,,,,,,,,,,43,88,17.74,17.78,17.79,,,,,,,,,,,,,,,,,"0,0,0,0,0,1,30,66,3",,,,,,,168,,,,,,,,,,,,,,,,,,,,,,,,,,,,,,,,,,,,,14,4,23,72,,1016,,,0,5,3,,1,0,,,,,"WK 10k Unicup Münster",,"Polar BEAT",,0,,0,168070,250480,30378,,,,,,,,,,,,,,,,,,,,,,,,10,2102,,,0,Leonardo-Campus-Run,,,,,,,0,0,30378,5963964,8725,,,
5963965,b8937997-5be4-46ef-a67d-79b1834f8e25,1505846238,120,1548678384,,0,0,6.73,1813,1877,76,76,,,1,0,0.03,0.71,0.51,,445,152,176,,,,63.86,44.27,64.76,1,,,,,,,,,,,,,,49,83,13.38,15.58,15.66,14.7,,,,,,,,,,,,,,,,"34,2,2,2,2,3,6,43,7","0,22,47,31,0",,,,,,134,,,,,,,,,,,,,,,,,,,,,,,,,,,,,,,,,,,,51.7,14,9,305,77,,1019,,,0,5,3,,1,0,I1.002|3:25-I1.032|3:21-I0.186|1:58-I1.026|3:18-I0.138|1:58-I0.517|1:38-I0.373|3:29-I0.498|1:36-I0.176|2:11-I0.308|0:57-I0.208|1:28-I0.515|1:33-I0.190|1:27-I0.519|1:35-I0.037|2:04,,Running,,,,"Polar M430",43,0,,0,168070,250480,30378,,,,,,,,,,,,,,,,,,,,,,,,,,,,,,,,,,,,,,,,,,,
5963966,a0340248-2d97-4f6f-8784-943d1e4a0a44,1455647736,60,1548678384,,0,0,16.59,4740,6343,185,185,,,1,1.1,0.44,,,,1141,,,,,,,44.03,,1,,,,,,,,,,,,,,98,82,12.83,13.34,13.58,,,,,,,,,,,,,,,,,"11,5,6,15,24,15,17,6,0",,,,,,,128,,,,,,,,,,,,,,,,,,,,,,,,,,,,,,,,,,,,,-1,6,86,74,,1036,,,1,3,3,,1,0,,,,,"Aachen Laufen",,"Polar BEAT",,0,,0,168070,250480,30378,,,,,,,,,,,,,,,,,,,,,,,,,,,,,,,,,,,,,,,,,,,
5963967,7200bab4-8cc5-413a-8277-c7d7bc717278,1484766108,60,1548678385,,0,0,1.84,3528,3528,188,189,,,1,3.7,1,,,324,755,,,,,,,,,1,,,,,,,,,,,,,,39,,,1.88,,,,56,44,,1,117,110,,,,,,,,,"100,0,0,0,0,0,0",,"79,18,0,2,0",,,,,,,,,,,,,,,,,,,,,,,,,,,,,,,,,,,,,,,,,,-3,3,51,86,,1038,0,,1,3,3,,1,0,,,,,Radfahren,,"Polar BEAT",,0,,0,168072,,30378,,,,,,,,,,,,,,,,,,,,,,,,,,,,,,,,,,,,,,,,,,"4,4",
5963968,1f62487e-077c-4344-97a2-ff131d7e8b2b,1498954017,120,1548678385,,0,0,0.58,211,211,6,4,,,1,1,0.65,,,,40,,,,,,,24.98,,1,,,,,,,,,,,,,,4,76,10.13,10.22,10.49,,,,,,,,,,,,,,,,,"15,28,41,17,0,0,0,0,0",,,,,,,109,,,,,,,,,,,,,,,,,,,,,,,,,,,,,,,,,,,,,19,28,313,57,,1018,0,,1,3,3,,1,0,,,,,"Aix-en-Provence Laufen",,"Polar BEAT",,0,,0,168070,250480,30378,,,,,,,,,,,,,,,,,,,,,,,,,,,,,,,,,,,,,,,,,,,
5963969,f1f50a82-8a9f-4fc0-a4aa-5db8c8c44dac,1450467049,60,1548678386,,0,0,12.02,2816,2816,117,122,,,1,0.5,0.31,,,,812,,,,,,,54.09,,1,,,,,,,,,,,,,,58,83,15.45,15.4,15.56,,,,,,,,,,,,,,,,,"0,0,0,0,2,30,67,1,0",,,,,,,154,,,,,,,,,,,,,,,,,,,,,,,,,,,,,,,,,,,,,10,11,198,87,,1024,,,1,4,3,,1,0,,,,,"Aachen Laufen",,"Polar BEAT",,0,,0,168070,250480,30378,,,,,,,,,,,,,,,,,,,,,,,,,,,,,,,,,,,,,,,,,,,
5963970,,1466760307,120,1548678386,,0,0,5,0,0,,,,,0,,,,,,,,,,,,,,,1,,,,,,,,,,,,,,0,,,,,,,,,,,,,,,,,,,,,,,,,,,,,,,,,,,,,,,,,,,,,,,,,,,,,,,,,,,,,,,,,,,,,,,,,,1,,,0,0,,,,,"laufen ",,"Polar BEAT",,0,,0,168070,250480,30378,,,,,,,,,,,,,,,,,,,,,,,,,,,,,,,,,,,,,,,,,,,
5963971,166b68c3-b293-4848-bc90-18cad161df71,1455217218,60,1548678386,,0,0,12.03,2807,2843,91,90,,,1,0.7,0.35,,,,817,,,,,,,54.35,,1,,,,,,,,,,,,,,58,84,15.55,15.52,15.68,,,,,,,,,,,,,,,,,"0,0,0,1,5,22,69,4,0",,,,,,,153,,,,,,,,,,,,,,,,,,,,,,,,,,,,,,,,,,,,,3,9,209,89,,1006,,,1,5,3,,1,0,,,,,"Aachen Laufen",,"Polar BEAT",,0,,0,168070,250480,30378,,,,,,,,,,,,,,,,,,,,,,,,,,,,,,,,,,,,,,,,,,,
5963972,3bb274bd-2516-4940-aa7d-48cb0426c06f,1400935149,120,1548678387,,0,0,7.65,2476,2893,130,95,,,1,1.8,0.47,,,328,519,,,,,,,35.92,,1,,,,,,,,,,,,,,51,81,11.49,11.89,12.54,,,,,,,,,,,,,,,,,"11,3,10,28,38,10,2,0,0",,,,,,,114,,,,,,,,,,,,,,,,,,,,,,,,,,,,,,,,,,,,,17,11,200,58,,1015,5,,0,5,3,,1,0,,,,,"Einlaufen + Lauf ABC",,"Polar BEAT",,0,,0,168070,250480,30378,,,,,,,,,,,,,,,,,,,,,,,,,,,,,,,,,,,,,,,,,,"5,5",
5963973,772da92a-37eb-462f-b862-d0f0725f9334,1526459496,120,1548678389,,0,0,10.87,1911,1914,37,47,,,1,0,0.13,,0.48,,322,123,144,,,,,,,1,,,,,,,,,,,,,,24,,,22.33,,2.5,-46.8,103,85,,1,128,117,,,,,,,,,"18,10,52,19,1,0,0","2,93,5,0,0","87,3,0,1,8",,,,,,,,,,,,,,,,,,,,,,,,,,,,,,,,,,,,,,,,,14.4,13,1,244,92,,,1,,0,6,3,,1,0,,,Cycling,,,,"Polar M430",43,0,,0,168072,,30378,,,,,,,,,,,,,,,,,,,,,,,,,,,,,,,,,,,,,,,,,,,
5963975,43801972-b7aa-4468-8c36-c4c79d07d58c,1483469300,60,1548678390,,0,0,16.29,4244,5383,161,159,,,1,1,0.38,,,,1101,,,,,,,48.92,,1,,,,,,,,,,,,,,88,82,13.97,14.06,14.24,,,,,,,,,,,,,,,,,"3,2,4,8,14,40,27,2,0",,,,,,,140,,,,,,,,,,,,,,,,,,,,,,,,,,,,,,,,,,,,,2,15,242,90,,1025,0,,1,5,3,,1,0,,,,,"Aachen Laufen",,"Polar BEAT",,0,,0,168070,250480,30378,,,,,,,,,,,,,,,,,,,,,,,,,,,,,,,,,,,,,,,,,,,
5963976,717fb1c6-6fe0-4c43-8b07-bc55b7500790,1369400355,120,1548678391,,0,0,29.36,8654,8977,457,457,,,1,2.4,0.48,,,341,2049,,,,,,,44.35,,1,,,,,,,,,,,,,,179,,12.54,12.49,13.01,,,,,,,,,,,,,,,,,"6,5,11,23,27,21,6,1,0",,,,,,,,,,,,,,,,,,,,,,,,,,,,,,,,,,,,,,,,,,,,10,7,212,57,,1011,6,,0,5,3,,1,0,,,,,,,"Polar BEAT",,0,,0,168070,250480,30378,,,,,,,,,,,,,,,,,,,,,,,,,,,,,,,,,,,,,,,,,,"4,5,5",
5963977,4582f280-0a92-4534-9df0-2101917b0b05,1500044401,120,1548678391,,0,0,4.92,1535,1537,71,63,,,1,0,0.29,,,,334,,,,,,,36.53,,1,,,,,,,,,,,,,,31,78,11.88,12.23,12.4,,,,,,,,,,,,,,,,,"13,4,10,21,30,16,4,2,0",,,,,,,123,,,,,,,,,,,,,,,,,,,,,,,,,,,,,,,,,,,,,31,37,322,31,,1014,8,,0,3,3,,1,0,,,,,"Aix-en-Provence Laufen",,"Polar BEAT",,0,,0,168070,250480,30378,,,,,,,,,,,,,,,,,,,,,,,,,,,,,,,,,,,,,,,,,,,
5963978,4f5159ac-a485-4d40-8af6-0f8ea1dd91bf,1391852992,60,1548678392,,0,0,16.5,4083,4105,196,196,,,1,1.5,0.38,1.04,1.02,448,773,164,179,,,,63.68,51.97,64.61,1,,,,,,,,,,,,,,144,86,14.83,14.62,14.97,6.2,,,,,,,,,,,,,,,,"0,1,0,1,12,47,38,1,0","1,2,29,69,0",,,,,,141,,,,,,,,,,,,,,,,,,,,,,,,,,,,,,,,,,,,95.1,7,17,197,81,,993,0,,0,5,3,,1,0,,,,,"TDL Samstag",,"Polar BEAT",,0,,0,168070,250480,30378,,,,,,,,,,,,,,,,,,,,,,,,,,,,,,,,,,,,,,,,,,"5,5",
5963979,37559a1d-ba87-49f7-a71f-acaded90d350,1404651918,120,1548678393,,0,0,15,4087,4087,193,200,,,1,2,0.57,,,521,1012,,,,,,,46.15,,1,,,,,,,,,,,,,,84,82,13.43,13.35,13.6,,,,,,,,,,,,,,,,,"0,1,2,13,35,43,6,0,0",,,,,,,134,,,,,,,,,,,,,,,,,,,,,,,,,,,,,,,,,,,,,25,10,197,64,,1008,6,,0,5,3,,1,0,,,,,"Lockerer DL",,"Polar BEAT",,0,,0,168070,250480,30378,,,,,,,,,,,,,,,,,,,,,,,,,,,,,,,,,,,,,,,,,,4,
5963980,992b14bb-69eb-48ae-8bc6-22703335f0aa,1419074356,60,1548678393,,0,0,1.12,266,266,12,15,,,1,0,0.09,,,,66,,,,,,,43.48,,1,,,,,,,,,,,,,,5,89,15.24,15.79,15.87,,,,,,,,,,,,,,,,,"18,3,3,3,5,5,11,42,10",,,,,,,142,,,,,,,,,,,,,,,,,,,,,,,,,,,,,,,,,,,,,6,18,248,88,,,0,,0,5,3,,1,0,,,,,"Lauf ABC",,"Polar BEAT",,0,,0,168070,250480,30378,,,,,,,,,,,,,,,,,,,,,,,,,,,,,,,,,,,,,,,,,,,
5963981,a02aa1e9-4844-4ab7-94e3-5e1f071f1192,1476218004,120,1548678393,,0,0,2.44,1153,1156,39,41,,,1,0.7,0.41,,,,169,,,,,,,21.16,,1,,,,,,,,,,,,,,23,66,7.73,10.46,10.62,,,,,,,,,,,,,,,,,"43,6,7,20,15,7,2,0,0",,,,,,,96,,,,,,,,,,,,,,,,,,,,,,,,,,,,,,,,,,,,,9,1,17,86,,1021,0,,1,5,3,,1,0,,,,,"Aachen Laufen",,"Polar BEAT",,0,,0,168070,250480,30378,,,,,,,,,,,,,,,,,,,,,,,,,,,,,,,,,,,,,,,,,,,
5963982,9671e8f2-8ce9-4b27-8189-a7ca1225692d,1470217044,120,1548678394,,0,0,8.18,2380,2426,80,79,,,1,0.2,0.36,,,,567,,,,,,,40.91,,1,,,,,,,,,,,,,,49,80,12.53,12.45,12.7,,,,,,,,,,,,,,,,,"0,1,10,23,52,11,3,0,0",,,,,,,129,,,,,,,,,,,,,,,,,,,,,,,,,,,,,,,,,,,,,18,10,228,95,,1013,2,,0,5,3,,1,0,,,,,"Aachen Laufen",,"Polar BEAT",,0,,0,168070,250480,30378,,,,,,,,,,,,,,,,,,,,,,,,,,,,,,,,,,,,,,,,,,,
5963983,05e98c7f-0c23-403e-8e06-120b9f715888,1537294146,120,1548678394,,0,0,9,2299,2304,31,32,,,1,0,0.13,1.15,0.93,,558,148,174,,,,70.71,47.96,71.01,1,,,,,,,,,,,,,,56,83,14.13,14.34,14.41,2,,,,,,,,,,,,,,,,"2,0,1,5,18,52,13,8,0","0,27,57,16,0",,,,,,141,,,,,,,,,,,,,,,,,,,,,,,,,,,,,,,,,,,,49.9,29,7,250,39,,1016,,,0,4,3,,1,0,I7.083|30:54-I1.055|3:35-I0.421|2:11-I0.418|1:28-I0.025|0:17,,Running,,,,"Polar M430",43,0,,0,168070,250480,30378,,,,,,,,,,,,,,,,,,,,,,,,,,,,,,,,,,,,,,,,,,,
5963984,2d2feece-a42a-48c7-87b3-de553eaef8eb,1395999298,60,1548678395,,0,0,4.33,1250,1250,47,32,,,1,0.1,0.26,1.04,0.97,,247,146,161,,,,61.88,39.74,62.98,1,,,,,,,,,,,,,,28,82,12.72,12.58,12.91,2.7,,,,,,,,,,,,,,,,"1,0,1,20,78,0,0,0,0","1,15,83,1,0",,,,,,127,,,,,,,,,,,,,,,,,,,,,,,,,,,,,,,,,,,,28.5,10,6,105,68,,1016,2,,0,5,3,,1,0,,,,,"Einlaufen + Lauf ABC",,"Polar BEAT",,0,,0,168070,250480,30378,,,,,,,,,,,,,,,,,,,,,,,,,,,,,,,,,,,,,,,,,,,
5963985,c30e6199-8eed-4d65-8028-bb4b7ea3d63a,1369483829,120,1548678395,,0,0,2.84,905,905,57,56,,,1,1.6,0.64,,,414,194,,,,,,,34.35,,1,,,,,,,,,,,,,,18,,11.76,11.32,12.34,,,,,,,,,,,,,,,,,"0,0,30,60,10,0,0,0,0",,,,,,,,,,,,,,,,,,,,,,,,,,,,,,,,,,,,,,,,,,,,12,8,336,62,,1016,6,,0,5,3,,1,0,,,,,,,"Polar BEAT",,0,,0,168070,250480,30378,,,,,,,,,,,,,,,,,,,,,,,,,,,,,,,,,,,,,,,,,,5,
5963986,,1546154160,60,1548678395,,0,0,3,900,900,,,,,0,,,,,,220,,,,,,,37.02,,1,,,,,,,,,,,,,,18,,,,,,,,,,,,,,,,,,,,,,,,,,,,,,,,,,,,,,,,,,,,,,,,,,,,,,,,,,,,,,,,,,,,,,,,,,1,,,0,0,,,,,,,"no device name available",,0,,0,168070,250480,30378,,,,,,,,,,,,,,,,,,,,,,,,,,,,,,,,,,,,,,,,,,,
5963987,02093b64-2714-4b7b-9bed-c00ef6334b23,1394742311,60,1548678395,,0,0,1.8,556,556,22,20,,,1,0,0,1.07,0.89,,104,136,142,,,,62.27,34.11,63.3,1,,,,,,,,,,,,,,9,82,11.73,11.68,11.81,6.9,,,,,,,,,,,,,,,,"0,1,12,58,30,0,0,0,0","0,85,15,0,0",,,,,,118,,,,,,,,,,,,,,,,,,,,,,,,,,,,,,,,,,,,13.9,9,5,11,62,,1029,,,1,3,3,,1,0,,,,,Auslaufen,,"Polar BEAT",,0,,0,168070,250480,30378,,,,,,,,,,,,,,,,,,,,,,,,,,,,,,,,,,,,,,,,,,,
5963988,4de22cc5-0784-4685-86d9-fe8a787c5c1e,1422720545,60,1548678395,,0,0,2.97,967,1189,5,4,,,1,0,0,,,,202,,,,,,,33.61,,1,,,,,,,,,,,,,,20,80,11.09,11.98,12.04,,,,,,,,,,,,,,,,,"18,1,2,18,37,24,0,0,0",,,,,,,115,,,,,,,,,,,,,,,,,,,,,,,,,,,,,,,,,,,,,3,12,231,80,,984,,,0,5,3,,1,0,,,,,"Grevenbroich Laufen",,"Polar BEAT",,0,,0,168070,250480,30378,,,,,,,,,,,,,,,,,,,,,,,,,,,,,,,,,,,,,,,,,,,
5963989,,1402849805,120,1548678395,,0,0,3,0,0,,,,,0,,,,,,,,,,,,,,,1,,,,,,,,,,,,,,0,,,,,,,,,,,,,,,,,,,,,,,,,,,,,,,,,,,,,,,,,,,,,,,,,,,,,,,,,,,,,,,,,,,,,,,,,,1,,,0,0,,,,,"WK 3x1000m  - 1000m in ca. 2:49",,"Polar BEAT",,0,,0,168070,250480,30378,,,,,,,,,,,,,,,,,,,,,,,,,,,,,,,,,,,,,,,,,,,
5963990,37239580-d71b-4533-b0fa-6e9ae5211ac7,1468074791,120,1548678396,,0,0,1.85,554,554,18,20,,,1,0.3,0.34,,,,129,,,,,,,35.43,,1,,,,,,,,,,,,,,11,80,12.09,12.23,12.31,,,,,,,,,,,,,,,,,"3,6,11,25,37,19,0,0,0",,,,,,,125,,,,,,,,,,,,,,,,,,,,,,,,,,,,,,,,,,,,,23,8,246,60,,1020,6,,0,5,3,,1,0,,,,,"Aachen Laufen",,"Polar BEAT",,0,,0,168070,250480,30378,,,,,,,,,,,,,,,,,,,,,,,,,,,,,,,,,,,,,,,,,,,
5963991,c5615bcc-38e0-4510-b01f-4918585f513a,1539711375,120,1548678396,,0,0,19.84,5195,5196,72,71,,,1,0,0.08,1.07,0.94,,1305,152,177,,,,66.15,49.41,66.45,1,,,,,,,,,,,,,,138,81,13.79,13.89,13.97,-1.4,,,,,,,,,,,,,,,,"1,0,1,5,25,56,12,1,0","0,15,61,24,0",,,,,,141,,,,,,,,,,,,,,,,,,,,,,,,,,,,,,,,,,,,51.9,21,7,52,48,,1018,0,277,0,3,3,,1,0,I1.000|4:59-I1.000|4:45-I1.000|5:10-I1.000|4:22-I1.000|4:27-I1.000|4:17-I1.000|4:25-I1.000|4:16-I1.000|4:23-I1.000|4:11-I1.000|4:17-I1.000|4:19-I1.000|4:12-I1.000|3:48-I1.000|4:02-I1.000|4:18-I1.000|4:14-I1.000|4:15-I1.000|4:12-I0.844|3:46,,Running,,,,"Polar M430",43,0,,0,168070,250480,30378,,,,,,,,,,,,,,,,,,,,,,,,,,,,,,,,,,,,,,,,,,,
5963992,90a05ea2-4a41-4440-9f4b-dee1860fc320,1432472671,120,1548678397,,0,0,6.41,1890,1911,67,67,,,1,1.4,1,,,,376,,,,,,,39.68,,1,,,,,,,,,,,,,,39,77,12.33,15.22,15.49,,,,,,,,,,,,,,,,,"44,2,2,2,2,3,4,25,16",,,,,,,132,,,,,,,,,,,,,,,,,,,,,,,,,,,,,,,,,,,,,17,1,285,62,,,5,,0,5,3,,1,0,,,,,"Menden Laufen",,"Polar BEAT",,0,,0,168070,250480,30378,,,,,,,,,,,,,,,,,,,,,,,,,,,,,,,,,,,,,,,,,,,
5963993,90c58c3a-8f38-4f90-b4df-5f5bc486bab7,1474200387,120,1548678397,,0,0,1.93,532,565,20,0,,,1,0,0.06,,,,131,,,,,,,39.1,,1,,,,,,,,,,,,,,11,80,13.53,13.25,13.71,,,,,,,,,,,,,,,,,"2,1,4,7,42,45,0,0,0",,,,,,,136,,,,,,,,,,,,,,,,,,,,,,,,,,,,,,,,,,,,,15,5,13,91,,1017,3,,0,5,3,,1,0,,,,,"Aachen Laufen",,"Polar BEAT",,0,,0,168070,250480,30378,,,,,,,,,,,,,,,,,,,,,,,,,,,,,,,,,,,,,,,,,,,
5963994,f27f80db-5fc9-4b89-83c5-d5d650d85999,1403560928,120,1548678398,,0,0,2.13,701,737,19,26,,,1,0.4,0.38,,,,142,,,,,,,32.26,,1,,,,,,,,,,,,,,14,82,11.01,11.22,11.38,,,,,,,,,,,,,,,,,"11,13,18,31,28,0,0,0,0",,,,,,,111,,,,,,,,,,,,,,,,,,,,,,,,,,,,,,,,,,,,,17,3,48,63,,1020,0,,1,3,3,,1,0,,,,,Auslaufen,,"Polar BEAT",,0,,0,168070,250480,30378,,,,,,,,,,,,,,,,,,,,,,,,,,,,,,,,,,,,,,,,,,,
5963995,acf013af-8d6e-46ae-9f26-cdc2d4de5548,1398074321,120,1548678398,,0,0,5.69,1622,1622,75,76,,,1,1.2,0.46,1.02,0.96,259,330,148,168,,,,61.73,41,62.73,1,,,,,,,,,,,,,,39,84,12.93,13.04,13.28,-5.1,,,,,,,,,,,,,,,,"3,2,10,31,27,13,15,0,0","1,16,69,14,0",,,,,,125,,,,,,,,,,,,,,,,,,,,,,,,,,,,,,,,,,,,43.8,10,6,60,77,,,,,0,3,3,,1,0,,,,,"Regenerativer DL",,"Polar BEAT",,0,,0,168070,250480,30378,,,,,,,,,,,,,,,,,,,,,,,,,,,,,,,,,,,,,,,,,,5,
5963996,fcee5d9c-37c7-47d7-8b87-d2a5444fd4e8,1545489818,60,1548678398,,0,0,0.94,321,321,8,9,,,1,0,0,1.05,0.85,,55,123,149,,,,61.83,28.28,62.4,1,,,,,,,,,,,,,,4,83,10.57,10.62,10.65,-10.3,,,,,,,,,,,,,,,,"9,20,35,35,2,0,0,0,0","15,70,15,0,0",,,,,,106,,,,,,,,,,,,,,,,,,,,,,,,,,,,,,,,,,,,6.8,12,20,239,73,,1019,0,295,0,6,3,,1,0,,,Running,,,,"Polar M430",43,0,,0,168070,250480,30378,,,,,,,,,,,,,,,,,,,,,,,,,,,,,,,,,,,,,,,,,,,
5963997,a53885cd-0f7c-46c6-9649-21ab1a14b31f,1426189006,60,1548678398,,0,0,10.7,2676,2688,20,21,,,1,0,0.02,,,,665,,,,,,,49.72,,1,,,,,,,,,,,,,,55,85,14.47,15.71,15.73,,,,,,,,,,,,,,,,,"16,6,5,5,6,7,10,39,5",,,,,,,141,,,,,,,,,,,,,,,,,,,,,,,,,,,,,,,,,,,,,8,4,103,65,,1028,0,,1,3,3,,1,0,,,,,"2x 10x 400m",,"Polar BEAT",,0,,0,168070,250480,30378,,,,,,,,,,,,,,,,,,,,,,,,,,,,,,,,,,,,,,,,,,,
5963998,6fcbc18f-658c-41f8-b6a8-59812476aa57,1427544661,60,1548678399,,0,0,4.02,1852,2127,70,65,,,1,1.2,0.45,,,422,257,,,,,,,22.51,,1,,,,,,,,,,,,,,38,75,8.1,10.57,11.23,,,,,,,,,,,,,,,,,"49,3,7,16,11,13,2,0,0",,,,,,,87,,,,,,,,,,,,,,,,,,,,,,,,,,,,,,,,,,,,,8,22,198,85,,1017,,,0,4,3,,1,0,,,,,"Aachen Laufen",,"Polar BEAT",,0,,0,168070,250480,30378,,,,,,,,,,,,,,,,,,,,,,,,,,,,,,,,,,,,,,,,,,5,
5963999,c4d01eb9-9df8-4a58-bc0d-964045f8b847,1531757010,120,1548678401,,0,0,10.49,3097,3099,348,356,,,1,4.1,0.71,1.05,1.12,639,810,157,179,,,,54.53,40.91,56.72,1,,,,,,,,,,,,,,91,82,13.47,13.4,13.96,-11.5,,,,,,,,,,,,,,,,"27,10,11,9,6,7,25,6,0","1,6,55,38,0",,,,,,124,,,,,,,,,,,,,,,,,,,,,,,,,,,,,,,,,,,,73.6,28,11,311,28,,,,,0,3,3,,1,0,I1.000|5:48-I1.000|6:43-I1.000|6:49-I1.000|6:24-I1.000|4:37-I1.000|3:59-I1.000|3:41-I1.000|3:41-I1.000|3:35-I1.000|3:46-I0.493|2:37,,Running,,,,"Polar M430",43,0,,0,168070,250480,30378,,,,,,,,,,,,,,,,,,,,,,,,,,,,,,,,,,,,,,,,,,3,
5964000,a89669db-bfac-4ec0-8e59-f6301d0a212c,1458243422,60,1548678401,,0,0,8.3,2094,2227,89,89,,,1,0,0,,,,510,,,,,,,48.42,,1,,,,,,,,,,,,,,43,87,14.4,15.83,15.89,,,,,,,,,,,,,,,,,"31,3,3,3,3,4,6,35,12",,,,,,,137,,,,,,,,,,,,,,,,,,,,,,,,,,,,,,,,,,,,,6,6,20,61,,1026,,,1,3,3,,1,0,,,,,"Aachen Laufen",,"Polar BEAT",,0,,0,168070,250480,30378,,,,,,,,,,,,,,,,,,,,,,,,,,,,,,,,,,,,,,,,,,,
5964001,,1405985440,120,1548678402,,0,0,3,0,0,,,,,0,,,,,,174,,,,,,,,,1,,,,,,,,,,,,,,0,,,,,,,,,,,,,,,,,,,,,,,,,,,,,,,,,,,,,,,,,,,,,,,,,,,,,,,,,,,,,,,,,,,,,,,,,,1,,,0,0,,,,,"WK 3.000m Genth",,"Polar BEAT",,0,,0,168070,250480,30378,,,,,,,,,,,,,,,,,,,,,,,,,,,,,,,,,,,,,,,,,,,
5964002,b871b72b-c1e4-4f2f-8c9a-798ba1835e04,1396212113,120,1548678402,,0,0,9.59,2594,2645,131,133,,,1,1.8,0.49,1.05,0.94,290,519,151,166,,,,64.12,45.04,65.19,1,,,,,,,,,,,,,,66,83,13.53,13.46,13.9,0.3,,,,,,,,,,,,,,,,"2,2,5,12,29,38,12,1,0","0,12,68,20,0",,,,,,134,,,,,,,,,,,,,,,,,,,,,,,,,,,,,,,,,,,,47.6,15,1,91,55,,1016,0,,1,5,3,,1,0,,,,,"Lockerer DL",,"Polar BEAT",,0,,0,168070,250480,30378,,,,,,,,,,,,,,,,,,,,,,,,,,,,,,,,,,,,,,,,,,4,
5964003,f27c6a0e-1805-456d-b436-c3966aec7e1c,1429356049,120,1548678403,,0,0,15.29,4297,4297,232,232,,,1,2,0.53,,,328,1043,,,,,,,44.59,,1,,,,,,,,,,,,,,89,83,13.19,12.99,13.37,,,,,,,,,,,,,,,,,"3,1,7,15,35,34,5,0,0",,,,,,,129,,,,,,,,,,,,,,,,,,,,,,,,,,,,,,,,,,,,,10,19,61,44,,1027,,,0,3,3,,1,0,,,,,"Aachen Laufen",,"Polar BEAT",,0,,0,168070,250480,30378,,,,,,,,,,,,,,,,,,,,,,,,,,,,,,,,,,,,,,,,,,"5,5,5",
5964004,e0c198d7-bd43-4fc3-bd97-74ab8efd4679,1409408939,120,1548678403,,0,0,4.44,1532,1532,55,84,,,1,1.1,0.46,1.07,0.95,419,246,125,141,,,,59.96,32.21,60.39,1,,,,,,,,,,,,,,20,82,10.49,10.55,10.92,1.1,,,,,,,,,,,,,,,,"14,16,32,36,2,0,0,0,0","1,98,1,0,0",,,,,,106,,,,,,,,,,,,,,,,,,,,,,,,,,,,,,,,,,,,10.9,17,10,223,82,,1018,4,,0,5,3,,1,0,,,,,Auslaufen,,"Polar BEAT",,0,,0,168070,250480,30378,,,,,,,,,,,,,,,,,,,,,,,,,,,,,,,,,,,,,,,,,,5,
5964005,8724db81-9dcd-4b68-8a82-3edc1d77fdda,1422105512,60,1548678404,,0,0,13.35,4743,6375,278,275,,,1,2.4,0.39,,,467,823,,,,,,,33.54,,1,,,,,,,,,,,,,,98,80,10.64,12.01,12.44,,,,,,,,,,,,,,,,,"38,5,7,13,13,8,9,6,1",,,,,,,106,,,,,,,,,,,,,,,,,,,,,,,,,,,,,,,,,,,,,0,6,267,99,,1021,1,,0,9,3,,1,0,,,,,"Cross Training",,"Polar BEAT",,0,,0,168070,250480,30378,,,,,,,,,,,,,,,,,,,,,,,,,,,,,,,,,,,,,,,,,,"4,4",
5964006,,1464179520,120,1548678404,,0,0,3,0,0,,,,,0,,,,,,196,,,,,,,,,1,,,,,,,,,,,,,,0,,,,,,,,,,,,,,,,,,,,,,,,,,,,,,,,,,,,,,,,,,,,,,,,,,,,,,,,,,,,,,,,,,,,,,,,,,1,,,0,0,,,,,Auslaufen,,"Polar BEAT",,0,,0,168070,250480,30378,,,,,,,,,,,,,,,,,,,,,,,,,,,,,,,,,,,,,,,,,,,
5964007,db9b34e0-aefc-44f2-a011-7853689c29f4,1530125406,120,1548678404,,0,0,11.49,3623,3627,36,36,,,1,0,0.18,1.12,0.89,,752,135,152,,,,61.26,38.13,61.49,1,,,,,,,,,,,,,,61,80,11.46,11.44,11.53,2.4,,,,,,,,,,,,,,,,"1,1,16,68,13,0,0,0,0","1,94,6,0,0",,,,,,119,,,,,,,,,,,,,,,,,,,,,,,,,,,,,,,,,,,,18.5,27,22,50,28,,1016,,,0,5,3,,1,0,I1.000|5:07-I1.000|5:10-I1.000|5:07-I1.000|5:10-I1.000|5:11-I1.000|5:15-I1.000|5:17-I1.000|5:17-I1.000|5:26-I1.000|5:28-I1.000|5:24-I0.497|2:36,,Running,,,,"Polar M430",43,0,,0,168070,250480,30378,,,,,,,,,,,,,,,,,,,,,,,,,,,,,,,,,,,,,,,,,,,
5964008,75a1619d-bb06-4174-bbaf-151eb002eac3,1495975208,120,1548678405,,0,0,13.38,3710,3955,304,306,,,1,4,0.59,,,596,910,,,,,,,44.82,,1,,,,,,,,,,,,,,77,80,13.61,13.37,14.09,,,,,,,,,,,,,,,,,"1,4,12,17,21,32,11,2,0",,,,,,,135,,,,,,,,,,,,,,,,,,,,,,,,,,,,,,,,,,,,,18,2,93,92,,,5,,0,6,3,,1,0,,,,,"Balve Laufen",,"Polar BEAT",,0,,0,168070,250480,30378,,,,,,,,,,,,,,,,,,,,,,,,,,,,,,,,,,,,,,,,,,"4,4",
5964009,a86766c2-6fb8-41b4-9e7d-a288a1d932f6,1394739281,60,1548678406,,0,0,9.99,2738,2770,81,81,,,1,0,0.04,,,,562,161,181,,,,57.66,44.47,58.24,1,,,,,,,,,,,,,,90,83,13.19,14.65,14.66,-2.8,,,,,,,,,,,,,,,,"36,2,3,3,4,5,6,29,11","0,12,29,59,0",,,,,,132,,,,,,,,,,,,,,,,,,,,,,,,,,,,,,,,,,,,72.5,11,5,359,52,,1028,,,1,3,3,,1,0,,,,,"20x 400m",,"Polar BEAT",,0,,0,168070,250480,30378,,,,,,,,,,,,,,,,,,,,,,,,,,,,,,,,,,,,,,,,,,,
5964010,08d16e57-0e91-4357-8837-1f68b958302b,1425584128,60,1548678406,,0,0,8.54,2039,2043,0,3,,,1,0,0,,,,563,,,,,,,51.75,,1,,,,,,,,,,,,,,42,85,15.23,16.16,16.17,,,,,,,,,,,,,,,,,"17,1,1,2,2,3,17,57,1",,,,,,,148,,,,,,,,,,,,,,,,,,,,,,,,,,,,,,,,,,,,,5,4,275,74,,1038,0,,1,5,3,,1,0,,,,,"8x 1000",,"Polar BEAT",,0,,0,168070,250480,30378,,,,,,,,,,,,,,,,,,,,,,,,,,,,,,,,,,,,,,,,,,,
5964011,a5e5429c-60f8-4543-8af0-027b60f2b3c0,1414098238,120,1548678406,,0,0,1.01,358,358,0,2,,,1,0,0,,,,66,,,,,,,27.32,,1,,,,,,,,,,,,,,7,81,10.15,10.24,10.35,,,,,,,,,,,,,,,,,"10,30,49,10,0,0,0,0,0",,,,,,,104,,,,,,,,,,,,,,,,,,,,,,,,,,,,,,,,,,,,,11,9,184,88,,1024,,,1,5,3,,1,0,,,,,Auslaufen,,"Polar BEAT",,0,,0,168070,250480,30378,,,,,,,,,,,,,,,,,,,,,,,,,,,,,,,,,,,,,,,,,,,
5964012,65d81af2-075e-413a-b381-8165c44f1661,1539808108,120,1548678406,,0,0,10.36,1884,1884,44,39,,,1,0,0.14,2.38,,,256,111,140,,,,,,,1,,,,,,,,,,,,,,16,,,19.99,,1.9,-29.5,87,78,,1,107,100,,,,,,,,,"3,44,53,1,0,0,0","13,87,0,0,0","90,1,0,2,8",,,,,,,,,,,,,,,,,,,,,,,,,,,,,,,,,,,,,,,,,8,16,7,40,73,,,0,,1,3,3,,1,0,,,Cycling,,,,"Polar M430",43,0,,0,168072,,30378,,,,,,,,,,,,,,,,,,,,,,,,,,,,,,,,,,,,,,,,,,,
5964013,7a474d63-0015-48c1-8721-ea36e611fc50,1541610900,60,1548678407,,0,0,10.34,2992,2992,53,44,,,1,0,0.1,1.09,0.89,,758,152,168,,,,58.46,41.84,58.9,1,,,,,,,,,,,,,,77,82,12.51,12.48,12.6,5.2,,,,,,,,,,,,,,,,"0,0,2,21,71,6,0,0,0","0,2,96,2,0",,,,,,126,,,,,,,,,,,,,,,,,,,,,,,,,,,,,,,,,,,,42.3,13,2,212,74,,1012,0,286,1,5,3,,1,0,I1.000|4:56-I1.000|4:42-I1.000|5:01-I1.000|4:44-I1.000|4:39-I1.000|4:47-I1.000|4:42-I1.000|4:47-I1.000|4:47-I1.000|5:01-I0.340|1:47,,Running,,,,"Polar M430",43,0,,0,168070,250480,30378,,,,,,,,,,,,,,,,,,,,,,,,,,,,,,,,,,,,,,,,,,,
5964014,a93ad16f-34ca-4ceb-8af0-83121ab55cab,1412762865,120,1548678408,,0,0,13.37,4312,4951,145,145,,,1,1.6,0.5,1.03,1.03,343,721,142,161,,,,55.94,37.58,56.69,1,,,,,,,,,,,,,,89,82,11.32,11.28,11.5,1.2,,,,,,,,,,,,,,,,"6,8,19,46,17,3,0,0,0","0,49,51,0,0",,,,,,113,,,,,,,,,,,,,,,,,,,,,,,,,,,,,,,,,,,,33.1,12,6,172,92,,1007,1,,0,5,3,,1,0,,,,,"Sehr langsamer DL",,"Polar BEAT",,0,,0,168070,250480,30378,,,,,,,,,,,,,,,,,,,,,,,,,,,,,,,,,,,,,,,,,,5,
5964015,,1464651720,120,1548678408,,0,0,,0,0,,,,,0,,,,,,377,,,,,,,,,1,,,,,,,,,,,,,,0,,,,,,,,,,,,,,,,,,,,,,,,,,,,,,,,,,,,,,,,,,,,,,,,,,,,,,,,,,,,,,,,,,,,,,,,,,1,,,0,0,,,,,Gym,,"Polar BEAT",,0,,0,168075,,30378,,,,,,,,,,,,,,,,,,,,,,,,,,,,,,,,,,,,,,,,,,,
5964016,5b416e80-bbe6-431c-b389-654342f34903,1533716151,120,1548678408,,0,0,9.65,1366,1369,40,44,,,1,0,0.13,1.69,,,267,134,161,,,,,,,1,,,,,,,,,,,,,,23,,,26.31,,8.5,-24.7,141,120,,1,157,141,,,,,,,,,"6,4,11,69,9,0,0","1,83,16,0,0","69,19,0,1,11",,,,,,,,,,,,,,,,,,,,,,,,,,,,,,,,,,,,,,,,,18.9,23,8,256,74,,1013,,,0,5,3,,1,0,,,Cycling,,,,"Polar M430",43,0,,0,168072,,30378,,,,,,,,,,,,,,,,,,,,,,,,,,,,,,,,,,,,,,,,,,,
5964017,fefc1100-5ac4-492a-88cd-784127155f2b,1416741360,60,1548678409,,0,0,27.49,8066,8116,392,392,,,1,2.7,0.54,,,412,1848,,,,,,,44.39,,1,,,,,,,,,,,,,,167,83,12.55,12.52,12.86,,,,,,,,,,,,,,,,,"3,5,11,23,34,19,3,1,0",,,,,,,123,,,,,,,,,,,,,,,,,,,,,,,,,,,,,,,,,,,,,12,5,171,87,,1018,1,,0,5,3,,1,0,,,,,"Langer Langsamer DL",,"Polar BEAT",,0,,0,168070,250480,30378,,,,,,,,,,,,,,,,,,,,,,,,,,,,,,,,,,,,,,,,,,"4,5,5",
5964018,fafb340f-5035-4ec2-896f-851b068de0c6,1456171583,60,1548678410,,0,0,11.96,3122,3145,116,112,,,1,0.8,0.34,,,,831,,,,,,,47.68,,1,,,,,,,,,,,,,,64,83,13.98,14.09,14.31,,,,,,,,,,,,,,,,,"5,1,1,6,14,44,28,1,0",,,,,,,138,,,,,,,,,,,,,,,,,,,,,,,,,,,,,,,,,,,,,3,4,340,97,,1010,,,1,5,3,,1,0,,,,,"Aachen Laufen",,"Polar BEAT",,0,,0,168070,250480,30378,,,,,,,,,,,,,,,,,,,,,,,,,,,,,,,,,,,,,,,,,,,
5964019,dcc2208c-a7ff-43fd-8d7b-ca2cbe4ad7f2,1503772726,120,1548678410,,0,0,12.67,3424,3425,181,181,,,1,2.1,0.57,1.01,1.02,356,827,154,180,,,,62.48,45.99,63.59,1,,,,,,,,,,,,,,95,81,13.57,13.4,13.77,3.8,,,,,,,,,,,,,,,,"0,0,2,8,41,45,4,0,0","0,15,55,30,0",,,,,,137,,,,,,,,,,,,,,,,,,,,,,,,,,,,,,,,,,,,60.8,24,4,307,62,,1015,1,,0,5,3,,1,0,I1.000|4:52-I1.000|4:24-I1.000|4:36-I1.000|4:08-I1.000|4:12-I1.000|4:41-I1.000|4:53-I1.000|4:29-I1.000|4:37-I1.000|4:21-I1.000|4:34-I1.000|4:41-I0.674|2:40,,Running,,,,"Polar M430",43,0,,0,168070,250480,30378,,,,,,,,,,,,,,,,,,,,,,,,,,,,,,,,,,,,,,,,,,4,
5964020,c98bcb01-886a-4ad4-ab7a-a50683d78d86,1494767207,120,1548678410,,0,0,0.21,87,460,19,14,,,1,1.2,0.98,,,,15,,,,,,,19.79,,1,,,,,,,,,,,,,,1,73,8.67,8.75,8.42,,,,,,,,,,,,,,,,,"48,2,2,3,14,30,0,0,0",,,,,,,99,,,,,,,,,,,,,,,,,,,,,,,,,,,,,,,,,,,,,19,19,242,50,,1021,,,0,5,3,,1,0,,,,,"Aachen Laufen",,"Polar BEAT",,0,,0,168070,250480,30378,,,,,,,,,,,,,,,,,,,,,,,,,,,,,,,,,,,,,,,,,,,
5964021,74e62c4b-fe96-4297-bf4d-d9698b5db179,1370188348,120,1548678410,,0,0,1,284,344,13,16,,,1,0,0,,,,58,,,,,,,35.1,,1,,,,,,,,,,,,,,5,,12.75,16.97,17,,,,,,,,,,,,,,,,,"35,0,0,0,2,5,18,24,16",,,,,,,,,,,,,,,,,,,,,,,,,,,,,,,,,,,,,,,,,,,,17,12,341,46,,1025,5,,0,5,3,,1,0,,,,,,,"Polar BEAT",,0,,0,168070,250480,30378,,,,,,,,,,,,,,,,,,,,,,,,,,,,,,,,,,,,,,,,,,,
5964022,,1414152900,120,1548678410,,0,0,4,0,0,,,,,0,,,,,,270,,,,,,,,,1,,,,,,,,,,,,,,0,,,,,,,,,,,,,,,,,,,,,,,,,,,,,,,,,,,,,,,,,,,,,,,,,,,,,,,,,,,,,,,,,,,,,,,,,,1,,,0,0,,,,,"Lauf ABC",,"Polar BEAT",,0,,0,168070,250480,30378,,,,,,,,,,,,,,,,,,,,,,,,,,,,,,,,,,,,,,,,,,,
5964023,ba947cc5-6069-48c5-96a7-ceebef1e74ce,1434658335,120,1548678411,,0,0,3.35,1006,1006,65,64,,,1,1.7,0.64,,,413,224,,,,,,,37.29,,1,,,,,,,,,,,,,,20,81,12.44,12.17,12.9,,,,,,,,,,,,,,,,,"5,12,15,21,23,18,6,0,0",,,,,,,123,,,,,,,,,,,,,,,,,,,,,,,,,,,,,,,,,,,,,13,17,308,62,,1019,,,0,5,3,,1,0,,,,,"Aachen Laufen",,"Polar BEAT",,0,,0,168070,250480,30378,,,,,,,,,,,,,,,,,,,,,,,,,,,,,,,,,,,,,,,,,,5,
5964024,0043d49a-95b4-4803-af54-1e6ddacf0ed6,1402432561,120,1548678412,,0,0,6.75,2046,2086,0,1,,,1,0,0,,,,365,,,,,,,38.52,,1,,,,,,,,,,,,,,42,77,11.93,14.86,14.83,,,,,,,,,,,,,,,,,"47,4,2,3,2,3,4,13,21",,,,,,,129,,,,,,,,,,,,,,,,,,,,,,,,,,,,,,,,,,,,,23,6,329,68,,1020,,,0,5,3,,1,0,,,,,"3x 1000m + 8x 200m",,"Polar BEAT",,0,,0,168070,250480,30378,,,,,,,,,,,,,,,,,,,,,,,,,,,,,,,,,,,,,,,,,,,
5964025,fd4d40f9-36d4-438d-9f9a-75767c51b4a4,1444249277,120,1548678412,,0,0,1.05,342,367,17,0,,,1,0,0.23,,,,77,,,,,,,30.22,,1,,,,,,,,,,,,,,7,84,11.72,11.26,11.85,,,,,,,,,,,,,,,,,"4,17,20,39,20,0,0,0,0",,,,,,,110,,,,,,,,,,,,,,,,,,,,,,,,,,,,,,,,,,,,,12,17,223,91,,1015,,,1,4,3,,1,0,,,,,"Aachen Laufen",,"Polar BEAT",,0,,0,168070,250480,30378,,,,,,,,,,,,,,,,,,,,,,,,,,,,,,,,,,,,,,,,,,,
5964026,35074e0a-1acd-4897-9129-61ac3cac6607,1445968660,60,1548678413,,0,0,5.54,1422,1830,113,114,,,1,2,0.82,,,,359,,,,,,,46.33,,1,,,,,,,,,,,,,,29,84,14.26,15.06,15.6,,,,,,,,,,,,,,,,,"18,2,3,1,1,9,56,10,0",,,,,,,139,,,,,,,,,,,,,,,,,,,,,,,,,,,,,,,,,,,,,13,10,133,79,,1013,,,1,5,3,,1,0,,,,,"Aachen Laufen",,"Polar BEAT",,0,,0,168070,250480,30378,,,,,,,,,,,,,,,,,,,,,,,,,,,,,,,,,,,,,,,,,,,
5964027,96dae136-7725-467c-8b3e-b29d0c58916d,1418995926,60,1548678413,,0,0,2.74,800,800,32,32,,,1,0.3,0.37,,,,186,,,,,,,37.91,,1,,,,,,,,,,,,,,16,84,12.48,12.37,12.67,,,,,,,,,,,,,,,,,"0,1,5,29,59,7,0,0,0",,,,,,,122,,,,,,,,,,,,,,,,,,,,,,,,,,,,,,,,,,,,,10,16,247,96,,,0,,0,6,3,,1,0,,,,,"Balve Laufen",,"Polar BEAT",,0,,0,168070,250480,30378,,,,,,,,,,,,,,,,,,,,,,,,,,,,,,,,,,,,,,,,,,,
5964028,55af379d-1b2e-416d-9fb2-fe736a613a85,1474814739,120,1548678414,,0,0,16.22,5008,5171,327,326,,,1,3.4,0.65,,,523,1099,,,,,,,40.16,,1,,,,,,,,,,,,,,104,82,12.11,11.84,12.45,,,,,,,,,,,,,,,,,"6,8,19,29,23,14,1,0,0",,,,,,,118,,,,,,,,,,,,,,,,,,,,,,,,,,,,,,,,,,,,,25,9,217,45,,1016,3,,0,3,3,,1,0,,,,,"Aachen Laufen",,"Polar BEAT",,0,,0,168070,250480,30378,,,,,,,,,,,,,,,,,,,,,,,,,,,,,,,,,,,,,,,,,,"4,4",
5964029,f205a479-f211-452e-9c8b-786bac2c37be,1468271055,120,1548678415,,0,0,13,3405,3405,181,189,,,1,2.2,0.57,,,355,894,,,,,,,47.78,,1,,,,,,,,,,,,,,70,81,14.03,13.92,14.15,,,,,,,,,,,,,,,,,"2,2,2,2,23,54,13,3,0",,,,,,,141,,,,,,,,,,,,,,,,,,,,,,,,,,,,,,,,,,,,,20,7,236,62,,1013,0,,0,5,3,,1,0,,,,,"Aachen Laufen",,"Polar BEAT",,0,,0,168070,250480,30378,,,,,,,,,,,,,,,,,,,,,,,,,,,,,,,,,,,,,,,,,,4,
5964030,e629d694-2718-4b7c-9a5d-fcf35a1289c9,1459543015,120,1548678415,,0,0,7.32,1845,1853,151,150,,,1,1.9,0.89,,,,460,,,,,,,48.11,,1,,,,,,,,,,,,,,38,84,14.64,15.78,16.22,,,,,,,,,,,,,,,,,"18,8,9,4,4,5,6,39,7",,,,,,,142,,,,,,,,,,,,,,,,,,,,,,,,,,,,,,,,,,,,,9,3,127,67,,1020,0,,1,5,3,,1,0,,,,,"Aachen Laufen",,"Polar BEAT",,0,,0,168070,250480,30378,,,,,,,,,,,,,,,,,,,,,,,,,,,,,,,,,,,,,,,,,,,
5964031,8c750a49-0698-4afb-9f60-974af976a622,1400447911,120,1548678415,,0,0,8.68,2096,2276,106,106,,,1,1.1,0.49,,,,575,,,,,,,51.11,,1,,,,,,,,,,,,,,43,84,15.18,15.02,15.46,,,,,,,,,,,,,,,,,"0,0,1,2,10,35,43,9,0",,,,,,,148,,,,,,,,,,,,,,,,,,,,,,,,,,,,,,,,,,,,,18,2,82,61,,1010,0,,1,5,3,,1,0,,,,,TDL,,"Polar BEAT",,0,,0,168070,250480,30378,,,,,,,,,,,,,,,,,,,,,,,,,,,,,,,,,,,,,,,,,,,
5964033,9ee9826b-c07e-4248-bf0d-d65f45e9e655,1525370833,120,1548678416,,0,0,11.21,2949,2951,39,40,,,1,0,0.11,1.03,0.85,,790,161,181,,,,60.65,47.03,60.91,1,,,,,,,,,,,,,,98,81,13.73,13.93,14,8.5,,,,,,,,,,,,,,,,"3,0,1,4,21,52,18,1,0","0,15,8,77,0",,,,,,141,,,,,,,,,,,,,,,,,,,,,,,,,,,,,,,,,,,,89.6,18,15,24,49,,1014,,,0,5,3,,1,0,I10.774|46:25-I0.005|0:45-I0.194|0:49-I0.203|0:37-I0.033|0:35,,Running,,,,"Polar M430",43,0,,0,168070,250480,30378,,,,,,,,,,,,,,,,,,,,,,,,,,,,,,,,,,,,,,,,,,,
5964035,2895db64-643b-4ff0-85d9-0be8708e8031,1513445776,60,1548678416,,0,0,9.49,2560,2561,76,80,,,1,0.3,0.34,1.08,0.99,,630,153,170,,,,63.19,45.15,63.78,1,,,,,,,,,,,,,,68,82,13.46,13.46,13.57,0.1,,,,,,,,,,,,,,,,"0,1,2,9,36,46,6,0,0","0,8,74,18,0",,,,,,136,,,,,,,,,,,,,,,,,,,,,,,,,,,,,,,,,,,,49.7,3,8,277,94,,1016,0,,1,6,3,,1,0,I1.000|5:09-I1.000|4:37-I1.000|4:26-I1.000|4:40-I1.000|4:15-I1.000|4:27-I1.000|4:24-I1.000|4:10-I1.000|4:11-I0.495|2:23,,Running,,,,"Polar M430",43,0,,0,168070,250480,30378,,,,,,,,,,,,,,,,,,,,,,,,,,,,,,,,,,,,,,,,,,,
5964036,c94d5956-a0be-4137-963b-440d4a82b0b8,1530276870,120,1548678417,,0,0,16.01,4764,4765,368,366,,,1,4.5,0.71,1.12,0.98,641,1286,160,177,,,,52.57,41.88,54.07,1,,,,,,,,,,,,,,149,81,12.62,12.27,13.28,2.7,,,,,,,,,,,,,,,,"3,6,14,20,42,14,1,0,0","0,2,51,47,0",,,,,,124,,,,,,,,,,,,,,,,,,,,,,,,,,,,,,,,,,,,78.7,25,13,50,44,,,,,0,3,3,,1,0,I1.000|5:01-I1.000|5:22-I1.000|5:43-I1.000|4:42-I1.000|4:58-I1.000|5:14-I1.000|5:06-I1.000|4:48-I1.000|4:29-I1.000|4:27-I1.000|4:32-I1.000|5:11-I1.000|4:45-I1.000|5:27-I1.000|5:00-I1.000|4:38-I0.014|0:03,,Running,,,,"Polar M430",43,0,,0,168070,250480,30378,,,,,,,,,,,,,,,,,,,,,,,,,,,,,,,,,,,,,,,,,,"4,4,5",
5964037,60d1e2c4-b205-42cb-af4b-dfc3ce1a7b0f,1407105122,120,1548678418,,0,0,5,1028,1028,40,42,,,1,0.6,0.44,1.06,1,,242,168,178,,,,77.29,59.64,78.02,1,,,,,,,,,,,,,,38,88,17.63,17.57,17.72,6.3,,,,,,,,,,,,,,,,"0,0,0,0,0,0,49,51,0","0,3,10,87,0",,,,,,166,,,,,,,,,,,,,,,,,,,,,,,,,,,,,,,,,,,,81.4,17,2,195,95,,1014,0,,1,6,3,,1,0,,,,,TDL,,"Polar BEAT",,0,,0,168070,250480,30378,,,,,,,,,,,,,,,,,,,,,,,,,,,,,,,,,,,,,,,,,,,
5964038,c2fc29d1-8bd9-4d76-8c0c-82253e96a1f5,1422989291,60,1548678419,,0,0,16.87,4488,6096,187,190,,,1,1.5,0.47,1.07,0.86,,801,151,183,,,,65.45,47.88,66.33,1,,,,,,,,,,,,,,121,,13.59,14.23,14.68,5.7,,,,,,,,,,,,,,,,"5,5,9,16,18,17,13,15,1","0,38,28,28,5",,,,,,,,,,,,,,,,,,,,,,,,,,,,,,,,,,,,,,,,,,80.5,1,2,307,94,,1007,0,,1,5,3,,1,0,,,,,"4x Sprint Runden",,"Polar BEAT",,0,,0,168070,250480,30378,,,,,,,,,,,,,,,,,,,,,,,,,,,,,,,,,,,,,,,,,,,
5964039,5875d02f-022f-4260-b765-6539458147bd,1348066471,120,1548678420,,0,0,8.45,2571,2588,133,133,,,1,1.9,0.71,1.33,1.13,361,585,149,210,,,,56.45,38.9,57.55,1,,,,,,,,,,,,,,64,,12.08,12.87,13.41,18.1,,,,,,,,,,,,,,,,"13,4,9,14,25,24,6,6,0","4,12,77,6,2",,,,,,,,,,,,,,,,,,,,,,,,,,,,,,,,,,,,,,,,,,40,12,14,269,68,,1020,3,,0,5,3,,1,0,,,,,,,"Polar BEAT",,0,,0,168070,250480,30378,,,,,,,,,,,,,,,,,,,,,,,,,,,,,,,,,,,,,,,,,,5,
5964040,b10c6895-75ed-4d6d-96ce-1ed4735d2d54,1364918325,120,1548678421,,0,0,5.93,1821,1901,102,118,,,1,1.7,0.58,,,454,415,,,,,,,37.64,,1,,,,,,,,,,,,,,37,,12.05,12.3,12.79,,,,,,,,,,,,,,,,,"12,7,12,16,27,14,9,1,0",,,,,,,,,,,,,,,,,,,,,,,,,,,,,,,,,,,,,,,,,,,,5,23,72,44,,,,,0,3,3,,1,0,,,,,,,"Polar BEAT",,0,,0,168070,250480,30378,,,,,,,,,,,,,,,,,,,,,,,,,,,,,,,,,,,,,,,,,,5,
5964041,2590a9a9-e937-4d4e-9080-6619963351a3,1452020558,60,1548678421,,0,0,15.59,4797,5419,162,154,,,1,0.9,0.47,,,,1058,,,,,,,40.19,,1,,,,,,,,,,,,,,99,78,11.86,13.54,13.75,,,,,,,,,,,,,,,,,"22,4,4,8,19,13,19,11,0",,,,,,,125,,,,,,,,,,,,,,,,,,,,,,,,,,,,,,,,,,,,,6,11,164,88,,994,,,1,4,3,,1,0,,,,,"Aachen Laufen",,"Polar BEAT",,0,,0,168070,250480,30378,,,,,,,,,,,,,,,,,,,,,,,,,,,,,,,,,,,,,,,,,,,
5964042,,1433422644,120,1548678421,,0,0,5,0,0,,,,,0,,,,,,331,,,,,,,,,1,,,,,,,,,,,,,,0,,,,,,,,,,,,,,,,,,,,,,,,,,,,,,,,,,,,,,,,,,,,,,,,,,,,,,,,,,,,,,,,,,,,,,,,,,1,,,0,0,,,,,Laufen,,"Polar BEAT",,0,,0,168070,250480,30378,,,,,,,,,,,,,,,,,,,,,,,,,,,,,,,,,,,,,,,,,,,
5964043,59269d88-e7f3-4b62-8dd9-a3c0a69df68b,1542227326,60,1548678422,,0,0,14.01,3858,3858,41,40,,,1,0,0.04,1.07,0.92,,961,151,166,,,,62.71,45.34,62.95,1,,,,,,,,,,,,,,98,81,13.1,13.12,13.18,6.1,,,,,,,,,,,,,,,,"0,0,1,10,49,39,1,0,0","0,17,72,11,0",,,,,,134,,,,,,,,,,,,,,,,,,,,,,,,,,,,,,,,,,,,51.5,6,8,194,100,,1028,0,256,1,9,3,,1,0,I1.000|4:38-I1.000|4:55-I1.000|4:45-I1.000|4:27-I1.000|4:27-I1.000|4:32-I1.000|4:30-I1.000|4:30-I1.000|4:32-I1.000|4:31-I1.000|4:28-I1.000|4:24-I1.000|4:44-I1.000|4:55-I0.013|0:02,,Running,,,,"Polar M430",43,0,,0,168070,250480,30378,,,,,,,,,,,,,,,,,,,,,,,,,,,,,,,,,,,,,,,,,,,
5964044,,1404849654,120,1548678422,,0,0,3,0,0,,,,,0,,,,,,,,,,,,,,,1,,,,,,,,,,,,,,0,,,,,,,,,,,,,,,,,,,,,,,,,,,,,,,,,,,,,,,,,,,,,,,,,,,,,,,,,,,,,,,,,,,,,,,,,,1,,,0,0,,,,,Einlaufen,,"Polar BEAT",,0,,0,168070,250480,30378,,,,,,,,,,,,,,,,,,,,,,,,,,,,,,,,,,,,,,,,,,,
5964045,88302be5-3cfb-4cf0-8b32-8e043cf74a81,1460408225,120,1548678423,,0,0,12.16,3271,3272,129,138,,,1,1.1,0.44,,,705,837,,,,,,,46.09,,1,,,,,,,,,,,,,,67,81,13.59,14.15,14.44,,,,,,,,,,,,,,,,,"7,1,1,5,10,57,17,4,0",,,,,,,138,,,,,,,,,,,,,,,,,,,,,,,,,,,,,,,,,,,,,16,10,182,48,,1010,0,,1,5,3,,1,0,,,,,"Aachen Laufen",,"Polar BEAT",,0,,0,168070,250480,30378,,,,,,,,,,,,,,,,,,,,,,,,,,,,,,,,,,,,,,,,,,5,
5964046,5f34d779-58ff-453a-aec3-3ef999d5b682,1412970775,120,1548678423,,0,0,2.26,622,622,20,43,,,1,0.7,0.54,,,,149,,,,,,,39.83,,1,,,,,,,,,,,,,,12,84,12.97,13.21,13.12,,,,,,,,,,,,,,,,,"0,0,5,23,20,52,1,0,0",,,,,,,130,,,,,,,,,,,,,,,,,,,,,,,,,,,,,,,,,,,,,13,1,160,88,,1016,0,,1,5,3,,1,0,,,,,Auslaufen,,"Polar BEAT",,0,,0,168070,250480,30378,,,,,,,,,,,,,,,,,,,,,,,,,,,,,,,,,,,,,,,,,,,
5964047,0e3571af-e460-43bf-b88d-64b5b5feb1ba,1423766967,60,1548678424,,0,0,14.4,4289,6410,202,205,,,1,1.5,0.37,,,467,933,,,,,,,41.48,,1,,,,,,,,,,,,,,89,83,12.3,13.11,13.41,,,,,,,,,,,,,,,,,"18,4,7,16,25,16,4,7,3",,,,,,,121,,,,,,,,,,,,,,,,,,,,,,,,,,,,,,,,,,,,,3,6,142,82,,1021,,,1,3,3,,1,0,,,,,"5x (500,200)",,"Polar BEAT",,0,,0,168070,250480,30378,,,,,,,,,,,,,,,,,,,,,,,,,,,,,,,,,,,,,,,,,,4,
5964048,35058801-6169-46f6-88e4-8a1180a81530,1533665440,120,1548678424,,0,0,11.05,2975,2975,45,44,,,1,0,0.13,1.16,0.94,,616,134,157,,,,75.18,45.73,75.57,1,,,,,,,,,,,,,,51,82,13.42,13.59,13.7,26.6,,,,,,,,,,,,,,,,"0,0,3,15,38,29,13,2,0","1,57,42,0,0",,,,,,136,,,,,,,,,,,,,,,,,,,,,,,,,,,,,,,,,,,,30.9,33,11,161,33,,1009,,,0,5,3,,1,0,I1.000|4:31-I1.000|4:28-I1.000|3:41-I1.000|3:52-I1.000|4:22-I1.000|4:25-I1.000|4:33-I1.000|4:40-I1.000|4:52-I1.000|5:14-I1.000|4:43-I0.051|0:15,,Running,,,,"Polar M430",43,0,,0,168070,250480,30378,,,,,,,,,,,,,,,,,,,,,,,,,,,,,,,,,,,,,,,,,,,
5964049,facf7466-304a-4687-a19b-e575ce22dd81,1516440146,60,1548678424,,0,0,1.19,384,384,5,8,,,1,0.7,0.49,2.29,0.37,,78,136,150,,,,,,,1,,,,,,,,,,,,,,6,,,11.2,,5.4,,44,41,,1,58,56,,,,,,,,,"100,0,0,0,0,0,0","6,51,43,0,0","96,0,0,0,4",,,,,,,,,,,,,,,,,,,,,,,,,,,,,,,,,,,,,,,,,12.3,3,21,190,86,,1011,,,0,6,1,,1,0,,,Cycling,,,,"Polar M430",43,0,,0,168072,,30378,,,,,,,,,,,,,,,,,,,,,,,,,,,,,,,,,,,,,,,,,,,
5964050,137fdf3f-c5cb-4154-92e2-91977a563df2,1443118046,120,1548678424,,0,0,2.49,739,827,0,4,,,1,0,0,,,,171,,,,,,,36.88,,1,,,,,,,,,,,,,,15,82,12.08,12.3,12.27,,,,,,,,,,,,,,,,,"4,4,5,29,40,18,0,0,0",,,,,,,123,,,,,,,,,,,,,,,,,,,,,,,,,,,,,,,,,,,,,16,13,208,72,,1015,,,0,4,3,,1,0,,,,,"Münster Laufen",,"Polar BEAT",,0,,0,168070,250480,30378,,,,,,,,,,,,,,,,,,,,,,,,,,,,,,,,,,,,,,,,,,,
5964051,2e0862d5-5240-403c-b2c6-8e81640aff43,1444254016,120,1548678426,,0,0,1,328,328,0,17,,,1,0.4,0.4,,,,68,,,,,,,29.82,,1,,,,,,,,,,,,,,6,84,10.61,11.12,10.7,,,,,,,,,,,,,,,,,"0,9,39,44,8,0,0,0,0",,,,,,,109,,,,,,,,,,,,,,,,,,,,,,,,,,,,,,,,,,,,,12,16,227,91,,1016,,,1,4,3,,1,0,,,,,"Aachen Laufen",,"Polar BEAT",,0,,0,168070,250480,30378,,,,,,,,,,,,,,,,,,,,,,,,,,,,,,,,,,,,,,,,,,,
5964052,006a9840-ab9d-4952-ad02-a9c97c7c0e9e,1468182617,120,1548678426,,0,0,1.34,389,394,17,33,,,1,0.1,0.31,,,,81,,,,,,,35.4,,1,,,,,,,,,,,,,,8,80,12.16,15.46,14.96,,,,,,,,,,,,,,,,,"29,19,13,1,6,19,3,2,10",,,,,,,129,,,,,,,,,,,,,,,,,,,,,,,,,,,,,,,,,,,,,27,6,235,53,,1009,0,,0,5,3,,1,0,,,,,"Aachen Laufen",,"Polar BEAT",,0,,0,168070,250480,30378,,,,,,,,,,,,,,,,,,,,,,,,,,,,,,,,,,,,,,,,,,,
5964053,24976548-d0be-4f4c-983c-ccf50d96dfb6,1524163567,120,1548678426,,0,0,7.68,2158,2161,1,0,,,1,0,0,,,,583,165,185,,,,53.94,42.46,53.96,1,,,,,,,,,,,,,,77,82,12.84,13.66,13.69,5.6,,,,,,,,,,,,,,,,"14,5,8,9,10,27,18,9,0","0,7,16,74,2",,,,,,130,,,,,,,,,,,,,,,,,,,,,,,,,,,,,,,,,,,,76.9,27,9,70,28,,1025,,,0,5,3,,1,0,I0.400|1:30-I0.218|1:14-I0.403|1:40-I0.215|1:10-I0.409|1:41-I0.215|1:14-I0.409|1:41-I0.216|1:11-I0.404|1:41-I0.203|1:14-I0.410|1:39-I0.213|1:13-I0.412|1:39-I0.207|1:13-I0.409|1:36-I0.210|1:14-I0.413|1:36-I0.198|1:17-I0.437|1:28-I0.562|3:48-I0.429|1:24-I0.210|0:56-I0.423|1:24-I0.043|1:19,,Running,,,,"Polar M430",43,0,,0,168070,250480,30378,,,,,,,,,,,,,,,,,,,,,,,,,,,,,,,,,,,,,,,,,,,
5964054,0810eedf-5a98-4a87-955d-8189cfbacbd5,1500046475,120,1548678426,,0,0,0.92,293,301,4,16,,,1,0.8,0.56,,,,63,,,,,,,30.55,,1,,,,,,,,,,,,,,6,78,11,11.49,11.04,,,,,,,,,,,,,,,,,"2,17,18,38,19,6,0,0,0",,,,,,,121,,,,,,,,,,,,,,,,,,,,,,,,,,,,,,,,,,,,,31,37,322,31,,1014,8,,0,3,3,,1,0,,,,,"Aix-en-Provence Laufen",,"Polar BEAT",,0,,0,168070,250480,30378,,,,,,,,,,,,,,,,,,,,,,,,,,,,,,,,,,,,,,,,,,,
5964055,5bac5ca1-5185-49c5-b3ea-5013c246ab3b,1366828403,120,1548678427,,0,0,3.14,995,1246,65,67,,,1,1.7,0.74,,,,184,,,,,,,34.84,,1,,,,,,,,,,,,,,20,,11.67,14.75,14.98,,,,,,,,,,,,,,,,,"47,3,2,3,3,4,5,19,15",,,,,,,,,,,,,,,,,,,,,,,,,,,,,,,,,,,,,,,,,,,,21,10,266,46,,1024,1,,0,3,3,,1,0,,,,,,,"Polar BEAT",,0,,0,168070,250480,30378,,,,,,,,,,,,,,,,,,,,,,,,,,,,,,,,,,,,,,,,,,,
5964056,8105c9cc-572e-4f62-b886-2c2443eac4b3,1443518300,120,1548678427,,0,0,5.16,1668,1706,13,12,,,1,0,0,,,,348,,,,,,,35.12,,1,,,,,,,,,,,,,,34,84,11.15,11.23,11.28,,,,,,,,,,,,,,,,,"8,10,19,43,17,2,0,0,0",,,,,,,110,,,,,,,,,,,,,,,,,,,,,,,,,,,,,,,,,,,,,10,9,61,82,,1038,,,0,3,3,,1,0,,,,,"Münster Laufen",,"Polar BEAT",,0,,0,168070,250480,30378,,,,,,,,,,,,,,,,,,,,,,,,,,,,,,,,,,,,,,,,,,,
5964057,9a97aba9-88e4-40b4-a5d9-64e05f691c7a,1435954928,120,1548678428,,0,0,5.39,1177,1177,101,105,,,1,1.8,0.47,,,361,364,,,,,,,55.89,,1,,,,,,,,,,,,,,24,87,16.79,16.55,17.19,,,,,,,,,,,,,,,,,"0,0,0,0,4,7,56,33,0",,,,,,,158,,,,,,,,,,,,,,,,,,,,,,,,,,,,,,,,,,,,,29,11,50,54,,1021,,,0,3,3,,1,0,,,,,"Aachen Laufen",,"Polar BEAT",,0,,0,168070,250480,30378,,,,,,,,,,,,,,,,,,,,,,,,,,,,,,,,,,,,,,,,,,4,
5964058,cf2406c1-7e79-4909-a795-be02440235ea,1533113476,120,1548678428,,0,0,10.64,1377,1392,36,44,,,1,0,0.13,,,,272,136,174,,,,,,,1,,,,,,,,,,,,,,27,,,29.61,,17.4,-1.1,166,143,,1,199,178,,,,,,,,,"7,8,8,19,53,4,0","12,33,39,17,0","42,45,2,0,11",,,,,,,,,,,,,,,,,,,,,,,,,,,,,,,,,,,,,,,,,46.2,25,11,18,60,,1019,,,0,5,3,,1,0,,,Cycling,,,,"Polar M430",43,0,,0,168072,,30378,,,,,,,,,,,,,,,,,,,,,,,,,,,,,,,,,,,,,,,,,,,
5964059,e441c553-b436-400f-8d0f-07e08272cd12,1432389722,120,1548678428,,0,0,10.21,2298,2298,165,165,,,1,2.1,0.46,,,441,682,,,,,,,56.07,,1,,,,,,,,,,,,,,47,87,16.43,16.19,16.66,,,,,,,,,,,,,,,,,"0,0,1,2,5,15,56,19,2",,,,,,,153,,,,,,,,,,,,,,,,,,,,,,,,,,,,,,,,,,,,,19,3,332,56,,,,,0,3,3,,1,0,,,,,"Balve Laufen",,"Polar BEAT",,0,,0,168070,250480,30378,,,,,,,,,,,,,,,,,,,,,,,,,,,,,,,,,,,,,,,,,,"4,5",
5964060,57d1a15d-150c-4a81-bf48-2b2c4266e32e,1404501158,120,1548678429,,0,0,3.05,1243,1255,53,72,,,1,1.4,0.66,,,,198,,,,,,,25.75,,1,,,,,,,,,,,,,,25,76,8.94,10.09,10.48,,,,,,,,,,,,,,,,,"30,16,33,12,2,4,2,0,0",,,,,,,97,,,,,,,,,,,,,,,,,,,,,,,,,,,,,,,,,,,,,25,2,168,51,,1008,1,,0,5,3,,1,0,,,,,Auslaufen,,"Polar BEAT",,0,,0,168070,250480,30378,,,,,,,,,,,,,,,,,,,,,,,,,,,,,,,,,,,,,,,,,,,
5964061,42004d3a-d43c-4853-90b6-b11c39f65cc1,1504551740,120,1548678429,,0,0,11.35,3291,3292,137,144,,,1,1.9,0.5,1.06,0.98,295,724,144,165,,,,62.66,42.02,63.55,1,,,,,,,,,,,,,,71,80,12.63,12.55,12.79,-4.5,,,,,,,,,,,,,,,,"3,1,4,20,52,20,0,0,0","0,27,72,1,0",,,,,,129,,,,,,,,,,,,,,,,,,,,,,,,,,,,,,,,,,,,30.2,16,8,189,80,,1018,0,,0,5,3,,1,0,I1.000|4:58-I1.000|4:39-I1.000|4:52-I1.000|5:03-I1.000|5:23-I1.000|4:34-I1.000|4:35-I1.000|4:33-I1.000|4:56-I1.000|4:58-I1.000|4:30-I0.353|1:51,,Running,,,,"Polar M430",43,0,,0,168070,250480,30378,,,,,,,,,,,,,,,,,,,,,,,,,,,,,,,,,,,,,,,,,,4,
5964062,523efbb4-ba82-4b5c-981e-a6e02fffb32a,1515600380,60,1548678430,,0,0,10.02,2812,2815,134,144,,,1,1.3,0.52,1.06,0.98,272,691,153,175,,,,60.17,43.27,61.09,1,,,,,,,,,,,,,,77,82,13.1,12.9,13.32,9.4,,,,,,,,,,,,,,,,"1,1,5,13,40,39,1,0,0","0,24,33,43,0",,,,,,130,,,,,,,,,,,,,,,,,,,,,,,,,,,,,,,,,,,,70.8,8,6,191,79,,1009,0,,0,5,3,,1,0,I1.000|5:10-I1.000|4:56-I1.000|4:33-I1.000|4:25-I1.000|4:37-I1.000|4:31-I1.000|4:53-I1.000|4:39-I1.000|4:30-I1.000|4:41-I0.020|0:03,,Running,,,,"Polar M430",43,0,,0,168070,250480,30378,,,,,,,,,,,,,,,,,,,,,,,,,,,,,,,,,,,,,,,,,,"5,5",
5964063,781a3018-3fbf-4c5b-b1fa-f56b0e72f38b,1532462516,120,1548678430,,0,0,15.44,4337,4340,57,60,,,1,0,0.1,1.08,0.93,,890,148,163,,,,62.87,44.65,63.14,1,,,,,,,,,,,,,,41,81,12.85,12.91,12.98,,,,,,,,,,,,,,,,,"0,0,4,16,49,28,2,0,0","0,3,97,0,0",,,,,,132,,,,,,,,,,,,,,,,,,,,,,,,,,,,,,,,,,,,35.7,29,7,8,41,,1012,,,0,3,3,,1,0,I1.000|4:56-I1.000|4:45-I1.000|4:41-I1.000|4:43-I1.000|4:31-I1.000|4:32-I1.000|4:27-I1.000|4:35-I1.000|4:34-I1.000|4:38-I1.000|4:44-I1.000|4:50-I1.000|4:49-I1.000|4:07-I1.000|5:16-I0.442|2:14,,Running,,,,"Polar M430",43,0,,0,168070,250480,30378,,,,,,,,,,,,,,,,,,,,,,,,,,,,,,,,,,,,,,,,,,,
5964064,b2b8a16c-bae1-4207-ba49-f7c41c9250c3,1525711051,120,1548678431,,0,0,4.31,1320,1327,1,0,,,1,0,0,,,,283,142,183,,,,59.63,37.05,59.66,1,,,,,,,,,,,,,,27,81,11.78,14.45,14.49,44.7,,,,,,,,,,,,,,,,"38,1,1,1,1,3,40,16,1","0,53,37,9,1",,,,,,121,,,,,,,,,,,,,,,,,,,,,,,,,,,,,,,,,,,,39.3,26,8,57,33,,1014,,,0,5,3,,1,0,I1.023|3:44-I1.040|3:46-I1.033|3:46-I0.497|7:37-I0.319|0:58-I0.107|0:48-I0.197|0:37-I0.087|0:52,,Running,,,,"Polar M430",43,0,,0,168070,250480,30378,,,,,,,,,,,,,,,,,,,,,,,,,,,,,,,,,,,,,,,,,,,
5964065,0e5f7dca-32eb-457f-a8f6-1a70b27d5267,1457641260,60,1548678431,,0,0,2.53,850,850,22,24,,,1,0.4,0.4,,,,178,,,,,,,31.99,,1,,,,,,,,,,,,,,17,83,10.8,10.86,11.04,,,,,,,,,,,,,,,,,"6,19,28,36,11,0,0,0,0",,,,,,,108,,,,,,,,,,,,,,,,,,,,,,,,,,,,,,,,,,,,,3,9,44,75,,1023,,,1,5,3,,1,0,,,,,"Aachen Laufen",,"Polar BEAT",,0,,0,168070,250480,30378,,,,,,,,,,,,,,,,,,,,,,,,,,,,,,,,,,,,,,,,,,,
5964066,7d427ee1-6274-42ee-b050-ae6d7c127d5c,1483560156,60,1548678431,,0,0,0.7,212,212,5,16,,,1,0.1,0.29,,,,47,,,,,,,31.44,,1,,,,,,,,,,,,,,4,82,11.6,12.02,11.75,,,,,,,,,,,,,,,,,"1,10,15,14,43,17,0,0,0",,,,,,,121,,,,,,,,,,,,,,,,,,,,,,,,,,,,,,,,,,,,,2,9,308,92,,1020,0,,1,6,3,,1,0,,,,,"Aachen Laufen",,"Polar BEAT",,0,,0,168070,250480,30378,,,,,,,,,,,,,,,,,,,,,,,,,,,,,,,,,,,,,,,,,,,
5964067,581eb4fa-482e-4109-9f86-0dd9da0bfeac,1349013241,120,1548678432,,0,0,17.34,2092,2460,97,98,,,1,0,0.18,2.31,0.47,,641,136,157,,,,,,,1,,,,,,,,,,,,,,38,,,30.97,,9.5,-20.2,220,187,,1,259,226,,,,,,,,,"3,4,8,29,39,15,2","1,42,57,0,0","46,14,26,4,10",,,,,,,,,,,,,,,,,,,,,,,,,,,,,,,,,,,,,,,,,26.1,14,8,62,74,,1022,3,,0,5,3,,1,0,,,,,,,"Polar BEAT",,0,,0,168072,,30378,,,,,,,,,,,,,,,,,,,,,,,,,,,,,,,,,,,,,,,,,,,
5964068,5cf2adbb-f95f-42f8-ac1e-dbfa1bcc6260,1435494822,120,1548678433,,0,0,21.09,5984,5997,263,270,,,1,1.9,0.47,,,304,1437,,,,,,,45.24,,1,,,,,,,,,,,,,,124,82,12.96,13.24,13.53,,,,,,,,,,,,,,,,,"6,1,2,10,33,42,7,0,0",,,,,,,129,,,,,,,,,,,,,,,,,,,,,,,,,,,,,,,,,,,,,21,9,179,48,,1021,,,0,5,3,,1,0,,,,,"Aachen Laufen",,"Polar BEAT",,0,,0,168070,250480,30378,,,,,,,,,,,,,,,,,,,,,,,,,,,,,,,,,,,,,,,,,,5,
5964069,34420cca-8bdc-4a29-9f80-58b09884d179,1447960362,60,1548678433,,0,0,3.2,947,947,31,41,,,1,0.6,0.44,,,,230,,,,,,,37.8,,1,,,,,,,,,,,,,,19,81,12.25,12.54,12.48,,,,,,,,,,,,,,,,,"7,5,5,26,26,24,6,0,0",,,,,,,125,,,,,,,,,,,,,,,,,,,,,,,,,,,,,,,,,,,,,8,9,269,97,,1010,,,1,6,3,,1,0,,,,,"Aachen Laufen",,"Polar BEAT",,0,,0,168070,250480,30378,,,,,,,,,,,,,,,,,,,,,,,,,,,,,,,,,,,,,,,,,,,
5964070,579a8547-69bc-4be8-af28-4579ae826157,1534871611,120,1548678433,,0,0,8.48,1254,1254,34,36,,,1,0,0.12,,,,216,123,144,,,,,,,1,,,,,,,,,,,,,,15,,,25.07,,9.8,-14.7,125,108,,1,140,128,,,,,,,,,"5,3,22,70,0,0,0","1,99,1,0,0","85,4,0,0,10",,,,,,,,,,,,,,,,,,,,,,,,,,,,,,,,,,,,,,,,,9.9,30,8,49,33,,1018,,,0,3,3,,1,0,,,Cycling,,,,"Polar M430",43,0,,0,168072,,30378,,,,,,,,,,,,,,,,,,,,,,,,,,,,,,,,,,,,,,,,,,,
5964071,20ca5e54-26b5-428a-9dca-9d38c3c58b27,1461320650,120,1548678434,,0,0,1.11,375,375,17,12,,,1,1.1,0.64,,,,76,,,,,,,29.17,,1,,,,,,,,,,,,,,7,83,10.99,10.66,11.25,,,,,,,,,,,,,,,,,"7,25,19,45,4,0,0,0,0",,,,,,,107,,,,,,,,,,,,,,,,,,,,,,,,,,,,,,,,,,,,,10,9,52,69,,1020,3,,0,5,3,,1,0,,,,,"Aachen Laufen",,"Polar BEAT",,0,,0,168070,250480,30378,,,,,,,,,,,,,,,,,,,,,,,,,,,,,,,,,,,,,,,,,,,
5964072,b5bb8551-7023-4a11-be27-2a70144c616c,1496092450,120,1548678434,,0,0,9.82,3032,3247,121,116,,,1,1.4,0.49,,,175,674,,,,,,,38.63,,1,,,,,,,,,,,,,,62,77,11.8,12.53,12.6,,,,,,,,,,,,,,,,,"12,2,5,18,35,26,2,0,1",,,,,,,126,,,,,,,,,,,,,,,,,,,,,,,,,,,,,,,,,,,,,23,7,309,74,,1012,,,1,5,3,,1,0,,,,,"Aachen Laufen",,"Polar BEAT",,0,,0,168070,250480,30378,,,,,,,,,,,,,,,,,,,,,,,,,,,,,,,,,,,,,,,,,,5,
5964073,,1413931980,120,1548678434,,0,0,5,0,0,,,,,0,,,,,,343,,,,,,,,,1,,,,,,,,,,,,,,0,,,,,,,,,,,,,,,,,,,,,,,,,,,,,,,,,,,,,,,,,,,,,,,,,,,,,,,,,,,,,,,,,,,,,,,,,,1,,,0,0,,,,,"Einlaufen + Lauf ABC",,"Polar BEAT",,0,,0,168070,250480,30378,,,,,,,,,,,,,,,,,,,,,,,,,,,,,,,,,,,,,,,,,,,
5964074,,1461786300,120,1548678434,,0,0,19,0,0,,,,,0,,,,,,1194,,,,,,,,,1,,,,,,,,,,,,,,0,,,,,,,,,,,,,,,,,,,,,,,,,,,,,,,,,,,,,,,,,,,,,,,,,,,,,,,,,,,,,,,,,,,,,,,,,,1,,,0,0,,,,,"DL - 5x Finnbahn + Orsbach kurz",,"Polar BEAT",,0,,0,168070,250480,30378,,,,,,,,,,,,,,,,,,,,,,,,,,,,,,,,,,,,,,,,,,,
5964075,6e91bd3c-be43-4085-ae88-95cd323e87bf,1529142300,120,1548678434,,0,0,9.9,2209,2209,41,42,,,1,0,0.06,1.06,0.89,,713,178,186,,,,63.8,56.53,64.12,1,,,,,,,,,,,,,,105,85,16.16,16.17,16.24,7.2,,,,,,,,,,,,,,,,"0,0,0,0,0,12,71,16,1","0,2,4,32,62",,,,,,158,,,,,,,,,,,,,,,,,,,,,,,,,,,,,,,,,,,,135.9,19,5,356,72,,,,,0,3,3,,1,0,I4.931|18:13-I4.974|18:37,,Running,,,,"Polar M430",43,0,,0,168070,250480,30378,,,,,,,,,,,,,,,,,,,,,,,,,,,,,,,,,,,,,,,,,,,
5964076,456de041-4813-48c4-83a3-7e42640b45bc,1477427638,120,1548678437,,0,0,3.72,925,999,34,33,,,1,0.6,0.43,,,,245,,,,,,,46.8,,1,,,,,,,,,,,,,,19,83,14.63,15.49,15.6,,,,,,,,,,,,,,,,,"10,0,0,0,4,21,50,13,0",,,,,,,145,,,,,,,,,,,,,,,,,,,,,,,,,,,,,,,,,,,,,8,1,44,97,,1026,0,,1,5,3,,1,0,,,,,"Aachen Laufen",,"Polar BEAT",,0,,0,168070,250480,30378,,,,,,,,,,,,,,,,,,,,,,,,,,,,,,,,,,,,,,,,,,,
5964077,93b09983-3110-4995-8123-80bc662eb8d2,1522586978,120,1548678437,,0,0,7.78,2427,2428,148,144,,,1,2,0.64,1.07,0.94,303,588,152,174,,,,53.28,37.57,54.57,1,,,,,,,,,,,,,,65,82,12.06,11.73,12.39,13.7,,,,,,,,,,,,,,,,"7,8,12,35,31,7,0,0,0","1,19,45,35,0",,,,,,117,,,,,,,,,,,,,,,,,,,,,,,,,,,,,,,,,,,,55.1,3,1,19,97,,,3,,0,4,3,,1,0,I1.000|4:58-I1.000|5:10-I1.000|5:15-I1.000|5:06-I1.000|5:22-I1.000|4:44-I1.000|5:58-I0.784|3:57,,Running,,,,"Polar M430",43,0,,0,168070,250480,30378,,,,,,,,,,,,,,,,,,,,,,,,,,,,,,,,,,,,,,,,,,"4,5",
5964078,e14f7ff3-f5f5-47e1-a493-8d899c5e5163,1453230080,60,1548678438,,0,0,5.03,1466,1734,63,82,,,1,0.9,0.6,,,,356,,,,,,,39.66,,1,,,,,,,,,,,,,,30,80,12.44,12.5,12.78,,,,,,,,,,,,,,,,,"3,4,9,16,45,21,2,0,0",,,,,,,129,,,,,,,,,,,,,,,,,,,,,,,,,,,,,,,,,,,,,-4,4,203,81,,1018,,,1,5,3,,1,0,,,,,"Aachen Laufen",,"Polar BEAT",,0,,0,168070,250480,30378,,,,,,,,,,,,,,,,,,,,,,,,,,,,,,,,,,,,,,,,,,,
5964079,e580d03b-8941-4167-a3ff-7c90ca0b21bd,1510855852,60,1548678438,,0,0,11.85,2955,2957,36,36,,,1,0,0.1,,0.91,,832,166,183,,,,61.95,50.25,62.18,1,,,,,,,,,,,,,,108,83,14.48,14.65,14.7,4.9,,,,,,,,,,,,,,,,"0,1,2,6,12,36,42,1,0","1,2,36,53,8",,,,,,145,,,,,,,,,,,,,,,,,,,,,,,,,,,,,,,,,,,,113.8,3,2,191,86,,1026,,,1,5,3,,1,0,I1.000|5:00-I1.000|4:24-I1.000|4:24-I1.000|4:10-I1.000|3:55-I1.000|3:50-I1.000|3:58-I1.000|3:59-I1.000|3:51-I1.000|3:43-I1.000|3:54-I0.855|4:11,,Running,,,,"Polar M430",43,0,,0,168070,250480,30378,,,,,,,,,,,,,,,,,,,,,,,,,,,,,,,,,,,,,,,,,,,
5964081,2866cc19-1e9d-450b-8c5d-6d161a959767,1345131067,120,1548678439,,0,0,28.35,3747,3814,653,651,,,1,4.1,0.62,,,915,982,,,,,,,,,1,,,,,,,,,,,,,,41,,,30.44,,,,386,265,,1,515,377,,,,,,,,,"9,10,18,23,20,9,10",,"54,7,11,4,24",,,,,,,,,,,,,,,,,,,,,,,,,,,,,,,,,,,,,,,,,,24,11,240,49,,1019,4,,0,5,3,,1,0,,,,,,,"Polar BEAT",,0,,0,168072,,30378,,,,,,,,,,,,,,,,,,,,,,,,,,,,,,,,,,,,,,,,,,"4,4,4,5,5,5",
5964082,74861ad0-1471-4080-a2c0-789ef3e9acab,1410810259,120,1548678440,,0,0,6.19,2200,2232,103,85,,,1,1.7,0.51,1.42,1.43,292,323,145,210,,,,48.31,31.71,49.47,1,,,,,,,,,,,,,,49,75,10.44,11.96,12.49,-44.6,,,,,,,,,,,,,,,,"21,2,8,24,33,11,2,0,1","0,36,61,1,2",,,,,,113,,,,,,,,,,,,,,,,,,,,,,,,,,,,,,,,,,,,56.8,19,2,86,80,,1015,0,,1,3,3,,1,0,,,,,Einlaufen,,"Polar BEAT",,0,,0,168070,250480,30378,,,,,,,,,,,,,,,,,,,,,,,,,,,,,,,,,,,,,,,,,,4,
5964083,2cbeb634-8580-4b0c-91b9-f590bebd1d83,1426934676,60,1548678440,,0,0,8.49,2421,2425,86,84,,,1,1.1,0.43,,,,579,,,,,,,42,,1,,,,,,,,,,,,,,50,83,12.78,12.72,12.95,,,,,,,,,,,,,,,,,"0,2,5,18,49,26,0,0,0",,,,,,,127,,,,,,,,,,,,,,,,,,,,,,,,,,,,,,,,,,,,,5,7,277,90,,1019,2,,0,5,3,,1,0,,,,,"Aachen Laufen",,"Polar BEAT",,0,,0,168070,250480,30378,,,,,,,,,,,,,,,,,,,,,,,,,,,,,,,,,,,,,,,,,,,
5964084,f2e57550-2543-43d8-90ef-5fbf91c4bbb7,1534954433,120,1548678441,,0,0,10.03,2654,2655,44,37,,,1,0,0.21,1.13,0.9,,674,152,173,,,,65.3,46.35,65.71,1,,,,,,,,,,,,,,71,82,13.68,13.64,13.77,15.7,,,,,,,,,,,,,,,,"0,0,0,2,29,67,2,0,0","0,22,43,36,0",,,,,,138,,,,,,,,,,,,,,,,,,,,,,,,,,,,,,,,,,,,53.2,33,7,264,28,,,,,0,3,3,,1,0,I1.000|4:32-I1.000|4:19-I1.000|4:22-I1.000|4:17-I1.000|4:14-I1.000|4:23-I1.000|4:30-I1.000|4:29-I1.000|4:30-I1.000|4:31-I0.036|0:10,,Running,,,,"Polar M430",43,0,,0,168070,250480,30378,,,,,,,,,,,,,,,,,,,,,,,,,,,,,,,,,,,,,,,,,,,
5964085,d0967781-cf94-42af-93ed-6e05e5015c0a,1413492062,120,1548678441,,0,0,7.78,2126,2147,0,4,,,1,0,0.04,,,,451,,,,,,,43.91,,1,,,,,,,,,,,,,,44,83,13.21,15.36,15.38,,,,,,,,,,,,,,,,,"33,3,2,3,5,5,7,31,11",,,,,,,132,,,,,,,,,,,,,,,,,,,,,,,,,,,,,,,,,,,,,13,6,205,88,,1008,0,,1,5,3,,1,0,,,,,"2x (500 300 500 300 500 3009 + 500 300 200",,"Polar BEAT",,0,,0,168070,250480,30378,,,,,,,,,,,,,,,,,,,,,,,,,,,,,,,,,,,,,,,,,,,
5964086,7b00d239-507e-4773-ac06-9bf6897901ae,1452887152,60,1548678442,,0,0,2.92,914,1165,62,70,,,1,1.7,0.79,,,,201,,,,,,,35.15,,1,,,,,,,,,,,,,,18,79,11.88,11.84,12.35,,,,,,,,,,,,,,,,,"6,4,19,29,31,9,2,1,0",,,,,,,121,,,,,,,,,,,,,,,,,,,,,,,,,,,,,,,,,,,,,1,8,342,93,,1017,,,1,7,3,,1,0,,,,,"Aachen Laufen",,"Polar BEAT",,0,,0,168070,250480,30378,,,,,,,,,,,,,,,,,,,,,,,,,,,,,,,,,,,,,,,,,,,
5964087,9d829abd-0b74-4b44-9a2b-03fa80700cf0,1547370906,60,1548678442,,0,0,3.18,968,969,64,58,,,1,1.7,0.83,0.94,0.92,503,227,146,166,,,,57.96,36.56,59.54,1,,,,,,,,,,,,,,22,80,12.28,12,12.4,3,,,,,,,,,,,,,,,,"0,8,22,26,34,11,0,0,0","0,22,75,3,0",,,,,,123,,,,,,,,,,,,,,,,,,,,,,,,,,,,,,,,,,,,32.4,5,20,230,96,,1009,0,316,0,6,3,,1,0,,,Running,,,,"Polar M430",43,0,,0,168070,250480,30378,,,,,,,,,,,,,,,,,,,,,,,,,,,,,,,,,,,,,,,,,,5,
5964088,fe561bd5-cb64-4beb-8fd4-6f8b47a50422,1447098904,60,1548678442,,0,0,10,2344,2359,75,88,,,1,0.4,0.35,,,,674,,,,,,,53.4,,1,,,,,,,,,,,,,,48,85,15.4,15.5,15.59,,,,,,,,,,,,,,,,,"1,0,0,1,4,20,69,4,0",,,,,,,151,,,,,,,,,,,,,,,,,,,,,,,,,,,,,,,,,,,,,12,24,227,72,,1026,,,1,5,3,,1,0,,,,,"Aachen Laufen",,"Polar BEAT",,0,,0,168070,250480,30378,,,,,,,,,,,,,,,,,,,,,,,,,,,,,,,,,,,,,,,,,,,
5964089,85c61bb1-5a3b-4907-ade3-61bc51679ae8,1348912162,120,1548678443,,0,0,40.68,4834,4952,187,190,,,1,0,0.14,1,,,1390,146,180,,,,,,,1,,,,,,,,,,,,,,114,,,35.65,,7.8,-41.8,304,236,,1,396,353,,,,,,,,,"16,6,9,14,18,11,25","1,22,63,14,0","48,12,9,7,23",,,,,,,,,,,,,,,,,,,,,,,,,,,,,,,,,,,,,,,,,60,11,1,20,90,,1018,,,0,5,3,,1,0,,,,,,,"Polar BEAT",,0,,0,168072,,30378,,,,,,,,,,,,,,,,,,,,,,,,,,,,,,,,,,,,,,,,,,,
5964090,0b4d4579-dfe4-4884-854c-6ff52b770c9c,1420659477,60,1548678444,,0,0,15.1,4031,4031,199,203,,,1,1.9,0.52,1.03,1.05,424,788,151,177,,,,65.17,47.28,66.21,1,,,,,,,,,,,,,,104,,13.71,13.57,13.91,0.3,,,,,,,,,,,,,,,,"1,1,0,7,38,44,10,0,0","0,16,68,16,0",,,,,,,,,,,,,,,,,,,,,,,,,,,,,,,,,,,,,,,,,,52.8,2,11,199,90,,1029,0,,1,5,3,,1,0,,,,,"Lockerer DL",,"Polar BEAT",,0,,0,168070,250480,30378,,,,,,,,,,,,,,,,,,,,,,,,,,,,,,,,,,,,,,,,,,4,
5964091,9d71beee-967b-4401-8414-b145ef8038b7,1405263073,120,1548678444,,0,0,8.87,2878,2878,100,109,,,1,1.4,0.5,,,,595,,,,,,,36.18,,1,,,,,,,,,,,,,,59,80,11.23,11.14,11.38,,,,,,,,,,,,,,,,,"1,5,29,56,8,0,0,0,0",,,,,,,116,,,,,,,,,,,,,,,,,,,,,,,,,,,,,,,,,,,,,20,5,238,83,,,5,,0,5,3,,1,0,,,,,"Regenerativer DL",,"Polar BEAT",,0,,0,168070,250480,30378,,,,,,,,,,,,,,,,,,,,,,,,,,,,,,,,,,,,,,,,,,,
5964092,c6c5e72b-9ae5-4619-bb91-f1365f9be862,1397162468,120,1548678445,,0,0,9.1,2758,2804,55,55,,,1,0,0,0.57,,,493,159,183,,,,51.85,39.27,52.24,1,,,,,,,,,,,,,,89,80,12.02,13.95,13.98,11.6,,,,,,,,,,,,,,,,"46,3,3,3,4,5,6,16,14","0,15,31,49,4",,,,,,124,,,,,,,,,,,,,,,,,,,,,,,,,,,,,,,,,,,,69.2,14,3,60,65,,1020,0,,1,5,3,,1,0,,,,,"10x 400m + 10x 200m",,"Polar BEAT",,0,,0,168070,250480,30378,,,,,,,,,,,,,,,,,,,,,,,,,,,,,,,,,,,,,,,,,,,
5964093,16412fa5-076f-4cf9-a5fe-7bb08f7a50ed,1481145931,60,1548678445,,0,0,1.71,728,743,6,4,,,1,0,0.06,,,,115,,,,,,,23.36,,1,,,,,,,,,,,,,,15,75,8.54,10.05,10.05,,,,,,,,,,,,,,,,,"27,18,28,19,9,0,0,0,0",,,,,,,94,,,,,,,,,,,,,,,,,,,,,,,,,,,,,,,,,,,,,7,7,205,62,,1033,0,,1,5,3,,1,0,,,,,"Aachen Laufen",,"Polar BEAT",,0,,0,168070,250480,30378,,,,,,,,,,,,,,,,,,,,,,,,,,,,,,,,,,,,,,,,,,,
5964094,2e86b8cc-25d7-4595-a4f1-77bf8d67c7a8,1453553478,60,1548678445,,0,0,4.63,1449,1552,41,75,,,1,0.8,0.48,,,,322,,,,,,,36.27,,1,,,,,,,,,,,,,,30,81,11.44,11.76,11.75,,,,,,,,,,,,,,,,,"4,7,14,37,28,8,2,0,0",,,,,,,118,,,,,,,,,,,,,,,,,,,,,,,,,,,,,,,,,,,,,6,10,214,95,,1034,,,0,5,3,,1,0,,,,,"Aachen Laufen",,"Polar BEAT",,0,,0,168070,250480,30378,,,,,,,,,,,,,,,,,,,,,,,,,,,,,,,,,,,,,,,,,,,
5964095,9ffd16de-2d2d-49b6-b042-ce0abea2ac42,1506274243,120,1548678445,,0,0,4.67,1343,1343,55,48,,,1,1.3,0.57,1.13,0.98,,294,143,171,,,,63.88,40.11,64.93,1,,,,,,,,,,,,,,30,81,12.77,12.66,12.9,14.2,,,,,,,,,,,,,,,,"1,3,8,18,47,24,0,0,0","0,32,50,18,0",,,,,,129,,,,,,,,,,,,,,,,,,,,,,,,,,,,,,,,,,,,46,19,9,64,63,,1022,,,0,3,3,,1,0,I1.000|5:13-I1.000|4:43-I1.000|4:46-I1.000|4:36-I0.675|3:05,,Running,,,,"Polar M430",43,0,,0,168070,250480,30378,,,,,,,,,,,,,,,,,,,,,,,,,,,,,,,,,,,,,,,,,,,
5964096,dad05e6d-d562-4f19-8542-3f00f2964d17,1453883705,60,1548678445,,0,0,1.06,384,384,20,14,,,1,1.1,0.62,,,,74,,,,,,,26.79,,1,,,,,,,,,,,,,,7,80,10.28,10.19,10.74,,,,,,,,,,,,,,,,,"41,7,15,26,9,2,0,0,0",,,,,,,104,,,,,,,,,,,,,,,,,,,,,,,,,,,,,,,,,,,,,9,25,200,83,,1018,,,0,5,3,,1,0,,,,,"Aachen Laufen",,"Polar BEAT",,0,,0,168070,250480,30378,,,,,,,,,,,,,,,,,,,,,,,,,,,,,,,,,,,,,,,,,,,
5964097,723b05aa-17ed-425c-93c1-162d3aa742da,1403729748,120,1548678446,,0,0,2.77,1010,1054,15,12,,,1,0,0,,,,183,,,,,,,29.25,,1,,,,,,,,,,,,,,20,75,9.93,10.97,11.02,,,,,,,,,,,,,,,,,"27,0,9,38,24,1,0,0,0",,,,,,,110,,,,,,,,,,,,,,,,,,,,,,,,,,,,,,,,,,,,,14,4,23,72,,1016,,,0,5,3,,1,0,,,,,Einlaufen,,"Polar BEAT",,0,,0,168070,250480,30378,,,,,,,,,,,,,,,,,,,,,,,,,,,,,,,,,,,,,,,,,,,
5964098,2c09fd77-495b-40a3-bc8f-cd9915a785e3,1468618723,120,1548678446,,0,0,14.67,3849,3871,318,320,,,1,3.9,0.56,,,625,1005,,,,,,,48.13,,1,,,,,,,,,,,,,,79,82,14.35,14.24,14.8,,,,,,,,,,,,,,,,,"2,6,7,11,22,16,28,7,0",,,,,,,139,,,,,,,,,,,,,,,,,,,,,,,,,,,,,,,,,,,,,16,1,255,75,,,0,,1,5,3,,1,0,,,,,"Balve Laufen",,"Polar BEAT",,0,,0,168070,250480,30378,,,,,,,,,,,,,,,,,,,,,,,,,,,,,,,,,,,,,,,,,,"4,4",
5964099,7d31c546-f2b8-4795-b144-c30b54b6cc47,1437222038,120,1548678447,,0,0,15.94,4660,4660,383,382,,,1,4.4,0.67,,,610,1099,,,,,,,42.73,,1,,,,,,,,,,,,,,96,83,12.96,12.73,13.47,,,,,,,,,,,,,,,,,"4,5,13,24,27,17,9,1,0",,,,,,,124,,,,,,,,,,,,,,,,,,,,,,,,,,,,,,,,,,,,,22,18,254,55,,,,,0,3,3,,1,0,,,,,"Balve Laufen",,"Polar BEAT",,0,,0,168070,250480,30378,,,,,,,,,,,,,,,,,,,,,,,,,,,,,,,,,,,,,,,,,,"4,4,5",
5964100,c4314546-fcbe-4755-9d32-a4dca9f4c719,1440795982,120,1548678448,,0,0,14.91,4389,4651,344,399,,,1,3.9,0.64,,,1083,992,,,,,,,42.17,,1,,,,,,,,,,,,,,91,81,12.39,12.75,13.97,,,,,,,,,,,,,,,,,"8,3,11,17,31,23,7,1,0",,,,,,,126,,,,,,,,,,,,,,,,,,,,,,,,,,,,,,,,,,,,,15,5,222,82,,,,,1,3,3,,1,0,,,,,"Balve Laufen",,"Polar BEAT",,0,,0,168070,250480,30378,,,,,,,,,,,,,,,,,,,,,,,,,,,,,,,,,,,,,,,,,,"4,4,5",
5964101,9bc5565b-e4d7-4a18-a4e1-24ea87f9b31e,1397405532,120,1548678450,,0,0,24,5835,5867,28,28,,,1,0,0.03,,,,1249,164,179,,,,65.08,54.65,65.18,1,,,,,,,,,,,,,,203,84,14.82,14.87,14.89,3.9,,,,,,,,,,,,,,,,"0,0,0,0,1,54,45,0,0","0,0,40,60,0",,,,,,147,,,,,,,,,,,,,,,,,,,,,,,,,,,,,,,,,,,,97.7,10,28,278,73,,1019,3,,0,5,3,,1,0,,,,,"Langer TDL",,"Polar BEAT",,0,,0,168070,250480,30378,,,,,,,,,,,,,,,,,,,,,,,,,,,,,,,,,,,,,,,,,,,
5964103,de2d5671-866d-489e-a0b0-0efb21d4181f,1537980916,120,1548678452,,0,0,17.02,5289,5292,60,58,,,1,0,0.05,1.1,0.92,,1171,140,149,,,,59.63,40.01,59.9,1,,,,,,,,,,,,,,102,80,11.63,11.6,11.69,-0.4,,,,,,,,,,,,,,,,"0,1,9,74,16,0,0,0,0","1,42,57,0,0",,,,,,121,,,,,,,,,,,,,,,,,,,,,,,,,,,,,,,,,,,,22.9,19,4,278,35,,1033,,,0,3,3,,1,0,I1.000|5:17-I1.000|5:09-I1.000|5:04-I1.000|5:02-I1.000|5:17-I1.000|5:15-I1.000|5:13-I1.000|5:13-I1.000|5:07-I1.000|5:08-I1.000|5:15-I1.000|5:08-I1.000|5:10-I1.000|5:11-I1.000|5:15-I1.000|5:14-I1.000|5:10-I0.017|0:05,,Running,,,,"Polar M430",43,0,,0,168070,250480,30378,,,,,,,,,,,,,,,,,,,,,,,,,,,,,,,,,,,,,,,,,,,
5964104,55c140d8-d159-4d0d-ad44-ddd202b351b6,1468158362,120,1548678453,,0,0,0.27,113,117,6,9,,,1,1.2,1,,,,20,,,,,,,19.84,,1,,,,,,,,,,,,,,2,80,8.59,8.55,8.63,,,,,,,,,,,,,,,,,"100,0,0,0,0,0,0,0,0",,,,,,,90,,,,,,,,,,,,,,,,,,,,,,,,,,,,,,,,,,,,,28,9,213,51,,1011,8,,0,3,3,,1,0,,,,,"Aachen Laufen",,"Polar BEAT",,0,,0,168070,250480,30378,,,,,,,,,,,,,,,,,,,,,,,,,,,,,,,,,,,,,,,,,,,
5964105,2acaea8f-bc07-44f0-ae63-92cab004db06,1412800505,120,1548678453,,0,0,16.09,4304,4304,203,228,,,1,1.9,0.53,1.02,1.05,420,754,144,176,,,,69.24,47.4,70.19,1,,,,,,,,,,,,,,95,84,13.66,13.8,14.07,1.7,,,,,,,,,,,,,,,,"3,1,3,9,30,41,9,5,0","0,41,47,12,0",,,,,,134,,,,,,,,,,,,,,,,,,,,,,,,,,,,,,,,,,,,60.7,16,6,213,89,,1003,0,,1,5,3,,1,0,,,,,"Lockerer DL",,"Polar BEAT",,0,,0,168070,250480,30378,,,,,,,,,,,,,,,,,,,,,,,,,,,,,,,,,,,,,,,,,,4,
5964106,c51f0ce9-b2bc-45e9-b4d4-bd2642211403,1500212919,120,1548678453,,0,0,0.43,137,137,8,7,,,1,0,0.06,,,,24,,,,,,,28.4,,1,,,,,,,,,,,,,,2,81,11.31,11.8,12.28,,,,,,,,,,,,,,,,,"23,26,7,7,8,18,10,0,0",,,,,,,116,,,,,,,,,,,,,,,,,,,,,,,,,,,,,,,,,,,,,30,9,266,29,,1019,9,,0,3,3,,1,0,,,,,"Aix-en-Provence Laufen",,"Polar BEAT",,0,,0,168070,250480,30378,,,,,,,,,,,,,,,,,,,,,,,,,,,,,,,,,,,,,,,,,,,
5964107,0d36a08b-6c67-4939-9d97-d36aea652224,1473287853,120,1548678454,,0,0,0.94,278,278,10,16,,,1,0,0.15,,,,64,,,,,,,33.3,,1,,,,,,,,,,,,,,5,84,12.18,12.3,12.3,,,,,,,,,,,,,,,,,"0,0,26,10,44,21,0,0,0",,,,,,,121,,,,,,,,,,,,,,,,,,,,,,,,,,,,,,,,,,,,,18,1,103,75,,1016,0,,1,3,3,,1,0,,,,,"Aachen Laufen",,"Polar BEAT",,0,,0,168070,250480,30378,,,,,,,,,,,,,,,,,,,,,,,,,,,,,,,,,,,,,,,,,,,
5964109,2af25836-1f0f-466c-a77a-075271bd36f8,1537544156,120,1548678454,,0,0,13.52,4210,4215,46,45,,,1,0,0.04,1.1,0.89,,907,138,151,,,,60.56,39.19,60.82,1,,,,,,,,,,,,,,77,81,11.6,11.59,11.66,3.4,,,,,,,,,,,,,,,,"0,3,13,62,21,1,0,0,0","1,65,35,0,0",,,,,,119,,,,,,,,,,,,,,,,,,,,,,,,,,,,,,,,,,,,23.2,25,21,236,35,,1012,,,0,6,3,,1,0,I1.000|5:16-I1.000|5:09-I1.000|5:16-I1.000|5:06-I1.000|5:11-I1.000|5:09-I1.000|5:25-I1.000|5:07-I1.000|5:12-I1.000|5:10-I1.000|5:09-I1.000|5:11-I1.000|5:14-I0.526|2:42,,Running,,,,"Polar M430",43,0,,0,168070,250480,30378,,,,,,,,,,,,,,,,,,,,,,,,,,,,,,,,,,,,,,,,,,,
5964110,75d798b5-1385-4d0e-b243-984f4638b5c0,1339781451,120,1548678454,,0,0,2.36,726,729,30,16,,,1,0.2,0.32,,,,166,,,,,,,35.22,,1,,,,,,,,,,,,,,15,,12.18,12.23,12.5,,,,,,,,,,,,,,,,,"17,4,8,16,33,18,4,1,0",,,,,,,,,,,,,,,,,,,,,,,,,,,,,,,,,,,,,,,,,,,,19,13,221,66,,1014,2,,0,5,3,,1,0,,,,,,,"Polar BEAT",,0,,0,168070,250480,30378,,,,,,,,,,,,,,,,,,,,,,,,,,,,,,,,,,,,,,,,,,,
5964111,4ff16848-2568-410c-8cd3-1e69e84bd1af,1347102708,120,1548678455,,0,0,8.96,2966,3282,176,176,,,1,2.7,0.53,,,729,625,,,,,,,35.36,,1,,,,,,,,,,,,,,61,,11.39,11.72,12.37,,,,,,,,,,,,,,,,,"23,14,18,18,12,7,3,3,3",,,,,,,,,,,,,,,,,,,,,,,,,,,,,,,,,,,,,,,,,,,,21,8,261,66,,1022,3,,0,3,3,,1,0,,,,,mellen,,"Polar BEAT",,0,,0,168070,250480,30378,,,,,,,,,,,,,,,,,,,,,,,,,,,,,,,,,,,,,,,,,,"4,4",
5964112,ea290f89-c2d2-4a38-988f-ecde25bc2a31,1530428422,120,1548678456,,0,0,28.51,8688,8731,705,705,,,1,4.8,0.67,1.19,0.92,547,1981,143,164,,,,59.46,42.56,61.28,1,,,,,,,,,,,,,,182,82,12.4,12.15,13.27,6.6,,,,,,,,,,,,,,,,"8,4,15,23,30,19,1,0,0","0,32,67,0,0",,,,,,120,,,,,,,,,,,,,,,,,,,,,,,,,,,,,,,,,,,,37.5,13,9,70,62,,,,,0,3,3,,1,0,I6.175|34:23-I11.819|53:06-I10.522|58:02,,Running,,,,"Polar M430",43,0,,0,168070,250480,30378,,,,,,,,,,,,,,,,,,,,,,,,,,,,,,,,,,,,,,,,,,"4,4,4,4,5,5,5,5",
5964113,a79836be-4c4e-4417-b182-6ea93257e843,1455736012,60,1548678457,,0,0,13.42,3667,3667,200,203,,,1,2.3,0.58,,,354,928,,,,,,,45.6,,1,,,,,,,,,,,,,,76,82,13.45,13.34,13.66,,,,,,,,,,,,,,,,,"1,1,3,12,44,32,8,1,0",,,,,,,134,,,,,,,,,,,,,,,,,,,,,,,,,,,,,,,,,,,,,1,2,132,79,,1016,,,1,5,3,,1,0,,,,,"Aachen Laufen",,"Polar BEAT",,0,,0,168070,250480,30378,,,,,,,,,,,,,,,,,,,,,,,,,,,,,,,,,,,,,,,,,,4,
5964114,3b191a17-a129-4f93-bb10-7d82048280a9,1470085564,120,1548678458,,0,0,12.95,3412,3412,190,195,,,1,2.2,0.64,,,426,881,,,,,,,47.44,,1,,,,,,,,,,,,,,70,81,13.93,13.97,14.34,,,,,,,,,,,,,,,,,"3,1,3,5,27,42,15,4,0",,,,,,,141,,,,,,,,,,,,,,,,,,,,,,,,,,,,,,,,,,,,,18,1,283,70,,1019,0,,1,4,3,,1,0,,,,,"Aachen Laufen",,"Polar BEAT",,0,,0,168070,250480,30378,,,,,,,,,,,,,,,,,,,,,,,,,,,,,,,,,,,,,,,,,,4,
5964115,24d7de00-a141-43d3-b062-29034aa0f93f,1497904602,120,1548678458,,0,0,5.56,2369,5064,142,140,,,1,2.7,0.54,,,312,364,,,,,,,25.29,,1,,,,,,,,,,,,,,49,78,8.81,8.6,9.25,,,,,,,,,,,,,,,,,"80,11,5,2,2,0,0,0,0",,,,,,,90,,,,,,,,,,,,,,,,,,,,,,,,,,,,,,,,,,,,,29,3,31,40,,1016,0,,0,3,3,,1,0,,,,,"Aachen Laufen",,"Polar BEAT",,0,,0,168070,250480,30378,,,,,,,,,,,,,,,,,,,,,,,,,,,,,,,,,,,,,,,,,,"4,4",
5964117,b0df046f-48ef-4b21-87ca-0b56f3dc60a7,1527878635,120,1548678459,,0,0,11.61,3788,3791,49,52,,,1,0,0.17,1.15,0.97,,762,135,152,,,,58.73,36.67,59.01,1,,,,,,,,,,,,,,64,81,11.07,11.11,11.21,-3.9,,,,,,,,,,,,,,,,"5,14,27,40,12,3,0,0,0","1,85,14,0,0",,,,,,114,,,,,,,,,,,,,,,,,,,,,,,,,,,,,,,,,,,,20.6,22,9,265,69,,1018,,,0,3,3,,1,0,I3.006|16:34-I8.604|46:39,,Running,,,,"Polar M430",43,0,,0,168070,250480,30378,,,,,,,,,,,,,,,,,,,,,,,,,,,,,,,,,,,,,,,,,,,
5964118,162958d8-6b0b-47bc-876b-f95377c3396c,1529951688,120,1548678459,,0,0,15.13,4388,4392,36,36,,,1,0,0.04,1.13,0.95,,1011,144,161,,,,62.65,42.95,62.83,1,,,,,,,,,,,,,,94,80,12.45,12.44,12.51,6.4,,,,,,,,,,,,,,,,"0,0,2,25,67,5,0,0,0","0,16,84,0,0",,,,,,129,,,,,,,,,,,,,,,,,,,,,,,,,,,,,,,,,,,,30.1,23,14,17,43,,1023,,,0,5,3,,1,0,I1.000|4:47-I1.000|4:50-I1.000|4:44-I1.000|4:55-I1.000|4:45-I1.000|4:52-I1.000|4:54-I1.000|4:53-I1.000|4:46-I1.000|4:44-I1.000|4:52-I1.000|4:45-I1.000|4:59-I1.000|5:00-I1.000|4:47-I0.134|0:42,,Running,,,,"Polar M430",43,0,,0,168070,250480,30378,,,,,,,,,,,,,,,,,,,,,,,,,,,,,,,,,,,,,,,,,,,
5964119,00a53221-59e3-449d-b4be-1e87e831996b,1510732445,60,1548678460,,0,0,11.81,3572,3581,52,52,,,1,0,0.1,1.06,0.9,,662,128,152,,,,68.69,40.12,69.06,1,,,,,,,,,,,,,,52,82,11.95,11.93,12.01,-6.9,,,,,,,,,,,,,,,,"0,2,5,50,43,0,0,0,0","0,86,14,0,0",,,,,,121,,,,,,,,,,,,,,,,,,,,,,,,,,,,,,,,,,,,19.9,0,0,82,93,,,0,,0,9,3,,1,0,I1.000|5:16-I1.000|5:03-I1.000|5:09-I1.000|5:07-I1.000|5:03-I1.000|4:56-I1.000|5:16-I1.000|4:55-I1.000|4:57-I1.000|5:03-I1.000|4:56-I0.807|4:01,,Running,,,,"Polar M430",43,0,,0,168070,250480,30378,,,,,,,,,,,,,,,,,,,,,,,,,,,,,,,,,,,,,,,,,,,
5964120,f7d3e980-0378-4355-9585-0116a87fba9a,1367144170,120,1548678461,,0,0,12.45,4524,5619,431,465,,,1,2.8,0.72,1.26,1.18,439,873,129,176,,,,54.26,32.48,56.41,1,,,,,,,,,,,,,,70,,10.24,10.98,11.39,2.4,,,,,,,,,,,,,,,,"21,13,25,20,13,6,2,1,0","7,65,27,1,0",,,,,,,,,,,,,,,,,,,,,,,,,,,,,,,,,,,,,,,,,,25.4,5,5,54,73,,1018,3,,0,5,3,,1,0,,,,,,,"Polar BEAT",,0,,0,168070,250480,30378,,,,,,,,,,,,,,,,,,,,,,,,,,,,,,,,,,,,,,,,,,4,
5964122,b53b6a11-91cf-42bc-ab45-39b33387d548,1348412989,120,1548678461,,0,0,9.98,3055,3133,63,63,,,1,0,0.17,1.02,0.87,,693,152,210,,,,54.54,39.07,54.97,1,,,,,,,,,,,,,,81,,11.88,12.34,12.46,8.1,,,,,,,,,,,,,,,,"9,5,12,22,29,15,5,3,0","2,5,83,10,0",,,,,,,,,,,,,,,,,,,,,,,,,,,,,,,,,,,,,,,,,,45.6,18,13,94,69,,1014,3,,0,5,3,,1,0,,,,,,,"Polar BEAT",,0,,0,168070,250480,30378,,,,,,,,,,,,,,,,,,,,,,,,,,,,,,,,,,,,,,,,,,,
5964123,afc17f74-6600-412e-80d2-ca1b2eec2bfb,1406383409,120,1548678462,,0,0,2.87,714,764,35,37,,,1,0,0.08,,,,176,,,,,,,45.74,,1,,,,,,,,,,,,,,14,87,14.52,15.51,15.62,,,,,,,,,,,,,,,,,"15,3,2,5,6,13,18,33,5",,,,,,,139,,,,,,,,,,,,,,,,,,,,,,,,,,,,,,,,,,,,,23,4,298,64,,1014,5,,0,5,3,,1,0,,,,,Samstagstraining,,"Polar BEAT",,0,,0,168070,250480,30378,,,,,,,,,,,,,,,,,,,,,,,,,,,,,,,,,,,,,,,,,,,
5964124,84e14f2e-20d2-4239-b404-c022b3420c80,1422474557,60,1548678462,,0,0,12.94,3755,3755,62,96,,,1,0,0.22,,,,881,,,,,,,42.4,,1,,,,,,,,,,,,,,77,84,12.45,12.58,12.69,,,,,,,,,,,,,,,,,"2,1,5,21,53,14,3,0,0",,,,,,,123,,,,,,,,,,,,,,,,,,,,,,,,,,,,,,,,,,,,,3,19,264,94,,1000,,,1,5,3,,1,0,,,,,"Zügiger DL - 14km, GPS war aus",,"Polar BEAT",,0,,0,168070,250480,30378,,,,,,,,,,,,,,,,,,,,,,,,,,,,,,,,,,,,,,,,,,,
5964125,588cce52-5c70-4f7b-8dc0-85edea13c532,1412194842,120,1548678463,,0,0,15.02,3903,3914,203,212,,,1,2,0.55,1.04,1.03,437,772,151,176,,,,67.38,48.76,68.46,1,,,,,,,,,,,,,,102,83,14.08,14.06,14.4,-1.8,,,,,,,,,,,,,,,,"0,1,1,7,30,42,16,2,1","0,27,45,28,0",,,,,,139,,,,,,,,,,,,,,,,,,,,,,,,,,,,,,,,,,,,71.7,15,1,189,88,,1028,0,,1,3,3,,1,0,,,,,"Gesteigerter DL",,"Polar BEAT",,0,,0,168070,250480,30378,,,,,,,,,,,,,,,,,,,,,,,,,,,,,,,,,,,,,,,,,,4,
5964126,41f27fd3-297c-4eea-8922-d204cecd3d4c,1426101207,60,1548678464,,0,0,21.13,6043,6568,262,260,,,1,1.9,0.45,,,402,1439,,,,,,,44.84,,1,,,,,,,,,,,,,,125,84,12.78,12.84,13.16,,,,,,,,,,,,,,,,,"5,2,5,19,37,26,7,0,0",,,,,,,125,,,,,,,,,,,,,,,,,,,,,,,,,,,,,,,,,,,,,4,7,65,67,,1031,,,1,3,3,,1,0,,,,,"Aachen Laufen",,"Polar BEAT",,0,,0,168070,250480,30378,,,,,,,,,,,,,,,,,,,,,,,,,,,,,,,,,,,,,,,,,,4,
5964127,e9a24cdb-ff2f-4527-8e51-42ea52e65fea,1542045513,60,1548678464,,0,0,2.75,887,888,9,8,,,1,0,0,1.09,0.78,,187,137,152,,,,58.5,33.78,58.77,1,,,,,,,,,,,,,,16,80,11.18,11.23,11.31,3.9,,,,,,,,,,,,,,,,"1,7,21,61,10,0,0,0,0","3,55,41,0,0",,,,,,116,,,,,,,,,,,,,,,,,,,,,,,,,,,,,,,,,,,,19.7,16,8,230,63,,1017,,,1,2,1,,1,0,I1.000|5:18-I1.000|5:25-I0.746|4:07,,Running,,,,"Polar M430",43,0,,0,168070,250480,30378,,,,,,,,,,,,,,,,,,,,,,,,,,,,,,,,,,,,,,,,,,,
5964128,e92900d8-07ea-4303-8ba9-fa2d594e3d8f,1540317170,120,1548678464,,0,0,16.72,4401,4401,61,61,,,1,0,0.12,1.04,0.89,,1142,155,181,,,,63.97,48.44,64.26,1,,,,,,,,,,,,,,128,84,13.72,13.97,14.01,7.9,,,,,,,,,,,,,,,,"1,4,8,4,20,41,20,3,0","0,15,49,36,0",,,,,,136,,,,,,,,,,,,,,,,,,,,,,,,,,,,,,,,,,,,87.9,14,23,224,54,,1026,0,275,1,5,3,,1,0,I9.787|41:59-I1.064|4:05-I0.506|2:01-I0.546|2:02-I0.217|1:02-I4.606|22:14,,Running,,,,"Polar M430",43,0,,0,168070,250480,30378,,,,,,,,,,,,,,,,,,,,,,,,,,,,,,,,,,,,,,,,,,,
5964129,8838685d-12ad-4182-a163-41a34a2c3148,1403261914,120,1548678465,,0,0,13.07,3590,3664,147,147,,,1,1.3,0.51,,,425,872,,,,,,,45.23,,1,,,,,,,,,,,,,,74,83,13.29,13.2,13.47,,,,,,,,,,,,,,,,,"1,2,3,11,32,49,1,0,0",,,,,,,132,,,,,,,,,,,,,,,,,,,,,,,,,,,,,,,,,,,,,14,7,327,79,,1021,4,,0,5,3,,1,0,,,,,"Lockerer DL",,"Polar BEAT",,0,,0,168070,250480,30378,,,,,,,,,,,,,,,,,,,,,,,,,,,,,,,,,,,,,,,,,,5,
5964130,f2063092-b213-42cc-9927-e4157965875f,1508869022,120,1548678466,,0,0,15.74,4396,4466,162,162,,,1,0.9,0.45,1.26,1.23,,1134,159,192,,,,57.36,45.01,58.09,1,,,,,,,,,,,,,,145,82,13.01,14.45,14.55,25.8,,,,,,,,,,,,,,,,"17,1,4,9,11,17,25,15,1","0,20,30,34,16",,,,,,131,,,,,,,,,,,,,,,,,,,,,,,,,,,,,,,,,,,,109.6,15,8,215,93,,1022,,,1,5,3,,1,0,I3.234|14:27-I2.296|8:35-I2.322|8:31-I0.005|0:01-I0.141|3:56-I2.307|8:30-I0.184|3:19-I2.310|8:26-I0.078|2:35-I0.394|1:19-I0.118|0:59-I0.398|1:04-I0.063|2:34-I1.884|10:16,,Running,,,,"Polar M430",43,0,,0,168070,250480,30378,,,,,,,,,,,,,,,,,,,,,,,,,,,,,,,,,,,,,,,,,,,
5964131,db693e01-13d4-416c-bc07-642763468431,1454613736,60,1548678468,,0,0,13.19,4791,5195,112,111,,,1,0.8,0.34,,,,896,,,,,,,32.64,,1,,,,,,,,,,,,,,99,78,10.04,10.16,10.34,,,,,,,,,,,,,,,,,"23,23,32,19,2,1,0,0,0",,,,,,,106,,,,,,,,,,,,,,,,,,,,,,,,,,,,,,,,,,,,,6,16,303,91,,1023,,,1,5,3,,1,0,,,,,"Aachen Laufen",,"Polar BEAT",,0,,0,168070,250480,30378,,,,,,,,,,,,,,,,,,,,,,,,,,,,,,,,,,,,,,,,,,,
5964132,746a07e3-9378-4468-82d7-a2213329aca8,1424866624,60,1548678469,,0,0,26.01,7446,7625,363,364,,,1,2.6,0.53,,,415,1772,,,,,,,45.5,,1,,,,,,,,,,,,,,154,84,12.83,13.13,13.49,,,,,,,,,,,,,,,,,"7,1,4,9,29,44,6,0,0",,,,,,,125,,,,,,,,,,,,,,,,,,,,,,,,,,,,,,,,,,,,,5,9,206,85,,1018,2,,0,5,3,,1,0,,,,,"Langer DL",,"Polar BEAT",,0,,0,168070,250480,30378,,,,,,,,,,,,,,,,,,,,,,,,,,,,,,,,,,,,,,,,,,"5,5,5",
5964133,6ef35cfa-db62-41fe-ae13-a7f6898c8341,1393357205,60,1548678470,,0,0,10.17,2772,2823,13,14,,,1,0,0.02,0.61,0.62,,531,158,183,,,,59.64,44.82,59.73,1,,,,,,,,,,,,,,90,82,13.25,15.76,15.83,15.2,,,,,,,,,,,,,,,,"30,9,2,1,2,2,3,50,1","0,29,13,48,10",,,,,,134,,,,,,,,,,,,,,,,,,,,,,,,,,,,,,,,,,,,76.8,9,9,159,77,,1009,0,,1,5,3,,1,0,,,,,"8x 1000m in <3:15",,"Polar BEAT",,0,,0,168070,250480,30378,,,,,,,,,,,,,,,,,,,,,,,,,,,,,,,,,,,,,,,,,,,
5964134,a5ddab73-c69e-45a7-9602-10419f15d684,1366749742,120,1548678470,,0,0,7.23,2141,2633,89,93,,,1,0.4,0.27,,,,494,,,,,,,39.76,,1,,,,,,,,,,,,,,44,,12.36,15.12,15.29,,,,,,,,,,,,,,,,,"31,7,2,5,4,7,13,22,10",,,,,,,,,,,,,,,,,,,,,,,,,,,,,,,,,,,,,,,,,,,,12,5,238,72,,1023,0,,1,5,3,,1,0,,,,,,,"Polar BEAT",,0,,0,168070,250480,30378,,,,,,,,,,,,,,,,,,,,,,,,,,,,,,,,,,,,,,,,,,,
5964135,604c0895-37df-4e90-9abf-f699197a1289,1443267552,120,1548678471,,0,0,11.14,3377,3379,321,324,,,1,3.9,0.65,1.12,0.97,535,490,152,175,,,,55.2,39.84,57.15,1,,,,,,,,,,,,,,91,84,12.56,12.03,13.47,-4.5,,,,,,,,,,,,,,,,"3,6,14,28,42,6,2,0,0","0,36,17,46,0",,,,,,118,,,,,,,,,,,,,,,,,,,,,,,,,,,,,,,,,,,,69.1,14,7,25,76,,,,,0,3,3,,1,0,,,,,"Balve Laufen",,"Polar BEAT",,0,,0,168070,250480,30378,,,,,,,,,,,,,,,,,,,,,,,,,,,,,,,,,,,,,,,,,,3,
5964136,0c8e89ea-941b-4310-9206-4645ad4e7701,1437235977,120,1548678471,,0,0,5.9,2196,2243,98,103,,,1,1.9,0.61,,,225,406,,,,,,,29.91,,1,,,,,,,,,,,,,,45,73,9.89,9.85,10.17,,,,,,,,,,,,,,,,,"31,28,26,15,0,0,0,0,0",,,,,,,110,,,,,,,,,,,,,,,,,,,,,,,,,,,,,,,,,,,,,24,15,281,42,,,,,0,3,3,,1,0,,,,,"Balve Laufen",,"Polar BEAT",,0,,0,168070,250480,30378,,,,,,,,,,,,,,,,,,,,,,,,,,,,,,,,,,,,,,,,,,4,
5964137,a2cdece7-7a83-49ee-af30-30cf8e7d1346,1543749672,60,1548678472,,0,0,32.61,10380,10425,501,504,,,1,3.8,0.39,1.12,0.88,693,1970,144,159,,,,55.84,40.75,56.9,1,,,,,,,,,,,,,,77,82,11.77,11.63,12.34,,,,,,,,,,,,,,,,,"12,8,14,28,28,9,1,0,0","0,6,94,0,0",,,,,,115,,,,,,,,,,,,,,,,,,,,,,,,,,,,,,,,,,,,30.8,11,42,200,87,,1006,,,0,6,1,,1,0,I1.000|4:49-I1.000|4:58-I1.000|4:35-I1.000|4:39-I1.000|4:41-I1.000|4:54-I1.000|5:06-I1.000|4:49-I1.000|4:37-I1.000|4:45-I1.000|4:47-I1.000|5:04-I1.000|5:03-I1.000|4:57-I1.000|6:26-I1.000|6:56-I1.000|5:17-I1.000|4:43-I1.000|5:01-I1.000|4:58-I1.000|7:27-I1.000|6:36-I1.000|5:36-I1.000|5:27-I1.000|5:25-I1.000|5:24-I1.000|5:21-I1.000|5:24-I1.000|5:27-I1.000|5:56-I1.000|5:18-I1.000|5:49-I0.616|3:28,,Running,,,,"Polar M430",43,0,,0,168070,250480,30378,,,,,,,,,,,,,,,,,,,,,,,,,,,,,,,,,,,,,,,,,,"3,4,5",
5964138,e5425d65-2f6e-4b3c-9443-64119779d4bb,1457032499,60,1548678473,,0,0,10.6,3379,3990,104,105,,,1,1,0.45,,,,697,,,,,,,37.42,,1,,,,,,,,,,,,,,70,81,11.42,12.64,12.89,,,,,,,,,,,,,,,,,"23,7,7,16,21,9,3,10,3",,,,,,,116,,,,,,,,,,,,,,,,,,,,,,,,,,,,,,,,,,,,,2,6,230,86,,1007,,,1,5,3,,1,0,,,,,"Aachen Laufen",,"Polar BEAT",,0,,0,168070,250480,30378,,,,,,,,,,,,,,,,,,,,,,,,,,,,,,,,,,,,,,,,,,,
5964139,8ba6b25d-43b5-4465-abfb-b06a26f67695,1458245841,60,1548678473,,0,0,2.24,696,696,32,32,,,1,1.2,0.64,,,,156,,,,,,,34.64,,1,,,,,,,,,,,,,,14,82,11.77,11.78,11.89,,,,,,,,,,,,,,,,,"8,2,18,26,46,0,0,0,0",,,,,,,118,,,,,,,,,,,,,,,,,,,,,,,,,,,,,,,,,,,,,4,5,26,68,,1026,,,1,3,3,,1,0,,,,,"Aachen Laufen",,"Polar BEAT",,0,,0,168070,250480,30378,,,,,,,,,,,,,,,,,,,,,,,,,,,,,,,,,,,,,,,,,,,
5964140,e46fd60b-4a1c-4b5a-9268-2eae30a12f23,1401016692,120,1548678474,,0,0,10.72,3674,4300,185,168,,,1,2.1,0.53,,,,726,,,,,,,34.39,,1,,,,,,,,,,,,,,76,82,10.76,10.65,11.1,,,,,,,,,,,,,,,,,"13,13,36,33,5,1,0,0,0",,,,,,,107,,,,,,,,,,,,,,,,,,,,,,,,,,,,,,,,,,,,,18,4,205,56,,1020,6,,0,3,3,,1,0,,,,,"Sehr Langsamer DL",,"Polar BEAT",,0,,0,168070,250480,30378,,,,,,,,,,,,,,,,,,,,,,,,,,,,,,,,,,,,,,,,,,,
5964141,d3254e48-367f-4168-91ca-8bb7b2b33242,1516126100,60,1548678475,,0,0,13.21,3476,3476,24,21,,,1,0,0.06,,0.93,,863,153,166,,,,65.16,47.58,65.32,1,,,,,,,,,,,,,,94,82,13.72,13.79,13.85,3.2,,,,,,,,,,,,,,,,"0,0,3,4,23,62,8,0,0","1,11,70,19,0",,,,,,139,,,,,,,,,,,,,,,,,,,,,,,,,,,,,,,,,,,,53.1,6,21,253,83,,998,,,1,6,3,,1,0,I12.018|51:53-I1.189|6:04,,Running,,,,"Polar M430",43,0,,0,168070,250480,30378,,,,,,,,,,,,,,,,,,,,,,,,,,,,,,,,,,,,,,,,,,,
5964143,6b7c5b4b-1a34-4af5-ba3f-c15ac7599268,1404757309,120,1548678475,,0,0,6.06,1670,1670,67,66,,,1,1,0.57,,,,406,,,,,,,42.83,,1,,,,,,,,,,,,,,34,82,13.2,13.62,13.81,,,,,,,,,,,,,,,,,"2,1,2,21,47,18,6,1,2",,,,,,,133,,,,,,,,,,,,,,,,,,,,,,,,,,,,,,,,,,,,,22,4,40,48,,1016,2,,0,5,3,,1,0,,,,,"Einlaufen Mit Lauf ABC",,"Polar BEAT",,0,,0,168070,250480,30378,,,,,,,,,,,,,,,,,,,,,,,,,,,,,,,,,,,,,,,,,,,
5964144,149adef1-4963-4ae4-9664-3bbecb841762,1439214017,120,1548678476,,0,0,10.6,3343,4018,189,189,,,1,2.2,0.52,,,685,727,,,,,,,37.89,,1,,,,,,,,,,,,,,69,84,11.8,11.57,12.19,,,,,,,,,,,,,,,,,"10,4,11,39,31,4,0,0,0",,,,,,,113,,,,,,,,,,,,,,,,,,,,,,,,,,,,,,,,,,,,,23,7,334,67,,1018,,,0,5,3,,1,0,,,,,"Balve Laufen",,"Polar BEAT",,0,,0,168070,250480,30378,,,,,,,,,,,,,,,,,,,,,,,,,,,,,,,,,,,,,,,,,,"4,5",
5964145,8b335b47-fa4c-4696-a80d-7f647fd5acc6,1480013310,60,1548678476,,0,0,6.05,1776,2116,72,74,,,1,0.8,0.57,,,,417,,,,,,,39.75,,1,,,,,,,,,,,,,,36,80,12.49,12.51,12.78,,,,,,,,,,,,,,,,,"11,3,3,17,40,23,5,0,0",,,,,,,128,,,,,,,,,,,,,,,,,,,,,,,,,,,,,,,,,,,,,7,16,51,89,,1020,,,1,5,3,,1,0,,,,,"Aachen Laufen",,"Polar BEAT",,0,,0,168070,250480,30378,,,,,,,,,,,,,,,,,,,,,,,,,,,,,,,,,,,,,,,,,,,
5964146,e0a9b980-fdfe-4b42-a70a-e1ed7b15c35c,1408982887,120,1548678477,,0,0,13.1,3845,3845,176,159,,,1,1.8,0.45,,,393,890,,,,,,,41.88,,1,,,,,,,,,,,,,,79,81,12.53,12.39,12.73,,,,,,,,,,,,,,,,,"3,2,7,19,58,11,0,0,0",,,,,,,126,,,,,,,,,,,,,,,,,,,,,,,,,,,,,,,,,,,,,16,5,204,82,,1013,3,,0,5,3,,1,0,,,,,"Lockerer DL ",,"Polar BEAT",,0,,0,168070,250480,30378,,,,,,,,,,,,,,,,,,,,,,,,,,,,,,,,,,,,,,,,,,4,
5964147,53e070d8-70e7-46d3-b57a-099d8b0c0195,1393780660,60,1548678477,,0,0,5.04,1386,1386,86,87,,,1,1.8,0.56,1.18,0.97,331,278,150,167,,,,63.39,42.47,64.71,1,,,,,,,,,,,,,,34,83,13.33,13.22,13.9,4,,,,,,,,,,,,,,,,"1,2,2,6,52,31,7,0,0","0,5,84,10,0",,,,,,131,,,,,,,,,,,,,,,,,,,,,,,,,,,,,,,,,,,,40.1,7,6,192,59,,,0,,0,3,3,,1,0,,,,,Auslaufen,,"Polar BEAT",,0,,0,168070,250480,30378,,,,,,,,,,,,,,,,,,,,,,,,,,,,,,,,,,,,,,,,,,4,
5964148,7e97b221-bff2-410c-a3d3-ce1c8db2d33d,1429043497,120,1548678477,,0,0,5.15,1909,1961,0,0,,,1,0,0,,,,302,,,,,,,29.81,,1,,,,,,,,,,,,,,39,74,9.76,13.5,13.58,,,,,,,,,,,,,,,,,"53,1,1,2,2,2,8,25,5",,,,,,,109,,,,,,,,,,,,,,,,,,,,,,,,,,,,,,,,,,,,,17,12,244,52,,1024,,,1,3,3,,1,0,,,,,"Aachen Laufen",,"Polar BEAT",,0,,0,168070,250480,30378,,,,,,,,,,,,,,,,,,,,,,,,,,,,,,,,,,,,,,,,,,,
5964149,24472272-88e3-4ea3-b756-6526753a6c4d,1371992968,120,1548678478,,0,0,30,8377,8414,323,323,,,1,1.9,0.39,,,294,2053,,,,,,,47.32,,1,,,,,,,,,,,,,,173,,13.08,13.42,13.7,,,,,,,,,,,,,,,,,"6,2,5,15,26,27,15,3,1",,,,,,,,,,,,,,,,,,,,,,,,,,,,,,,,,,,,,,,,,,,,13,15,232,89,,1013,5,,0,5,3,,1,0,,,,,,,"Polar BEAT",,0,,0,168070,250480,30378,,,,,,,,,,,,,,,,,,,,,,,,,,,,,,,,,,,,,,,,,,"4,4",
5964150,f032714e-76c1-4baf-9c2b-28887ac5db22,1424120499,60,1548678479,,0,0,11.42,2969,2969,162,178,,,1,2.4,0.52,,,554,764,,,,,,,47.74,,1,,,,,,,,,,,,,,61,83,14.07,14.9,16.84,,,,,,,,,,,,,,,,,"6,6,7,14,20,17,16,10,5",,,,,,,139,,,,,,,,,,,,,,,,,,,,,,,,,,,,,,,,,,,,,1,4,184,88,,1021,0,,1,5,3,,1,0,,,,,"Aachen Laufen",,"Polar BEAT",,0,,0,168070,250480,30378,,,,,,,,,,,,,,,,,,,,,,,,,,,,,,,,,,,,,,,,,,"4,5",
5964151,7307372c-7e1e-47e8-81e0-fb2389c3252f,1503058416,120,1548678479,,0,0,10.26,2865,2868,177,186,,,1,2.3,0.51,1.01,0.96,466,670,150,175,,,,62.2,43.59,63.46,1,,,,,,,,,,,,,,74,81,13.26,13.12,13.55,4.7,,,,,,,,,,,,,,,,"2,4,9,15,28,34,9,0,0","1,19,57,23,0",,,,,,133,,,,,,,,,,,,,,,,,,,,,,,,,,,,,,,,,,,,53.8,19,5,225,94,,1013,4,,0,6,3,,1,0,I1.000|4:59-I1.000|4:49-I1.000|4:31-I1.000|4:49-I1.000|5:22-I1.000|4:58-I1.000|4:14-I1.000|4:06-I1.000|4:12-I1.000|4:35-I0.268|1:15,,Running,,,,"Polar M430",43,0,,0,168070,250480,30378,,,,,,,,,,,,,,,,,,,,,,,,,,,,,,,,,,,,,,,,,,4,
5964152,f622bfac-9731-4cdf-8761-c56dd4217a63,1409490008,120,1548678480,,0,0,10,2141,2141,187,187,,,1,2.2,0.49,,,418,654,,,,,,,59.37,,1,,,,,,,,,,,,,,44,88,17.54,17,17.97,,,,,,,,,,,,,,,,,"0,0,0,0,4,8,51,36,0",,,,,,,159,,,,,,,,,,,,,,,,,,,,,,,,,,,,,,,,,,,,,13,6,239,86,,,4,,0,5,3,,1,0,,,,,"WK 10k Burgberg Lauf",,"Polar BEAT",,0,,0,168070,250480,30378,,,,,,,,,,,,,,,,,,,,,,,,,,,,,,,,,,,,,,,,,,"4,4",
5964153,d1c3ac0c-516b-47fc-9aeb-438c6b8b2d22,1440449578,120,1548678480,,0,0,11.93,3346,3612,159,161,,,1,2.2,0.54,,,294,816,,,,,,,43.84,,1,,,,,,,,,,,,,,69,83,13.14,13.02,13.35,,,,,,,,,,,,,,,,,"3,1,4,12,40,37,3,0,0",,,,,,,129,,,,,,,,,,,,,,,,,,,,,,,,,,,,,,,,,,,,,17,25,197,73,,1001,,,1,11,3,,1,0,,,,,"Aachen Laufen",,"Polar BEAT",,0,,0,168070,250480,30378,,,,,,,,,,,,,,,,,,,,,,,,,,,,,,,,,,,,,,,,,,4,
5964154,81fa2eaf-9331-4fc1-8b26-5d4bdf7fd1cb,1530609601,120,1548678481,,0,0,14.59,4341,4342,317,317,,,1,4,0.61,1.09,0.94,582,802,139,153,,,,63.49,41.57,65.2,1,,,,,,,,,,,,,,6,82,12.66,12.46,13.17,,,,,,,,,,,,,,,,,"8,7,12,22,23,23,5,0,0","1,1,98,0,0",,,,,,123,,,,,,,,,,,,,,,,,,,,,,,,,,,,,,,,,,,,14.6,20,8,350,44,,,,,0,3,3,,1,0,I1.000|5:25-I1.000|5:32-I1.000|6:30-I1.000|5:13-I1.000|5:15-I1.000|5:39-I1.000|5:10-I1.000|5:01-I1.000|4:30-I1.000|4:34-I1.000|4:21-I1.000|4:05-I1.000|4:06-I1.000|4:11-I0.591|2:49,,Running,,,,"Polar M430",43,0,,0,168070,250480,30378,,,,,,,,,,,,,,,,,,,,,,,,,,,,,,,,,,,,,,,,,,"4,4",
5964155,,1412966700,120,1548678481,,0,0,1,0,0,,,,,0,,,,,,67,,,,,,,,,1,,,,,,,,,,,,,,0,,,,,,,,,,,,,,,,,,,,,,,,,,,,,,,,,,,,,,,,,,,,,,,,,,,,,,,,,,,,,,,,,,,,,,,,,,1,,,0,0,,,,,Einlaufen,,"Polar BEAT",,0,,0,168070,250480,30378,,,,,,,,,,,,,,,,,,,,,,,,,,,,,,,,,,,,,,,,,,,
5964156,2937e440-4a13-4ab0-9717-aaddbf9d33ce,1514966336,60,1548678482,,0,0,11.04,3269,3269,29,42,,,1,0,0.02,1.12,0.94,,702,155,169,,,,55.31,40.92,55.41,1,,,,,,,,,,,,,,91,82,12.14,12.21,12.24,1.8,,,,,,,,,,,,,,,,"1,1,7,31,51,8,1,0,0","0,2,84,14,0",,,,,,124,,,,,,,,,,,,,,,,,,,,,,,,,,,,,,,,,,,,46,11,16,213,84,,,0,,0,6,3,,1,0,I1.000|4:41-I1.000|4:52-I1.000|4:46-I1.000|4:52-I1.000|4:57-I1.000|4:59-I1.000|4:59-I1.000|5:18-I1.000|4:57-I1.000|4:54-I1.000|5:01-I0.043|0:14,,Running,,,,"Polar M430",43,0,,0,168070,250480,30378,,,,,,,,,,,,,,,,,,,,,,,,,,,,,,,,,,,,,,,,,,,
5964157,8818883a-f173-4684-8ee9-1537b192862f,1430252010,120,1548678484,,0,0,3.33,907,907,61,60,,,1,1.6,0.58,,,466,226,,,,,,,41.75,,1,,,,,,,,,,,,,,18,83,13.62,13.3,14.13,,,,,,,,,,,,,,,,,"0,0,6,22,25,30,16,0,0",,,,,,,133,,,,,,,,,,,,,,,,,,,,,,,,,,,,,,,,,,,,,7,8,288,48,,1021,,,0,3,3,,1,0,,,,,"Aachen Laufen",,"Polar BEAT",,0,,0,168070,250480,30378,,,,,,,,,,,,,,,,,,,,,,,,,,,,,,,,,,,,,,,,,,4,
5964158,cd336688-5f9e-4f67-aa48-bb2d6256704d,1424724883,60,1548678485,,0,0,11.13,3113,3320,124,124,,,1,1.1,0.56,,,,757,,,,,,,43.76,,1,,,,,,,,,,,,,,64,83,13.01,13.18,13.34,,,,,,,,,,,,,,,,,"7,3,4,11,28,39,9,0,0",,,,,,,129,,,,,,,,,,,,,,,,,,,,,,,,,,,,,,,,,,,,,4,11,223,90,,998,0,,1,5,3,,1,0,,,,,"Aachen Laufen",,"Polar BEAT",,0,,0,168070,250480,30378,,,,,,,,,,,,,,,,,,,,,,,,,,,,,,,,,,,,,,,,,,,
5964159,,1512680700,60,1548678485,,0,0,15,4200,4200,,,,,0,,,,,,1027,,,,,,,44.71,,1,,,,,,,,,,,,,,87,,,,,,,,,,,,,,,,,,,,,,,,,,,,,,,,,,,,,,,,,,,,,,,,,,,,,,,,,,,,,,,,,,,,,,,,,,1,,,0,0,,,,,,,"no device name available",,0,,0,168070,250480,30378,,,,,,,,,,,,,,,,,,,,,,,,,,,,,,,,,,,,,,,,,,,
5964160,43c57e6c-8dd8-4b46-9526-e701b599456d,1438335037,120,1548678485,,0,0,7.41,2267,2267,110,109,,,1,1.8,0.49,,,430,508,,,,,,,38.32,,1,,,,,,,,,,,,,,47,82,12.13,11.86,12.42,,,,,,,,,,,,,,,,,"1,8,14,31,44,3,0,0,0",,,,,,,120,,,,,,,,,,,,,,,,,,,,,,,,,,,,,,,,,,,,,13,3,45,75,,1021,,,0,5,3,,1,0,,,,,"Aachen Laufen",,"Polar BEAT",,0,,0,168070,250480,30378,,,,,,,,,,,,,,,,,,,,,,,,,,,,,,,,,,,,,,,,,,"5,5",
5964161,a88f42fa-39e7-48e8-a10b-ad96d4ee00d3,1406148649,120,1548678486,,0,0,15.01,3748,3748,201,209,,,1,1.8,0.53,1.05,1.03,835,796,159,187,,,,65.87,51.06,66.92,1,,,,,,,,,,,,,,118,82,14.61,14.6,14.98,2.5,,,,,,,,,,,,,,,,"0,0,1,5,15,49,27,4,0","0,14,41,37,8",,,,,,147,,,,,,,,,,,,,,,,,,,,,,,,,,,,,,,,,,,,111.4,25,6,54,62,,1016,0,,0,3,3,,1,0,,,,,"Gesteigerter DL ",,"Polar BEAT",,0,,0,168070,250480,30378,,,,,,,,,,,,,,,,,,,,,,,,,,,,,,,,,,,,,,,,,,4,
5964162,f38ddaa3-29c4-4288-9cde-d05776147c32,1523300049,120,1548678486,,0,0,10,3145,3172,19,20,,,1,0,0,,0.59,,729,149,186,,,,54.19,37.86,54.31,1,,,,,,,,,,,,,,79,79,11.44,12.85,12.9,22.2,,,,,,,,,,,,,,,,"25,8,9,14,14,2,24,4,0","0,25,54,21,1",,,,,,121,,,,,,,,,,,,,,,,,,,,,,,,,,,,,,,,,,,,58.5,19,8,218,55,,1002,,,0,5,3,,1,0,I3.086|15:45-I1.020|3:51-I1.023|3:50-I0.188|1:59-I1.021|3:46-I0.199|2:05-I0.236|0:52-I0.160|2:53-I1.038|3:39-I2.029|14:17,,Running,,,,"Polar M430",43,0,,0,168070,250480,30378,,,,,,,,,,,,,,,,,,,,,,,,,,,,,,,,,,,,,,,,,,,
5964163,9887d8c5-89b5-4e5e-a6bd-c262da8e8589,1454690622,60,1548678487,,0,0,10.53,2666,2666,82,93,,,1,0.5,0.33,,,,720,,,,,,,48.96,,1,,,,,,,,,,,,,,55,82,14.26,14.27,14.38,,,,,,,,,,,,,,,,,"0,0,0,1,16,62,22,0,0",,,,,,,145,,,,,,,,,,,,,,,,,,,,,,,,,,,,,,,,,,,,,9,15,208,90,,1023,,,0,5,3,,1,0,,,,,"Aachen Laufen",,"Polar BEAT",,0,,0,168070,250480,30378,,,,,,,,,,,,,,,,,,,,,,,,,,,,,,,,,,,,,,,,,,,
5964164,,1400618029,120,1548678487,,0,0,3.3,0,0,,,,,0,,,,,,,,,,,,,,,1,,,,,,,,,,,,,,0,,,,,,,,,,,,,,,,,,,,,,,,,,,,,,,,,,,,,,,,,,,,,,,,,,,,,,,,,,,,,,,,,,,,,,,,,,1,,,0,0,,,,,Einlaufen,,"Polar BEAT",,0,,0,168070,250480,30378,,,,,,,,,,,,,,,,,,,,,,,,,,,,,,,,,,,,,,,,,,,
5964165,75d67f6d-0efb-43f4-9037-5b21b5265372,1404569209,120,1548678487,,0,0,1.13,374,374,0,55,,,1,0.9,0.64,,,,83,,,,,,,29.93,,1,,,,,,,,,,,,,,7,78,10.32,11.15,10.64,,,,,,,,,,,,,,,,,"12,11,22,32,16,7,1,0,0",,,,,,,116,,,,,,,,,,,,,,,,,,,,,,,,,,,,,,,,,,,,,19,18,201,89,,1007,,,0,4,3,,1,0,,,,,Auslaufen,,"Polar BEAT",,0,,0,168070,250480,30378,,,,,,,,,,,,,,,,,,,,,,,,,,,,,,,,,,,,,,,,,,,
5964166,802e6278-0fb6-4ac8-8914-b966ea1cae7b,1402755127,120,1548678487,,0,0,0.32,58,58,0,2,,,1,0.3,0.37,,,,16,,,,,,,54.35,,1,,,,,,,,,,,,,,1,97,19.85,21.27,21.35,,,,,,,,,,,,,,,,,"0,0,0,0,0,0,5,22,72",,,,,,,171,,,,,,,,,,,,,,,,,,,,,,,,,,,,,,,,,,,,,17,6,351,65,,1022,5,,0,5,3,,1,0,,,,,"Lauf ABC",,"Polar BEAT",,0,,0,168070,250480,30378,,,,,,,,,,,,,,,,,,,,,,,,,,,,,,,,,,,,,,,,,,,
5964167,d1a0e0d6-43c5-4b5b-8b7a-4fd4b06c7734,1399753842,120,1548678488,,0,0,11,3232,3244,131,141,,,1,1,0.39,,,291,745,,,,,,,41.28,,1,,,,,,,,,,,,,,67,83,12.5,12.33,12.69,,,,,,,,,,,,,,,,,"1,4,7,24,52,12,1,0,0",,,,,,,123,,,,,,,,,,,,,,,,,,,,,,,,,,,,,,,,,,,,,12,10,242,90,,1006,0,,0,6,3,,1,0,,,,,"Regenerativer DL",,"Polar BEAT",,0,,0,168070,250480,30378,,,,,,,,,,,,,,,,,,,,,,,,,,,,,,,,,,,,,,,,,,5,
5964168,,1396637127,120,1548678488,,0,0,8,0,0,,,,,0,,,,,,,,,,,,,,,1,,,,,,,,,,,,,,0,,,,,,,,,,,,,,,,,,,,,,,,,,,,,,,,,,,,,,,,,,,,,,,,,,,,,,,,,,,,,,,,,,,,,,,,,,1,,,0,0,,,,,"Lockerer DL",,"Polar BEAT",,0,,0,168070,250480,30378,,,,,,,,,,,,,,,,,,,,,,,,,,,,,,,,,,,,,,,,,,,
5964169,26fbd42c-6b20-44f8-af22-b8776a28fc32,1426342112,60,1548678488,,0,0,3.03,919,919,20,51,,,1,0.4,0.4,,,,209,,,,,,,36.58,,1,,,,,,,,,,,,,,19,81,11.75,12.14,12.01,,,,,,,,,,,,,,,,,"14,3,5,25,35,9,7,1,0",,,,,,,122,,,,,,,,,,,,,,,,,,,,,,,,,,,,,,,,,,,,,6,8,49,73,,1026,2,,0,5,3,,1,0,,,,,"Aachen Laufen",,"Polar BEAT",,0,,0,168070,250480,30378,,,,,,,,,,,,,,,,,,,,,,,,,,,,,,,,,,,,,,,,,,,
5964170,d33bb7e4-3a11-4d37-9616-702bc94f7204,1392059183,60,1548678488,,0,0,3.73,1169,1169,82,78,,,1,1.6,0.51,1.25,1.01,,210,140,154,,,,59.01,35.72,60.69,1,,,,,,,,,,,,,,23,84,11.77,11.66,12.37,-6,,,,,,,,,,,,,,,,"10,8,10,36,29,7,0,0,0","0,46,54,0,0",,,,,,114,,,,,,,,,,,,,,,,,,,,,,,,,,,,,,,,,,,,23.1,3,3,235,95,,996,0,,1,6,3,,1,0,,,,,"Auslaufen Finnbahn",,"Polar BEAT",,0,,0,168070,250480,30378,,,,,,,,,,,,,,,,,,,,,,,,,,,,,,,,,,,,,,,,,,,
5964171,ec941411-09b8-46c9-a6f5-a2775f286fe9,1442754848,120,1548678489,,0,0,0.95,314,318,5,4,,,1,0,0.15,0.81,,,46,132,143,,,,59.37,29.39,59.84,1,,,,,,,,,,,,,,5,82,11.13,11.42,11.33,-7.8,,,,,,,,,,,,,,,,"20,13,18,19,12,15,3,0,0","4,86,10,0,0",,,,,,111,,,,,,,,,,,,,,,,,,,,,,,,,,,,,,,,,,,,8.3,15,9,273,67,,1026,,,0,5,3,,1,0,,,,,"Aachen Laufen",,"Polar BEAT",,0,,0,168070,250480,30378,,,,,,,,,,,,,,,,,,,,,,,,,,,,,,,,,,,,,,,,,,,
5964172,d89c935f-28f4-4e7c-a8be-a24d51e04a02,1468669793,120,1548678489,,0,0,1.32,495,638,62,58,,,1,2.3,1,,,720,89,,,,,,,26.4,,1,,,,,,,,,,,,,,10,78,11.31,9.98,11.66,,,,,,,,,,,,,,,,,"46,10,11,17,11,6,0,0,0",,,,,,,103,,,,,,,,,,,,,,,,,,,,,,,,,,,,,,,,,,,,,18,14,235,68,,1024,,,0,4,3,,1,0,,,,,"Menden Laufen",,"Polar BEAT",,0,,0,168070,250480,30378,,,,,,,,,,,,,,,,,,,,,,,,,,,,,,,,,,,,,,,,,,4,
5964173,cc4131a4-4322-46e7-8cd1-2d2141dc1be7,1417260504,60,1548678489,,0,0,4.5,1239,1239,49,32,,,1,0.3,0.28,,,,303,,,,,,,42.12,,1,,,,,,,,,,,,,,25,82,13.41,13.45,13.67,,,,,,,,,,,,,,,,,"6,3,6,8,15,55,7,0,0",,,,,,,133,,,,,,,,,,,,,,,,,,,,,,,,,,,,,,,,,,,,,5,7,89,89,,1014,1,,0,5,3,,1,0,,,,,"Lauf ABC",,"Polar BEAT",,0,,0,168070,250480,30378,,,,,,,,,,,,,,,,,,,,,,,,,,,,,,,,,,,,,,,,,,,
5964174,5724db22-3b31-4c9e-8fd7-ac7d4c487559,1461188585,120,1548678489,,0,0,2.25,692,692,51,54,,,1,0.7,0.37,,,,158,,,,,,,35.07,,1,,,,,,,,,,,,,,14,82,11.92,11.71,12.07,,,,,,,,,,,,,,,,,"0,2,16,47,35,0,0,0,0",,,,,,,119,,,,,,,,,,,,,,,,,,,,,,,,,,,,,,,,,,,,,10,6,52,58,,1028,0,,1,3,3,,1,0,,,,,"Aachen Laufen",,"Polar BEAT",,0,,0,168070,250480,30378,,,,,,,,,,,,,,,,,,,,,,,,,,,,,,,,,,,,,,,,,,,
5964175,7ba04905-36ed-49f3-a6c5-f4b3d942cf9e,1481271089,60,1548678490,,0,0,0.69,245,245,13,8,,,1,1.2,0.71,,,,47,,,,,,,26.14,,1,,,,,,,,,,,,,,5,80,10.61,10.22,10.93,,,,,,,,,,,,,,,,,"29,11,31,16,9,3,0,0,0",,,,,,,106,,,,,,,,,,,,,,,,,,,,,,,,,,,,,,,,,,,,,8,12,215,86,,1030,,,1,5,3,,1,0,,,,,"Aachen Laufen",,"Polar BEAT",,0,,0,168070,250480,30378,,,,,,,,,,,,,,,,,,,,,,,,,,,,,,,,,,,,,,,,,,,
5964176,d69a3769-b713-48b4-a9c9-f608157bfd80,1365619161,120,1548678490,,0,0,12.06,3236,3244,8,8,,,1,0,0,,,,832,,,,,,,46.2,,1,,,,,,,,,,,,,,67,,13.41,13.75,13.77,,,,,,,,,,,,,,,,,"6,4,4,7,19,35,22,4,0",,,,,,,,,,,,,,,,,,,,,,,,,,,,,,,,,,,,,,,,,,,,11,9,236,59,,1010,0,,0,11,3,,1,0,,,,,,,"Polar BEAT",,0,,0,168070,250480,30378,,,,,,,,,,,,,,,,,,,,,,,,,,,,,,,,,,,,,,,,,,,
5964177,dd642db0-8eb5-4f9c-ab1f-68666261bdd3,1397497965,120,1548678491,,0,0,3.62,1073,1336,20,17,,,1,0,0.28,0.95,0.88,,191,144,167,,,,60.98,38.07,61.46,1,,,,,,,,,,,,,,23,82,12.27,12.27,12.4,-9.5,,,,,,,,,,,,,,,,"4,3,6,25,49,12,2,0,0","0,27,60,12,0",,,,,,123,,,,,,,,,,,,,,,,,,,,,,,,,,,,,,,,,,,,23.7,9,29,321,72,,1021,1,,0,5,3,,1,0,,,,,"Einlaufen   Lauf ABC   Berg Sprints",,"Polar BEAT",,0,,0,168070,250480,30378,,,,,,,,,,,,,,,,,,,,,,,,,,,,,,,,,,,,,,,,,,,
5964178,01f7a2c8-fd2c-4b35-8f4d-31c5251ad75b,1494066136,120,1548678491,,0,0,2.68,759,759,29,38,,,1,1.2,0.62,,,,188,,,,,,,39.19,,1,,,,,,,,,,,,,,15,80,12.8,12.86,12.98,,,,,,,,,,,,,,,,,"2,5,8,18,33,29,4,2,0",,,,,,,132,,,,,,,,,,,,,,,,,,,,,,,,,,,,,,,,,,,,,14,8,92,76,,1010,4,,0,3,3,,1,0,,,,,"Aachen Laufen",,"Polar BEAT",,0,,0,168070,250480,30378,,,,,,,,,,,,,,,,,,,,,,,,,,,,,,,,,,,,,,,,,,,
5964179,60adacb6-aeaa-440e-8361-090b34d20837,1503141297,120,1548678491,,0,0,3.35,1007,1008,69,68,,,1,1.8,0.64,1.13,0.98,436,222,143,159,,,,60.47,37.24,62.04,1,,,,,,,,,,,,,,21,80,12.42,12.09,12.87,4,,,,,,,,,,,,,,,,"2,3,19,26,36,11,3,0,0","2,24,74,0,0",,,,,,125,,,,,,,,,,,,,,,,,,,,,,,,,,,,,,,,,,,,26,16,25,243,80,,1017,,,0,5,3,,1,0,I1.000|5:21-I1.000|5:09-I1.000|4:45-I0.359|1:34,,Running,,,,"Polar M430",43,0,,0,168070,250480,30378,,,,,,,,,,,,,,,,,,,,,,,,,,,,,,,,,,,,,,,,,,4,
5964180,5b9439f2-4c93-4756-be3b-0fa9ad9278ff,1403035868,120,1548678491,,0,0,2.36,878,879,25,22,,,1,0.6,0.4,,,,158,,,,,,,28.21,,1,,,,,,,,,,,,,,18,74,9.76,11.52,11.98,,,,,,,,,,,,,,,,,"25,2,8,28,22,15,0,0,0",,,,,,,109,,,,,,,,,,,,,,,,,,,,,,,,,,,,,,,,,,,,,18,6,1,77,,1021,0,,0,5,3,,1,0,,,,,Einlaufen,,"Polar BEAT",,0,,0,168070,250480,30378,,,,,,,,,,,,,,,,,,,,,,,,,,,,,,,,,,,,,,,,,,,
5964181,945911e3-301c-4299-9728-c4a17bc15f76,1478361696,60,1548678492,,0,0,10.01,2437,2437,69,75,,,1,0.6,0.34,,,,675,,,,,,,51.08,,1,,,,,,,,,,,,,,50,83,14.86,14.87,15,,,,,,,,,,,,,,,,,"0,0,0,1,8,48,42,0,0",,,,,,,148,,,,,,,,,,,,,,,,,,,,,,,,,,,,,,,,,,,,,8,6,256,76,,1001,0,,0,5,3,,1,0,,,,,"Aachen Laufen",,"Polar BEAT",,0,,0,168070,250480,30378,,,,,,,,,,,,,,,,,,,,,,,,,,,,,,,,,,,,,,,,,,,
5964182,c1765866-2e8c-484b-aa27-fd02f6737574,1438289042,120,1548678493,,0,0,3.6,1115,1115,39,53,,,1,1.2,0.62,,,,246,,,,,,,36.14,,1,,,,,,,,,,,,,,23,82,11.71,11.73,11.91,,,,,,,,,,,,,,,,,"2,2,13,46,36,0,0,0,0",,,,,,,118,,,,,,,,,,,,,,,,,,,,,,,,,,,,,,,,,,,,,12,5,281,90,,1019,,,0,5,3,,1,0,,,,,"Aachen Laufen",,"Polar BEAT",,0,,0,168070,250480,30378,,,,,,,,,,,,,,,,,,,,,,,,,,,,,,,,,,,,,,,,,,,
5964183,f17eee11-c731-4f4e-8616-940b5fae5396,1468151237,120,1548678494,,0,0,12,3820,4525,143,149,,,1,1.7,0.56,,,360,835,,,,,,,37.84,,1,,,,,,,,,,,,,,79,80,11.47,11.94,12.04,,,,,,,,,,,,,,,,,"15,4,9,21,36,11,4,0,0",,,,,,,118,,,,,,,,,,,,,,,,,,,,,,,,,,,,,,,,,,,,,26,18,208,54,,1012,,,0,5,3,,1,0,,,,,"Aachen Laufen",,"Polar BEAT",,0,,0,168070,250480,30378,,,,,,,,,,,,,,,,,,,,,,,,,,,,,,,,,,,,,,,,,,5,
5964184,eb03178b-b1b5-4fed-9f3b-c004839a242e,1490904984,120,1548678494,,0,0,1.04,315,330,14,21,,,1,0,0.23,,,,75,,,,,,,32.78,,1,,,,,,,,,,,,,,6,77,12.07,11.99,12.12,,,,,,,,,,,,,,,,,"2,2,22,15,50,9,0,0,0",,,,,,,129,,,,,,,,,,,,,,,,,,,,,,,,,,,,,,,,,,,,,18,3,152,54,,1021,0,,1,5,3,,1,0,,,,,"Aachen Laufen",,"Polar BEAT",,0,,0,168070,250480,30378,,,,,,,,,,,,,,,,,,,,,,,,,,,,,,,,,,,,,,,,,,,
5964185,751e671f-bf3c-45b1-bc2d-523895041e35,1410985325,120,1548678495,,0,0,15,4240,4240,208,202,,,1,2.2,0.57,1.01,1.07,404,766,146,181,,,,63.51,44.22,64.64,1,,,,,,,,,,,,,,98,82,13,12.91,13.2,0.2,,,,,,,,,,,,,,,,"1,2,5,19,49,21,2,1,1","0,33,55,12,0",,,,,,129,,,,,,,,,,,,,,,,,,,,,,,,,,,,,,,,,,,,50.2,18,6,81,78,,1011,,,1,3,3,,1,0,,,,,"Regenerativer DL",,"Polar BEAT",,0,,0,168070,250480,30378,,,,,,,,,,,,,,,,,,,,,,,,,,,,,,,,,,,,,,,,,,4,
5964186,9fd09bc0-c75a-40ca-9b2c-cf8626c1f65f,1397737543,120,1548678496,,0,0,15.09,4896,5052,69,70,,,1,0,0.12,1.2,0.98,,729,146,166,,,,53.57,37.68,53.87,1,,,,,,,,,,,,,,111,83,11.13,12.37,12.44,18.7,,,,,,,,,,,,,,,,"15,2,7,16,30,29,2,0,0","0,25,74,1,0",,,,,,111,,,,,,,,,,,,,,,,,,,,,,,,,,,,,,,,,,,,39.5,13,36,222,58,,1018,3,,0,5,3,,1,0,,,,,"Regenerativer DL",,"Polar BEAT",,0,,0,168070,250480,30378,,,,,,,,,,,,,,,,,,,,,,,,,,,,,,,,,,,,,,,,,,,
5964187,39cf0c5b-6fa4-41af-9b23-7cf79c904ed5,1532507866,120,1548678496,,0,0,9.78,1705,1706,35,35,,,1,0,0.14,1.93,,,224,109,134,,,,,,,1,,,,,,,,,,,,,,13,,,20.93,,5.5,-22,94,82,,1,109,99,,,,,,,,,"4,17,79,0,0,0,0","25,75,0,0,0","90,0,0,1,9",,,,,,,,,,,,,,,,,,,,,,,,,,,,,,,,,,,,,,,,,6.1,24,2,78,64,,1015,,,0,3,3,,1,0,,,Cycling,,,,"Polar M430",43,0,,0,168072,,30378,,,,,,,,,,,,,,,,,,,,,,,,,,,,,,,,,,,,,,,,,,,
5964188,24b80f34-459b-4419-9e6b-164c43321cd1,1479760400,60,1548678496,,0,0,2.74,816,863,29,28,,,1,1.3,0.59,,,,183,,,,,,,37.05,,1,,,,,,,,,,,,,,16,82,12.35,12.36,12.5,,,,,,,,,,,,,,,,,"9,7,11,9,38,23,4,0,0",,,,,,,123,,,,,,,,,,,,,,,,,,,,,,,,,,,,,,,,,,,,,11,9,155,88,,1000,0,,1,6,3,,1,0,,,,,"Aachen Laufen",,"Polar BEAT",,0,,0,168070,250480,30378,,,,,,,,,,,,,,,,,,,,,,,,,,,,,,,,,,,,,,,,,,,
5964189,c6023e9b-f811-4efe-8898-d464a67f7a75,1547820176,60,1548678497,,0,0,5.02,1340,1340,22,24,,,1,0,0.12,1.12,0.92,,286,137,152,,,,73.95,43.98,74.31,1,,,,,,,,,,,,,,24,83,13.5,13.51,13.57,-2.4,,,,,,,,,,,,,,,,"1,1,0,4,38,53,4,0,0","2,56,42,0,0",,,,,,135,,,,,,,,,,,,,,,,,,,,,,,,,,,,,,,,,,,,18.9,4,6,197,66,,1021,1,331,0,5,3,,1,0,,,Running,,,,"Polar M430",43,0,,0,168070,250480,30378,,,,,,,,,,,,,,,,,,,,,,,,,,,,,,,,,,,,,,,,,,,
5964190,c954edc7-c451-4395-9faa-4cd37841bba5,1515520217,60,1548678497,,0,0,11.71,3264,3270,136,139,,,1,0.8,0.47,1.05,1,222,777,150,175,,,,62.34,44.1,63.22,1,,,,,,,,,,,,,,83,82,13.06,13,13.21,-1.3,,,,,,,,,,,,,,,,"0,1,4,17,40,33,4,0,0","0,19,63,18,0",,,,,,131,,,,,,,,,,,,,,,,,,,,,,,,,,,,,,,,,,,,54.8,6,5,164,84,,1010,,,1,5,3,,1,0,I1.000|4:59-I1.000|4:46-I1.000|4:51-I1.000|4:28-I1.000|4:50-I1.000|4:21-I1.000|4:26-I1.000|4:28-I1.000|4:18-I1.000|4:43-I1.000|4:50-I0.716|3:32,,Running,,,,"Polar M430",43,0,,0,168070,250480,30378,,,,,,,,,,,,,,,,,,,,,,,,,,,,,,,,,,,,,,,,,,5,
5964191,5094ac02-86fe-43e1-b7ed-1d10b6ab795d,1418058789,60,1548678498,,0,0,12,3315,3571,147,147,,,1,1.1,0.42,,,,810,,,,,,,44.64,,1,,,,,,,,,,,,,,68,82,13.27,13.27,13.48,,,,,,,,,,,,,,,,,"4,3,5,11,22,46,9,1,0",,,,,,,132,,,,,,,,,,,,,,,,,,,,,,,,,,,,,,,,,,,,,2,6,233,95,,1018,0,,1,6,3,,1,0,,,,,"Lockerer DL",,"Polar BEAT",,0,,0,168070,250480,30378,,,,,,,,,,,,,,,,,,,,,,,,,,,,,,,,,,,,,,,,,,,
5964192,8a330544-f2a5-4492-9b40-298d07c4433b,1397651935,120,1548678498,,0,0,10.74,2937,2937,20,21,,,1,0,0.02,,,,551,150,161,,,,63.83,44.81,63.97,1,,,,,,,,,,,,,,73,85,13.17,13.24,13.28,-1.1,,,,,,,,,,,,,,,,"1,0,1,11,34,52,0,0,0","1,2,96,0,0",,,,,,129,,,,,,,,,,,,,,,,,,,,,,,,,,,,,,,,,,,,38.1,11,9,171,61,,1031,5,,0,3,3,,1,0,,,,,"Lockerer DL",,"Polar BEAT",,0,,0,168070,250480,30378,,,,,,,,,,,,,,,,,,,,,,,,,,,,,,,,,,,,,,,,,,,
5964193,498f604a-8d15-413b-905b-3a2c6f0186ff,1429477132,120,1548678498,,0,0,6.16,1530,1538,65,77,,,1,1,0.51,,,,420,,,,,,,48.45,,1,,,,,,,,,,,,,,31,85,14.61,14.8,14.95,,,,,,,,,,,,,,,,,"0,0,1,4,27,24,37,7,0",,,,,,,142,,,,,,,,,,,,,,,,,,,,,,,,,,,,,,,,,,,,,11,11,44,50,,1022,,,1,3,3,,1,0,,,,,"Aachen Laufen",,"Polar BEAT",,0,,0,168070,250480,30378,,,,,,,,,,,,,,,,,,,,,,,,,,,,,,,,,,,,,,,,,,,
5964194,63b892f4-3f0c-45c6-8013-ca951fff6be6,1393684436,60,1548678499,,0,0,3.84,1114,1114,12,12,,,1,0,0.11,,,,259,,,,,,,39.2,,1,,,,,,,,,,,,,,23,82,12.44,12.48,12.56,,,,,,,,,,,,,,,,,"0,0,8,28,44,20,0,0,0",,,,,,,126,,,,,,,,,,,,,,,,,,,,,,,,,,,,,,,,,,,,,7,9,182,74,,1001,,,0,4,3,,1,0,,,,,Einlaufen,,"Polar BEAT",,0,,0,168070,250480,30378,,,,,,,,,,,,,,,,,,,,,,,,,,,,,,,,,,,,,,,,,,,
5964195,afefed20-5f15-4442-955d-4f55a7218447,1459967606,120,1548678500,,0,0,20.49,5722,7331,311,315,,,1,3.1,0.55,,,349,1415,,,,,,,45.98,,1,,,,,,,,,,,,,,118,83,13.17,13.04,13.35,,,,,,,,,,,,,,,,,"2,2,4,15,38,37,2,0,0",,,,,,,129,,,,,,,,,,,,,,,,,,,,,,,,,,,,,,,,,,,,,12,15,223,69,,1008,0,,0,5,3,,1,0,,,,,"Aachen Laufen",,"Polar BEAT",,0,,0,168070,250480,30378,,,,,,,,,,,,,,,,,,,,,,,,,,,,,,,,,,,,,,,,,,4,
5964196,9b2c72ce-1057-43bc-8f35-1fdac2c71ee4,1481276106,60,1548678500,,0,0,0.82,266,266,13,18,,,1,0.7,0.49,,,,48,,,,,,,29.54,,1,,,,,,,,,,,,,,5,79,11.13,11.28,11.44,,,,,,,,,,,,,,,,,"11,11,36,13,19,9,0,0,0",,,,,,,117,,,,,,,,,,,,,,,,,,,,,,,,,,,,,,,,,,,,,8,7,235,82,,1030,0,,0,5,3,,1,0,,,,,"Aachen Laufen",,"Polar BEAT",,0,,0,168070,250480,30378,,,,,,,,,,,,,,,,,,,,,,,,,,,,,,,,,,,,,,,,,,,
5964197,cca184bf-3fc0-4ae7-b4df-dbdb99b65c76,1408479241,120,1548678500,,0,0,2.86,838,838,29,25,,,1,0.2,0.29,,,,188,,,,,,,37.89,,1,,,,,,,,,,,,,,17,81,12.39,12.4,12.8,,,,,,,,,,,,,,,,,"6,1,4,19,49,21,0,0,0",,,,,,,126,,,,,,,,,,,,,,,,,,,,,,,,,,,,,,,,,,,,,12,4,262,78,,1015,0,,0,5,3,,1,0,,,,,Einlaufen,,"Polar BEAT",,0,,0,168070,250480,30378,,,,,,,,,,,,,,,,,,,,,,,,,,,,,,,,,,,,,,,,,,,
5964198,a2986fbf-f2f7-422b-81a0-a571e0e439b3,1450960681,60,1548678501,,0,0,19.02,4696,4743,262,261,,,1,2.6,0.42,,,486,1286,,,,,,,52.7,,1,,,,,,,,,,,,,,97,83,14.9,14.72,15.18,,,,,,,,,,,,,,,,,"0,0,1,4,12,38,42,2,0",,,,,,,146,,,,,,,,,,,,,,,,,,,,,,,,,,,,,,,,,,,,,12,25,182,72,,1017,,,0,5,3,,1,0,,,,,"Menden Laufen",,"Polar BEAT",,0,,0,168070,250480,30378,,,,,,,,,,,,,,,,,,,,,,,,,,,,,,,,,,,,,,,,,,"4,4,5",
5964199,6254d398-e171-42eb-9c75-b0d393d8ddad,1404850641,120,1548678501,,0,0,1.77,517,528,10,8,,,1,0,0.23,,,,130,,,,,,,36.27,,1,,,,,,,,,,,,,,10,81,12.39,12.42,12.57,,,,,,,,,,,,,,,,,"5,9,4,6,66,7,3,0,0",,,,,,,127,,,,,,,,,,,,,,,,,,,,,,,,,,,,,,,,,,,,,12,8,306,99,,1013,0,,0,6,3,,1,0,,,,,,,"Polar BEAT",,0,,0,168070,250480,30378,,,,,,,,,,,,,,,,,,,,,,,,,,,,,,,,,,,,,,,,,,,
5964200,56b40cec-9658-4c6b-905d-728cea225bda,1472592819,120,1548678501,,0,0,4.19,1147,1171,45,62,,,1,1,0.56,,,,287,,,,,,,42.21,,1,,,,,,,,,,,,,,23,82,13.28,13.47,13.47,,,,,,,,,,,,,,,,,"6,1,3,12,22,39,16,0,0",,,,,,,134,,,,,,,,,,,,,,,,,,,,,,,,,,,,,,,,,,,,,17,2,69,68,,1024,0,,1,3,3,,1,0,,,,,"Aachen Laufen",,"Polar BEAT",,0,,0,168070,250480,30378,,,,,,,,,,,,,,,,,,,,,,,,,,,,,,,,,,,,,,,,,,,
5964201,fd0ad20b-6336-48ff-b80d-86ec8501ef5c,1435352733,120,1548678501,,0,0,10.01,2307,2307,118,122,,,1,1.2,0.48,,,,669,,,,,,,54.47,,1,,,,,,,,,,,,,,47,84,15.8,15.68,15.95,,,,,,,,,,,,,,,,,"0,0,0,0,2,28,61,9,0",,,,,,,155,,,,,,,,,,,,,,,,,,,,,,,,,,,,,,,,,,,,,22,7,180,61,,1017,,,0,5,3,,1,0,,,,,"Aachen Laufen",,"Polar BEAT",,0,,0,168070,250480,30378,,,,,,,,,,,,,,,,,,,,,,,,,,,,,,,,,,,,,,,,,,,
5964202,b718cab2-04f6-416b-b922-0dbcca44c486,1430856719,120,1548678502,,0,0,3.35,924,924,66,65,,,1,1.7,0.64,,,464,225,,,,,,,41.17,,1,,,,,,,,,,,,,,19,82,13.48,13.13,14.02,,,,,,,,,,,,,,,,,"0,2,5,14,41,27,11,1,0",,,,,,,133,,,,,,,,,,,,,,,,,,,,,,,,,,,,,,,,,,,,,14,8,229,63,,1009,0,,0,5,3,,1,0,,,,,"Aachen Laufen",,"Polar BEAT",,0,,0,168070,250480,30378,,,,,,,,,,,,,,,,,,,,,,,,,,,,,,,,,,,,,,,,,,4,
5964203,a4058d15-7d8b-49d1-9b60-a0e7c78ca442,1475701442,120,1548678502,,0,0,1.2,414,533,23,30,,,1,0.9,0.5,,,,80,,,,,,,28.74,,1,,,,,,,,,,,,,,8,80,11,10.48,11.27,,,,,,,,,,,,,,,,,"24,13,27,20,11,5,0,0,0",,,,,,,109,,,,,,,,,,,,,,,,,,,,,,,,,,,,,,,,,,,,,8,6,55,69,,1030,0,,1,3,3,,1,0,,,,,"Aachen Laufen",,"Polar BEAT",,0,,0,168070,250480,30378,,,,,,,,,,,,,,,,,,,,,,,,,,,,,,,,,,,,,,,,,,,
5964204,e8930248-4133-43fb-8077-49a019c32d09,1444212227,120,1548678502,,0,0,3.74,1436,1439,106,103,,,1,2.4,0.62,,,206,257,,,,,,,28.03,,1,,,,,,,,,,,,,,29,84,9.85,9.58,10.63,,,,,,,,,,,,,,,,,"40,23,26,10,1,0,0,0,0",,,,,,,93,,,,,,,,,,,,,,,,,,,,,,,,,,,,,,,,,,,,,14,16,209,89,,1009,,,0,5,3,,1,0,,,,,"Aachen Laufen",,"Polar BEAT",,0,,0,168070,250480,30378,,,,,,,,,,,,,,,,,,,,,,,,,,,,,,,,,,,,,,,,,,4,
5964205,c59c186c-8eee-4675-8972-cc577519546e,1410697959,120,1548678503,,0,0,20.16,5585,5625,308,307,,,1,2.8,0.48,,,512,1361,,,,,,,46.35,,1,,,,,,,,,,,,,,115,83,13.28,13.13,13.62,,,,,,,,,,,,,,,,,"2,1,5,15,31,42,4,1,0",,,,,,,130,,,,,,,,,,,,,,,,,,,,,,,,,,,,,,,,,,,,,15,5,64,90,,1021,3,,0,5,3,,1,0,,,,,"Langsamer DL ",,"Polar BEAT",,0,,0,168070,250480,30378,,,,,,,,,,,,,,,,,,,,,,,,,,,,,,,,,,,,,,,,,,"4,5,5",
5964206,dd8a91f5-1bc6-4c8b-91fa-04d41c35f381,1446287468,60,1548678503,,0,0,8.37,2541,2570,208,208,,,1,3.2,0.66,1.08,1.01,525,428,154,171,,,,54.12,38.98,55.79,1,,,,,,,,,,,,,,70,82,12.53,12.32,13.17,0.4,,,,,,,,,,,,,,,,"8,13,13,18,22,22,2,3,0","0,10,54,36,0",,,,,,121,,,,,,,,,,,,,,,,,,,,,,,,,,,,,,,,,,,,54.5,10,12,117,81,,1027,,,0,3,3,,1,0,,,,,"Balve Laufen",,"Polar BEAT",,0,,0,168070,250480,30378,,,,,,,,,,,,,,,,,,,,,,,,,,,,,,,,,,,,,,,,,,"4,5",
5964207,947ab2ce-24e0-4ee7-b1ee-79dfd052239c,1397564696,120,1548678506,,0,0,14,4994,5294,56,59,,,1,0,0.13,1.34,1.13,,758,148,200,,,,46.81,33.51,47.03,1,,,,,,,,,,,,,,126,80,10.14,12.51,12.58,31.9,,,,,,,,,,,,,,,,"27,1,3,8,15,40,5,0,0","9,6,71,14,0",,,,,,105,,,,,,,,,,,,,,,,,,,,,,,,,,,,,,,,,,,,50.2,8,22,357,66,,1029,3,,0,5,3,,1,0,,,,,"Züggiger DL",,"Polar BEAT",,0,,0,168070,250480,30378,,,,,,,,,,,,,,,,,,,,,,,,,,,,,,,,,,,,,,,,,,,
5964208,60c119ce-e95e-440a-bd94-ae9b66284229,1521448875,60,1548678506,,0,0,11.43,2038,2041,45,50,,,1,0,0.14,2.22,0.57,,409,138,162,,,,,,,1,,,,,,,,,,,,,,38,,,21.69,,1.6,-13.6,101,80,,1,116,101,,,,,,,,,"13,14,69,4,0,0,0","0,58,42,1,0","85,1,6,7,1",,,,,,,,,,,,,,,,,,,,,,,,,,,,,,,,,,,,,,,,,26.7,-1,6,53,71,,,1,,0,5,3,,1,0,,,Cycling,,,,"Polar M430",43,0,,0,168072,,30378,,,,,,,,,,,,,,,,,,,,,,,,,,,,,,,,,,,,,,,,,,,
5964209,058d5cdd-a697-4b75-b3b7-a9f0f39a3083,1458070754,60,1548678507,,0,0,10.51,2581,2635,8,10,,,1,0,0,,,,702,,,,,,,50.73,,1,,,,,,,,,,,,,,53,84,14.7,15.91,15.97,,,,,,,,,,,,,,,,,"10,6,6,8,4,3,14,47,1",,,,,,,145,,,,,,,,,,,,,,,,,,,,,,,,,,,,,,,,,,,,,4,11,38,86,,1026,,,1,5,3,,1,0,,,,,"Aachen Laufen",,"Polar BEAT",,0,,0,168070,250480,30378,,,,,,,,,,,,,,,,,,,,,,,,,,,,,,,,,,,,,,,,,,,
5964210,5bad6b48-ea29-443b-bc90-acac3f91ab7a,1408902655,120,1548678508,,0,0,25.66,7155,7159,387,387,,,1,2.9,0.54,,,548,1717,,,,,,,46.87,,1,,,,,,,,,,,,,,148,83,13.18,13.36,13.8,,,,,,,,,,,,,,,,,"4,1,4,14,28,37,12,1,0",,,,,,,130,,,,,,,,,,,,,,,,,,,,,,,,,,,,,,,,,,,,,15,4,295,70,,1019,1,,0,5,3,,1,0,,,,,"Lockerer DL",,"Polar BEAT",,0,,0,168070,250480,30378,,,,,,,,,,,,,,,,,,,,,,,,,,,,,,,,,,,,,,,,,,"4,5,5",
5964211,98cfaf3c-da75-4073-90d4-9347055ae9b7,1403808014,120,1548678508,,0,0,7,1632,1632,90,69,,,1,0.9,0.42,,,,468,,,,,,,52.59,,1,,,,,,,,,,,,,,33,85,15.77,15.58,15.93,,,,,,,,,,,,,,,,,"0,0,1,3,4,25,55,11,0",,,,,,,151,,,,,,,,,,,,,,,,,,,,,,,,,,,,,,,,,,,,,21,2,24,40,,1014,2,,0,5,3,,1,0,,,,,"Zügiger DL",,"Polar BEAT",,0,,0,168070,250480,30378,,,,,,,,,,,,,,,,,,,,,,,,,,,,,,,,,,,,,,,,,,,
5964212,3a4efee8-da7f-44e7-b230-826c5c10cd9b,1399930735,120,1548678509,,0,0,5,1214,1217,51,34,,,1,0.3,0.28,,,,334,,,,,,,49.13,,1,,,,,,,,,,,,,,25,83,15.15,15.29,15.48,,,,,,,,,,,,,,,,,"5,1,1,5,17,21,34,15,2",,,,,,,149,,,,,,,,,,,,,,,,,,,,,,,,,,,,,,,,,,,,,8,3,244,92,,1013,0,,1,6,3,,1,0,,,,,"Zügiger DL + Lauf ABC + Steigerungen",,"Polar BEAT",,0,,0,168070,250480,30378,,,,,,,,,,,,,,,,,,,,,,,,,,,,,,,,,,,,,,,,,,,
5964213,56c23885-81c7-444a-b6d7-1b27928c5f36,1472588621,120,1548678509,,0,0,0.3,106,106,4,5,,,1,0.2,0.33,,,,22,,,,,,,24.5,,1,,,,,,,,,,,,,,2,80,10.26,10.25,10.36,,,,,,,,,,,,,,,,,"13,12,44,30,0,0,0,0,0",,,,,,,106,,,,,,,,,,,,,,,,,,,,,,,,,,,,,,,,,,,,,18,2,62,63,,1024,0,,0,3,3,,1,0,,,,,"Aachen Laufen",,"Polar BEAT",,0,,0,168070,250480,30378,,,,,,,,,,,,,,,,,,,,,,,,,,,,,,,,,,,,,,,,,,,
5964214,216da8ee-a8e9-4bca-a1cb-61bfff1f4843,1366923444,120,1548678509,,0,0,7.72,2028,2049,145,144,,,1,2.1,0.6,1.07,1.01,569,539,166,182,,,,58.09,45.97,59.45,1,,,,,,,,,,,,,,75,,14.18,14.51,14.94,-6.4,,,,,,,,,,,,,,,,"10,3,4,9,11,23,27,12,1","4,3,13,78,2",,,,,,,,,,,,,,,,,,,,,,,,,,,,,,,,,,,,,,,,,,92.2,20,3,237,50,,1018,0,,1,3,3,,1,0,,,,,,,"Polar BEAT",,0,,0,168070,250480,30378,,,,,,,,,,,,,,,,,,,,,,,,,,,,,,,,,,,,,,,,,,4,
5964215,ede52c6a-fb39-483c-8424-080dd559084e,1405773594,120,1548678510,,0,0,15,3652,3652,415,417,,,1,3.9,0.73,,,569,997,,,,,,,52.57,,1,,,,,,,,,,,,,,75,82,15.44,15.01,16.32,,,,,,,,,,,,,,,,,"2,0,0,1,8,40,40,8,0",,,,,,,150,,,,,,,,,,,,,,,,,,,,,,,,,,,,,,,,,,,,,30,9,155,36,,,,,0,3,3,,1,0,,,,,"Zügiger DL",,"Polar BEAT",,0,,0,168070,250480,30378,,,,,,,,,,,,,,,,,,,,,,,,,,,,,,,,,,,,,,,,,,"4,4,5,5,5",
5964216,35507000-3b7e-4376-85f6-b806e4076006,1367352769,120,1548678511,,0,0,3.39,997,1012,66,65,,,1,1.8,0.65,1.04,1.02,452,240,152,169,,,,57.3,38.24,58.7,1,,,,,,,,,,,,,,26,,12.77,12.6,13.43,2.9,,,,,,,,,,,,,,,,"5,2,5,20,42,25,1,0,0","0,4,76,20,0",,,,,,,,,,,,,,,,,,,,,,,,,,,,,,,,,,,,,,,,,,34.4,12,6,56,50,,1022,0,,0,5,3,,1,0,,,,,,,"Polar BEAT",,0,,0,168070,250480,30378,,,,,,,,,,,,,,,,,,,,,,,,,,,,,,,,,,,,,,,,,,4,
5964217,b1b223a3-7763-4cc5-9df9-d7c2f97a3429,1363630617,60,1548678511,,0,0,9.87,2769,2796,12,9,,,1,0,0,,,,679,163,182,,,,55.03,43.24,55.13,1,,,,,,,,,,,,,,96,,12.88,13.3,13.34,4,,,,,,,,,,,,,,,,"3,3,11,25,17,23,16,1,1","0,1,56,29,14",,,,,,,,,,,,,,,,,,,,,,,,,,,,,,,,,,,,,,,,,,106.4,1,6,275,99,,993,0,,1,5,3,,1,0,,,,,,,"Polar BEAT",,0,,0,168070,250480,30378,,,,,,,,,,,,,,,,,,,,,,,,,,,,,,,,,,,,,,,,,,,
5964218,49f9e07e-3674-4f09-8a9e-816fd60a4743,1474808662,120,1548678512,,0,0,10.24,2361,2361,215,214,,,1,2.9,0.71,,,520,682,,,,,,,54.52,,1,,,,,,,,,,,,,,49,85,16.27,16.01,16.53,,,,,,,,,,,,,,,,,"0,1,1,4,9,24,33,25,3",,,,,,,153,,,,,,,,,,,,,,,,,,,,,,,,,,,,,,,,,,,,,22,15,182,49,,1016,,,0,3,3,,1,0,,,,,"Aachen Laufen",,"Polar BEAT",,0,,0,168070,250480,30378,,,,,,,,,,,,,,,,,,,,,,,,,,,,,,,,,,,,,,,,,,"4,5",
5964219,290f4c08-6f93-4392-a117-1928340948b5,1424454722,60,1548678512,,0,0,10.08,2855,3211,112,93,,,1,0.7,0.36,,,,699,,,,,,,42.82,,1,,,,,,,,,,,,,,59,84,12.97,12.89,13.11,,,,,,,,,,,,,,,,,"4,3,2,9,46,36,0,0,0",,,,,,,126,,,,,,,,,,,,,,,,,,,,,,,,,,,,,,,,,,,,,6,13,203,89,,1006,0,,1,6,3,,1,0,,,,,"Aachen Laufen",,"Polar BEAT",,0,,0,168070,250480,30378,,,,,,,,,,,,,,,,,,,,,,,,,,,,,,,,,,,,,,,,,,,
5964220,49d9585e-c6ed-4ab5-b585-a244170cda52,1455262971,60,1548678513,,0,0,13,3721,3806,155,154,,,1,1.6,0.47,,,356,900,,,,,,,43.1,,1,,,,,,,,,,,,,,77,84,12.78,12.75,13,,,,,,,,,,,,,,,,,"3,2,4,18,46,25,2,0,0",,,,,,,125,,,,,,,,,,,,,,,,,,,,,,,,,,,,,,,,,,,,,2,10,166,88,,1003,,,0,5,3,,1,0,,,,,"Aachen Laufen",,"Polar BEAT",,0,,0,168070,250480,30378,,,,,,,,,,,,,,,,,,,,,,,,,,,,,,,,,,,,,,,,,,"5,5",
5964221,,1427448595,60,1548678513,,0,0,8,0,0,,,,,0,,,,,,,,,,,,,,,1,,,,,,,,,,,,,,0,,,,,,,,,,,,,,,,,,,,,,,,,,,,,,,,,,,,,,,,,,,,,,,,,,,,,,,,,,,,,,,,,,,,,,,,,,1,,,0,0,,,,,"Lauf ABC ",,"Polar BEAT",,0,,0,168070,250480,30378,,,,,,,,,,,,,,,,,,,,,,,,,,,,,,,,,,,,,,,,,,,
5964222,3bc30722-43c7-4576-acd8-7713c87c7cdd,1407325246,120,1548678513,,0,0,7.08,2100,2100,82,57,,,1,0.5,0.37,,,,491,,,,,,,39.64,,1,,,,,,,,,,,,,,43,82,12.38,12.22,12.65,,,,,,,,,,,,,,,,,"2,1,11,32,44,10,1,0,0",,,,,,,123,,,,,,,,,,,,,,,,,,,,,,,,,,,,,,,,,,,,,23,8,192,56,,1016,4,,0,5,3,,1,0,,,,,"Einlaufen + Lauf ABC",,"Polar BEAT",,0,,0,168070,250480,30378,,,,,,,,,,,,,,,,,,,,,,,,,,,,,,,,,,,,,,,,,,,
5964223,e9fd93f9-55d7-4873-8e26-d4680b59f54d,1402571042,120,1548678514,,0,0,13.1,3898,3900,165,165,,,1,1.7,0.58,,,389,887,,,,,,,41.22,,1,,,,,,,,,,,,,,80,82,12.27,12.18,12.43,,,,,,,,,,,,,,,,,"2,2,10,23,58,5,0,0,0",,,,,,,123,,,,,,,,,,,,,,,,,,,,,,,,,,,,,,,,,,,,,19,4,29,59,,1028,6,,0,3,3,,1,0,,,,,"Langsamer DL",,"Polar BEAT",,0,,0,168070,250480,30378,,,,,,,,,,,,,,,,,,,,,,,,,,,,,,,,,,,,,,,,,,5,
5964224,8865a371-8026-4612-9cc2-af0d722a0b3f,1543045844,60,1548678515,,0,0,31.19,9764,9774,495,493,,,1,3.6,0.41,1.12,0.95,492,2500,154,178,,,,52.11,41.46,53.14,1,,,,,,,,,,,,,,274,84,11.93,11.62,12.46,5,,,,,,,,,,,,,,,,"7,5,12,40,34,2,0,0,0","0,12,54,34,0",,,,,,114,,,,,,,,,,,,,,,,,,,,,,,,,,,,,,,,,,,,73.8,2,5,180,100,,,0,,0,4,3,,1,0,I1.000|4:34-I1.000|4:46-I1.000|5:07-I1.000|5:09-I1.000|4:59-I1.000|5:09-I1.000|4:55-I1.000|5:15-I1.000|6:24-I1.000|5:36-I1.000|5:41-I1.000|5:00-I1.000|5:03-I1.000|4:59-I1.000|5:04-I1.000|5:12-I1.000|5:23-I1.000|5:39-I1.000|5:37-I1.000|6:20-I1.000|5:16-I1.000|4:59-I1.000|5:02-I1.000|5:02-I1.000|4:58-I1.000|5:02-I1.000|5:06-I1.000|5:11-I1.000|4:56-I1.000|5:16-I1.000|5:18-I0.189|0:59,,Running,,,,"Polar M430",43,0,,0,168070,250480,30378,,,,,,,,,,,,,,,,,,,,,,,,,,,,,,,,,,,,,,,,,,"3,4",
5964225,a4ae8d69-1c48-4bf3-8594-399dfb80982c,1469735918,120,1548678516,,0,0,5.05,1381,1490,105,41,,,1,1.6,0.52,,,587,346,,,,,,,42.76,,1,,,,,,,,,,,,,,28,80,13.98,13.48,14.49,,,,,,,,,,,,,,,,,"3,2,8,12,24,38,9,1,2",,,,,,,137,,,,,,,,,,,,,,,,,,,,,,,,,,,,,,,,,,,,,22,6,254,63,,1014,0,,0,3,3,,1,0,,,,,"Aachen Laufen",,"Polar BEAT",,0,,0,168070,250480,30378,,,,,,,,,,,,,,,,,,,,,,,,,,,,,,,,,,,,,,,,,,4,
5964226,1e0ae182-103e-4ea6-b458-38c214043d26,1410103968,120,1548678516,,0,0,9.6,2076,2078,21,20,,,1,0,0,,,,651,,,,,,,58.53,,1,,,,,,,,,,,,,,43,89,16.68,16.85,16.88,,,,,,,,,,,,,,,,,"0,0,1,2,4,11,35,43,3",,,,,,,156,,,,,,,,,,,,,,,,,,,,,,,,,,,,,,,,,,,,,21,5,273,60,,1015,,,0,5,3,,1,0,,,,,"WK 10k Kö Lauf",,"Polar BEAT",,0,,0,168070,250480,30378,,,,,,,,,,,,,,,,,,,,,,,,10,2076,,,0,"27. Stadtwerke Düsseldorf Kö-Lauf",,,,,,,0,0,30378,5964226,8675,,,
5964227,0fd66fde-ae9e-4a93-a1c2-e6f42bc454d4,1457079691,60,1548678516,,0,0,6.38,2110,2176,62,61,,,1,0.8,0.35,,,222,443,,,,,,,34.62,,1,,,,,,,,,,,,,,43,82,11.04,11.46,11.61,,,,,,,,,,,,,,,,,"14,5,9,33,39,1,0,0,0",,,,,,,111,,,,,,,,,,,,,,,,,,,,,,,,,,,,,,,,,,,,,2,22,152,84,,997,,,0,5,3,,1,0,,,,,"Aachen Laufen",,"Polar BEAT",,0,,0,168070,250480,30378,,,,,,,,,,,,,,,,,,,,,,,,,,,,,,,,,,,,,,,,,,5,
5964228,b557f596-b750-4302-84a4-bc92cda0f0f7,1548259556,60,1548678517,,0,0,10.09,2914,2916,65,65,,,1,0,0.12,1.05,0.87,,625,138,157,,,,66.47,41.86,67,1,,,,,,,,,,,,,,54,80,12.52,12.65,12.77,9,,,,,,,,,,,,,,,,"2,1,3,18,58,16,2,0,0","0,60,39,0,0",,,,,,130,,,,,,,,,,,,,,,,,,,,,,,,,,,,,,,,,,,,24.2,0,13,15,69,,999,0,403,0,4,3,,1,0,,,Running,,,,"Polar M430",43,0,,0,168070,250480,30378,,,,,,,,,,,,,,,,,,,,,,,,,,,,,,,,,,,,,,,,,,,
5964229,b2be26db-75db-42f9-ab9f-400b6ea6605b,1497467900,120,1548678517,,0,0,6.86,2114,2888,109,110,,,1,1.2,0.53,,,249,471,,,,,,,37.81,,1,,,,,,,,,,,,,,43,78,12.01,11.92,12.2,,,,,,,,,,,,,,,,,"11,5,7,28,35,14,0,0,0",,,,,,,125,,,,,,,,,,,,,,,,,,,,,,,,,,,,,,,,,,,,,25,8,53,48,,1016,,,0,3,3,,1,0,,,,,"Aachen Laufen",,"Polar BEAT",,0,,0,168070,250480,30378,,,,,,,,,,,,,,,,,,,,,,,,,,,,,,,,,,,,,,,,,,"5,5",
5964230,4459ebd7-8941-467b-a710-d5a120ed801a,1438287221,120,1548678518,,0,0,2.74,931,940,67,44,,,1,1.8,0.63,,,514,189,,,,,,,31.77,,1,,,,,,,,,,,,,,19,79,11.22,11.38,12.64,,,,,,,,,,,,,,,,,"17,2,7,35,37,2,0,0,0",,,,,,,112,,,,,,,,,,,,,,,,,,,,,,,,,,,,,,,,,,,,,12,5,281,90,,1019,,,0,5,3,,1,0,,,,,"Aachen Laufen",,"Polar BEAT",,0,,0,168070,250480,30378,,,,,,,,,,,,,,,,,,,,,,,,,,,,,,,,,,,,,,,,,,5,
5964231,cd506ac7-feb2-454e-9c41-80dbde9d2000,1420036151,60,1548678518,,0,0,14.95,3098,3098,24,18,,,1,0,0.03,,,,1009,,,,,,,63.35,,1,,,,,,,,,,,,,,64,88,17.42,17.39,17.43,,,,,,,,,,,,,,,,,"0,0,0,0,0,0,33,67,0",,,,,,,165,,,,,,,,,,,,,,,,,,,,,,,,,,,,,,,,,,,,,4,11,240,94,,,,,0,9,3,,1,0,,,,,"Silvester Lauf",,"Polar BEAT",,0,,0,168070,250480,30378,,,,,,,,,,,,,,,,,,,,,,,,15,3098,,,0,"Silvesterlauf Werl-Soest",,,,,,,0,0,30378,5964231,10743,,,
5964232,442bebc6-c8fd-4b6c-9778-29d22b916fc0,1542266945,60,1548678520,,0,0,10.84,3247,3252,28,32,,,1,0,0.06,1.1,0.91,,808,150,168,,,,57.04,40.32,57.19,1,,,,,,,,,,,,,,81,82,12.03,12.1,12.18,0.1,,,,,,,,,,,,,,,,"1,1,9,43,40,3,2,0,0","0,9,86,5,0",,,,,,122,,,,,,,,,,,,,,,,,,,,,,,,,,,,,,,,,,,,42.9,5,9,41,100,,,0,,0,4,3,,1,0,I7.028|35:16-I0.264|1:01-I0.196|1:00-I3.352|16:56,,Running,,,,"Polar M430",43,0,,0,168070,250480,30378,,,,,,,,,,,,,,,,,,,,,,,,,,,,,,,,,,,,,,,,,,,
5964233,888d3feb-fc6e-44aa-a1c5-41fa85d491e0,1499005437,120,1548678521,,0,0,0.03,12,12,0,5,,,1,1.2,1,,,,3,,,,,,,19.64,,1,,,,,,,,,,,,,,0,54,8.21,7.54,8.21,,,,,,,,,,,,,,,,,"100,0,0,0,0,0,0,0,0",,,,,,,139,,,,,,,,,,,,,,,,,,,,,,,,,,,,,,,,,,,,,25,31,325,45,,1017,9,,0,3,3,,1,0,,,,,"Saint-Marc-Jaumegarde Laufen",,"Polar BEAT",,0,,0,168070,250480,30378,,,,,,,,,,,,,,,,,,,,,,,,,,,,,,,,,,,,,,,,,,,
5964234,696e2353-5dd7-4e5d-83e4-ac9e9905ebee,1392924709,60,1548678521,,0,0,10.53,2668,2668,406,387,,,1,5.3,0.75,1.23,0.77,880,571,166,182,,,,60.74,48.92,63.79,1,,,,,,,,,,,,,,96,86,15.14,14.46,16.57,-1.1,,,,,,,,,,,,,,,,"0,2,9,15,18,12,32,13,0","0,0,35,64,1",,,,,,138,,,,,,,,,,,,,,,,,,,,,,,,,,,,,,,,,,,,70.7,9,13,199,86,,1006,0,,1,5,3,,1,0,,,,,"20x Dreieck",,"Polar BEAT",,0,,0,168070,250480,30378,,,,,,,,,,,,,,,,,,,,,,,,,,,,,,,,,,,,,,,,,,"5,5,5,5,5,5,5,5,5,5,5,5,5,5,5",
5964235,de7ed8df-1f33-498a-a1b6-74e1d8d8227c,1469562995,120,1548678521,,0,0,3.94,1081,1111,62,21,,,1,1,0.54,,,,278,,,,,,,41.92,,1,,,,,,,,,,,,,,22,81,13.67,13.32,14.07,,,,,,,,,,,,,,,,,"1,6,6,13,25,37,11,1,0",,,,,,,135,,,,,,,,,,,,,,,,,,,,,,,,,,,,,,,,,,,,,21,1,32,69,,1020,0,,0,5,3,,1,0,,,,,"Aachen Laufen",,"Polar BEAT",,0,,0,168070,250480,30378,,,,,,,,,,,,,,,,,,,,,,,,,,,,,,,,,,,,,,,,,,,
5964236,df54a840-e9fc-41f6-97f6-e7a8833bcc9c,1408821766,120,1548678521,,0,0,2.86,840,840,43,17,,,1,0.6,0.35,,,392,198,,,,,,,37.79,,1,,,,,,,,,,,,,,17,81,12.73,12.37,13.16,,,,,,,,,,,,,,,,,"0,4,18,21,41,11,4,1,0",,,,,,,126,,,,,,,,,,,,,,,,,,,,,,,,,,,,,,,,,,,,,13,4,244,85,,1015,0,,0,6,3,,1,0,,,,,Einlaufen,,"Polar BEAT",,0,,0,168070,250480,30378,,,,,,,,,,,,,,,,,,,,,,,,,,,,,,,,,,,,,,,,,,5,
5964237,77dd0d63-2dbf-4467-b57a-5a403ceb9ad3,1405024714,120,1548678522,,0,0,6.37,1740,1955,42,45,,,1,0,0.14,,,,381,,,,,,,43.41,,1,,,,,,,,,,,,,,36,81,13.2,15.2,15.23,,,,,,,,,,,,,,,,,"24,4,3,5,7,8,11,36,3",,,,,,,136,,,,,,,,,,,,,,,,,,,,,,,,,,,,,,,,,,,,,21,8,286,87,,1012,0,,0,5,3,,1,0,,,,,"5x 500m 2x5x 300m",,"Polar BEAT",,0,,0,168070,250480,30378,,,,,,,,,,,,,,,,,,,,,,,,,,,,,,,,,,,,,,,,,,,
5964238,c7af16d9-9b33-4a9a-81c0-eccbe6547027,1545156430,60,1548678522,,0,0,13.08,3346,3348,66,65,,,1,0,0.23,1.12,0.93,,919,160,172,,,,63.35,49.13,63.76,1,,,,,,,,,,,,,,105,83,14.12,14.11,14.22,1.8,,,,,,,,,,,,,,,,"0,0,0,1,10,81,8,0,0","1,2,41,56,0",,,,,,141,,,,,,,,,,,,,,,,,,,,,,,,,,,,,,,,,,,,64.6,1,8,131,98,,1022,0,264,1,9,3,,1,0,I1.000|4:42-I1.000|4:22-I1.000|4:13-I1.000|4:15-I1.000|4:12-I1.000|4:16-I1.000|4:09-I1.000|4:08-I1.000|4:06-I1.000|4:14-I1.000|4:18-I1.000|4:16-I1.000|4:17-I0.077|0:22,,Running,,,,"Polar M430",43,0,,0,168070,250480,30378,,,,,,,,,,,,,,,,,,,,,,,,,,,,,,,,,,,,,,,,,,,
5964239,38e4a782-cc6d-4a4a-b2bd-4e24472888b7,1512296607,60,1548678523,,0,0,3.39,1051,1051,54,50,,,1,0.2,0.3,1.14,0.9,,220,138,155,,,,60.89,35.95,62.17,1,,,,,,,,,,,,,,19,82,11.86,11.8,12.14,-9.9,,,,,,,,,,,,,,,,"4,13,22,22,28,7,4,0,0","2,45,53,0,0",,,,,,118,,,,,,,,,,,,,,,,,,,,,,,,,,,,,,,,,,,,25,-1,7,206,92,,1026,,,0,4,3,,1,0,I1.000|5:55-I1.000|5:14-I1.000|4:45-I0.394|1:39,,Running,,,,"Polar M430",43,0,,0,168070,250480,30378,,,,,,,,,,,,,,,,,,,,,,,,,,,,,,,,,,,,,,,,,,,
5964240,8249762d-c1ea-4c15-8041-33c8aae2b843,1475702553,120,1548678523,,0,0,2.1,522,522,41,43,,,1,1.2,1,,,,139,,,,,,,44.34,,1,,,,,,,,,,,,,,10,87,14.57,16.32,16.79,,,,,,,,,,,,,,,,,"18,0,0,1,0,1,42,38,0",,,,,,,139,,,,,,,,,,,,,,,,,,,,,,,,,,,,,,,,,,,,,8,6,55,69,,1030,0,,1,3,3,,1,0,,,,,"Aachen Laufen",,"Polar BEAT",,0,,0,168070,250480,30378,,,,,,,,,,,,,,,,,,,,,,,,,,,,,,,,,,,,,,,,,,,
5964241,6185f828-c3f9-4707-acb3-9bff4f4fb993,1515599607,60,1548678523,,0,0,0.51,167,169,6,0,,,1,0.5,0.4,,,,27,122,138,,,,65.71,27.9,67.63,1,,,,,,,,,,,,,,2,81,10.9,10.92,10.94,-0.5,,,,,,,,,,,,,,,,"9,8,28,50,5,0,0,0,0","11,89,0,0,0",,,,,,113,,,,,,,,,,,,,,,,,,,,,,,,,,,,,,,,,,,,3.2,8,6,191,79,,1009,0,,0,5,3,,1,0,,,Running,,,,"Polar M430",43,0,,0,168070,250480,30378,,,,,,,,,,,,,,,,,,,,,,,,,,,,,,,,,,,,,,,,,,,
5964243,5ede3755-e03d-4050-b8a4-80e4be8d715c,1526494794,120,1548678523,,0,0,11.04,1987,1988,48,45,,,1,0,0.1,2.61,0.33,,253,107,129,,,,,,,1,,,,,,,,,,,,,,15,,,20.52,,13.7,-17.8,93,82,,1,112,103,,,,,,,,,"6,23,70,1,0,0,0","27,73,0,0,0","90,1,0,1,9",,,,,,,,,,,,,,,,,,,,,,,,,,,,,,,,,,,,,,,,,7,19,2,17,59,,,2,,0,5,3,,1,0,,,Cycling,,,,"Polar M430",43,0,,0,168072,,30378,,,,,,,,,,,,,,,,,,,,,,,,,,,,,,,,,,,,,,,,,,,
5964244,755d5134-6518-4caa-9a56-0fbaeb30db4d,1466550631,120,1548678524,,0,0,6.77,1773,1773,83,83,,,1,1,0.46,,,393,464,,,,,,,45.78,,1,,,,,,,,,,,,,,36,81,14,14.31,14.43,,,,,,,,,,,,,,,,,"4,2,2,13,12,32,29,5,1",,,,,,,141,,,,,,,,,,,,,,,,,,,,,,,,,,,,,,,,,,,,,17,4,207,92,,1021,0,,1,5,3,,1,0,,,,,"Voeren Sint-Martens-Voeren Laufen",,"Polar BEAT",,0,,0,168070,250480,30378,,,,,,,,,,,,,,,,,,,,,,,,,,,,,,,,,,,,,,,,,,5,
5964245,035f5293-d2f8-4c3a-8264-8f0be4995646,1402696949,120,1548678524,,0,0,5.2,1104,1104,0,2,,,1,0,0,,,,346,,,,,,,57.62,,1,,,,,,,,,,,,,,22,87,16.95,17.13,17.12,,,,,,,,,,,,,,,,,"1,0,0,0,0,0,51,47,0",,,,,,,162,,,,,,,,,,,,,,,,,,,,,,,,,,,,,,,,,,,,,17,3,344,69,,1021,0,,1,5,3,,1,0,,,,,"WK 5.000m Hase",,"Polar BEAT",,0,,0,168070,250480,30378,,,,,,,,,,,,,,,,,,,,,,,,,,,,,,,,,,,,,,,,,,,
5964246,,1363532264,60,1548678524,,0,0,,3941,3941,,,,,0,,,,,,547,,,,,,,,,1,,,,,,,,,,,,,,44,,,,,,,,,,,,,,,,,,,,,,,,,,,,,,,,,,,,,,,,,,,,,,,,,,,,,,,,,,,,,,,,,,,,,,,,,,1,,,0,0,,,,,,,"Polar BEAT",,0,,0,168075,,30378,,,,,,,,,,,,,,,,,,,,,,,,,,,,,,,,,,,,,,,,,,,
5964247,f32a873d-0ef9-4d96-b85e-659f51d3d537,1455826424,60,1548678524,,0,0,1.83,567,567,26,37,,,1,1.3,0.77,,,,130,,,,,,,34.05,,1,,,,,,,,,,,,,,11,82,11.69,11.74,11.84,,,,,,,,,,,,,,,,,"1,8,11,43,36,0,0,0,0",,,,,,,118,,,,,,,,,,,,,,,,,,,,,,,,,,,,,,,,,,,,,0,5,180,76,,1017,,,1,3,3,,1,0,,,,,"Aachen Laufen",,"Polar BEAT",,0,,0,168070,250480,30378,,,,,,,,,,,,,,,,,,,,,,,,,,,,,,,,,,,,,,,,,,,
5964248,4022ff57-d6f0-4568-8619-238d59e2cbc7,1483189892,60,1548678525,,0,0,12.87,4040,4113,183,182,,,1,2.4,0.62,,,372,879,,,,,,,38.67,,1,,,,,,,,,,,,,,83,82,11.73,11.87,12.15,,,,,,,,,,,,,,,,,"8,4,13,28,35,11,1,0,0",,,,,,,117,,,,,,,,,,,,,,,,,,,,,,,,,,,,,,,,,,,,,1,3,229,71,,1033,1,,0,3,3,,1,0,,,,,"Aachen Laufen",,"Polar BEAT",,0,,0,168070,250480,30378,,,,,,,,,,,,,,,,,,,,,,,,,,,,,,,,,,,,,,,,,,4,
5964249,086675a7-5264-4bdd-9d81-492721e3b184,1520673163,60,1548678525,,0,0,6.48,1944,1944,21,20,,,1,0,0.06,1.12,0.95,,526,163,175,,,,50.66,38.9,50.87,1,,,,,,,,,,,,,,65,82,12.04,12.05,12.13,3.6,,,,,,,,,,,,,,,,"1,2,8,39,45,5,0,0,0","1,4,20,76,0",,,,,,122,,,,,,,,,,,,,,,,,,,,,,,,,,,,,,,,,,,,71.3,11,3,213,79,,,1,,0,5,3,,1,0,I1.000|5:04-I1.000|5:02-I1.000|4:56-I1.000|5:08-I1.000|4:58-I1.000|4:52-I0.491|2:25,,Running,,,,"Polar M430",43,0,,0,168070,250480,30378,,,,,,,,,,,,,,,,,,,,,,,,,,,,,,,,,,,,,,,,,,,
5964250,43a04ceb-09f4-425a-95f7-ed65ec673a6c,1506366997,120,1548678526,,0,0,13.48,3396,3396,191,194,,,1,2.4,0.63,0.99,0.98,386,951,166,187,,,,61.17,50.12,62.23,1,,,,,,,,,,,,,,126,81,14.6,14.46,14.83,1.8,,,,,,,,,,,,,,,,"1,1,1,7,7,53,29,2,0","0,1,40,43,15",,,,,,147,,,,,,,,,,,,,,,,,,,,,,,,,,,,,,,,,,,,110.4,17,11,50,72,,1020,,,1,4,1,,1,0,I1.000|5:07-I1.000|4:12-I1.000|4:10-I1.000|4:11-I1.000|3:53-I1.000|4:05-I1.000|4:49-I1.000|4:09-I1.000|4:09-I1.000|3:55-I1.000|4:01-I1.000|4:15-I1.000|3:40-I0.487|2:02,,Running,,,,"Polar M430",43,0,,0,168070,250480,30378,,,,,,,,,,,,,,,,,,,,,,,,,,,,,,,,,,,,,,,,,,4,
5964251,ca48a219-50d3-40af-8ec7-f15a3a76ef5d,1407180823,120,1548678527,,0,0,22.52,6763,6839,349,371,,,1,3.1,0.6,1.06,1.02,516,924,134,155,,,,65.65,42.57,66.83,1,,,,,,,,,,,,,,115,82,12.27,12.1,12.61,2.2,,,,,,,,,,,,,,,,"2,4,14,29,41,9,1,0,0","0,72,28,0,0",,,,,,122,,,,,,,,,,,,,,,,,,,,,,,,,,,,,,,,,,,,27.5,20,2,337,70,,1017,0,,0,5,3,,1,0,,,,,"Langer Langsamer DL",,"Polar BEAT",,0,,0,168070,250480,30378,,,,,,,,,,,,,,,,,,,,,,,,,,,,,,,,,,,,,,,,,,"4,5,5,5",
5964252,c1fb5718-8562-4d04-8b9f-c1ae1141fd6c,1480015794,60,1548678527,,0,0,4.04,1407,1784,44,43,,,1,1.1,0.6,,,,246,,,,,,,31.67,,1,,,,,,,,,,,,,,29,74,10.36,13.19,13.44,,,,,,,,,,,,,,,,,"43,2,2,2,4,7,21,18,0",,,,,,,116,,,,,,,,,,,,,,,,,,,,,,,,,,,,,,,,,,,,,7,16,51,89,,1020,,,1,5,3,,1,0,,,,,"Aachen Laufen",,"Polar BEAT",,0,,0,168070,250480,30378,,,,,,,,,,,,,,,,,,,,,,,,,,,,,,,,,,,,,,,,,,,
5964253,42cc4f31-d3a6-4cf3-87fa-380f58f04fdc,1473801027,120,1548678527,,0,0,5.83,1674,1800,0,1,,,1,0,0,,,,362,,,,,,,40.71,,1,,,,,,,,,,,,,,34,82,12.57,14.55,14.55,,,,,,,,,,,,,,,,,"35,2,2,3,3,4,9,31,10",,,,,,,127,,,,,,,,,,,,,,,,,,,,,,,,,,,,,,,,,,,,,24,3,105,61,,1012,0,,1,3,3,,1,0,,,,,"Aachen Laufen",,"Polar BEAT",,0,,0,168070,250480,30378,,,,,,,,,,,,,,,,,,,,,,,,,,,,,,,,,,,,,,,,,,,
5964254,,1413735480,120,1548678527,,0,0,3,0,0,,,,,0,,,,,,199,,,,,,,,,1,,,,,,,,,,,,,,0,,,,,,,,,,,,,,,,,,,,,,,,,,,,,,,,,,,,,,,,,,,,,,,,,,,,,,,,,,,,,,,,,,,,,,,,,,1,,,0,0,,,,,Einlaufen,,"Polar BEAT",,0,,0,168070,250480,30378,,,,,,,,,,,,,,,,,,,,,,,,,,,,,,,,,,,,,,,,,,,
5964255,e9077e0c-f938-433f-a3ef-91888364afca,1416514657,60,1548678528,,0,0,3.51,1148,1149,28,62,,,1,0.6,0.48,,,,232,,,,,,,33.83,,1,,,,,,,,,,,,,,23,82,10.88,11.14,11.09,,,,,,,,,,,,,,,,,"9,4,23,47,17,0,0,0,0",,,,,,,112,,,,,,,,,,,,,,,,,,,,,,,,,,,,,,,,,,,,,4,5,93,94,,1026,0,,1,5,3,,1,0,,,,,Auslaufen,,"Polar BEAT",,0,,0,168070,250480,30378,,,,,,,,,,,,,,,,,,,,,,,,,,,,,,,,,,,,,,,,,,,
5964256,7343aaa1-1a56-4fac-b9f5-3de82fb2ae75,1516520998,60,1548678528,,0,0,2.56,507,531,13,8,,,1,0,0.08,1.96,0.27,,74,116,134,,,,,,,1,,,,,,,,,,,,,,5,,,20.19,,41.4,-9.8,87,79,,1,107,103,,,,,,,,,"26,22,47,4,0,0,0","19,81,0,0,0","95,0,0,0,5",,,,,,,,,,,,,,,,,,,,,,,,,,,,,,,,,,,,,,,,,6.2,3,9,256,82,,1013,,,1,5,3,,1,0,,,Cycling,,,,"Polar M430",43,0,,0,168072,,30378,,,,,,,,,,,,,,,,,,,,,,,,,,,,,,,,,,,,,,,,,,,
5964257,9ec3b44a-fc44-48d7-bd11-7aa11677c7a4,1439669700,120,1548678528,,0,0,10.1,2115,2115,54,53,,,1,0,0.12,,,,685,,,,,,,60.97,,1,,,,,,,,,,,,,,43,88,17.24,17.25,17.33,,,,,,,,,,,,,,,,,"0,0,0,0,0,1,49,50,0",,,,,,,163,,,,,,,,,,,,,,,,,,,,,,,,,,,,,,,,,,,,,18,12,300,92,,1011,,,0,4,3,,1,0,,,,,"Duisburg Laufen",,"Polar BEAT",,0,,0,168070,250480,30378,,,,,,,,,,,,,,,,,,,,,,,,10,2115,,,0,"Duisburger Innenhafenlauf",,,,,,,0,0,30378,5964257,3175,,,
5964258,4c0c32de-81eb-4157-b725-e19d31cf1c70,1410381088,120,1548678531,,0,0,15.01,4002,4042,198,195,,,1,2.1,0.52,,,415,994,,,,,,,47.32,,1,,,,,,,,,,,,,,83,83,13.78,13.65,13.96,,,,,,,,,,,,,,,,,"1,1,5,9,27,44,14,0,0",,,,,,,136,,,,,,,,,,,,,,,,,,,,,,,,,,,,,,,,,,,,,14,3,25,79,,1019,0,,1,5,3,,1,0,,,,,"Lockerer DL",,"Polar BEAT",,0,,0,168070,250480,30378,,,,,,,,,,,,,,,,,,,,,,,,,,,,,,,,,,,,,,,,,,4,
5964259,f6dfba85-7a78-4eaa-a2c3-4bcc179e0a90,1524645144,120,1548678531,,0,0,11.15,2161,2178,36,43,,,1,0,0.16,2.18,0.56,,277,108,132,,,,,,,1,,,,,,,,,,,,,,17,,,19.61,,7.2,-9.1,83,68,,1,99,88,,,,,,,,,"17,26,55,2,0,0,0","24,76,0,0,0","86,1,10,2,1",,,,,,,,,,,,,,,,,,,,,,,,,,,,,,,,,,,,,,,,,7,15,4,215,74,,,1,,0,5,3,,1,0,,,Cycling,,,,"Polar M430",43,0,,0,168072,,30378,,,,,,,,,,,,,,,,,,,,,,,,,,,,,,,,,,,,,,,,,,,
5964260,,1485099606,60,1548678531,,0,0,,0,0,,,,,0,,,,,,,,,,,,,,,1,,,,,,,,,,,,,,0,,,,,,,,,,,,,,,,,,,,,,,,,,,,,,,,,,,,,,,,,,,,,,,,,,,,,,,,,,,,,,,,,,,,,,,,,,1,,,0,0,,,,,"Maasmechelen Laufen",,"Polar BEAT",,0,,0,168070,250480,30378,,,,,,,,,,,,,,,,,,,,,,,,,,,,,,,,,,,,,,,,,,,
5964261,,1539190800,120,1548678531,,0,0,10,1800,1800,,,,,0,,,,,,385,,,,,,,,,1,,,,,,,,,,,,,,20,,,,,,,,,,,,,,,,,,,,,,,,,,,,,,,,,,,,,,,,,,,,,,,,,,,,,,,,,,,,,,,,,,,,,,,,,,1,,,0,0,,,,,,,"no device name available",,0,,0,168072,,30378,,,,,,,,,,,,,,,,,,,,,,,,,,,,,,,,,,,,,,,,,,,
5964262,2c072717-b66b-4326-9909-1f617e023a9c,1492196733,120,1548678531,,0,0,,3,3,0,0,,,1,0,0,,,,1,,,,,,,,,1,,,,,,,,,,,,,,0,,,3.34,,,,4,4,,1,4,4,,,,,,,,,"100,0,0,0,0,0,0",,"100,0,0,0,0",,,,,,,,,,,,,,,,,,,,,,,,,,,,,,,,,,,,,,,,,,11,7,260,67,,,0,,0,5,3,,1,0,,,,,"Dortmund Radfahren",,"Polar BEAT",,0,,0,168072,,30378,,,,,,,,,,,,,,,,,,,,,,,,,,,,,,,,,,,,,,,,,,,
5964263,f71143a9-e059-492d-8ca3-bc1a5ae79b99,1424520610,60,1548678532,,0,0,3.35,942,942,67,67,,,1,1.7,0.64,,,466,230,,,,,,,40.26,,1,,,,,,,,,,,,,,19,84,13.21,12.86,13.72,,,,,,,,,,,,,,,,,"0,0,6,24,37,28,6,0,0",,,,,,,127,,,,,,,,,,,,,,,,,,,,,,,,,,,,,,,,,,,,,4,8,246,87,,1000,2,,0,5,3,,1,0,,,,,"Aachen Laufen",,"Polar BEAT",,0,,0,168070,250480,30378,,,,,,,,,,,,,,,,,,,,,,,,,,,,,,,,,,,,,,,,,,4,
5964264,5ccda4b8-4d53-411f-8214-21c3e9f49d0d,1516526022,60,1548678532,,0,0,2.72,645,731,15,12,,,1,0,0.18,1.93,0.37,,93,109,131,,,,,,,1,,,,,,,,,,,,,,5,,,17.79,,23.7,-29.2,82,63,,1,103,93,,,,,,,,,"32,33,35,0,0,0,0","19,81,0,0,0","96,0,0,0,4",,,,,,,,,,,,,,,,,,,,,,,,,,,,,,,,,,,,,,,,,4.3,3,2,253,84,,,0,,0,5,3,,1,0,,,Cycling,,,,"Polar M430",43,0,,0,168072,,30378,,,,,,,,,,,,,,,,,,,,,,,,,,,,,,,,,,,,,,,,,,,
5964265,ee704e2f-c606-49a6-a3b1-dd880713296c,1420116811,60,1548678532,,0,0,10.93,2782,2823,190,192,,,1,2.8,0.58,,,528,724,,,,,,,48.79,,1,,,,,,,,,,,,,,57,85,14.58,14.45,14.93,,,,,,,,,,,,,,,,,"2,3,4,7,12,27,45,0,0",,,,,,,139,,,,,,,,,,,,,,,,,,,,,,,,,,,,,,,,,,,,,4,12,204,87,,,,,0,3,3,,1,0,,,,,"Zügiger DL",,"Polar BEAT",,0,,0,168070,250480,30378,,,,,,,,,,,,,,,,,,,,,,,,,,,,,,,,,,,,,,,,,,"4,5",
5964266,d8207d73-4330-42ce-8822-fb1dea7817a0,1367354414,120,1548678533,,0,0,13.66,4332,5667,62,100,,,1,0.4,0.27,0.82,0.74,,907,135,210,,,,60.82,38.39,60.96,1,,,,,,,,,,,,,,94,,11.41,13.73,13.79,28.6,,,,,,,,,,,,,,,,"27,3,9,20,13,5,1,18,3","18,23,41,10,8",,,,,,,,,,,,,,,,,,,,,,,,,,,,,,,,,,,,,,,,,,88.5,12,6,56,50,,1022,0,,1,5,3,,1,0,,,,,,,"Polar BEAT",,0,,0,168070,250480,30378,,,,,,,,,,,,,,,,,,,,,,,,,,,,,,,,,,,,,,,,,,,
5964267,1a980115-1496-4232-8389-429dbee2203d,1398252927,120,1548678533,,0,0,4.98,1358,1360,37,28,,,1,0,0.12,1.24,0.93,,299,158,172,,,,59.61,42.87,60.29,1,,,,,,,,,,,,,,41,85,13.35,13.34,13.65,-6,,,,,,,,,,,,,,,,"2,0,3,10,31,51,3,0,0","1,2,55,42,0",,,,,,129,,,,,,,,,,,,,,,,,,,,,,,,,,,,,,,,,,,,52.7,17,2,231,67,,1020,5,,0,3,3,,1,0,,,,,"Einlaufen + Lauf ABC",,"Polar BEAT",,0,,0,168070,250480,30378,,,,,,,,,,,,,,,,,,,,,,,,,,,,,,,,,,,,,,,,,,,
5964268,e912abb0-e7b7-4f5f-965a-702b815af28e,1427132963,60,1548678534,,0,0,26.84,7590,7671,424,424,,,1,3.3,0.57,,,436,1820,,,,,,,46.26,,1,,,,,,,,,,,,,,157,83,13.02,13.3,13.9,,,,,,,,,,,,,,,,,"6,1,3,10,32,38,8,1,0",,,,,,,128,,,,,,,,,,,,,,,,,,,,,,,,,,,,,,,,,,,,,10,6,280,59,,1013,,,0,5,3,,1,0,,,,,"Längerer DL",,"Polar BEAT",,0,,0,168070,250480,30378,,,,,,,,,,,,,,,,,,,,,,,,,,,,,,,,,,,,,,,,,,"4,4,4,5",
5964270,e460516f-42cf-4db1-8637-379e49fd27d6,1452423637,60,1548678535,,0,0,23.43,6436,6832,342,342,,,1,2.3,0.47,,,351,1592,,,,,,,47.37,,1,,,,,,,,,,,,,,133,83,13.4,13.32,13.69,,,,,,,,,,,,,,,,,"4,1,3,9,32,45,6,0,0",,,,,,,132,,,,,,,,,,,,,,,,,,,,,,,,,,,,,,,,,,,,,6,21,201,79,,994,,,0,3,3,,1,0,,,,,"Aachen Laufen",,"Polar BEAT",,0,,0,168070,250480,30378,,,,,,,,,,,,,,,,,,,,,,,,,,,,,,,,,,,,,,,,,,"4,4,5",
5964271,9e4f3a47-9666-4ee3-91b4-ae3df4ef36ae,1409052239,120,1548678536,,0,0,8.02,2208,2214,96,96,,,1,1.2,0.5,,,,545,,,,,,,43.61,,1,,,,,,,,,,,,,,45,82,13.26,13.13,13.39,,,,,,,,,,,,,,,,,"0,0,0,13,48,37,2,0,0",,,,,,,133,,,,,,,,,,,,,,,,,,,,,,,,,,,,,,,,,,,,,15,3,230,99,,1005,3,,0,6,3,,1,0,,,,,"Regenerativer DL",,"Polar BEAT",,0,,0,168070,250480,30378,,,,,,,,,,,,,,,,,,,,,,,,,,,,,,,,,,,,,,,,,,,
5964272,b401f297-75b3-4ee0-8ab0-15e0df329282,1408620481,120,1548678537,,0,0,13.97,4498,4587,339,494,,,1,3.3,0.53,,,536,963,,,,,,,37.78,,1,,,,,,,,,,,,,,93,82,11.71,12.33,13.4,,,,,,,,,,,,,,,,,"16,11,12,29,25,5,1,0,1",,,,,,,114,,,,,,,,,,,,,,,,,,,,,,,,,,,,,,,,,,,,,15,9,238,77,,1018,4,,0,5,3,,1,0,,,,,"Langsamer DL",,"Polar BEAT",,0,,0,168070,250480,30378,,,,,,,,,,,,,,,,,,,,,,,,,,,,,,,,,,,,,,,,,,"4,5,5",
5964273,aa3eaf10-441d-44fd-9b66-af8bf771d084,1408656866,120,1548678537,,0,0,1.85,659,659,25,24,,,1,0.9,0.55,,,,120,,,,,,,29.04,,1,,,,,,,,,,,,,,13,82,10.29,10.16,10.37,,,,,,,,,,,,,,,,,"23,31,17,22,7,0,0,0,0",,,,,,,103,,,,,,,,,,,,,,,,,,,,,,,,,,,,,,,,,,,,,13,4,202,80,,1016,0,,1,5,3,,1,0,,,,,Auslaufen,,"Polar BEAT",,0,,0,168070,250480,30378,,,,,,,,,,,,,,,,,,,,,,,,,,,,,,,,,,,,,,,,,,,
5964274,9c12dac5-d96c-4bd8-9a21-ac429bb3eebd,1368041673,120,1548678537,,0,0,0.13,42,42,3,0,,,1,1.2,1,,,,5,,,,,,,26.29,,1,,,,,,,,,,,,,,0,,11.7,11.78,12.69,,,,,,,,,,,,,,,,,"26,14,5,17,7,31,0,0,0",,,,,,,,,,,,,,,,,,,,,,,,,,,,,,,,,,,,,,,,,,,,16,16,196,81,,1010,,,0,5,3,,1,0,,,,,,,"Polar BEAT",,0,,0,168070,250480,30378,,,,,,,,,,,,,,,,,,,,,,,,,,,,,,,,,,,,,,,,,,,
5964275,77aac7a1-59ef-4e07-8244-9069c5b5addb,1408797352,120,1548678538,,0,0,5.74,1786,2913,77,42,,,1,0.6,0.4,,,,384,,,,,,,36.98,,1,,,,,,,,,,,,,,37,80,11.89,11.67,12.1,,,,,,,,,,,,,,,,,"3,6,12,48,26,5,0,0,0",,,,,,,121,,,,,,,,,,,,,,,,,,,,,,,,,,,,,,,,,,,,,16,8,263,75,,1014,4,,0,5,3,,1,0,,,,,Einlaufen,,"Polar BEAT",,0,,0,168070,250480,30378,,,,,,,,,,,,,,,,,,,,,,,,,,,,,,,,,,,,,,,,,,,
5964276,5738c967-506a-4c76-878e-ac8abd93b8db,1412015805,120,1548678538,,0,0,2.56,822,822,24,42,,,1,0.8,0.55,1.04,1.07,,140,133,146,,,,60.98,33.76,61.16,1,,,,,,,,,,,,,,13,81,11.21,11.34,11.29,-4.9,,,,,,,,,,,,,,,,"4,13,12,49,20,2,0,0,0","0,89,11,0,0",,,,,,115,,,,,,,,,,,,,,,,,,,,,,,,,,,,,,,,,,,,12.8,16,4,207,91,,1024,0,,0,6,3,,1,0,,,,,Auslaufen,,"Polar BEAT",,0,,0,168070,250480,30378,,,,,,,,,,,,,,,,,,,,,,,,,,,,,,,,,,,,,,,,,,,
5964277,ff34c455-998f-41a2-92d0-cfcd5b04b76b,1465333567,120,1548678538,,0,0,5.66,1585,1714,105,100,,,1,2,0.61,,,273,392,,,,,,,41.86,,1,,,,,,,,,,,,,,32,80,13.2,12.97,13.6,,,,,,,,,,,,,,,,,"2,3,7,10,39,34,5,0,0",,,,,,,134,,,,,,,,,,,,,,,,,,,,,,,,,,,,,,,,,,,,,17,1,25,95,,1022,0,,0,6,3,,1,0,,,,,"Aachen Laufen",,"Polar BEAT",,0,,0,168070,250480,30378,,,,,,,,,,,,,,,,,,,,,,,,,,,,,,,,,,,,,,,,,,4,
5964278,8d3dabdc-5e16-4d90-9169-2e7e82cc676d,1529605494,120,1548678538,,0,0,0.91,319,319,4,4,,,1,0,0,1.22,1.04,,59,127,136,,,,57.75,27.34,58.06,1,,,,,,,,,,,,,,4,81,10.33,10.37,10.43,2.9,,,,,,,,,,,,,,,,"14,15,46,23,2,0,0,0,0","4,96,0,0,0",,,,,,106,,,,,,,,,,,,,,,,,,,,,,,,,,,,,,,,,,,,6.9,20,21,9,42,,,2,,0,3,3,,1,0,,,Running,,,,"Polar M430",43,0,,0,168070,250480,30378,,,,,,,,,,,,,,,,,,,,,,,,,,,,,,,,,,,,,,,,,,,
5964279,efe91932-501d-42e6-ae60-fe26dd6f109b,1547490864,60,1548678539,,0,0,3.26,1113,1115,19,20,,,1,0,0.12,1.14,0.97,,201,123,139,,,,61.85,31.99,62.27,1,,,,,,,,,,,,,,13,78,10.57,10.56,10.65,-1.8,,,,,,,,,,,,,,,,"1,13,70,14,3,0,0,0,0","0,100,0,0,0",,,,,,113,,,,,,,,,,,,,,,,,,,,,,,,,,,,,,,,,,,,8,3,5,190,93,,1019,0,315,1,5,3,,1,0,,,Running,,,,"Polar M430",43,0,,0,168070,250480,30378,,,,,,,,,,,,,,,,,,,,,,,,,,,,,,,,,,,,,,,,,,,
5964280,e64887c7-b7f0-4512-84b9-4a7f9a1c5022,1474663429,120,1548678539,,0,0,0.7,209,209,4,14,,,1,1.1,0.71,,,,47,,,,,,,31.95,,1,,,,,,,,,,,,,,4,81,11.88,12.25,12.02,,,,,,,,,,,,,,,,,"10,11,15,17,17,15,15,0,0",,,,,,,124,,,,,,,,,,,,,,,,,,,,,,,,,,,,,,,,,,,,,15,1,44,78,,1026,0,,1,3,3,,1,0,,,,,"Aachen Laufen",,"Polar BEAT",,0,,0,168070,250480,30378,,,,,,,,,,,,,,,,,,,,,,,,,,,,,,,,,,,,,,,,,,,
5964281,f07aa95c-eb56-4c78-8fc5-a4d2b32bb138,1479418054,60,1548678540,,0,0,14.18,4143,4523,218,186,,,1,2.2,0.52,,,296,958,,,,,,,42.36,,1,,,,,,,,,,,,,,86,80,12.69,13.23,13.67,,,,,,,,,,,,,,,,,"11,3,5,9,12,51,8,0,0",,,,,,,128,,,,,,,,,,,,,,,,,,,,,,,,,,,,,,,,,,,,,11,16,219,84,,1001,0,,1,5,3,,1,0,,,,,"Aachen Laufen",,"Polar BEAT",,0,,0,168070,250480,30378,,,,,,,,,,,,,,,,,,,,,,,,,,,,,,,,,,,,,,,,,,4,
5964282,681efe37-e35d-4273-83df-31bb4a477135,1448186017,60,1548678540,,0,0,10,2613,2650,45,45,,,1,0,0.1,,,,684,,,,,,,47.03,,1,,,,,,,,,,,,,,54,84,13.83,13.99,14.07,,,,,,,,,,,,,,,,,"0,0,2,9,27,37,21,2,0",,,,,,,137,,,,,,,,,,,,,,,,,,,,,,,,,,,,,,,,,,,,,8,4,63,51,,1002,,,0,3,3,,1,0,,,,,"Gorla Laufen",,"Polar BEAT",,0,,0,168070,250480,30378,,,,,,,,,,,,,,,,,,,,,,,,,,,,,,,,,,,,,,,,,,,
5964283,7c65c054-03ca-4310-a058-0e69945480cb,1464267105,120,1548678540,,0,0,4.24,1136,1887,65,67,,,1,1.6,0.57,,,412,285,,,,,,,43.32,,1,,,,,,,,,,,,,,23,82,13.75,13.95,14.66,,,,,,,,,,,,,,,,,"6,3,7,18,11,23,24,7,0",,,,,,,137,,,,,,,,,,,,,,,,,,,,,,,,,,,,,,,,,,,,,20,1,166,51,,1016,7,,0,5,3,,1,0,,,,,"Aachen Laufen",,"Polar BEAT",,0,,0,168070,250480,30378,,,,,,,,,,,,,,,,,,,,,,,,,,,,,,,,,,,,,,,,,,5,
5964285,5f75acc2-9b14-497d-85f0-47bcf3c1e8d3,1369582438,120,1548678543,,0,0,38.64,5123,5252,576,607,,,1,3.1,0.48,,,873,1277,,,,,,,,,1,,,,,,,,,,,,,,57,,,32.89,,,,262,201,,1,380,327,,,,,,,,,"19,15,12,14,10,8,21",,"46,19,11,8,15",,,,,,,,,,,,,,,,,,,,,,,,,,,,,,,,,,,,,,,,,,9,10,286,89,,1014,4,,0,5,3,,1,0,,,,,,,"Polar BEAT",,0,,0,168072,,30378,,,,,,,,,,,,,,,,,,,,,,,,,,,,,,,,,,,,,,,,,,"4,4,5,5,5",
5964286,cc243555-231d-44d0-a889-ee1046f4d40b,1457263074,60,1548678543,,0,0,10.44,2980,3245,146,146,,,1,1.3,0.44,,,252,721,,,,,,,42.54,,1,,,,,,,,,,,,,,61,82,12.87,13.75,14.06,,,,,,,,,,,,,,,,,"12,0,2,7,16,37,23,2,0",,,,,,,128,,,,,,,,,,,,,,,,,,,,,,,,,,,,,,,,,,,,,4,6,235,81,,1000,,,0,5,3,,1,0,,,,,"Balve Laufen",,"Polar BEAT",,0,,0,168070,250480,30378,,,,,,,,,,,,,,,,,,,,,,,,,,,,,,,,,,,,,,,,,,4,
5964287,7de75720-43bd-4645-9931-7352da032a99,1470746154,120,1548678544,,0,0,12.48,3948,3951,195,196,,,1,2.4,0.64,,,372,872,,,,,,,38.23,,1,,,,,,,,,,,,,,81,78,11.67,11.93,12.33,,,,,,,,,,,,,,,,,"10,5,7,20,49,9,1,0,0",,,,,,,122,,,,,,,,,,,,,,,,,,,,,,,,,,,,,,,,,,,,,18,6,290,64,,1023,5,,0,5,3,,1,0,,,,,"Aachen Laufen",,"Polar BEAT",,0,,0,168070,250480,30378,,,,,,,,,,,,,,,,,,,,,,,,,,,,,,,,,,,,,,,,,,4,
5964288,325b3599-1efa-49d7-ae32-121bbde74905,1394973136,60,1548678545,,0,0,20.06,4627,4628,263,263,,,1,1.9,0.48,1.04,1.02,356,1180,176,182,,,,62.35,57.25,63.36,1,,,,,,,,,,,,,,207,86,15.94,15.78,16.04,-2,,,,,,,,,,,,,,,,"0,0,0,1,5,31,47,16,0","0,0,1,93,6",,,,,,151,,,,,,,,,,,,,,,,,,,,,,,,,,,,,,,,,,,,112.4,11,20,258,77,,1022,,,0,5,3,,1,0,,,,,"WK 20km Eschweiler",,"Polar BEAT",,0,,0,168070,250480,30378,,,,,,,,,,,,,,,,,,,,,,,,,,,,,,,,,,,,,,,,,,"5,5",
5964289,78922a60-f1f9-40d4-81ce-90e9d07c38a0,1508613879,120,1548678545,,0,0,0.69,232,234,8,14,,,1,0.5,0.42,1.22,0.94,,36,120,133,,,,64.75,27.84,64.99,1,,,,,,,,,,,,,,2,82,10.64,10.71,10.62,-8.4,,,,,,,,,,,,,,,,"26,21,22,4,9,15,3,0,0","6,94,0,0,0",,,,,,109,,,,,,,,,,,,,,,,,,,,,,,,,,,,,,,,,,,,3.8,12,17,198,77,,1012,,,1,5,3,,1,0,,,Running,,,,"Polar M430",43,0,,0,168070,250480,30378,,,,,,,,,,,,,,,,,,,,,,,,,,,,,,,,,,,,,,,,,,,
5964290,b6a16f50-a945-4cb2-a7d4-f2fef445b473,1419429538,60,1548678545,,0,0,5.17,1315,1315,68,70,,,1,1.5,0.59,,,304,343,,,,,,,46.63,,1,,,,,,,,,,,,,,27,83,14.37,14.26,14.61,,,,,,,,,,,,,,,,,"2,0,0,4,13,58,18,4,0",,,,,,,142,,,,,,,,,,,,,,,,,,,,,,,,,,,,,,,,,,,,,8,17,212,96,,,0,,0,4,3,,1,0,,,,,"Balve Laufen",,"Polar BEAT",,0,,0,168070,250480,30378,,,,,,,,,,,,,,,,,,,,,,,,,,,,,,,,,,,,,,,,,,5,
5964291,fe50cae5-1643-49f9-a388-e9c35b0db11f,1406719895,120,1548678546,,0,0,8,2636,2699,155,134,,,1,2.1,0.55,,,271,541,,,,,,,35.28,,1,,,,,,,,,,,,,,54,80,11.32,11.29,11.84,,,,,,,,,,,,,,,,,"15,9,16,26,27,6,0,0,0",,,,,,,114,,,,,,,,,,,,,,,,,,,,,,,,,,,,,,,,,,,,,19,7,319,80,,1014,5,,0,5,3,,1,0,,,,,"Regenerativer DL",,"Polar BEAT",,0,,0,168070,250480,30378,,,,,,,,,,,,,,,,,,,,,,,,,,,,,,,,,,,,,,,,,,4,
5964292,750409f3-1776-4617-bec5-0220c328bf78,1537695249,120,1548678546,,0,0,14.71,3603,3946,42,32,,,1,0,0.08,1.93,,,550,114,143,,,,,,,1,,,,,,,,,,,,,,34,,,18.46,,24.2,-7.2,86,56,,1,108,86,,,,,,,,,"38,33,19,8,2,0,0","15,85,0,0,0","83,6,8,1,1",,,,,,,,,,,,,,,,,,,,,,,,,,,,,,,,,,,,,,,,,8.4,19,29,200,71,,1014,,,0,11,3,,1,0,,,Cycling,,,,"Polar M430",43,0,,0,168072,,30378,,,,,,,,,,,,,,,,,,,,,,,,,,,,,,,,,,,,,,,,,,,
5964293,271cff42-8c8c-4020-9707-fcbf6a085f97,1431260594,120,1548678547,,0,0,3.02,912,912,28,28,,,1,0,0.27,,,,200,,,,,,,36.75,,1,,,,,,,,,,,,,,18,82,11.96,12.13,12.49,,,,,,,,,,,,,,,,,"1,6,18,38,19,13,4,0,0",,,,,,,121,,,,,,,,,,,,,,,,,,,,,,,,,,,,,,,,,,,,,16,2,252,63,,1027,6,,0,5,3,,1,0,,,,,"Stolberg (Rheinland) Laufen",,"Polar BEAT",,0,,0,168070,250480,30378,,,,,,,,,,,,,,,,,,,,,,,,,,,,,,,,,,,,,,,,,,,
5964294,9a2b6656-0395-4203-a1ba-9103dc103fb6,1540406662,120,1548678547,,0,0,10.81,2483,2483,58,44,,,1,0,0.12,2.3,0.44,,186,89,108,,,,,,,1,,,,,,,,,,,,,,9,,,16.62,,11.6,-23.1,71,58,,1,90,81,,,,,,,,,"18,80,2,0,0,0,0","97,3,0,0,0","87,0,11,0,1",,,,,,,,,,,,,,,,,,,,,,,,,,,,,,,,,,,,,,,,,1.9,13,12,214,89,,,0,,1,5,3,,1,0,,,Cycling,,,,"Polar M430",43,0,,0,168072,,30378,,,,,,,,,,,,,,,,,,,,,,,,,,,,,,,,,,,,,,,,,,,
5964295,c280e2f4-cfe3-4929-87de-8431cc8ffa41,1407933838,120,1548678548,,0,0,8,2525,2538,90,90,,,1,1.1,0.48,,,,535,,,,,,,37.12,,1,,,,,,,,,,,,,,52,82,11.56,11.47,11.71,,,,,,,,,,,,,,,,,"2,8,22,45,22,3,0,0,0",,,,,,,116,,,,,,,,,,,,,,,,,,,,,,,,,,,,,,,,,,,,,18,6,273,67,,1005,,,0,5,3,,1,0,,,,,"Langsamer DL",,"Polar BEAT",,0,,0,168070,250480,30378,,,,,,,,,,,,,,,,,,,,,,,,,,,,,,,,,,,,,,,,,,,
5964296,57b85ef5-de7b-4ba2-a920-6e2643915bc5,1499730238,120,1548678548,,0,0,5.03,1300,1300,54,59,,,1,0.8,0.4,,,349,342,,,,,,,45.68,,1,,,,,,,,,,,,,,27,80,14.08,14.02,14.27,,,,,,,,,,,,,,,,,"2,0,1,4,17,58,17,0,0",,,,,,,145,,,,,,,,,,,,,,,,,,,,,,,,,,,,,,,,,,,,,22,2,196,71,,1015,0,,1,3,3,,1,0,,,,,"Aix-en-Provence Laufen",,"Polar BEAT",,0,,0,168070,250480,30378,,,,,,,,,,,,,,,,,,,,,,,,,,,,,,,,,,,,,,,,,,5,
5964297,bc966dd2-7ba6-40c3-9e8d-edfa829c27fd,1411311890,120,1548678549,,0,0,10.17,2397,2397,180,179,,,1,2.7,0.62,,,465,674,,,,,,,53.11,,1,,,,,,,,,,,,,,49,86,15.65,15.56,16.05,,,,,,,,,,,,,,,,,"0,0,3,4,10,31,31,19,2",,,,,,,148,,,,,,,,,,,,,,,,,,,,,,,,,,,,,,,,,,,,,16,4,300,83,,,3,,0,5,3,,1,0,,,,,"WK 10k Panoramalauf",,"Polar BEAT",,0,,0,168070,250480,30378,,,,,,,,,,,,,,,,,,,,,,,,,,,,,,,,,,,,,,,,,,"4,4",
5964298,7b4a5b32-1953-4bf8-89cc-46bd67c22a5b,1414956230,60,1548678549,,0,0,10.21,2297,2297,218,218,,,1,2.4,0.86,,,,668,,,,,,,56.1,,1,,,,,,,,,,,,,,47,85,16.36,16.06,16.62,,,,,,,,,,,,,,,,,"0,0,0,0,0,2,87,11,0",,,,,,,157,,,,,,,,,,,,,,,,,,,,,,,,,,,,,,,,,,,,,15,9,187,87,,1010,0,,1,5,3,,1,0,,,,,TDL,,"Polar BEAT",,0,,0,168070,250480,30378,,,,,,,,,,,,,,,,,,,,,,,,,,,,,,,,,,,,,,,,,,,
5964299,48137a29-6df4-463a-a9b5-57caeb1d8a95,1467403445,120,1548678550,,0,0,2.19,692,1129,76,78,,,1,2.2,0.92,,,832,151,,,,,,,33.9,,1,,,,,,,,,,,,,,14,80,12.4,11.73,13.27,,,,,,,,,,,,,,,,,"18,4,10,30,17,16,5,0,0",,,,,,,119,,,,,,,,,,,,,,,,,,,,,,,,,,,,,,,,,,,,,20,16,202,66,,1014,,,0,3,3,,1,0,,,,,"Sundern Laufen",,"Polar BEAT",,0,,0,168070,250480,30378,,,,,,,,,,,,,,,,,,,,,,,,,,,,,,,,,,,,,,,,,,4,
5964300,f5d46730-9bb5-4227-845c-bb6b39c4b179,1415218105,60,1548678550,,0,0,15.74,4101,4101,178,185,,,1,1.7,0.49,,,431,1049,,,,,,,48.78,,1,,,,,,,,,,,,,,85,84,14.01,14.04,14.31,,,,,,,,,,,,,,,,,"0,1,2,8,24,50,11,5,0",,,,,,,137,,,,,,,,,,,,,,,,,,,,,,,,,,,,,,,,,,,,,6,6,180,91,,1007,,,1,5,3,,1,0,,,,,"Lockerer DL",,"Polar BEAT",,0,,0,168070,250480,30378,,,,,,,,,,,,,,,,,,,,,,,,,,,,,,,,,,,,,,,,,,4,
5964301,aee982ff-9f62-4a7c-85d3-86c10dd19b1b,1404990342,120,1548678551,,0,0,4.4,1229,1230,71,53,,,1,1,0.45,,,285,303,,,,,,,41.35,,1,,,,,,,,,,,,,,25,82,13.2,13.13,13.65,,,,,,,,,,,,,,,,,"1,6,7,12,41,26,5,1,1",,,,,,,131,,,,,,,,,,,,,,,,,,,,,,,,,,,,,,,,,,,,,18,5,21,99,,1010,4,,0,5,3,,1,0,,,,,"Einlaufen Mit Lauf ABC",,"Polar BEAT",,0,,0,168070,250480,30378,,,,,,,,,,,,,,,,,,,,,,,,,,,,,,,,,,,,,,,,,,5,
5964303,3bce60d4-91fc-4812-a65a-b9d8fd48ca7b,1349898081,120,1548678552,,0,0,17,5234,5288,79,85,,,1,0,0.11,,,,1191,,,,,,,40.44,,1,,,,,,,,,,,,,,108,,11.77,12.01,12.11,,,,,,,,,,,,,,,,,"7,7,14,23,30,14,4,0,0",,,,,,,,,,,,,,,,,,,,,,,,,,,,,,,,,,,,,,,,,,,,9,1,316,77,,1015,0,,1,5,3,,1,0,,,,,,,"Polar BEAT",,0,,0,168070,250480,30378,,,,,,,,,,,,,,,,,,,,,,,,,,,,,,,,,,,,,,,,,,,
5964304,93239d35-ba6f-43ca-8d06-7d9edf48f822,1452107234,60,1548678552,,0,0,7.65,2484,2484,159,142,,,1,2.2,0.55,,,,523,,,,,,,35.79,,1,,,,,,,,,,,,,,51,81,11.5,11.58,12.07,,,,,,,,,,,,,,,,,"15,13,24,29,9,3,4,3,0",,,,,,,114,,,,,,,,,,,,,,,,,,,,,,,,,,,,,,,,,,,,,6,7,174,95,,1000,,,1,5,3,,1,0,,,,,,,"Polar BEAT",,0,,0,168070,250480,30378,,,,,,,,,,,,,,,,,,,,,,,,,,,,,,,,,,,,,,,,,,,
5964305,9a2005fa-f345-4731-bd98-789535f4e709,1483178403,60,1548678553,,0,0,24.1,7384,7591,384,384,,,1,3.1,0.57,,,564,1631,,,,,,,41.79,,1,,,,,,,,,,,,,,153,80,12.08,12.26,12.63,,,,,,,,,,,,,,,,,"10,4,8,18,38,22,1,0,0",,,,,,,122,,,,,,,,,,,,,,,,,,,,,,,,,,,,,,,,,,,,,-4,2,203,85,,1035,0,,0,5,3,,1,0,,,,,"Aachen Laufen",,"Polar BEAT",,0,,0,168070,250480,30378,,,,,,,,,,,,,,,,,,,,,,,,,,,,,,,,,,,,,,,,,,"4,5",
5964306,2be28741-df0d-461c-a2b9-a728c8f8d9b8,1452948156,60,1548678554,,0,0,7.23,2592,2837,132,187,,,1,1.9,0.58,,,258,477,,,,,,,31.69,,1,,,,,,,,,,,,,,53,75,10.67,11.69,12.09,,,,,,,,,,,,,,,,,"32,5,5,10,19,18,9,1,0",,,,,,,112,,,,,,,,,,,,,,,,,,,,,,,,,,,,,,,,,,,,,2,18,308,83,,1023,,,0,6,3,,1,0,,,,,"Raeren Hauset Laufen",,"Polar BEAT",,0,,0,168070,250480,30378,,,,,,,,,,,,,,,,,,,,,,,,,,,,,,,,,,,,,,,,,,"4,5",
5964307,8b730001-8d5a-4785-ac58-46c620d130f0,1518341665,60,1548678554,,0,0,1.95,599,599,12,13,,,1,0,0.1,0.99,0.89,,149,156,173,,,,52.39,34.61,52.76,1,,,,,,,,,,,,,,17,81,11.78,11.81,11.92,11,,,,,,,,,,,,,,,,"3,6,7,40,40,4,0,0,0","0,11,41,48,0",,,,,,121,,,,,,,,,,,,,,,,,,,,,,,,,,,,,,,,,,,,41.7,2,15,205,89,,,0,,0,6,3,,1,0,I1.000|5:02-I0.954|4:59,,Running,,,,"Polar M430",43,0,,0,168070,250480,30378,,,,,,,,,,,,,,,,,,,,,,,,,,,,,,,,,,,,,,,,,,,
5964308,3c9b4bcb-25a7-47e3-9dad-301107c01df4,1466808171,120,1548678554,,0,0,5.01,1014,1014,0,1,,,1,0,0,,,,357,,,,,,,60.75,,1,,,,,,,,,,,,,,21,89,17.77,17.86,17.86,,,,,,,,,,,,,,,,,"0,0,0,0,0,1,8,91,0",,,,,,,167,,,,,,,,,,,,,,,,,,,,,,,,,,,,,,,,,,,,,19,1,317,87,,1018,0,,1,5,3,,1,0,,,,,"Aachen Laufen",,"Polar BEAT",,0,,0,168070,250480,30378,,,,,,,,,,,,,,,,,,,,,,,,,,,,,,,,,,,,,,,,,,,
5964309,b66d1e53-467d-4fa4-ba14-64a253493820,1401321610,120,1548678555,,0,0,3.12,1027,1027,1,0,,,1,0,0.06,,,,210,,,,,,,33.3,,1,,,,,,,,,,,,,,21,81,10.99,11.04,11.08,,,,,,,,,,,,,,,,,"10,8,27,37,16,2,1,0,0",,,,,,,113,,,,,,,,,,,,,,,,,,,,,,,,,,,,,,,,,,,,,13,1,24,77,,,0,,1,5,3,,1,0,,,,,Einlaufen,,"Polar BEAT",,0,,0,168070,250480,30378,,,,,,,,,,,,,,,,,,,,,,,,,,,,,,,,,,,,,,,,,,,
5964310,6d070445-fdba-4540-b47d-16608de247f9,1451576116,60,1548678555,,0,0,1.13,409,409,0,0,,,1,0,0,,,,82,,,,,,,27.02,,1,,,,,,,,,,,,,,8,84,9.98,10.24,10.24,,,,,,,,,,,,,,,,,"29,7,29,26,5,4,0,0,0",,,,,,,99,,,,,,,,,,,,,,,,,,,,,,,,,,,,,,,,,,,,,8,15,211,74,,1020,,,0,5,3,,1,0,,,,,"Soest Laufen",,"Polar BEAT",,0,,0,168070,250480,30378,,,,,,,,,,,,,,,,,,,,,,,,,,,,,,,,,,,,,,,,,,,
5964311,7ceb2c77-224f-4a6e-aff7-415ebb9b30ab,1465851810,120,1548678556,,0,0,1.55,416,416,16,20,,,1,0.6,0.48,,,,97,,,,,,,39.31,,1,,,,,,,,,,,,,,8,80,13.46,13.58,13.58,,,,,,,,,,,,,,,,,"0,0,4,12,32,41,12,0,0",,,,,,,140,,,,,,,,,,,,,,,,,,,,,,,,,,,,,,,,,,,,,14,5,238,92,,1003,0,,0,6,3,,1,0,,,,,"Aachen Laufen",,"Polar BEAT",,0,,0,168070,250480,30378,,,,,,,,,,,,,,,,,,,,,,,,,,,,,,,,,,,,,,,,,,,
5964312,da42398b-3c61-47ff-ae11-f7643ae557c9,1458477108,60,1548678557,,0,0,20.17,4621,4621,260,260,,,1,2,0.5,,,377,1372,,,,,,,57.72,,1,,,,,,,,,,,,,,95,85,16.02,15.82,16.18,,,,,,,,,,,,,,,,,"0,0,0,0,4,23,58,15,0",,,,,,,154,,,,,,,,,,,,,,,,,,,,,,,,,,,,,,,,,,,,,6,9,343,74,,1022,,,0,5,3,,1,0,,,,,"Eschweiler Laufen",,"Polar BEAT",,0,,0,168070,250480,30378,,,,,,,,,,,,,,,,,,,,,,,,21.1,4621,,,0,"46. Internationaler Eschweiler Volkslauf",,,,,,,0,0,30378,5964312,14836,,"5,5,5",
5964313,4ebfdd97-f74f-4c33-9a01-b2f3a574d389,1402431173,120,1548678557,,0,0,2.27,698,773,24,21,,,1,0.4,0.36,,,,153,,,,,,,35.1,,1,,,,,,,,,,,,,,14,80,11.83,12.16,12.6,,,,,,,,,,,,,,,,,"10,1,2,27,51,9,0,0,0",,,,,,,122,,,,,,,,,,,,,,,,,,,,,,,,,,,,,,,,,,,,,23,6,329,68,,1020,,,0,5,3,,1,0,,,,,Einlaufen,,"Polar BEAT",,0,,0,168070,250480,30378,,,,,,,,,,,,,,,,,,,,,,,,,,,,,,,,,,,,,,,,,,,
5964314,b1478fb6-aecb-4f0d-8ba9-f5025f39af8d,1482345058,60,1548678558,,0,0,13.18,3732,3732,195,189,,,1,2.4,0.6,,,401,895,,,,,,,43.69,,1,,,,,,,,,,,,,,77,81,13.02,12.86,13.2,,,,,,,,,,,,,,,,,"3,3,4,11,51,27,2,0,0",,,,,,,131,,,,,,,,,,,,,,,,,,,,,,,,,,,,,,,,,,,,,4,10,188,80,,1028,0,,1,5,3,,1,0,,,,,"Aachen Laufen",,"Polar BEAT",,0,,0,168070,250480,30378,,,,,,,,,,,,,,,,,,,,,,,,,,,,,,,,,,,,,,,,,,4,
5964315,5a20f556-7cb1-41b9-8366-ecdb97c29668,1474206205,120,1548678558,,0,0,1.99,519,519,0,19,,,1,0,0.1,,,,136,,,,,,,41.76,,1,,,,,,,,,,,,,,10,82,13.42,13.85,13.5,,,,,,,,,,,,,,,,,"0,0,0,4,25,70,1,0,0",,,,,,,140,,,,,,,,,,,,,,,,,,,,,,,,,,,,,,,,,,,,,16,4,11,87,,1017,3,,0,5,3,,1,0,,,,,"Aachen Laufen",,"Polar BEAT",,0,,0,168070,250480,30378,,,,,,,,,,,,,,,,,,,,,,,,,,,,,,,,,,,,,,,,,,,
5964316,330e8025-297a-4d36-b25f-f897ab00feae,1541441325,60,1548678559,,0,0,11.26,3395,3400,41,41,,,1,0,0.04,1.11,0.96,,750,140,161,,,,61.89,40.12,62.17,1,,,,,,,,,,,,,,67,81,11.97,12.03,12.08,6.1,,,,,,,,,,,,,,,,"1,3,9,39,44,3,2,0,0","1,39,60,0,0",,,,,,123,,,,,,,,,,,,,,,,,,,,,,,,,,,,,,,,,,,,29.2,9,4,,93,,1008,,,1,5,1,,1,0,I1.000|5:13-I1.000|4:57-I1.000|4:57-I1.000|4:59-I1.000|4:54-I1.000|4:50-I1.000|5:17-I1.000|5:14-I1.000|5:30-I1.000|5:03-I1.000|4:32-I0.262|1:14,,Running,,,,"Polar M430",43,0,,0,168070,250480,30378,,,,,,,,,,,,,,,,,,,,,,,,,,,,,,,,,,,,,,,,,,,
5964317,ba24adfd-c3ad-4cb9-936a-03be5847a446,1457858254,60,1548678559,,0,0,10.01,2490,2546,57,52,,,1,0,0.18,,,,686,,,,,,,49.82,,1,,,,,,,,,,,,,,51,85,14.56,14.69,14.8,,,,,,,,,,,,,,,,,"3,2,2,2,5,36,50,1,0",,,,,,,142,,,,,,,,,,,,,,,,,,,,,,,,,,,,,,,,,,,,,8,4,281,69,,1021,,,0,3,3,,1,0,,,,,"Benimamet Laufen",,"Polar BEAT",,0,,0,168070,250480,30378,,,,,,,,,,,,,,,,,,,,,,,,,,,,,,,,,,,,,,,,,,,
5964318,46952fec-812a-4a13-8b1a-67ca7b8cdb2a,1346942079,120,1548678561,,0,0,79.07,11207,11321,2034,2034,,,1,5.9,0.6,,,871,2895,,,,,,,,,1,,,,,,,,,,,,,,125,,,31.74,,,,380,240,,1,533,398,,,,,,,,,"20,18,16,12,11,7,15",,"51,12,10,7,19",,,,,,,,,,,,,,,,,,,,,,,,,,,,,,,,,,,,,,,,,,17,6,294,55,,1028,3,,0,5,3,,1,0,,,,,,,"Polar BEAT",,0,,0,168072,,30378,,,,,,,,,,,,,,,,,,,,,,,,,,,,,,,,,,,,,,,,,,"2,4,4,4,4,4,4,4,4,4,5,5,5,5,5,5,5,5,5",
5964319,462b6678-0160-4e64-8ab3-edf291df86b1,1393268808,60,1548678562,,0,0,3.39,1039,1048,72,77,,,1,1.5,0.58,,,,226,,,,,,,36.44,,1,,,,,,,,,,,,,,21,85,12,11.98,12.43,,,,,,,,,,,,,,,,,"3,0,5,41,51,0,0,0,0",,,,,,,115,,,,,,,,,,,,,,,,,,,,,,,,,,,,,,,,,,,,,10,7,179,65,,1013,0,,1,5,3,,1,0,,,,,Auslaufen,,"Polar BEAT",,0,,0,168070,250480,30378,,,,,,,,,,,,,,,,,,,,,,,,,,,,,,,,,,,,,,,,,,,
5964320,833385b7-e739-45d2-86e7-ca0791d1789c,1370080755,120,1548678562,,0,0,0.5,180,205,8,6,,,1,0.9,0.59,,,,36,,,,,,,24.93,,1,,,,,,,,,,,,,,3,,10.5,10.62,11.37,,,,,,,,,,,,,,,,,"22,13,21,35,9,0,0,0,0",,,,,,,,,,,,,,,,,,,,,,,,,,,,,,,,,,,,,,,,,,,,10,10,305,92,,1017,3,,0,5,3,,1,0,,,,,,,"Polar BEAT",,0,,0,168070,250480,30378,,,,,,,,,,,,,,,,,,,,,,,,,,,,,,,,,,,,,,,,,,,
5964321,51bccafd-1592-44b5-bf71-811db070bf8b,1412889553,120,1548678562,,0,0,1.82,567,567,21,22,,,1,0.7,0.44,0.99,1,,105,137,150,,,,61.07,33.82,61.9,1,,,,,,,,,,,,,,10,82,11.8,11.76,11.87,-5.8,,,,,,,,,,,,,,,,"7,10,14,16,53,0,0,0,0","0,57,43,0,0",,,,,,117,,,,,,,,,,,,,,,,,,,,,,,,,,,,,,,,,,,,13.7,13,9,197,90,,1010,0,,1,5,3,,1,0,,,,,Auslaufen,,"Polar BEAT",,0,,0,168070,250480,30378,,,,,,,,,,,,,,,,,,,,,,,,,,,,,,,,,,,,,,,,,,,
5964322,9f266de7-ec8f-4818-991c-594d572fd080,1452538739,60,1548678562,,0,0,9.78,2723,2801,114,119,,,1,1.1,0.51,,,,667,,,,,,,43.6,,1,,,,,,,,,,,,,,56,82,13.09,13.52,13.74,,,,,,,,,,,,,,,,,"6,1,5,8,22,43,15,0,0",,,,,,,131,,,,,,,,,,,,,,,,,,,,,,,,,,,,,,,,,,,,,5,19,221,92,,986,,,1,5,3,,1,0,,,,,"Aachen Laufen",,"Polar BEAT",,0,,0,168070,250480,30378,,,,,,,,,,,,,,,,,,,,,,,,,,,,,,,,,,,,,,,,,,,
5964323,76b1069d-a35d-40c5-88b7-689e508be35a,1456254336,60,1548678563,,0,0,7.97,2493,2583,71,66,,,1,0.5,0.39,,,,549,,,,,,,37.51,,1,,,,,,,,,,,,,,51,77,11.64,13.38,13.6,,,,,,,,,,,,,,,,,"21,2,5,7,19,21,17,8,1",,,,,,,125,,,,,,,,,,,,,,,,,,,,,,,,,,,,,,,,,,,,,3,9,261,92,,1018,,,1,5,3,,1,0,,,,,"Aachen Laufen",,"Polar BEAT",,0,,0,168070,250480,30378,,,,,,,,,,,,,,,,,,,,,,,,,,,,,,,,,,,,,,,,,,,
5964324,36c6f778-8d5b-421d-b005-4e01d97ba0d7,1433929209,120,1548678563,,0,0,10.72,2892,2892,146,148,,,1,1.4,0.45,,,500,732,,,,,,,45.52,,1,,,,,,,,,,,,,,60,83,13.72,13.59,13.87,,,,,,,,,,,,,,,,,"1,2,7,13,26,38,13,0,0",,,,,,,134,,,,,,,,,,,,,,,,,,,,,,,,,,,,,,,,,,,,,15,15,55,63,,1026,,,0,3,3,,1,0,,,,,"Voeren Sint-Martens-Voeren Laufen",,"Polar BEAT",,0,,0,168070,250480,30378,,,,,,,,,,,,,,,,,,,,,,,,,,,,,,,,,,,,,,,,,,4,
5964325,a9f25304-bf02-4055-821b-52537c9bc66f,1429524313,120,1548678563,,0,0,7.01,2024,2024,72,81,,,1,0.8,0.45,,,,481,,,,,,,40.89,,1,,,,,,,,,,,,,,42,84,12.56,12.55,12.7,,,,,,,,,,,,,,,,,"2,3,6,11,65,13,0,0,0",,,,,,,124,,,,,,,,,,,,,,,,,,,,,,,,,,,,,,,,,,,,,12,9,62,51,,1027,,,0,5,3,,1,0,,,,,"Aachen Laufen",,"Polar BEAT",,0,,0,168070,250480,30378,,,,,,,,,,,,,,,,,,,,,,,,,,,,,,,,,,,,,,,,,,,
5964326,21cd8bee-d5f0-48f0-9460-eb73b0ef9c42,1421495287,60,1548678565,,0,0,17.22,5386,7452,308,310,,,1,2.7,0.46,,,497,1132,,,,,,,39.75,,1,,,,,,,,,,,,,,111,82,11.97,12.07,12.63,,,,,,,,,,,,,,,,,"15,3,8,22,34,12,4,2,0",,,,,,,117,,,,,,,,,,,,,,,,,,,,,,,,,,,,,,,,,,,,,3,4,245,92,,1017,1,,0,3,3,,1,0,,,,,"Aachen Laufen",,"Polar BEAT",,0,,0,168070,250480,30378,,,,,,,,,,,,,,,,,,,,,,,,,,,,,,,,,,,,,,,,,,"4,5",
5964327,ef2a7762-8b9f-4d1b-b63f-58c8c747119e,1410812968,120,1548678565,,0,0,10.38,2447,2542,116,120,,,1,0,0.02,,,,554,165,186,,,,67.01,53.17,67.91,1,,,,,,,,,,,,,,89,86,15.45,16.2,16.24,5.1,,,,,,,,,,,,,,,,"10,0,0,0,1,0,68,18,1","0,10,6,83,1",,,,,,148,,,,,,,,,,,,,,,,,,,,,,,,,,,,,,,,,,,,87.3,16,7,87,86,,1016,,,1,3,3,,1,0,,,,,"2x 5000m",,"Polar BEAT",,0,,0,168070,250480,30378,,,,,,,,,,,,,,,,,,,,,,,,,,,,,,,,,,,,,,,,,,,
5964328,7709edac-2b9a-48ef-a633-0ea68998e25f,1409307743,120,1548678566,,0,0,5.38,1662,2288,65,64,,,1,1.1,0.41,,,,366,,,,,,,37.16,,1,,,,,,,,,,,,,,34,83,11.82,11.86,12.15,,,,,,,,,,,,,,,,,"7,5,12,22,48,6,0,0,0",,,,,,,117,,,,,,,,,,,,,,,,,,,,,,,,,,,,,,,,,,,,,16,6,237,89,,1017,2,,0,5,3,,1,0,,,,,"Lauf ABC ",,"Polar BEAT",,0,,0,168070,250480,30378,,,,,,,,,,,,,,,,,,,,,,,,,,,,,,,,,,,,,,,,,,,
5964329,c8a7e432-fc91-45cf-a80b-09b98180b54f,1509379709,60,1548678566,,0,0,15.11,2432,2447,48,57,,,1,0,0.11,2.02,0.45,,470,134,165,,,,,,,1,,,,,,,,,,,,,,43,,,25.42,,26.4,-12,139,101,,1,164,134,,,,,,,,,"18,13,10,45,15,0,0","6,50,37,7,0","68,18,2,10,3",,,,,,,,,,,,,,,,,,,,,,,,,,,,,,,,,,,,,,,,,40.4,10,1,307,63,,,0,,0,5,3,,1,0,,,Cycling,,,,"Polar M430",43,0,,0,168072,,30378,,,,,,,,,,,,,,,,,,,,,,,,,,,,,,,,,,,,,,,,,,,
5964330,b96f0921-d243-42de-8975-90f77c6ba384,1479839103,60,1548678566,,0,0,2.21,730,730,32,36,,,1,0.6,0.36,,,,150,,,,,,,32.24,,1,,,,,,,,,,,,,,15,78,11.1,10.94,11.33,,,,,,,,,,,,,,,,,"1,15,31,53,0,0,0,0,0",,,,,,,116,,,,,,,,,,,,,,,,,,,,,,,,,,,,,,,,,,,,,10,2,170,84,,1013,0,,1,5,3,,1,0,,,,,"Aachen Laufen",,"Polar BEAT",,0,,0,168070,250480,30378,,,,,,,,,,,,,,,,,,,,,,,,,,,,,,,,,,,,,,,,,,,
5964331,,1404855028,120,1548678567,,0,0,3,0,0,,,,,0,,,,,,,,,,,,,,,1,,,,,,,,,,,,,,0,,,,,,,,,,,,,,,,,,,,,,,,,,,,,,,,,,,,,,,,,,,,,,,,,,,,,,,,,,,,,,,,,,,,,,,,,,1,,,0,0,,,,,Auslaufen,,"Polar BEAT",,0,,0,168070,250480,30378,,,,,,,,,,,,,,,,,,,,,,,,,,,,,,,,,,,,,,,,,,,
5964332,385246c9-964f-42da-82ff-220bf78ac279,1423215358,60,1548678567,,0,0,8.23,2408,2429,90,89,,,1,0.9,0.51,,,,556,,,,,,,40.66,,1,,,,,,,,,,,,,,50,84,12.48,12.38,12.65,,,,,,,,,,,,,,,,,"1,1,4,34,49,12,1,0,0",,,,,,,122,,,,,,,,,,,,,,,,,,,,,,,,,,,,,,,,,,,,,-3,13,48,83,,1026,0,,0,5,3,,1,0,,,,,"Aachen Laufen",,"Polar BEAT",,0,,0,168070,250480,30378,,,,,,,,,,,,,,,,,,,,,,,,,,,,,,,,,,,,,,,,,,,
5964333,badff229-1068-44ab-9cd1-a68f31d0602c,1459368427,120,1548678568,,0,0,10.81,3034,3034,127,133,,,1,1.6,0.47,,,422,745,,,,,,,43.49,,1,,,,,,,,,,,,,,63,83,13.03,12.94,13.21,,,,,,,,,,,,,,,,,"0,3,4,14,42,35,1,0,0",,,,,,,129,,,,,,,,,,,,,,,,,,,,,,,,,,,,,,,,,,,,,10,3,248,67,,1012,0,,1,5,3,,1,0,,,,,"Aachen Laufen",,"Polar BEAT",,0,,0,168070,250480,30378,,,,,,,,,,,,,,,,,,,,,,,,,,,,,,,,,,,,,,,,,,5,
5964334,cda6f6f8-4111-4e8c-b52e-45e6e659145d,1465419570,120,1548678568,,0,0,9.93,2136,2136,66,64,,,1,0,0.16,,,,677,,,,,,,59.02,,1,,,,,,,,,,,,,,44,86,16.83,16.82,16.92,,,,,,,,,,,,,,,,,"0,0,0,0,0,11,49,39,1",,,,,,,162,,,,,,,,,,,,,,,,,,,,,,,,,,,,,,,,,,,,,19,2,327,65,,1016,0,,0,5,3,,1,0,,,,,"Köln Laufen",,"Polar BEAT",,0,,0,168070,250480,30378,,,,,,,,,,,,,,,,,,,,,,,,10,2136,,,0,"Unilauf Köln",,,,,,,0,0,30378,5964334,1904,,,
5964335,41d0c894-d38d-415a-8277-9109d2ac42a5,1505246338,120,1548678568,,0,0,1.17,239,243,13,12,,,1,0.8,0.48,0.87,0.89,,38,117,148,,,,,51.77,,1,,,,,,,,,,,,,,2,80,17.91,18.41,18.93,25.4,,,,,,,,,,,,,,,,"0,0,1,7,8,10,26,21,27","18,60,22,0,0",,,,,,184,,,,,,,,,,,,,,,,,,,,,,,,,,,,,,,,,,,,3.6,13,15,224,79,,1010,,,1,6,3,,1,0,I1.000|3:22-I0.176|0:41,,Running,,,,"Polar M430",43,0,,0,168070,250480,30378,,,,,,,,,,,,,,,,,,,,,,,,,,,,,,,,,,,,,,,,,,,
5964336,9d09abaf-7595-4ff0-bf2d-2454e2f92c4e,1466376177,120,1548678570,,0,0,9.66,2889,2891,160,159,,,1,2.1,0.63,,,494,673,,,,,,,40.06,,1,,,,,,,,,,,,,,60,79,12.33,12.12,12.52,,,,,,,,,,,,,,,,,"0,1,11,31,55,2,0,0,0",,,,,,,127,,,,,,,,,,,,,,,,,,,,,,,,,,,,,,,,,,,,,13,2,176,80,,1025,0,,1,5,3,,1,0,,,,,"Voeren Sint-Martens-Voeren Laufen",,"Polar BEAT",,0,,0,168070,250480,30378,,,,,,,,,,,,,,,,,,,,,,,,,,,,,,,,,,,,,,,,,,4,
5964337,819a61f5-f2b5-457d-a492-3adee9538cfc,1402838836,120,1548678571,,0,0,3.93,1192,1192,25,25,,,1,0,0.15,,,,262,,,,,,,37.26,,1,,,,,,,,,,,,,,24,81,11.98,11.98,12.11,,,,,,,,,,,,,,,,,"1,7,17,34,33,6,2,1,0",,,,,,,122,,,,,,,,,,,,,,,,,,,,,,,,,,,,,,,,,,,,,18,4,356,66,,1024,6,,0,5,3,,1,0,,,,,Einlaufen,,"Polar BEAT",,0,,0,168070,250480,30378,,,,,,,,,,,,,,,,,,,,,,,,,,,,,,,,,,,,,,,,,,,
5964338,,1334141538,120,1548678571,,0,0,10.6,0,0,,,,,0,,,,,,719,,,,,,,,,1,,,,,,,,,,,,,,0,,,,,,,,,,,,,,,,,,,,,,,,,,,,,,,,,,,,,,,,,,,,,,,,,,,,,,,,,,,,,,,,,,,,,,,,,,1,,,0,0,,,,,,,"Polar BEAT",,0,,0,168070,250480,30378,,,,,,,,,,,,,,,,,,,,,,,,,,,,,,,,,,,,,,,,,,,
5964339,c2a08aea-a66c-4dda-b9dc-22f0e4d2c8e5,1425032575,60,1548678571,,0,0,10.46,3383,3597,145,146,,,1,1.9,0.6,,,225,718,,,,,,,36.75,,1,,,,,,,,,,,,,,70,83,11.37,11.37,11.64,,,,,,,,,,,,,,,,,"9,5,20,51,10,3,2,1,0",,,,,,,112,,,,,,,,,,,,,,,,,,,,,,,,,,,,,,,,,,,,,4,9,333,91,,1015,1,,0,5,3,,1,0,,,,,"Aachen Laufen",,"Polar BEAT",,0,,0,168070,250480,30378,,,,,,,,,,,,,,,,,,,,,,,,,,,,,,,,,,,,,,,,,,5,
5964340,96f55769-4d3d-4c22-bde6-e8f571c26f62,1470516665,120,1548678572,,0,0,2.24,620,620,14,8,,,1,0,0.09,,,,155,,,,,,,39.53,,1,,,,,,,,,,,,,,12,80,13.15,13.23,13.31,,,,,,,,,,,,,,,,,"0,3,12,7,29,49,1,0,0",,,,,,,135,,,,,,,,,,,,,,,,,,,,,,,,,,,,,,,,,,,,,19,2,303,71,,1028,0,,0,5,3,,1,0,,,,,"Eschweiler Laufen",,"Polar BEAT",,0,,0,168070,250480,30378,,,,,,,,,,,,,,,,,,,,,,,,,,,,,,,,,,,,,,,,,,,
5964341,aba85266-bb50-445c-9ac6-b8a3b4c73197,1539020376,120,1548678572,,0,0,5.71,1738,1739,29,32,,,1,0,0.18,1.15,0.86,,376,139,152,,,,61.73,37.95,62.07,1,,,,,,,,,,,,,,32,79,11.87,11.89,12.03,-5.7,,,,,,,,,,,,,,,,"1,2,12,41,39,5,0,0,0","1,34,65,0,0",,,,,,125,,,,,,,,,,,,,,,,,,,,,,,,,,,,,,,,,,,,20.3,21,14,359,56,,1020,0,295,0,3,3,,1,0,I1.000|5:08-I1.000|5:11-I1.000|5:14-I1.000|5:07-I1.000|4:53-I0.715|3:29,,Running,,,,"Polar M430",43,0,,0,168070,250480,30378,,,,,,,,,,,,,,,,,,,,,,,,,,,,,,,,,,,,,,,,,,,
5964342,d029369d-8ddc-4640-8752-929e55f63d18,1413923192,120,1548678573,,0,0,9.43,2319,2371,82,82,,,1,1,0.47,,,,633,,,,,,,50.29,,1,,,,,,,,,,,,,,48,85,14.76,16.04,16.13,,,,,,,,,,,,,,,,,"14,2,4,3,1,6,33,33,4",,,,,,,144,,,,,,,,,,,,,,,,,,,,,,,,,,,,,,,,,,,,,7,13,248,89,,1009,0,,1,5,3,,1,0,,,,,"Doppel, Einzel, Halbe",,"Polar BEAT",,0,,0,168070,250480,30378,,,,,,,,,,,,,,,,,,,,,,,,,,,,,,,,,,,,,,,,,,,
5964343,bcd599db-bbfa-4753-8827-1d7a031015bf,1540923032,60,1548678573,,0,0,11.3,2868,2873,28,28,,,1,0,0.04,,1,,734,153,168,,,,68.14,49.06,68.35,1,,,,,,,,,,,,,,79,82,14.23,14.32,14.37,8.9,,,,,,,,,,,,,,,,"1,1,1,2,12,63,20,1,0","1,18,35,47,0",,,,,,144,,,,,,,,,,,,,,,,,,,,,,,,,,,,,,,,,,,,57.4,8,34,202,70,,1005,0,333,1,11,3,,1,0,I1.000|4:49-I1.000|4:14-I1.000|4:23-I1.000|4:17-I1.000|3:52-I1.000|4:02-I1.000|4:07-I1.000|4:09-I1.000|4:09-I1.000|4:03-I1.000|4:10-I0.303|1:38,,Running,,,,"Polar M430",43,0,,0,168070,250480,30378,,,,,,,,,,,,,,,,,,,,,,,,,,,,,,,,,,,,,,,,,,,
5964344,69ef95bc-6485-4383-b2b5-894e448fda8b,1360689390,60,1548678573,,0,0,,41,41,,,,,0,,,,,,9,92,97,,,,,,,1,,,,,,,,,,,,,,0,,,,,,,,,,,,,,,,,,,,,,"100,0,0,0,0",,,,,,,,,,,,,,,,,,,,,,,,,,,,,,,,,,,,,,,,,,0.1,,,,,,,,,,1,,,1,0,,,,,,,"Polar BEAT",,0,,0,168072,,30378,,,,,,,,,,,,,,,,,,,,,,,,,,,,,,,,,,,,,,,,,,,
5964345,bd98ad6a-562e-43d1-bcf4-4fd1e2a1d79d,1429265001,120,1548678574,,0,0,10.01,2699,2781,132,141,,,1,1.3,0.5,,,,689,,,,,,,45.34,,1,,,,,,,,,,,,,,56,84,13.5,13.51,13.79,,,,,,,,,,,,,,,,,"0,2,3,6,44,33,10,3,0",,,,,,,132,,,,,,,,,,,,,,,,,,,,,,,,,,,,,,,,,,,,,8,17,48,62,,1017,,,0,5,3,,1,0,,,,,"Aachen Laufen",,"Polar BEAT",,0,,0,168070,250480,30378,,,,,,,,,,,,,,,,,,,,,,,,,,,,,,,,,,,,,,,,,,,
5964346,8d5571d4-f7ca-4f1f-8844-0e78e3b8b4f6,1434017021,120,1548678574,,0,0,0.78,286,289,16,17,,,1,0.8,0.52,,,,54,,,,,,,25.53,,1,,,,,,,,,,,,,,5,81,10.18,9.95,10.55,,,,,,,,,,,,,,,,,"23,34,32,11,0,0,0,0,0",,,,,,,101,,,,,,,,,,,,,,,,,,,,,,,,,,,,,,,,,,,,,19,12,74,56,,1020,,,0,5,3,,1,0,,,,,"Voeren Sint-Martens-Voeren Laufen",,"Polar BEAT",,0,,0,168070,250480,30378,,,,,,,,,,,,,,,,,,,,,,,,,,,,,,,,,,,,,,,,,,,
5964347,00de6151-6c0d-4ff2-b22f-02b0eefaf4ae,1453490314,60,1548678574,,0,0,10.01,2314,2314,73,81,,,1,0.3,0.3,,,,682,,,,,,,54.27,,1,,,,,,,,,,,,,,48,84,15.65,15.68,15.79,,,,,,,,,,,,,,,,,"1,0,0,0,3,19,70,7,0",,,,,,,154,,,,,,,,,,,,,,,,,,,,,,,,,,,,,,,,,,,,,1,19,176,89,,1023,,,1,6,3,,1,0,,,,,"Aachen Laufen",,"Polar BEAT",,0,,0,168070,250480,30378,,,,,,,,,,,,,,,,,,,,,,,,,,,,,,,,,,,,,,,,,,,
5964348,c1e2b469-6570-4a67-bc66-d75ce447b976,1422724953,60,1548678574,,0,0,2.33,700,700,4,4,,,1,0,0,,,,158,,,,,,,36.14,,1,,,,,,,,,,,,,,14,85,12.01,12.07,12.1,,,,,,,,,,,,,,,,,"0,0,5,42,49,4,0,0,0",,,,,,,117,,,,,,,,,,,,,,,,,,,,,,,,,,,,,,,,,,,,,3,3,239,76,,,0,,1,5,3,,1,0,,,,,"Grevenbroich Laufen",,"Polar BEAT",,0,,0,168070,250480,30378,,,,,,,,,,,,,,,,,,,,,,,,,,,,,,,,,,,,,,,,,,,
5964350,e47a4c69-d485-4df8-8937-18645345b835,1445373347,120,1548678575,,0,0,10.09,2889,2968,7,12,,,1,0,0.04,,,,641,,,,,,,42.28,,1,,,,,,,,,,,,,,60,82,12.62,14.37,14.42,,,,,,,,,,,,,,,,,"25,1,3,6,6,4,41,14,0",,,,,,,128,,,,,,,,,,,,,,,,,,,,,,,,,,,,,,,,,,,,,9,6,328,96,,1025,,,1,5,3,,1,0,,,,,"Aachen Laufen",,"Polar BEAT",,0,,0,168070,250480,30378,,,,,,,,,,,,,,,,,,,,,,,,,,,,,,,,,,,,,,,,,,,
5964351,107ff17b-c68d-4cd7-bf4e-115cdf5654cd,1429819862,120,1548678575,,0,0,8.19,2544,3842,92,90,,,1,0.6,0.25,,,463,511,,,,,,,37.88,,1,,,,,,,,,,,,,,52,80,11.78,13.52,13.81,,,,,,,,,,,,,,,,,"22,6,13,12,13,12,6,9,6",,,,,,,121,,,,,,,,,,,,,,,,,,,,,,,,,,,,,,,,,,,,,13,5,14,54,,1016,,,0,3,3,,1,0,,,,,"Aachen Laufen",,"Polar BEAT",,0,,0,168070,250480,30378,,,,,,,,,,,,,,,,,,,,,,,,,,,,,,,,,,,,,,,,,,5,
5964352,1b981150-4379-4e07-9e5d-0431a801ec7b,1524390970,120,1548678575,,0,0,0.91,304,306,0,19,,,1,0.8,0.55,0.81,0.93,,64,139,155,,,,55.03,28.89,53.61,1,,,,,,,,,,,,,,6,81,10.31,10.93,10.5,10,,,,,,,,,,,,,,,,"15,13,27,25,13,6,0,0,0","4,37,59,0,0",,,,,,111,,,,,,,,,,,,,,,,,,,,,,,,,,,,,,,,,,,,13.6,20,10,187,59,,1013,,,0,3,3,,1,0,,,Running,,,,"Polar M430",43,0,,0,168070,250480,30378,,,,,,,,,,,,,,,,,,,,,,,,,,,,,,,,,,,,,,,,,,,
5964353,c7b36d3b-5ad3-440e-a8e6-c8e74165c8f7,1451651068,60,1548678576,,0,0,12.02,3101,3195,217,219,,,1,3,0.57,,,619,812,,,,,,,48.35,,1,,,,,,,,,,,,,,64,83,14.42,14.29,14.71,,,,,,,,,,,,,,,,,"5,1,3,8,15,25,42,0,0",,,,,,,140,,,,,,,,,,,,,,,,,,,,,,,,,,,,,,,,,,,,,6,6,172,90,,1025,,,0,5,3,,1,0,,,,,"Balve Laufen",,"Polar BEAT",,0,,0,168070,250480,30378,,,,,,,,,,,,,,,,,,,,,,,,,,,,,,,,,,,,,,,,,,"4,5,5",
5964354,ead3e518-7576-46bc-922f-0ca7138ccf13,1365537740,120,1548678576,,0,0,12.05,3837,4068,85,86,,,1,0,0.18,,,,823,,,,,,,37.84,,1,,,,,,,,,,,,,,79,,11.39,13.59,13.8,,,,,,,,,,,,,,,,,"22,2,4,13,18,13,17,7,4",,,,,,,,,,,,,,,,,,,,,,,,,,,,,,,,,,,,,,,,,,,,7,11,230,80,,1005,,,1,6,3,,1,0,,,,,,,"Polar BEAT",,0,,0,168070,250480,30378,,,,,,,,,,,,,,,,,,,,,,,,,,,,,,,,,,,,,,,,,,,
5964355,2b780dc1-1d0f-4997-b28d-8a2cf7f2d2c0,1476995541,120,1548678577,,0,0,10.84,3019,3025,366,378,,,1,4.7,0.73,,,987,679,,,,,,,43.9,,1,,,,,,,,,,,,,,62,82,13.56,13.7,15.53,,,,,,,,,,,,,,,,,"8,3,9,19,16,10,30,5,0",,,,,,,131,,,,,,,,,,,,,,,,,,,,,,,,,,,,,,,,,,,,,7,5,8,98,,1014,0,,1,5,3,,1,0,,,,,"Aachen Laufen",,"Polar BEAT",,0,,0,168070,250480,30378,,,,,,,,,,,,,,,,,,,,,,,,,,,,,,,,,,,,,,,,,,"5,5,5,5,5,5,5,5,5,5,5,5",
5964356,8b22d9f6-b784-45ef-909d-b95e58392325,1395776376,60,1548678577,,0,0,3.47,873,885,0,1,,,1,0,0.01,,,,196,164,182,,,,62.39,45.92,62.37,1,,,,,,,,,,,,,,31,83,14.39,16.53,16.5,11.9,,,,,,,,,,,,,,,,"29,1,1,1,1,2,3,55,6","0,21,10,62,7",,,,,,144,,,,,,,,,,,,,,,,,,,,,,,,,,,,,,,,,,,,73.1,5,4,81,70,,1012,0,,1,5,3,,1,0,,,,,"3x 1000m",,"Polar BEAT",,0,,0,168070,250480,30378,,,,,,,,,,,,,,,,,,,,,,,,,,,,,,,,,,,,,,,,,,,
5964357,de3563dc-c223-447d-8b9d-dea53f8d6596,1415823024,60,1548678578,,0,0,14.99,3844,3844,178,194,,,1,1.7,0.5,,,437,999,,,,,,,49.5,,1,,,,,,,,,,,,,,79,84,14.21,14.25,14.54,,,,,,,,,,,,,,,,,"1,0,1,6,22,43,25,3,0",,,,,,,139,,,,,,,,,,,,,,,,,,,,,,,,,,,,,,,,,,,,,9,6,188,94,,1008,,,1,3,3,,1,0,,,,,"Zügiger DL",,"Polar BEAT",,0,,0,168070,250480,30378,,,,,,,,,,,,,,,,,,,,,,,,,,,,,,,,,,,,,,,,,,4,
5964358,3546ad0d-fcd7-46ca-a285-ef30bc5aedce,1535126342,120,1548678578,,0,0,13.82,3975,3975,47,48,,,1,0,0.06,1.14,0.89,,919,143,155,,,,63.86,43.06,64.13,1,,,,,,,,,,,,,,83,81,12.55,12.56,12.63,5.7,,,,,,,,,,,,,,,,"0,0,3,19,64,13,0,0,0","1,6,93,0,0",,,,,,129,,,,,,,,,,,,,,,,,,,,,,,,,,,,,,,,,,,,25.1,20,11,259,57,,1014,,,0,5,3,,1,0,I1.000|4:35-I1.000|4:32-I1.000|4:35-I1.000|4:46-I1.000|4:45-I1.000|4:48-I1.000|4:45-I1.000|4:48-I1.000|4:50-I1.000|4:57-I1.000|4:53-I1.000|4:50-I1.000|4:57-I0.829|4:14,,Running,,,,"Polar M430",43,0,,0,168070,250480,30378,,,,,,,,,,,,,,,,,,,,,,,,,,,,,,,,,,,,,,,,,,,
5964359,4644b1a6-b3a8-4041-a187-d7591fbc3029,1444249805,120,1548678579,,0,0,12.64,3547,3550,181,181,,,1,2,0.59,,,408,867,,,,,,,44.01,,1,,,,,,,,,,,,,,73,85,13.07,12.93,13.29,,,,,,,,,,,,,,,,,"1,0,3,13,52,30,0,0,0",,,,,,,126,,,,,,,,,,,,,,,,,,,,,,,,,,,,,,,,,,,,,12,17,223,91,,1015,,,1,4,3,,1,0,,,,,"Aachen Laufen",,"Polar BEAT",,0,,0,168070,250480,30378,,,,,,,,,,,,,,,,,,,,,,,,,,,,,,,,,,,,,,,,,,4,
5964360,c46f0922-ad5e-48ba-8167-360cd8bab591,1544958364,60,1548678579,,0,0,18.19,4112,4112,194,276,,,1,1.3,0.36,1.04,1.01,474,1313,177,186,,,,63.35,58.14,63.83,1,,,,,,,,,,,,,,188,87,16.04,16.07,16.19,7.3,,,,,,,,,,,,,,,,"0,0,0,1,5,17,57,20,0","0,1,0,58,40",,,,,,153,,,,,,,,,,,,,,,,,,,,,,,,,,,,,,,,,,,,129.2,0,8,195,91,,1012,0,312,0,4,3,,1,0,I1.000|3:41-I1.000|4:07-I1.000|3:37-I1.000|3:36-I1.000|3:18-I1.000|3:24-I1.000|3:55-I1.000|3:37-I1.000|3:39-I1.000|3:48-I1.000|3:43-I1.000|3:59-I1.000|3:48-I1.000|3:39-I1.000|4:10-I1.000|3:59-I1.000|4:09-I1.000|3:41-I0.193|0:42,,Running,,,,"Polar M430",43,0,,0,168070,250480,30378,,,,,,,,,,,,,,,,,,,,,,,,18,4112,,,0,Winterlauf,,,,,,,0,0,30378,5964360,994,,5,
5964362,59a7d91b-409b-4b79-b452-37ce1c71e920,1429042467,120,1548678581,,0,0,2.11,599,599,28,18,,,1,0.7,0.43,,,,146,,,,,,,38.18,,1,,,,,,,,,,,,,,12,83,12.99,12.81,13.4,,,,,,,,,,,,,,,,,"4,1,1,14,47,33,0,0,0",,,,,,,127,,,,,,,,,,,,,,,,,,,,,,,,,,,,,,,,,,,,,17,12,244,52,,1024,,,0,3,3,,1,0,,,,,"Aachen Laufen",,"Polar BEAT",,0,,0,168070,250480,30378,,,,,,,,,,,,,,,,,,,,,,,,,,,,,,,,,,,,,,,,,,,
5964363,486ef532-3aa9-4463-b65d-a849b1e68bd3,1411589266,120,1548678582,,0,0,15.01,4055,4125,196,205,,,1,2.2,0.58,1.03,1.05,410,726,146,176,,,,67.17,46.61,68.21,1,,,,,,,,,,,,,,95,82,13.54,13.49,13.79,-2.3,,,,,,,,,,,,,,,,"1,1,4,11,37,32,13,1,0","0,34,50,17,0",,,,,,135,,,,,,,,,,,,,,,,,,,,,,,,,,,,,,,,,,,,64.1,12,6,233,94,,1012,0,,1,5,3,,1,0,,,,,"Lockerer DL ",,"Polar BEAT",,0,,0,168070,250480,30378,,,,,,,,,,,,,,,,,,,,,,,,,,,,,,,,,,,,,,,,,,4,
5964364,a38e6106-60f8-4d66-8ba1-573b074ad65b,1396719023,120,1548678583,,0,0,10,2087,2087,29,30,,,1,0,0.06,,,,677,,,,,,,61.18,,1,,,,,,,,,,,,,,43,88,17.28,17.35,17.39,,,,,,,,,,,,,,,,,"0,0,0,0,0,1,39,59,0",,,,,,,163,,,,,,,,,,,,,,,,,,,,,,,,,,,,,,,,,,,,,16,3,253,65,,1016,1,,0,5,3,,1,0,,,,,"WK 10k Titz",,"Polar BEAT",,0,,0,168070,250480,30378,,,,,,,,,,,,,,,,,,,,,,,,,,,,,,,,,,,,,,,,,,,
5964365,c69c68c2-73d7-449e-b5b9-0b7424e89cbd,1446894411,60,1548678583,,0,0,3.48,932,932,66,67,,,1,1.1,0.42,,,,241,,,,,,,42.72,,1,,,,,,,,,,,,,,19,84,13.7,13.52,13.87,,,,,,,,,,,,,,,,,"0,0,1,3,39,56,0,0,0",,,,,,,133,,,,,,,,,,,,,,,,,,,,,,,,,,,,,,,,,,,,,17,16,203,89,,1024,,,0,4,3,,1,0,,,,,"Aachen Laufen",,"Polar BEAT",,0,,0,168070,250480,30378,,,,,,,,,,,,,,,,,,,,,,,,,,,,,,,,,,,,,,,,,,,
5964366,c64da14e-2ee5-44e4-9b4e-a3b97c1caf3a,1411155957,120,1548678583,,0,0,0.91,311,311,12,13,,,1,0.8,0.56,,,,57,,,,,,,28.15,,1,,,,,,,,,,,,,,6,79,10.67,10.91,11.27,,,,,,,,,,,,,,,,,"7,4,43,46,0,0,0,0,0",,,,,,,111,,,,,,,,,,,,,,,,,,,,,,,,,,,,,,,,,,,,,19,0,270,86,,,0,,1,5,3,,1,0,,,,,Auslaufen,,"Polar BEAT",,0,,0,168070,250480,30378,,,,,,,,,,,,,,,,,,,,,,,,,,,,,,,,,,,,,,,,,,,
5964367,8960c4d1-4faa-4311-888c-7c53d95b729f,1496264431,120,1548678583,,0,0,0.85,342,388,3,4,,,1,0,0.05,,,,58,,,,,,,23.14,,1,,,,,,,,,,,,,,7,77,9.01,9.37,9.36,,,,,,,,,,,,,,,,,"49,28,7,8,7,0,0,0,0",,,,,,,97,,,,,,,,,,,,,,,,,,,,,,,,,,,,,,,,,,,,,21,4,2,60,,1021,0,,0,5,3,,1,0,,,,,"Aachen Laufen",,"Polar BEAT",,0,,0,168070,250480,30378,,,,,,,,,,,,,,,,,,,,,,,,,,,,,,,,,,,,,,,,,,,
5964368,a0c18d80-c29d-4dbb-a5a5-3f31b986e5e5,1456575325,60,1548678584,,0,0,3.32,952,952,65,64,,,1,1.6,0.57,,,459,227,,,,,,,39.32,,1,,,,,,,,,,,,,,19,85,12.98,12.65,13.58,,,,,,,,,,,,,,,,,"0,3,11,28,28,31,0,0,0",,,,,,,123,,,,,,,,,,,,,,,,,,,,,,,,,,,,,,,,,,,,,5,20,55,51,,1009,,,0,3,3,,1,0,,,,,"Aachen Laufen",,"Polar BEAT",,0,,0,168070,250480,30378,,,,,,,,,,,,,,,,,,,,,,,,,,,,,,,,,,,,,,,,,,5,
5964369,,1423918801,60,1548678584,,0,0,,0,0,,,,,0,,,,,,,,,,,,,,,1,,,,,,,,,,,,,,0,,,,,,,,,,,,,,,,,,,,,,,,,,,,,,,,,,,,,,,,,,,,,,,,,,,,,,,,,,,,,,,,,,,,,,,,,,1,,,0,0,,,,,Auslaufen,,"Polar BEAT",,0,,0,168070,250480,30378,,,,,,,,,,,,,,,,,,,,,,,,,,,,,,,,,,,,,,,,,,,
5964370,a75f000b-64c2-48c4-ba17-23c98dad0f15,1463307014,120,1548678584,,0,0,15,3758,3758,393,398,,,1,3.4,0.65,,,401,1035,,,,,,,50.86,,1,,,,,,,,,,,,,,78,85,14.81,14.47,15.43,,,,,,,,,,,,,,,,,"0,1,1,2,13,51,28,3,0",,,,,,,141,,,,,,,,,,,,,,,,,,,,,,,,,,,,,,,,,,,,,6,10,286,86,,,3,,0,6,3,,1,0,,,,,"Balve Laufen",,"Polar BEAT",,0,,0,168070,250480,30378,,,,,,,,,,,,,,,,,,,,,,,,,,,,,,,,,,,,,,,,,,"4,5,5,5,5",
5964371,6c3707ce-d21d-46b6-b3c6-204486693826,1432672720,120,1548678585,,0,0,5.85,1702,1893,57,58,,,1,0,0.03,,,,334,,,,,,,40.09,,1,,,,,,,,,,,,,,35,81,12.45,15.65,15.7,,,,,,,,,,,,,,,,,"45,1,1,1,2,2,4,22,22",,,,,,,127,,,,,,,,,,,,,,,,,,,,,,,,,,,,,,,,,,,,,13,7,340,53,,1023,0,,0,5,3,,1,0,,,,,"Aachen Laufen",,"Polar BEAT",,0,,0,168070,250480,30378,,,,,,,,,,,,,,,,,,,,,,,,,,,,,,,,,,,,,,,,,,,
5964372,e9f53cff-4ae7-48ad-ac00-4c296bf200d1,1435695140,120,1548678585,,0,0,2.34,671,671,25,22,,,1,0.3,0.31,,,,163,,,,,,,38.14,,1,,,,,,,,,,,,,,13,81,12.73,12.74,13.2,,,,,,,,,,,,,,,,,"3,1,2,16,59,17,1,0,0",,,,,,,129,,,,,,,,,,,,,,,,,,,,,,,,,,,,,,,,,,,,,26,10,71,35,,1018,,,0,3,3,,1,0,,,,,"Aachen Laufen",,"Polar BEAT",,0,,0,168070,250480,30378,,,,,,,,,,,,,,,,,,,,,,,,,,,,,,,,,,,,,,,,,,,
5964373,85f2b3da-c8a6-45de-91e9-bd760dd8152a,1523903188,120,1548678585,,0,0,11.78,3474,3487,20,21,,,1,0,0.02,,0.72,,884,157,187,,,,54.6,41.31,54.71,1,,,,,,,,,,,,,,108,80,12.24,13.38,13.43,12.7,,,,,,,,,,,,,,,,"18,10,8,18,10,6,25,5,0","0,24,37,21,18",,,,,,127,,,,,,,,,,,,,,,,,,,,,,,,,,,,,,,,,,,,115.3,18,10,289,46,,1014,,,0,5,3,,1,0,I3.035|15:34-I1.030|3:44-I1.027|3:51-I0.620|3:33-I1.030|3:40-I0.424|2:33-I1.031|4:06-I1.041|3:52-I0.412|4:10-I0.420|1:19-I0.078|1:17-I1.626|10:29,,Running,,,,"Polar M430",43,0,,0,168070,250480,30378,,,,,,,,,,,,,,,,,,,,,,,,,,,,,,,,,,,,,,,,,,,
5964374,d29b1b2c-68a2-4376-931b-ed9fe51ea98f,1415656637,60,1548678586,,0,0,3.55,1187,1602,32,53,,,1,1.3,0.51,,,1103,230,,,,,,,32.98,,1,,,,,,,,,,,,,,24,83,10.7,10.89,10.91,,,,,,,,,,,,,,,,,"13,9,25,42,11,0,0,0,0",,,,,,,108,,,,,,,,,,,,,,,,,,,,,,,,,,,,,,,,,,,,,6,3,162,92,,1010,0,,1,5,3,,1,0,,,,,Auslaufen,,"Polar BEAT",,0,,0,168070,250480,30378,,,,,,,,,,,,,,,,,,,,,,,,,,,,,,,,,,,,,,,,,,5,
5964375,c84e1554-7c75-4175-b601-f3ae34838523,1442600382,120,1548678586,,0,0,14.26,4338,4608,216,214,,,1,2.2,0.55,,,411,966,,,,,,,40.44,,1,,,,,,,,,,,,,,90,83,12.07,12.21,12.6,,,,,,,,,,,,,,,,,"8,2,8,20,47,14,1,0,0",,,,,,,119,,,,,,,,,,,,,,,,,,,,,,,,,,,,,,,,,,,,,16,13,196,69,,1015,,,0,5,3,,1,0,,,,,"Aachen Laufen",,"Polar BEAT",,0,,0,168070,250480,30378,,,,,,,,,,,,,,,,,,,,,,,,,,,,,,,,,,,,,,,,,,"4,5",
5964376,892ce50b-4380-4f58-b734-a2575ebbb765,1412887205,120,1548678587,,0,0,7.69,2077,2089,0,3,,,1,0,0,0.31,,,395,155,181,,,,61.96,44.49,61.93,1,,,,,,,,,,,,,,63,83,13.41,15.35,15.38,1.4,,,,,,,,,,,,,,,,"25,5,3,3,6,7,8,37,6","0,23,21,56,0",,,,,,134,,,,,,,,,,,,,,,,,,,,,,,,,,,,,,,,,,,,69.6,13,9,201,90,,1010,0,,1,5,3,,1,0,,,,,"2x (500 300 500 300 500 300) + 500 300 200",,"Polar BEAT",,0,,0,168070,250480,30378,,,,,,,,,,,,,,,,,,,,,,,,,,,,,,,,,,,,,,,,,,,
5964377,bac283aa-a80a-4b0a-ad07-59a40653e020,1525713494,120,1548678587,,0,0,5.36,1939,1940,28,29,,,1,0,0.19,1.13,0.92,,402,137,154,,,,50.78,30.77,51.1,1,,,,,,,,,,,,,,35,81,9.99,10.04,10.2,2.7,,,,,,,,,,,,,,,,"17,39,31,12,1,0,0,0,0","1,70,29,0,0",,,,,,102,,,,,,,,,,,,,,,,,,,,,,,,,,,,,,,,,,,,20.3,26,8,57,33,,1014,,,0,5,3,,1,0,I1.000|5:56-I1.000|5:58-I1.000|5:52-I1.000|5:47-I1.000|6:29-I0.357|2:19,,Running,,,,"Polar M430",43,0,,0,168070,250480,30378,,,,,,,,,,,,,,,,,,,,,,,,,,,,,,,,,,,,,,,,,,,
5964378,c4bfbe86-8bf3-4940-b6cc-852048eac730,1370352916,120,1548678589,,0,0,116.65,18121,19383,1526,1536,,,1,3.6,0.46,,,709,4078,,,,,,,,,1,,,,,,,,,,,,,,202,,,29.47,,,,286,184,,1,397,316,,,,,,,,,"25,16,16,14,12,6,11",,"58,14,9,5,15",,,,,,,,,,,,,,,,,,,,,,,,,,,,,,,,,,,,,,,,,,15,8,15,64,,1023,6,,0,5,3,,1,0,,,,,,,"Polar BEAT",,0,,0,168072,,30378,,,,,,,,,,,,,,,,,,,,,,,,,,,,,,,,,,,,,,,,,,"4,4,4,4,5,5,5,5,5,5,5,5,5",
5964379,b940afba-db20-44d8-8029-4c72d957f27e,1415535218,60,1548678590,,0,0,18.52,4902,4902,226,291,,,1,1.6,0.39,,,292,1230,,,,,,,48.53,,1,,,,,,,,,,,,,,101,83,13.75,14.08,14.26,,,,,,,,,,,,,,,,,"2,2,8,13,26,24,18,8,0",,,,,,,137,,,,,,,,,,,,,,,,,,,,,,,,,,,,,,,,,,,,,10,4,131,85,,1008,1,,0,5,3,,1,0,,,,,"Gesteigerter DL / Winterlauf auf Probe",,"Polar BEAT",,0,,0,168070,250480,30378,,,,,,,,,,,,,,,,,,,,,,,,,,,,,,,,,,,,,,,,,,5,
5964380,53dbce98-ba4a-4bdf-862e-334543a7513b,1473710078,120,1548678590,,0,0,0.7,233,233,16,8,,,1,1.2,0.71,,,,48,,,,,,,28.21,,1,,,,,,,,,,,,,,4,81,11.48,10.9,11.62,,,,,,,,,,,,,,,,,"6,11,42,23,18,0,0,0,0",,,,,,,111,,,,,,,,,,,,,,,,,,,,,,,,,,,,,,,,,,,,,25,1,64,62,,1015,0,,0,3,3,,1,0,,,,,"Aachen Laufen",,"Polar BEAT",,0,,0,168070,250480,30378,,,,,,,,,,,,,,,,,,,,,,,,,,,,,,,,,,,,,,,,,,,
5964381,e009e212-0207-4fdb-8900-9725448ed410,1463166548,120,1548678591,,0,0,13.73,4042,4733,233,226,,,1,2.6,0.57,,,434,950,,,,,,,41.89,,1,,,,,,,,,,,,,,83,82,12.6,12.53,13.06,,,,,,,,,,,,,,,,,"9,3,8,15,43,15,6,1,0",,,,,,,124,,,,,,,,,,,,,,,,,,,,,,,,,,,,,,,,,,,,,19,17,9,39,,1004,,,0,3,3,,1,0,,,,,"Aachen Laufen",,"Polar BEAT",,0,,0,168070,250480,30378,,,,,,,,,,,,,,,,,,,,,,,,,,,,,,,,,,,,,,,,,,4,
5964382,9ba8b16c-88dd-4cca-9ae5-afe330a3538a,1458327215,60,1548678591,,0,0,13.12,3604,3613,190,204,,,1,1.9,0.46,,,432,913,,,,,,,45.24,,1,,,,,,,,,,,,,,74,83,13.42,13.23,13.63,,,,,,,,,,,,,,,,,"2,1,2,8,47,34,6,0,0",,,,,,,132,,,,,,,,,,,,,,,,,,,,,,,,,,,,,,,,,,,,,4,5,325,90,,1023,,,1,5,3,,1,0,,,,,"Aachen Laufen",,"Polar BEAT",,0,,0,168070,250480,30378,,,,,,,,,,,,,,,,,,,,,,,,,,,,,,,,,,,,,,,,,,"5,5",
5964383,02c0234b-5f57-496c-a5bc-6d4a06057b15,1458762350,60,1548678592,,0,0,14.86,4198,4369,267,265,,,1,2.1,0.56,,,359,1027,,,,,,,44.22,,1,,,,,,,,,,,,,,87,83,13.17,12.94,13.43,,,,,,,,,,,,,,,,,"2,4,7,17,32,31,7,0,0",,,,,,,128,,,,,,,,,,,,,,,,,,,,,,,,,,,,,,,,,,,,,7,9,323,75,,1014,,,1,5,3,,1,0,,,,,"Aachen Laufen",,"Polar BEAT",,0,,0,168070,250480,30378,,,,,,,,,,,,,,,,,,,,,,,,,,,,,,,,,,,,,,,,,,"4,5,5",
5964384,866c61d3-c3cf-47a8-8bfd-b73951a59d2a,1518535015,60,1548678592,,0,0,10.68,1527,1527,52,45,,,1,0,0.1,2.4,,,314,139,157,,,,,,,1,,,,,,,,,,,,,,29,,,26.07,,15,-0.7,141,121,,1,160,144,,,,,,,,,"6,5,16,68,6,0,0","1,43,55,0,0","72,17,0,0,10",,,,,,,,,,,,,,,,,,,,,,,,,,,,,,,,,,,,,,,,,25.1,6,4,90,44,,,,,0,3,3,,1,0,,,Cycling,,,,"Polar M430",43,0,,0,168072,,30378,,,,,,,,,,,,,,,,,,,,,,,,,,,,,,,,,,,,,,,,,,,
5964385,c9665a34-d19c-41d2-a3c4-a1baeb1a07d8,1451127681,60,1548678593,,0,0,15.01,3524,3524,368,375,,,1,3.7,0.7,,,450,1012,,,,,,,54.83,,1,,,,,,,,,,,,,,73,83,15.86,15.61,16.55,,,,,,,,,,,,,,,,,"2,0,0,1,10,16,60,10,0",,,,,,,154,,,,,,,,,,,,,,,,,,,,,,,,,,,,,,,,,,,,,13,23,214,68,,1022,,,0,5,3,,1,0,,,,,"Sundern Laufen",,"Polar BEAT",,0,,0,168070,250480,30378,,,,,,,,,,,,,,,,,,,,,,,,,,,,,,,,,,,,,,,,,,"4,5,5,5,5,5",
5964386,480fe129-1d75-46cb-8dd1-39044aac6c71,1530733793,120,1548678593,,0,0,5.01,2234,2236,70,69,,,1,0.6,0.28,1.32,1.12,590,600,160,198,,,,31.85,23.76,32.41,1,,,,,,,,,,,,,,80,88,8.3,8.12,8.58,27.1,,,,,,,,,,,,,,,,"97,3,0,0,0,0,0,0,0","0,35,13,16,36",,,,,,76,,,,,,,,,,,,,,,,,,,,,,,,,,,,,,,,,,,,166.1,24,7,238,56,,1013,,,0,6,3,,1,0,I3.360|24:55-I1.650|12:24,,Running,,,,"Polar M430",43,0,,0,168070,250480,30378,,,,,,,,,,,,,,,,,,,,,,,,,,,,,,,,,,,,,,,,,,5,
5964387,,1333483959,120,1548678595,,0,0,2.42,0,0,,,,,0,,,,,,174,,,,,,,,,1,,,,,,,,,,,,,,0,,,,,,,,,,,,,,,,,,,,,,,,,,,,,,,,,,,,,,,,,,,,,,,,,,,,,,,,,,,,,,,,,,,,,,,,,,1,,,0,0,,,,,,,"Polar BEAT",,0,,0,168070,250480,30378,,,,,,,,,,,,,,,,,,,,,,,,,,,,,,,,,,,,,,,,,,,
5964388,48610c31-552c-47ea-a910-a98dabcf5a5a,1402143147,120,1548678596,,0,0,14,3138,3205,385,383,,,1,3.7,0.75,,,513,921,,,,,,,57.56,,1,,,,,,,,,,,,,,65,86,16.61,16.11,17.3,,,,,,,,,,,,,,,,,"0,0,0,0,2,11,74,13,0",,,,,,,156,,,,,,,,,,,,,,,,,,,,,,,,,,,,,,,,,,,,,27,6,145,42,,,,,0,3,3,,1,0,,,,,TDL,,"Polar BEAT",,0,,0,168070,250480,30378,,,,,,,,,,,,,,,,,,,,,,,,,,,,,,,,,,,,,,,,,,"4,5,5,5,5,5",
5964389,7f5c6ac2-1200-455a-887c-f5d4aac4e361,1516694673,60,1548678596,,0,0,11.11,1485,1487,16,30,,,1,0,0.04,,,,357,154,178,,,,,,,1,,,,,,,,,,,,,,44,,,28.77,,-8.4,-12.2,156,131,,1,175,156,,,,,,,,,"7,11,5,22,54,1,0","0,23,21,56,0","40,50,0,1,9",,,,,,,,,,,,,,,,,,,,,,,,,,,,,,,,,,,,,,,,,75.6,6,1,226,85,,,0,,0,5,3,,1,0,I1.152|5:06-I9.965|19:44,,Cycling,,,,"Polar M430",43,0,,0,168072,,30378,,,,,,,,,,,,,,,,,,,,,,,,,,,,,,,,,,,,,,,,,,,
5964390,1a31c9d6-6591-4a1a-8052-e8168517c9f4,1414095136,120,1548678596,,0,0,3.34,1062,1062,64,64,,,1,1.6,0.58,,,419,218,,,,,,,34.86,,1,,,,,,,,,,,,,,22,79,11.7,11.64,12.51,,,,,,,,,,,,,,,,,"5,5,25,30,30,3,1,0,0",,,,,,,119,,,,,,,,,,,,,,,,,,,,,,,,,,,,,,,,,,,,,11,9,184,88,,1024,,,1,5,3,,1,0,,,,,Einlaufen,,"Polar BEAT",,0,,0,168070,250480,30378,,,,,,,,,,,,,,,,,,,,,,,,,,,,,,,,,,,,,,,,,,4,
5964391,c7884f5e-3756-4f3a-9ca4-162daf9c0785,1407103593,120,1548678596,,0,0,2.55,929,1254,42,20,,,1,1,0.47,1.12,0.99,,146,131,151,,,,53.13,29.1,54.78,1,,,,,,,,,,,,,,14,79,10.28,10.01,10.56,-6.9,,,,,,,,,,,,,,,,"23,21,38,17,2,0,0,0,0","2,83,15,0,0",,,,,,104,,,,,,,,,,,,,,,,,,,,,,,,,,,,,,,,,,,,14.4,17,2,195,95,,1014,0,,1,6,3,,1,0,,,,,Einlaufen,,"Polar BEAT",,0,,0,168070,250480,30378,,,,,,,,,,,,,,,,,,,,,,,,,,,,,,,,,,,,,,,,,,,
5964392,3557953e-d8ce-4bef-af07-c3bab0c60247,1505292423,120,1548678597,,0,0,6.72,2017,2017,70,68,,,1,0.9,0.46,1.01,0.96,,491,151,169,,,,56.39,38.96,57.13,1,,,,,,,,,,,,,,52,80,12.16,12.05,12.25,-2.3,,,,,,,,,,,,,,,,"3,1,7,40,45,5,0,0,0","0,7,85,8,0",,,,,,125,,,,,,,,,,,,,,,,,,,,,,,,,,,,,,,,,,,,41.2,14,23,243,90,,1001,0,,0,6,3,,1,0,I1.000|5:13-I1.000|4:43-I1.000|5:10-I1.000|5:01-I1.000|4:58-I1.000|5:11-I0.725|3:22,,Running,,,,"Polar M430",43,0,,0,168070,250480,30378,,,,,,,,,,,,,,,,,,,,,,,,,,,,,,,,,,,,,,,,,,,
5964393,918ddc13-af5e-4389-a3a5-05e7b4633fc9,1540570125,120,1548678597,,0,0,5.32,1553,1553,133,131,,,1,2.6,0.62,1.12,0.93,420,389,151,164,,,,58.35,39.71,60.19,1,,,,,,,,,,,,,,39,81,12.88,12.57,13.44,4,,,,,,,,,,,,,,,,"5,4,10,23,33,17,8,0,0","0,9,86,4,0",,,,,,127,,,,,,,,,,,,,,,,,,,,,,,,,,,,,,,,,,,,37.2,10,19,252,73,,1007,1,292,0,5,3,,1,0,I1.000|5:47-I1.000|5:01-I1.000|5:03-I1.000|4:34-I1.000|4:12-I0.318|1:18,,Running,,,,"Polar M430",43,0,,0,168070,250480,30378,,,,,,,,,,,,,,,,,,,,,,,,,,,,,,,,,,,,,,,,,,4,
5964394,cd7330aa-d6b5-48f5-bc86-6bc2f8fffe10,1364651478,60,1548678599,,0,0,10.05,2279,2302,730,553,,,1,0,0.01,,,,676,,,,,,,55.52,,1,,,,,,,,,,,,,,47,,16.17,16.3,16.99,,,,,,,,,,,,,,,,,"3,0,0,0,2,14,50,28,2",,,,,,,,,,,,,,,,,,,,,,,,,,,,,,,,,,,,,,,,,,,,2,8,4,69,,1009,,,0,5,3,,1,0,,,,,,,"Polar BEAT",,0,,0,168070,250480,30378,,,,,,,,,,,,,,,,,,,,,,,,,,,,,,,,,,,,,,,,,,,
5964395,89aa2418-9801-48c7-9b8e-217ec42867fd,1414842448,60,1548678600,,0,0,6.84,2073,2876,125,95,,,1,2,0.59,,,428,455,,,,,,,38.56,,1,,,,,,,,,,,,,,43,81,12.34,12.01,12.64,,,,,,,,,,,,,,,,,"2,4,16,29,38,10,1,0,0",,,,,,,122,,,,,,,,,,,,,,,,,,,,,,,,,,,,,,,,,,,,,19,6,180,65,,1020,1,,0,5,3,,1,0,,,,,"Einlaufen + Lauf ABC",,"Polar BEAT",,0,,0,168070,250480,30378,,,,,,,,,,,,,,,,,,,,,,,,,,,,,,,,,,,,,,,,,,4,
5964396,e0edf500-decc-4c41-b828-24738fb299e5,1514552008,60,1548678601,,0,0,11.2,3263,3263,328,329,,,1,4.1,0.72,1.06,0.92,644,855,158,180,,,,54.93,41.75,56.92,1,,,,,,,,,,,,,,101,81,13.16,12.59,13.79,-3,,,,,,,,,,,,,,,,"1,6,14,20,31,26,3,0,0","0,8,52,40,0",,,,,,127,,,,,,,,,,,,,,,,,,,,,,,,,,,,,,,,,,,,90.3,3,10,184,79,,,1,,0,5,3,,1,0,I1.000|4:56-I1.000|5:29-I1.000|5:47-I1.000|4:53-I1.000|4:59-I1.000|5:14-I1.000|4:39-I1.000|4:22-I1.000|4:22-I1.000|4:11-I1.000|4:30-I0.204|1:01,,Running,,,,"Polar M430",43,0,,0,168070,250480,30378,,,,,,,,,,,,,,,,,,,,,,,,,,,,,,,,,,,,,,,,,,3,
5964397,2098766b-01ee-491e-9819-6e0034428c70,1533748961,120,1548678602,,0,0,10.5,1476,1476,62,51,,,1,0,0.13,1.59,,,262,125,152,,,,,,,1,,,,,,,,,,,,,,20,,,26.54,,7.3,-18.2,139,124,,1,160,146,,,,,,,,,"2,13,16,55,14,0,0","1,83,16,0,0","68,21,0,0,10",,,,,,,,,,,,,,,,,,,,,,,,,,,,,,,,,,,,,,,,,17.3,30,14,262,38,,,2,,0,5,3,,1,0,,,Cycling,,,,"Polar M430",43,0,,0,168072,,30378,,,,,,,,,,,,,,,,,,,,,,,,,,,,,,,,,,,,,,,,,,,
5964398,be83e499-f6ac-42a1-af1b-3d212aaf2510,1426417313,60,1548678603,,0,0,9.62,2370,2370,146,145,,,1,1.8,0.53,,,373,652,,,,,,,50.25,,1,,,,,,,,,,,,,,49,84,15.07,14.79,15.17,,,,,,,,,,,,,,,,,"0,0,0,6,16,34,42,3,0",,,,,,,145,,,,,,,,,,,,,,,,,,,,,,,,,,,,,,,,,,,,,4,6,68,89,,1026,2,,0,5,3,,1,0,,,,,"Eschweiler Laufen",,"Polar BEAT",,0,,0,168070,250480,30378,,,,,,,,,,,,,,,,,,,,,,,,,,,,,,,,,,,,,,,,,,"5,5",
5964399,f567d0e3-a5c4-4668-a79e-a7f38e492e63,1545242239,60,1548678604,,0,0,6.67,1543,1543,32,32,,,1,0,0.18,1.04,0.93,,411,157,175,,,,73.73,52.92,74.17,1,,,,,,,,,,,,,,46,84,15.6,15.58,15.69,10.4,,,,,,,,,,,,,,,,"0,0,0,0,0,16,83,1,0","1,15,30,54,0",,,,,,154,,,,,,,,,,,,,,,,,,,,,,,,,,,,,,,,,,,,69,5,5,155,97,,,0,,1,5,3,,1,0,I1.000|3:55-I1.000|3:58-I1.000|3:50-I1.000|3:51-I1.000|3:49-I1.000|3:51-I0.672|2:30,,Running,,,,"Polar M430",43,0,,0,168070,250480,30378,,,,,,,,,,,,,,,,,,,,,,,,,,,,,,,,,,,,,,,,,,,
5964400,e833b67b-152c-46b4-b630-ffa47f15aadb,1442521813,120,1548678604,,0,0,10.21,3042,3067,0,0,,,1,0,0,,,,658,,,,,,,40.39,,1,,,,,,,,,,,,,,63,75,12.19,14.37,14.41,,,,,,,,,,,,,,,,,"33,1,1,1,2,4,40,18,0",,,,,,,134,,,,,,,,,,,,,,,,,,,,,,,,,,,,,,,,,,,,,12,11,213,91,,1009,,,1,5,3,,1,0,,,,,"Aachen Laufen",,"Polar BEAT",,0,,0,168070,250480,30378,,,,,,,,,,,,,,,,,,,,,,,,,,,,,,,,,,,,,,,,,,,
5964401,,1402695638,120,1548678604,,0,0,8,0,0,,,,,0,,,,,,,,,,,,,,,1,,,,,,,,,,,,,,0,,,,,,,,,,,,,,,,,,,,,,,,,,,,,,,,,,,,,,,,,,,,,,,,,,,,,,,,,,,,,,,,,,,,,,,,,,1,,,0,0,,,,,"WK 800m Alemannia ",,"Polar BEAT",,0,,0,168070,250480,30378,,,,,,,,,,,,,,,,,,,,,,,,,,,,,,,,,,,,,,,,,,,
5964402,d2a7d93a-fda0-4a24-b1ea-74d6dff8a652,1421785089,60,1548678605,,0,0,3,943,943,39,20,,,1,0.9,0.46,,,,203,,,,,,,35.05,,1,,,,,,,,,,,,,,19,84,11.76,11.59,11.98,,,,,,,,,,,,,,,,,"7,6,12,38,31,6,0,0,0",,,,,,,114,,,,,,,,,,,,,,,,,,,,,,,,,,,,,,,,,,,,,-1,3,157,84,,1014,0,,1,5,3,,1,0,,,,,"Aachen Laufen",,"Polar BEAT",,0,,0,168070,250480,30378,,,,,,,,,,,,,,,,,,,,,,,,,,,,,,,,,,,,,,,,,,,
5964403,0489f629-4115-48c0-be89-019cb83c15ad,1365328716,120,1548678607,,0,0,27.23,9253,9601,52,52,,,1,0,0.05,,,,1894,,,,,,,37.3,,1,,,,,,,,,,,,,,192,,10.63,12.25,12.29,,,,,,,,,,,,,,,,,"27,7,11,14,15,11,10,3,1",,,,,,,,,,,,,,,,,,,,,,,,,,,,,,,,,,,,,,,,,,,,2,10,326,76,,1022,2,,0,5,3,,1,0,,,,,,,"Polar BEAT",,0,,0,168070,250480,30378,,,,,,,,,,,,,,,,,,,,,,,,,,,,,,,,,,,,,,,,,,,
5964404,1c932f28-8262-4f50-a899-56377bd3ab0a,1531046110,120,1548678608,,0,0,8.52,2622,2623,150,148,,,1,2,0.62,1.08,1.04,269,612,145,163,,,,57.7,38.4,58.97,1,,,,,,,,,,,,,,59,82,12.09,11.91,12.27,6.8,,,,,,,,,,,,,,,,"1,5,24,42,17,7,4,0,0","0,26,71,3,0",,,,,,119,,,,,,,,,,,,,,,,,,,,,,,,,,,,,,,,,,,,40.5,17,10,324,58,,,5,,0,3,3,,1,0,I1.000|5:24-I1.000|5:17-I1.000|5:24-I1.000|5:14-I1.000|5:22-I1.000|5:00-I1.000|5:08-I1.000|4:38-I0.523|2:16,,Running,,,,"Polar M430",43,0,,0,168070,250480,30378,,,,,,,,,,,,,,,,,,,,,,,,,,,,,,,,,,,,,,,,,,5,
5964405,c1f27abd-1d91-4a1e-8985-292db6dbe1aa,1513197748,60,1548678608,,0,0,9.87,2833,2835,38,29,,,1,0,0.1,1.09,0.94,,625,142,157,,,,64.61,42.1,64.99,1,,,,,,,,,,,,,,58,84,12.62,12.65,12.75,7.8,,,,,,,,,,,,,,,,"0,1,5,21,52,22,0,0,0","1,26,74,0,0",,,,,,124,,,,,,,,,,,,,,,,,,,,,,,,,,,,,,,,,,,,27.5,5,10,206,90,,,0,,1,4,3,,1,0,I1.000|4:44-I1.000|4:30-I1.000|4:34-I1.000|4:33-I1.000|4:40-I1.000|4:49-I1.000|4:37-I1.000|4:50-I1.000|5:11-I0.876|4:48,,Running,,,,"Polar M430",43,0,,0,168070,250480,30378,,,,,,,,,,,,,,,,,,,,,,,,,,,,,,,,,,,,,,,,,,,
5964406,0b08931c-9a22-443b-b167-d4dc620a5f03,1412109842,120,1548678609,,0,0,10.51,2532,2543,121,121,,,1,0,0.1,,,,664,,,,,,,51.88,,1,,,,,,,,,,,,,,52,82,15.01,16.28,16.34,,,,,,,,,,,,,,,,,"17,0,1,1,1,1,38,40,2",,,,,,,152,,,,,,,,,,,,,,,,,,,,,,,,,,,,,,,,,,,,,15,1,165,89,,1026,0,,1,3,3,,1,0,,,,,"5x 2000m in 7min , 2min Pause",,"Polar BEAT",,0,,0,168070,250480,30378,,,,,,,,,,,,,,,,,,,,,,,,,,,,,,,,,,,,,,,,,,,
5964407,1c5d0690-3a30-4360-a901-c6fe80aee7fa,1368227105,120,1548678609,,0,0,0.21,28,28,4,6,,,1,0,0,,,,8,,,,,,,78.06,,1,,,,,,,,,,,,,,0,,26.72,27.38,26.73,,,,,,,,,,,,,,,,,"0,0,0,0,0,0,0,0,100",,,,,,,,,,,,,,,,,,,,,,,,,,,,,,,,,,,,,,,,,,,,10,8,232,83,,1018,0,,1,5,3,,1,0,,,,,,,"Polar BEAT",,0,,0,168070,250480,30378,,,,,,,,,,,,,,,,,,,,,,,,,,,,,,,,,,,,,,,,,,,
5964408,59e48e5a-3aa0-420f-b9a3-4ed50936b5fc,1476994514,120,1548678609,,0,0,2.17,658,658,53,42,,,1,1.3,0.53,,,458,151,,,,,,,35.51,,1,,,,,,,,,,,,,,13,80,12.48,11.88,12.98,,,,,,,,,,,,,,,,,"1,5,15,31,48,1,0,0,0",,,,,,,124,,,,,,,,,,,,,,,,,,,,,,,,,,,,,,,,,,,,,7,5,8,98,,1014,0,,1,5,3,,1,0,,,,,"Aachen Laufen",,"Polar BEAT",,0,,0,168070,250480,30378,,,,,,,,,,,,,,,,,,,,,,,,,,,,,,,,,,,,,,,,,,5,
5964409,e32ddff2-a0c0-4a2c-9e84-921fa9551cd1,1495052047,120,1548678610,,0,0,8.28,3693,4030,178,159,,,1,2.2,0.51,,,353,567,,,,,,,24.6,,1,,,,,,,,,,,,,,76,76,8.39,10.48,10.77,,,,,,,,,,,,,,,,,"56,14,7,9,4,3,5,2,0",,,,,,,89,,,,,,,,,,,,,,,,,,,,,,,,,,,,,,,,,,,,,27,7,166,39,,1012,0,,0,5,3,,1,0,,,,,"Aachen Laufen",,"Polar BEAT",,0,,0,168070,250480,30378,,,,,,,,,,,,,,,,,,,,,,,,,,,,,,,,,,,,,,,,,,"4,5",
5964410,03307bec-6efe-46e0-84b6-203f4f83269c,1485002601,60,1548678610,,0,0,2.2,646,646,40,16,,,1,1.1,0.54,,,,153,,,,,,,36.89,,1,,,,,,,,,,,,,,13,80,12.85,12.47,13.05,,,,,,,,,,,,,,,,,"3,9,3,22,44,16,2,0,0",,,,,,,128,,,,,,,,,,,,,,,,,,,,,,,,,,,,,,,,,,,,,2,10,133,53,,1029,,,0,3,3,,1,0,,,,,"Aachen Laufen",,"Polar BEAT",,0,,0,168070,250480,30378,,,,,,,,,,,,,,,,,,,,,,,,,,,,,,,,,,,,,,,,,,,
5964411,c8994cbb-1b5a-491b-bb53-52fd486ff4ea,1456945206,60,1548678611,,0,0,13.36,3629,3789,176,177,,,1,2.1,0.61,,,419,923,,,,,,,45.9,,1,,,,,,,,,,,,,,75,84,13.49,13.44,13.76,,,,,,,,,,,,,,,,,"2,1,4,7,27,52,6,0,0",,,,,,,131,,,,,,,,,,,,,,,,,,,,,,,,,,,,,,,,,,,,,2,23,218,89,,998,,,1,6,3,,1,0,,,,,"Aachen Laufen",,"Polar BEAT",,0,,0,168070,250480,30378,,,,,,,,,,,,,,,,,,,,,,,,,,,,,,,,,,,,,,,,,,4,
5964412,97e95a4a-9e77-406f-a123-28a0116c3573,1450810617,60,1548678613,,0,0,9.66,3074,3863,123,123,,,1,1.2,0.48,,,,671,,,,,,,37.24,,1,,,,,,,,,,,,,,63,79,11.51,12.4,12.65,,,,,,,,,,,,,,,,,"16,4,14,23,25,6,9,4,0",,,,,,,119,,,,,,,,,,,,,,,,,,,,,,,,,,,,,,,,,,,,,11,22,205,78,,1021,,,1,5,3,,1,0,,,,,"Aachen Laufen",,"Polar BEAT",,0,,0,168070,250480,30378,,,,,,,,,,,,,,,,,,,,,,,,,,,,,,,,,,,,,,,,,,,
5964413,faa49ba7-c0a2-4388-aea3-b07d8d9cf0d4,1543837189,60,1548678614,,0,0,10.48,3401,3402,36,36,,,1,0,0.15,1.07,0.88,,784,144,164,,,,54.53,36.61,54.76,1,,,,,,,,,,,,,,73,81,11.14,11.19,11.3,8.4,,,,,,,,,,,,,,,,"3,11,32,37,17,0,0,0,0","0,37,62,1,0",,,,,,114,,,,,,,,,,,,,,,,,,,,,,,,,,,,,,,,,,,,37,14,35,206,82,,,1,,0,11,3,,1,0,I1.000|4:57-I1.000|5:05-I1.000|5:02-I1.000|5:16-I1.000|5:21-I1.000|5:32-I1.000|5:38-I1.000|5:39-I1.000|5:42-I1.000|5:40-I0.486|2:50,,Running,,,,"Polar M430",43,0,,0,168070,250480,30378,,,,,,,,,,,,,,,,,,,,,,,,,,,,,,,,,,,,,,,,,,,
5964414,bad84e14-eb95-4556-9b33-b4fbdfa746c4,1417351483,60,1548678614,,0,0,8.35,2041,2041,203,196,,,1,2.8,0.64,,,578,573,,,,,,,50.27,,1,,,,,,,,,,,,,,42,89,15.35,15.01,15.82,,,,,,,,,,,,,,,,,"0,0,2,5,23,24,33,12,1",,,,,,,138,,,,,,,,,,,,,,,,,,,,,,,,,,,,,,,,,,,,,3,6,178,92,,1013,,,0,5,3,,1,0,,,,,"WK LVN Cross Meisterschaften",,"Polar BEAT",,0,,0,168070,250480,30378,,,,,,,,,,,,,,,,,,,,,,,,,,,,,,,,,,,,,,,,,,"5,5",
5964415,c5b40ed6-fde7-49b5-82a1-86a8ef08fd31,1508079812,120,1548678614,,0,0,13.23,4161,4162,198,193,,,1,2.5,0.6,1.01,1.03,414,997,150,175,,,,53.71,38.67,54.72,1,,,,,,,,,,,,,,104,81,11.73,11.55,11.9,5.7,,,,,,,,,,,,,,,,"2,6,22,35,34,1,0,0,0","1,18,73,9,0",,,,,,118,,,,,,,,,,,,,,,,,,,,,,,,,,,,,,,,,,,,51.8,23,14,175,51,,1022,,,0,3,3,,1,0,I1.000|5:28-I1.000|4:43-I1.000|5:15-I1.000|5:10-I1.000|4:51-I1.000|4:56-I1.000|5:55-I1.000|5:17-I1.000|5:42-I1.000|4:56-I1.000|5:00-I1.000|5:34-I1.000|5:21-I0.232|1:14,,Running,,,,"Polar M430",43,0,,0,168070,250480,30378,,,,,,,,,,,,,,,,,,,,,,,,,,,,,,,,,,,,,,,,,,4,
5964416,36f1b454-526b-4fe6-9def-4793b1072d81,1450863404,60,1548678615,,0,0,1.14,387,387,16,16,,,1,0.7,0.47,,,,82,,,,,,,29.1,,1,,,,,,,,,,,,,,8,81,10.76,10.63,10.96,,,,,,,,,,,,,,,,,"5,24,37,29,2,2,0,0,0",,,,,,,109,,,,,,,,,,,,,,,,,,,,,,,,,,,,,,,,,,,,,10,22,231,86,,1024,,,0,5,3,,1,0,,,,,"Aachen Laufen",,"Polar BEAT",,0,,0,168070,250480,30378,,,,,,,,,,,,,,,,,,,,,,,,,,,,,,,,,,,,,,,,,,,
5964417,d8a787d8-6fb2-4012-8be1-68b102b0f65b,1367442531,120,1548678615,,0,0,3.48,1057,1088,40,30,,,1,0.6,0.48,,,,247,,,,,,,36.89,,1,,,,,,,,,,,,,,21,,12.09,12.06,12.41,,,,,,,,,,,,,,,,,"7,3,11,21,49,9,0,0,0",,,,,,,,,,,,,,,,,,,,,,,,,,,,,,,,,,,,,,,,,,,,15,3,61,62,,1019,0,,1,5,3,,1,0,,,,,,,"Polar BEAT",,0,,0,168070,250480,30378,,,,,,,,,,,,,,,,,,,,,,,,,,,,,,,,,,,,,,,,,,,
5964418,7b701327-5e4a-4370-8d99-7daad716f0d3,1466107943,120,1548678615,,0,0,2.23,681,719,53,41,,,1,1.6,0.63,,,425,153,,,,,,,35.32,,1,,,,,,,,,,,,,,14,80,12.44,11.82,13.1,,,,,,,,,,,,,,,,,"0,0,14,53,27,5,0,0,0",,,,,,,123,,,,,,,,,,,,,,,,,,,,,,,,,,,,,,,,,,,,,14,1,228,91,,1002,0,,0,6,3,,1,0,,,,,"Aachen Laufen",,"Polar BEAT",,0,,0,168070,250480,30378,,,,,,,,,,,,,,,,,,,,,,,,,,,,,,,,,,,,,,,,,,5,
5964419,e8e4993d-be53-4471-91df-e8edbf1fd9b6,1445087485,120,1548678615,,0,0,3.38,1034,1034,70,70,,,1,1.7,0.64,,,421,227,,,,,,,36.51,,1,,,,,,,,,,,,,,21,82,12.18,11.86,12.62,,,,,,,,,,,,,,,,,"2,7,16,41,24,8,3,0,0",,,,,,,120,,,,,,,,,,,,,,,,,,,,,,,,,,,,,,,,,,,,,7,9,170,86,,1018,,,0,4,3,,1,0,,,,,"Aachen Laufen",,"Polar BEAT",,0,,0,168070,250480,30378,,,,,,,,,,,,,,,,,,,,,,,,,,,,,,,,,,,,,,,,,,4,
5964420,fa659463-8bb8-42a6-827c-e2d0866bf8a7,1468749574,120,1548678616,,0,0,2.7,863,863,33,33,,,1,0.6,0.37,,,,186,,,,,,,34.09,,1,,,,,,,,,,,,,,17,79,11.43,11.33,11.59,,,,,,,,,,,,,,,,,"3,9,25,40,24,0,0,0,0",,,,,,,119,,,,,,,,,,,,,,,,,,,,,,,,,,,,,,,,,,,,,19,6,256,89,,,3,,0,5,3,,1,0,,,,,"Balve Laufen",,"Polar BEAT",,0,,0,168070,250480,30378,,,,,,,,,,,,,,,,,,,,,,,,,,,,,,,,,,,,,,,,,,,
5964421,,1516730400,60,1548678616,,0,0,10,1800,1800,,,,,0,,,,,,385,,,,,,,,,1,,,,,,,,,,,,,,20,,,,,,,,,,,,,,,,,,,,,,,,,,,,,,,,,,,,,,,,,,,,,,,,,,,,,,,,,,,,,,,,,,,,,,,,,,1,,,0,0,,,,,,,"no device name available",,0,,0,168072,,30378,,,,,,,,,,,,,,,,,,,,,,,,,,,,,,,,,,,,,,,,,,,
5964422,014b7370-1b5b-4087-ab2e-44baa58352bd,1496495800,120,1548678616,,0,0,7.1,1679,1679,183,183,,,1,3.1,0.62,,,755,476,,,,,,,51.76,,1,,,,,,,,,,,,,,34,83,16.21,15.61,16.55,,,,,,,,,,,,,,,,,"0,4,5,6,4,21,39,20,2",,,,,,,153,,,,,,,,,,,,,,,,,,,,,,,,,,,,,,,,,,,,,23,3,257,73,,,7,,0,5,3,,1,0,,,,,"Balve Laufen",,"Polar BEAT",,0,,0,168070,250480,30378,,,,,,,,,,,,,,,,,,,,,,,,,,,,,,,,,,,,,,,,,,"4,5",
5964423,8ec93a0d-5289-4d87-a25d-d490e1930922,1410620422,120,1548678617,,0,0,3.06,1023,1074,20,52,,,1,0.4,0.41,,,,202,,,,,,,32.65,,1,,,,,,,,,,,,,,21,81,10.61,10.8,10.82,,,,,,,,,,,,,,,,,"5,13,45,29,7,2,0,0,0",,,,,,,111,,,,,,,,,,,,,,,,,,,,,,,,,,,,,,,,,,,,,18,7,24,73,,1025,3,,0,4,3,,1,0,,,,,"Auslaufen ",,"Polar BEAT",,0,,0,168070,250480,30378,,,,,,,,,,,,,,,,,,,,,,,,,,,,,,,,,,,,,,,,,,,
5964424,bef251ca-09f0-49b2-81ae-04c9ce06de2d,1393263257,60,1548678617,,0,0,5.11,1056,1056,112,101,,,1,1.9,1,1.21,0.9,,253,171,184,,,,74.74,59.38,76.99,1,,,,,,,,,,,,,,42,88,17.84,17.43,18.07,1,,,,,,,,,,,,,,,,"0,0,0,0,0,0,47,53,0","0,1,4,81,13",,,,,,165,,,,,,,,,,,,,,,,,,,,,,,,,,,,,,,,,,,,94.9,12,9,199,55,,1012,0,,0,5,3,,1,0,,,,,"5.000m TDL",,"Polar BEAT",,0,,0,168070,250480,30378,,,,,,,,,,,,,,,,,,,,,,,,,,,,,,,,,,,,,,,,,,,
5964425,343f896a-3351-4962-a985-74736df5efc6,1533466240,120,1548678618,,0,0,7.98,7090,7249,267,228,,,1,4.4,0.7,,,190,659,80,111,,,,,,,1,,,,,,,,,,,,,,16,,,4.66,,-19.9,,,,,,,,,,,,,,,,"64,36,0,0,0,0","92,8,0,0,0",,,,,,,,,,,,,,,,,,,,,,,,,,,,,,,,,,,,,,,,,,2.7,27,18,27,54,,1020,,,0,5,3,,1,0,I1.000|18:20-I1.000|12:35-I1.000|14:38-I1.000|17:05-I1.000|12:38-I1.000|16:56-I1.000|15:30-I1.000|13:08,,Hiking,,,,"Polar M430",43,0,,0,168075,,30378,,,,,,,,,,,,,,,,,,,,,,,,,,,,,,,,,,,,,,,,,,"3,5,5",
5964426,3b0ce37a-bf1b-4d16-b2e9-59b2c458706c,1443204269,120,1548678618,,0,0,11.78,3553,3723,304,280,,,1,4.3,0.74,,,453,799,,,,,,,40.24,,1,,,,,,,,,,,,,,73,83,12.55,12.06,13.31,,,,,,,,,,,,,,,,,"4,6,13,24,44,10,0,0,0",,,,,,,120,,,,,,,,,,,,,,,,,,,,,,,,,,,,,,,,,,,,,14,7,309,70,,,,,0,3,3,,1,0,,,,,"Balve Laufen",,"Polar BEAT",,0,,0,168070,250480,30378,,,,,,,,,,,,,,,,,,,,,,,,,,,,,,,,,,,,,,,,,,3,
5964427,2ed6f79c-a18f-46ad-969f-fff731370237,1423081954,60,1548678619,,0,0,15.43,4334,4558,201,225,,,1,2.4,0.55,,,380,1036,,,,,,,44.65,,1,,,,,,,,,,,,,,90,84,12.98,13.04,13.28,,,,,,,,,,,,,,,,,"3,2,3,17,35,35,4,1,0",,,,,,,127,,,,,,,,,,,,,,,,,,,,,,,,,,,,,,,,,,,,,-1,2,12,95,,1018,0,,1,5,3,,1,0,,,,,"Aachen Laufen",,"Polar BEAT",,0,,0,168070,250480,30378,,,,,,,,,,,,,,,,,,,,,,,,,,,,,,,,,,,,,,,,,,"4,5",
5964428,,1415873160,60,1548678619,,0,0,7,0,0,,,,,0,,,,,,447,,,,,,,,,1,,,,,,,,,,,,,,0,,,,,,,,,,,,,,,,,,,,,,,,,,,,,,,,,,,,,,,,,,,,,,,,,,,,,,,,,,,,,,,,,,,,,,,,,,1,,,0,0,,,,,"Lauf ABC",,"Polar BEAT",,0,,0,168070,250480,30378,,,,,,,,,,,,,,,,,,,,,,,,,,,,,,,,,,,,,,,,,,,
5964429,9f96aa4b-7a02-4a35-84b6-804fbeb30ddc,1408361059,120,1548678620,,0,0,14.44,4508,4509,202,202,,,1,2.2,0.55,,,380,985,,,,,,,39.28,,1,,,,,,,,,,,,,,93,81,11.77,11.84,12.18,,,,,,,,,,,,,,,,,"7,4,7,35,43,4,0,0,0",,,,,,,119,,,,,,,,,,,,,,,,,,,,,,,,,,,,,,,,,,,,,16,12,252,69,,1008,4,,0,5,3,,1,0,,,,,"Langsamer DL ",,"Polar BEAT",,0,,0,168070,250480,30378,,,,,,,,,,,,,,,,,,,,,,,,,,,,,,,,,,,,,,,,,,"4,5",
5964430,f97ae4dd-6dd6-49d0-ad3d-39a8d91c6620,1500213117,120,1548678620,,0,0,1.55,493,516,21,16,,,1,1.1,0.61,,,,104,,,,,,,32.45,,1,,,,,,,,,,,,,,10,79,11.68,12,11.96,,,,,,,,,,,,,,,,,"13,18,24,19,4,7,15,0,0",,,,,,,119,,,,,,,,,,,,,,,,,,,,,,,,,,,,,,,,,,,,,30,9,266,29,,1019,9,,0,3,3,,1,0,,,,,"Aix-en-Provence Laufen",,"Polar BEAT",,0,,0,168070,250480,30378,,,,,,,,,,,,,,,,,,,,,,,,,,,,,,,,,,,,,,,,,,,
5964431,9b0c8760-c5c7-48d3-a64f-e978279523ff,1516980945,60,1548678620,,0,0,10.37,1623,1630,52,39,,,1,0,0.18,2.04,,,296,128,142,,,,,,,1,,,,,,,,,,,,,,23,,,23.89,,1.7,-24.5,125,108,,1,142,127,,,,,,,,,"7,10,33,49,1,0,0","0,99,1,0,0","84,4,0,1,11",,,,,,,,,,,,,,,,,,,,,,,,,,,,,,,,,,,,,,,,,13.7,8,0,308,88,,,0,,0,6,3,,1,0,,,Cycling,,,,"Polar M430",43,0,,0,168072,,30378,,,,,,,,,,,,,,,,,,,,,,,,,,,,,,,,,,,,,,,,,,,
5964432,35cbdfe6-f0c3-413d-a841-d6ea6d926fee,1422558638,60,1548678621,,0,0,13.58,3656,4284,153,152,,,1,1.1,0.45,,,,882,,,,,,,46.43,,1,,,,,,,,,,,,,,75,86,13.5,14.06,14.26,,,,,,,,,,,,,,,,,"11,3,5,16,25,15,6,16,4",,,,,,,130,,,,,,,,,,,,,,,,,,,,,,,,,,,,,,,,,,,,,2,9,207,93,,978,0,,1,5,3,,1,0,,,,,"Aachen Laufen",,"Polar BEAT",,0,,0,168070,250480,30378,,,,,,,,,,,,,,,,,,,,,,,,,,,,,,,,,,,,,,,,,,,
5964433,fc3afc90-8c01-4ba4-af2a-874cbc3925bd,1458586933,60,1548678622,,0,0,13.32,3434,3460,180,179,,,1,1.9,0.55,,,441,913,,,,,,,48.75,,1,,,,,,,,,,,,,,71,84,14.23,14.07,14.43,,,,,,,,,,,,,,,,,"0,0,1,4,22,53,20,0,0",,,,,,,139,,,,,,,,,,,,,,,,,,,,,,,,,,,,,,,,,,,,,7,9,271,74,,1020,,,1,5,3,,1,0,,,,,"Aachen Laufen",,"Polar BEAT",,0,,0,168070,250480,30378,,,,,,,,,,,,,,,,,,,,,,,,,,,,,,,,,,,,,,,,,,4,
5964434,64c70f34-16dc-456f-a4b5-ca7430f1d22b,1448997274,60,1548678622,,0,0,11.64,3079,3465,111,112,,,1,1,0.41,,,,790,,,,,,,46.85,,1,,,,,,,,,,,,,,63,83,13.73,14.77,14.94,,,,,,,,,,,,,,,,,"12,2,3,7,21,10,26,19,1",,,,,,,137,,,,,,,,,,,,,,,,,,,,,,,,,,,,,,,,,,,,,11,18,244,92,,1027,,,1,4,3,,1,0,,,,,"Aachen Laufen",,"Polar BEAT",,0,,0,168070,250480,30378,,,,,,,,,,,,,,,,,,,,,,,,,,,,,,,,,,,,,,,,,,,
5964435,c626f17c-417e-4022-8467-8fb13781b904,1509646191,60,1548678623,,0,0,15.08,3757,3757,45,45,,,1,0,0.09,,0.95,,1052,165,177,,,,62.58,51.21,62.81,1,,,,,,,,,,,,,,133,83,14.48,14.57,14.63,2.1,,,,,,,,,,,,,,,,"0,1,2,3,9,48,36,1,0","0,2,23,74,0",,,,,,145,,,,,,,,,,,,,,,,,,,,,,,,,,,,,,,,,,,,90.1,12,3,247,79,,,0,,1,5,3,,1,0,I1.000|5:04-I1.000|4:20-I1.000|4:06-I1.000|4:10-I1.000|4:10-I1.000|4:08-I1.000|3:59-I1.000|4:06-I1.000|4:02-I1.000|3:56-I1.000|3:55-I1.000|4:05-I1.000|4:04-I1.000|4:04-I1.000|4:01-I0.084|0:26,,Running,,,,"Polar M430",43,0,,0,168070,250480,30378,,,,,,,,,,,,,,,,,,,,,,,,,,,,,,,,,,,,,,,,,,,
5964436,21cda0ab-cc59-432f-81c5-bd00cc5a3ff1,1433277990,120,1548678623,,0,0,3.22,934,934,2,0,,,1,0,0,,,,219,,,,,,,38.71,,1,,,,,,,,,,,,,,19,82,12.44,12.44,12.48,,,,,,,,,,,,,,,,,"1,1,3,26,59,11,0,0,0",,,,,,,126,,,,,,,,,,,,,,,,,,,,,,,,,,,,,,,,,,,,,19,12,240,70,,1014,0,,0,5,3,,1,0,,,,,"Aachen Laufen",,"Polar BEAT",,0,,0,168070,250480,30378,,,,,,,,,,,,,,,,,,,,,,,,,,,,,,,,,,,,,,,,,,,
5964437,4c1d7e60-f047-4ad2-b88d-857971418048,1510127302,60,1548678626,,0,0,11.86,3644,3645,52,53,,,1,0,0.1,1.06,0.92,,872,150,159,,,,55.28,39.4,55.57,1,,,,,,,,,,,,,,89,82,11.75,11.75,11.84,1.1,,,,,,,,,,,,,,,,"1,2,10,52,31,3,0,0,0","1,3,96,0,0",,,,,,119,,,,,,,,,,,,,,,,,,,,,,,,,,,,,,,,,,,,36.7,7,1,248,92,,,0,,0,6,3,,1,0,I1.000|5:06-I1.000|4:55-I1.000|5:02-I1.000|5:04-I1.000|5:01-I1.000|5:08-I1.000|5:18-I1.000|5:15-I1.000|5:03-I1.000|5:09-I1.000|5:14-I0.856|4:32,,Running,,,,"Polar M430",43,0,,0,168070,250480,30378,,,,,,,,,,,,,,,,,,,,,,,,,,,,,,,,,,,,,,,,,,,
5964438,d3db684a-41a2-4813-98e0-1d84ef8ad275,1546624304,60,1548678626,,0,0,1.64,314,314,0,65,,,1,1.2,0.99,,1.03,,83,161,174,,,,90.03,57.76,85.58,1,,,,,,,,,,,,,,10,89,17.16,18.95,17.3,11.3,,,,,,,,,,,,,,,,"0,0,0,0,0,0,5,77,18","1,8,19,71,0",,,,,,176,,,,,,,,,,,,,,,,,,,,,,,,,,,,,,,,,,,,34.7,2,14,272,85,,1034,0,256,1,5,3,,1,0,I1.000|3:08-I0.640|2:07,,Running,,,,"Polar M430",43,0,,0,168070,250480,30378,,,,,,,,,,,,,,,,,,,,,,,,,,,,,,,,,,,,,,,,,,,
5964439,a07abf7a-d52a-4df8-80bb-abd68c5943b7,1344529349,120,1548678627,,0,0,13.26,4286,4339,259,259,,,1,2.6,0.53,,,386,904,,,,,,,37.46,,1,,,,,,,,,,,,,,89,,11.62,11.93,12.5,,,,,,,,,,,,,,,,,"17,6,11,20,31,10,3,1,1",,,,,,,,,,,,,,,,,,,,,,,,,,,,,,,,,,,,,,,,,,,,20,6,351,63,,1025,3,,0,5,3,,1,0,,,,,,,"Polar BEAT",,0,,0,168070,250480,30378,,,,,,,,,,,,,,,,,,,,,,,,,,,,,,,,,,,,,,,,,,"4,4,5",
5964440,b1e7215d-8520-486f-bbd6-37886ccbf0cf,1395083151,60,1548678628,,0,0,6.94,1839,1842,143,148,,,1,1.4,0.39,1.3,0.95,,356,152,177,,,,65.18,45.22,66.79,1,,,,,,,,,,,,,,49,83,13.82,14.27,14.82,-3.2,,,,,,,,,,,,,,,,"9,1,1,5,28,32,5,19,0","0,20,57,22,0",,,,,,136,,,,,,,,,,,,,,,,,,,,,,,,,,,,,,,,,,,,62.4,10,4,281,75,,1021,0,,1,5,3,,1,0,,,,,"Auslaufen + 2x 1000m in 3:20",,"Polar BEAT",,0,,0,168070,250480,30378,,,,,,,,,,,,,,,,,,,,,,,,,,,,,,,,,,,,,,,,,,,
5964441,1402fba5-475c-4c26-ba2a-9f745fe8d2b4,1400430958,120,1548678628,,0,0,3.36,1204,1208,0,1,,,1,0,0,,,,221,,,,,,,30.26,,1,,,,,,,,,,,,,,25,81,10.03,10.08,10.09,,,,,,,,,,,,,,,,,"9,32,59,0,0,0,0,0,0",,,,,,,103,,,,,,,,,,,,,,,,,,,,,,,,,,,,,,,,,,,,,21,4,61,47,,1012,4,,0,5,3,,1,0,,,,,Auslaufen,,"Polar BEAT",,0,,0,168070,250480,30378,,,,,,,,,,,,,,,,,,,,,,,,,,,,,,,,,,,,,,,,,,,
5964442,2c071704-d60d-4954-8d0e-b3deaf0763cf,1465049440,120,1548678629,,0,0,1.48,367,367,22,22,,,1,0,0.04,,,,85,,,,,,,42.73,,1,,,,,,,,,,,,,,7,89,14.63,14.69,15.03,,,,,,,,,,,,,,,,,"1,4,2,5,10,30,43,3,2",,,,,,,136,,,,,,,,,,,,,,,,,,,,,,,,,,,,,,,,,,,,,17,2,311,93,,1014,5,,0,5,3,,1,0,,,,,"Aachen Laufen",,"Polar BEAT",,0,,0,168070,250480,30378,,,,,,,,,,,,,,,,,,,,,,,,,,,,,,,,,,,,,,,,,,,
5964443,583fe277-2fd8-4c08-afd1-a94de03dcc7f,1478725426,60,1548678629,,0,0,4.96,1445,1699,69,70,,,1,1.5,0.59,,,292,344,,,,,,,39.64,,1,,,,,,,,,,,,,,30,79,12.54,12.44,12.72,,,,,,,,,,,,,,,,,"2,0,4,30,44,19,0,0,0",,,,,,,130,,,,,,,,,,,,,,,,,,,,,,,,,,,,,,,,,,,,,3,3,259,95,,1000,0,,1,6,3,,1,0,,,,,"Aachen Laufen",,"Polar BEAT",,0,,0,168070,250480,30378,,,,,,,,,,,,,,,,,,,,,,,,,,,,,,,,,,,,,,,,,,5,
5964444,910268d5-a0c5-4e2a-855e-3db35e670af2,1512486236,60,1548678630,,0,0,14.69,2727,2811,53,49,,,1,0,0.08,2.21,,,451,122,157,,,,,,,1,,,,,,,,,,,,,,33,,,21.25,,21.3,-6.7,101,76,,1,117,100,,,,,,,,,"18,11,61,9,1,0,0","4,92,4,0,0","85,3,5,6,1",,,,,,,,,,,,,,,,,,,,,,,,,,,,,,,,,,,,,,,,,15.9,6,5,236,81,,,0,,0,5,3,,1,0,I1.454|4:29-I0.100|0:16-I13.139|42:09,,Cycling,,,,"Polar M430",43,0,,0,168072,,30378,,,,,,,,,,,,,,,,,,,,,,,,,,,,,,,,,,,,,,,,,,,
5964445,2e6a0626-32a0-48d6-9dbf-d52a3aae9aa2,1406378499,120,1548678630,,0,0,6.28,1904,2530,111,77,,,1,1.6,0.55,,,467,410,,,,,,,38.34,,1,,,,,,,,,,,,,,39,82,12.35,12.13,12.78,,,,,,,,,,,,,,,,,"8,7,13,21,28,21,1,1,0",,,,,,,121,,,,,,,,,,,,,,,,,,,,,,,,,,,,,,,,,,,,,22,3,280,72,,1014,5,,0,5,3,,1,0,,,,,Einlaufen,,"Polar BEAT",,0,,0,168070,250480,30378,,,,,,,,,,,,,,,,,,,,,,,,,,,,,,,,,,,,,,,,,,4,
5964446,19dd3a2d-fc00-4923-bcb1-2df58a0492de,1478361430,60,1548678630,,0,0,0.67,196,197,12,9,,,1,1,0.61,,,,51,,,,,,,32.57,,1,,,,,,,,,,,,,,4,81,12.93,12.57,12.72,,,,,,,,,,,,,,,,,"29,12,12,15,5,6,5,3,14",,,,,,,127,,,,,,,,,,,,,,,,,,,,,,,,,,,,,,,,,,,,,8,6,256,76,,1001,0,,0,5,3,,1,0,,,,,"Aachen Laufen",,"Polar BEAT",,0,,0,168070,250480,30378,,,,,,,,,,,,,,,,,,,,,,,,,,,,,,,,,,,,,,,,,,,
5964447,cf81f72a-5eef-4cf9-8a9f-107847ed445e,1505560578,120,1548678630,,0,0,3.85,1242,1254,72,70,,,1,1.7,0.58,1.36,1.25,441,282,145,162,,,,54.44,34.59,55.73,1,,,,,,,,,,,,,,28,80,11.48,11.94,12.8,9.9,,,,,,,,,,,,,,,,"18,3,20,16,20,18,5,0,0","1,21,77,1,0",,,,,,116,,,,,,,,,,,,,,,,,,,,,,,,,,,,,,,,,,,,31.9,13,12,229,71,,1012,,,0,5,3,,1,0,I1.000|5:27-I1.000|4:48-I1.000|4:31-I0.850|6:08,,Running,,,,"Polar M430",43,0,,0,168070,250480,30378,,,,,,,,,,,,,,,,,,,,,,,,,,,,,,,,,,,,,,,,,,4,
5964448,,1464370607,120,1548678630,,0,0,,0,0,,,,,0,,,,,,,,,,,,,,,1,,,,,,,,,,,,,,0,,,,,,,,,,,,,,,,,,,,,,,,,,,,,,,,,,,,,,,,,,,,,,,,,,,,,,,,,,,,,,,,,,,,,,,,,,1,,,0,0,,,,,"gym ",,"Polar BEAT",,0,,0,168075,,30378,,,,,,,,,,,,,,,,,,,,,,,,,,,,,,,,,,,,,,,,,,,
5964449,b9de3b57-3f3a-428d-a2d7-29e53fa341e2,1495485270,120,1548678631,,0,0,4,2054,2277,102,42,,,1,0.5,0.45,,,160,248,,,,,,,19.63,,1,,,,,,,,,,,,,,42,69,7.63,8.26,9.1,,,,,,,,,,,,,,,,,"74,10,10,6,1,0,0,0,0",,,,,,,85,,,,,,,,,,,,,,,,,,,,,,,,,,,,,,,,,,,,,22,2,104,50,,1015,0,,0,5,3,,1,0,,,,,"Aachen Laufen",,"Polar BEAT",,0,,0,168070,250480,30378,,,,,,,,,,,,,,,,,,,,,,,,,,,,,,,,,,,,,,,,,,4,
5964450,ed2a1e98-cbd0-4566-b6af-c66d05210b68,1447355492,60,1548678631,,0,0,3.33,1043,1043,63,62,,,1,1.5,0.61,,,383,229,,,,,,,35.47,,1,,,,,,,,,,,,,,21,80,11.87,11.63,12.26,,,,,,,,,,,,,,,,,"5,3,25,31,31,4,0,0,0",,,,,,,120,,,,,,,,,,,,,,,,,,,,,,,,,,,,,,,,,,,,,12,8,171,82,,1024,,,1,5,3,,1,0,,,,,"Aachen Laufen",,"Polar BEAT",,0,,0,168070,250480,30378,,,,,,,,,,,,,,,,,,,,,,,,,,,,,,,,,,,,,,,,,,5,
5964451,6d290bdb-a856-4921-9d27-455669320ea7,1520448654,60,1548678632,,0,0,10.46,3330,3331,39,32,,,1,0,0.08,1.09,0.91,,803,150,160,,,,52.91,37.44,53.19,1,,,,,,,,,,,,,,82,81,11.37,11.34,11.43,6.5,,,,,,,,,,,,,,,,"0,2,22,69,7,1,0,0,0","1,7,92,0,0",,,,,,116,,,,,,,,,,,,,,,,,,,,,,,,,,,,,,,,,,,,39.2,6,4,220,81,,,0,,1,5,3,,1,0,I1.000|5:15-I1.000|5:04-I1.000|5:15-I1.000|5:24-I1.000|5:15-I1.000|5:19-I1.000|5:26-I1.000|5:19-I1.000|5:16-I1.000|5:21-I0.465|2:39,,Running,,,,"Polar M430",43,0,,0,168070,250480,30378,,,,,,,,,,,,,,,,,,,,,,,,,,,,,,,,,,,,,,,,,,,
5964452,2274a46f-669d-4f3f-ad1f-821322c36700,1409088018,120,1548678632,,0,0,1.38,422,422,18,12,,,1,1,0.56,,,,93,,,,,,,33.49,,1,,,,,,,,,,,,,,8,83,12.18,12.16,12.28,,,,,,,,,,,,,,,,,"8,13,16,13,19,31,0,0,0",,,,,,,118,,,,,,,,,,,,,,,,,,,,,,,,,,,,,,,,,,,,,13,4,46,100,,1008,0,,1,6,3,,1,0,,,,,Auslaufen,,"Polar BEAT",,0,,0,168070,250480,30378,,,,,,,,,,,,,,,,,,,,,,,,,,,,,,,,,,,,,,,,,,,
5964453,9304a3a9-1037-4f1a-9162-1f4002bfc15e,1531756521,120,1548678632,,0,0,0.91,405,405,10,4,,,1,0,0.22,1.26,0.98,,70,122,132,,,,44.99,20.72,45.97,1,,,,,,,,,,,,,,4,81,8.29,8.22,8.51,5.5,,,,,,,,,,,,,,,,"91,9,0,0,0,0,0,0,0","5,95,0,0,0",,,,,,83,,,,,,,,,,,,,,,,,,,,,,,,,,,,,,,,,,,,6.2,28,11,311,28,,,,,0,3,3,,1,0,,,Running,,,,"Polar M430",43,0,,0,168070,250480,30378,,,,,,,,,,,,,,,,,,,,,,,,,,,,,,,,,,,,,,,,,,,
5964454,9fa5df09-09ea-48b5-b9b2-4d800911ca40,1505051851,120,1548678633,,0,0,7.88,6383,6463,205,212,,,1,3.3,0.79,,,160,895,109,130,,,,,,,1,,,,,,,,,,,,,,51,,,5.01,,-8.1,,,,,,,,,,,,,,,,"64,34,2,0,0,0","19,81,0,0,0",,,,,,,,,,,,,,,,,,,,,,,,,,,,,,,,,,,,,,,,,,7.3,16,10,223,72,,1005,4,,0,5,3,,1,0,I1.000|11:22-I1.000|14:50-I1.000|12:02-I1.000|15:28-I1.000|13:30-I1.000|14:39-I1.000|14:16-I1.000|11:37,,Hiking,,,,"Polar M430",43,0,,0,168075,,30378,,,,,,,,,,,,,,,,,,,,,,,,,,,,,,,,,,,,,,,,,,"4,4",
5964455,a1ed9b37-aa2a-4a69-9e20-b964a68ba84d,1414433087,60,1548678634,,0,0,12.12,3068,3068,91,102,,,1,0.1,0.28,,,,791,,,,,,,49.46,,1,,,,,,,,,,,,,,63,85,14.26,14.44,14.6,,,,,,,,,,,,,,,,,"0,0,1,5,23,47,19,3,1",,,,,,,139,,,,,,,,,,,,,,,,,,,,,,,,,,,,,,,,,,,,,13,3,148,85,,1023,0,,1,5,3,,1,0,,,,,"Zügiger DL",,"Polar BEAT",,0,,0,168070,250480,30378,,,,,,,,,,,,,,,,,,,,,,,,,,,,,,,,,,,,,,,,,,,
5964456,281b3d08-f131-4478-ae81-ccf2292556ca,1516350913,60,1548678634,,0,0,11.02,1594,1613,29,38,,,1,0,0.06,,,,345,143,175,,,,,,,1,,,,,,,,,,,,,,35,,,26.81,,13.6,-6.4,134,115,,1,152,137,,,,,,,,,"9,7,11,63,9,1,0","3,19,76,3,0","62,29,0,0,9",,,,,,,,,,,,,,,,,,,,,,,,,,,,,,,,,,,,,,,,,34.6,4,10,246,76,,,0,,0,5,3,,1,0,I0.995|3:23-I10.026|23:31,,Cycling,,,,"Polar M430",43,0,,0,168072,,30378,,,,,,,,,,,,,,,,,,,,,,,,,,,,,,,,,,,,,,,,,,,
5964457,9204349a-d65b-4f5c-8f43-d8a17ad614a8,1456859041,60,1548678635,,0,0,19.53,5478,6293,207,204,,,1,1.3,0.49,,,,1326,,,,,,,45.57,,1,,,,,,,,,,,,,,113,83,12.98,13.63,13.88,,,,,,,,,,,,,,,,,"11,3,9,16,16,15,22,7,1",,,,,,,129,,,,,,,,,,,,,,,,,,,,,,,,,,,,,,,,,,,,,3,23,195,92,,1012,,,1,4,3,,1,0,,,,,"Aachen Laufen",,"Polar BEAT",,0,,0,168070,250480,30378,,,,,,,,,,,,,,,,,,,,,,,,,,,,,,,,,,,,,,,,,,,
5964458,f217e8b4-9a54-42e5-82f0-236a995a8324,1397325270,120,1548678635,,0,0,3.46,1174,1330,12,12,,,1,0,0.12,1.12,0.95,,204,141,151,,,,53.02,32.36,53.25,1,,,,,,,,,,,,,,23,82,10.65,10.81,10.88,-4.3,,,,,,,,,,,,,,,,"22,17,17,20,24,0,0,0,0","0,42,58,0,0",,,,,,108,,,,,,,,,,,,,,,,,,,,,,,,,,,,,,,,,,,,21.5,11,24,239,84,,1016,1,,0,5,3,,1,0,,,,,Einlaufen,,"Polar BEAT",,0,,0,168070,250480,30378,,,,,,,,,,,,,,,,,,,,,,,,,,,,,,,,,,,,,,,,,,,
5964459,c56b1514-bf52-4040-a28a-9e8b01650169,1469961479,120,1548678636,,0,0,30.64,8809,9275,290,298,,,1,1.3,0.39,,,330,2126,,,,,,,45.79,,1,,,,,,,,,,,,,,182,81,12.65,12.77,13.05,,,,,,,,,,,,,,,,,"5,0,1,8,64,21,1,0,0",,,,,,,129,,,,,,,,,,,,,,,,,,,,,,,,,,,,,,,,,,,,,17,5,284,86,,1014,3,,0,5,3,,1,0,,,,,"Aachen Laufen",,"Polar BEAT",,0,,0,168070,250480,30378,,,,,,,,,,,,,,,,,,,,,,,,,,,,,,,,,,,,,,,,,,"5,5",
5964460,62bd1501-7cbb-4147-b7b6-f9d94c523216,1466694048,120,1548678637,,0,0,8.35,2399,2411,188,187,,,1,2.4,0.7,,,216,551,,,,,,,41.58,,1,,,,,,,,,,,,,,49,82,12.82,12.97,14.46,,,,,,,,,,,,,,,,,"13,3,4,13,23,28,13,2,0",,,,,,,127,,,,,,,,,,,,,,,,,,,,,,,,,,,,,,,,,,,,,31,3,187,59,,1016,7,,0,3,3,,1,0,,,,,"Voeren Sint-Martens-Voeren Laufen",,"Polar BEAT",,0,,0,168070,250480,30378,,,,,,,,,,,,,,,,,,,,,,,,,,,,,,,,,,,,,,,,,,"5,5",
5964461,07d779cd-4151-40bf-9990-8db9d1342e4a,1406837429,120,1548678637,,0,0,3.37,990,990,68,68,,,1,1.7,0.64,,,446,223,,,,,,,38.27,,1,,,,,,,,,,,,,,20,82,12.65,12.39,13.22,,,,,,,,,,,,,,,,,"1,3,8,36,34,13,5,0,0",,,,,,,125,,,,,,,,,,,,,,,,,,,,,,,,,,,,,,,,,,,,,23,0,272,58,,1013,0,,0,5,3,,1,0,,,,,Einlaufen,,"Polar BEAT",,0,,0,168070,250480,30378,,,,,,,,,,,,,,,,,,,,,,,,,,,,,,,,,,,,,,,,,,4,
5964462,3b213cf2-5220-4063-93cb-1383a79bb99b,1542829323,60,1548678640,,0,0,14.02,4033,4035,44,47,,,1,0,0.03,,0.93,,983,148,158,,,,61.05,43.1,61.27,1,,,,,,,,,,,,,,94,80,12.54,12.55,12.6,-0.8,,,,,,,,,,,,,,,,"0,0,3,16,72,9,0,0,0","0,4,96,0,0",,,,,,130,,,,,,,,,,,,,,,,,,,,,,,,,,,,,,,,,,,,33.4,-1,5,27,93,,,0,,1,5,3,,1,0,I1.000|4:54-I1.000|4:59-I1.000|4:47-I1.000|4:38-I1.000|4:45-I1.000|4:42-I1.000|4:46-I1.000|4:43-I1.000|4:35-I1.000|4:48-I1.000|4:44-I1.000|4:56-I1.000|4:56-I1.000|4:59-I0.022|0:05,,Running,,,,"Polar M430",43,0,,0,168070,250480,30378,,,,,,,,,,,,,,,,,,,,,,,,,,,,,,,,,,,,,,,,,,,
5964463,723faa38-4c90-4d6f-addd-6b5516b28a2c,1547492516,60,1548678640,,0,0,0.16,90,90,0,1,,,1,0,0,,0.8,,14,118,135,,,,34.9,,34.63,1,,,,,,,,,,,,,,0,82,6.33,6.37,6.31,-45.4,,,,,,,,,,,,,,,,"100,0,0,0,0,0,0,0,0","14,86,0,0,0",,,,,,65,,,,,,,,,,,,,,,,,,,,,,,,,,,,,,,,,,,,1.6,3,5,190,93,,1019,0,315,1,5,3,,1,0,,,Running,,,,"Polar M430",43,0,,0,168070,250480,30378,,,,,,,,,,,,,,,,,,,,,,,,,,,,,,,,,,,,,,,,,,,
5964464,0f5f841c-307e-4dfb-abdf-557977ad6d92,1464980743,120,1548678640,,0,0,11.89,3265,3446,157,165,,,1,1.9,0.59,,,430,819,,,,,,,44.93,,1,,,,,,,,,,,,,,67,82,13.36,13.23,13.57,,,,,,,,,,,,,,,,,"1,1,3,12,35,42,5,0,0",,,,,,,133,,,,,,,,,,,,,,,,,,,,,,,,,,,,,,,,,,,,,18,3,330,90,,1012,1,,0,5,3,,1,0,,,,,"Aachen Laufen",,"Polar BEAT",,0,,0,168070,250480,30378,,,,,,,,,,,,,,,,,,,,,,,,,,,,,,,,,,,,,,,,,,"5,5",
5964465,,1458835620,60,1548678641,,0,0,1,0,0,,,,,0,,,,,,66,,,,,,,,,1,,,,,,,,,,,,,,0,,,,,,,,,,,,,,,,,,,,,,,,,,,,,,,,,,,,,,,,,,,,,,,,,,,,,,,,,,,,,,,,,,,,,,,,,,1,,,0,0,,,,,Laufen,,"Polar BEAT",,0,,0,168070,250480,30378,,,,,,,,,,,,,,,,,,,,,,,,,,,,,,,,,,,,,,,,,,,
5964466,0de6d860-f46e-4314-b7e7-e76db0a0724c,1348921029,120,1548678642,,0,0,13.66,4161,4330,71,70,,,1,0,0.16,1.02,0.82,,947,162,210,,,,50.16,40.24,50.49,1,,,,,,,,,,,,,,141,,11.92,12.57,12.71,6.7,,,,,,,,,,,,,,,,"13,3,8,16,26,23,8,1,1","2,4,17,75,3",,,,,,,,,,,,,,,,,,,,,,,,,,,,,,,,,,,,,,,,,,85.6,12,3,231,86,,1018,3,,0,5,3,,1,0,,,,,,,"Polar BEAT",,0,,0,168070,250480,30378,,,,,,,,,,,,,,,,,,,,,,,,,,,,,,,,,,,,,,,,,,,
5964467,ef4c756e-9331-4fe1-bdb1-9c51ef98395d,1420196230,60,1548678643,,0,0,14.88,4210,4297,346,346,,,1,4.3,0.7,1.05,1.01,604,773,151,181,,,,60.65,44.14,62.4,1,,,,,,,,,,,,,,107,,13.34,13.01,13.76,-7.3,,,,,,,,,,,,,,,,"2,6,8,20,23,31,10,0,0","1,18,68,14,0",,,,,,,,,,,,,,,,,,,,,,,,,,,,,,,,,,,,,,,,,,51.1,6,12,238,98,,,0,,0,5,3,,1,0,,,,,"Langsamer DL",,"Polar BEAT",,0,,0,168070,250480,30378,,,,,,,,,,,,,,,,,,,,,,,,,,,,,,,,,,,,,,,,,,"4,4",
5964468,08f0185a-5bf4-4293-80dc-75fd1dc04cd6,1394132404,60,1548678643,,0,0,4,1092,1198,56,31,,,1,1,0.5,1.03,0.97,,214,154,195,,,,61.7,42.21,63.25,1,,,,,,,,,,,,,,30,81,13.6,13.36,13.81,-3.9,,,,,,,,,,,,,,,,"5,2,4,6,25,50,9,0,0","0,8,65,26,1",,,,,,136,,,,,,,,,,,,,,,,,,,,,,,,,,,,,,,,,,,,44.3,9,2,141,64,,1028,0,,1,3,3,,1,0,,,,,Einlaufen,,"Polar BEAT",,0,,0,168070,250480,30378,,,,,,,,,,,,,,,,,,,,,,,,,,,,,,,,,,,,,,,,,,,
5964469,cd6e907e-570f-4fab-ba55-d14892b42ee7,1449514977,60,1548678644,,0,0,12.3,4055,4088,120,121,,,1,0.7,0.39,,,,832,,,,,,,36.39,,1,,,,,,,,,,,,,,84,80,11.03,11.43,11.61,,,,,,,,,,,,,,,,,"11,8,20,41,14,4,1,1,1",,,,,,,114,,,,,,,,,,,,,,,,,,,,,,,,,,,,,,,,,,,,,10,11,151,83,,1030,,,1,5,3,,1,0,,,,,"Aachen Laufen",,"Polar BEAT",,0,,0,168070,250480,30378,,,,,,,,,,,,,,,,,,,,,,,,,,,,,,,,,,,,,,,,,,,
5964470,2ed3a913-4ac9-46fb-8e8e-9232201019aa,1533144975,120,1548678644,,0,0,10.5,1593,1593,42,34,,,1,0,0.1,2.29,,,275,122,136,,,,,,,1,,,,,,,,,,,,,,18,,,24.15,,3.9,-23.4,120,107,,1,139,129,,,,,,,,,"2,9,44,45,0,0,0","0,100,0,0,0","87,2,0,1,10",,,,,,,,,,,,,,,,,,,,,,,,,,,,,,,,,,,,,,,,,9.4,26,16,323,48,,,2,,0,5,3,,1,0,,,Cycling,,,,"Polar M430",43,0,,0,168072,,30378,,,,,,,,,,,,,,,,,,,,,,,,,,,,,,,,,,,,,,,,,,,
5964471,dcc051c7-bfbe-4a3e-a33a-099282ba1316,1422784660,60,1548678645,,0,0,30.01,8406,8846,415,414,,,1,2.8,0.47,1.05,0.99,426,1441,153,182,,,,60.31,47.15,61.35,1,,,,,,,,,,,,,,228,,13.11,13.08,13.47,-1.3,,,,,,,,,,,,,,,,"3,1,5,15,35,35,6,0,0","0,9,62,28,0",,,,,,,,,,,,,,,,,,,,,,,,,,,,,,,,,,,,,,,,,,56.6,1,8,260,97,,990,0,,0,7,3,,1,0,,,,,"Sehr langer DL",,"Polar BEAT",,0,,0,168070,250480,30378,,,,,,,,,,,,,,,,,,,,,,,,,,,,,,,,,,,,,,,,,,"4,4,5,5,5",
5964472,d37548a3-aec8-4f8d-a7fd-74df7ee64f92,1436703002,120,1548678646,,0,0,20.01,4601,4615,154,155,,,1,0.2,0.23,,,,1340,,,,,,,57.44,,1,,,,,,,,,,,,,,95,86,15.78,15.78,15.91,,,,,,,,,,,,,,,,,"0,0,1,1,4,28,50,17,0",,,,,,,152,,,,,,,,,,,,,,,,,,,,,,,,,,,,,,,,,,,,,17,12,249,75,,1019,,,0,5,3,,1,0,,,,,"Aachen Laufen",,"Polar BEAT",,0,,0,168070,250480,30378,,,,,,,,,,,,,,,,,,,,,,,,,,,,,,,,,,,,,,,,,,,
5964473,3280341e-ec64-432e-9a43-172e79beb8b6,1395743644,60,1548678647,,0,0,4.34,1182,1184,49,33,,,1,0,0.21,1.03,1.01,,257,154,172,,,,61.88,42.56,63.03,1,,,,,,,,,,,,,,32,83,13.5,13.33,13.63,-4.5,,,,,,,,,,,,,,,,"0,1,2,13,33,49,2,0,0","1,4,64,31,0",,,,,,133,,,,,,,,,,,,,,,,,,,,,,,,,,,,,,,,,,,,42.6,7,3,122,71,,1011,3,,0,3,3,,1,0,,,,,"Einlaufen + Lauf ABC ",,"Polar BEAT",,0,,0,168070,250480,30378,,,,,,,,,,,,,,,,,,,,,,,,,,,,,,,,,,,,,,,,,,,
5964474,eb563e23-2d02-49fe-93b8-9a25b20b984d,1367266392,120,1548678649,,0,0,9.26,2827,4220,86,160,,,1,0.3,0.37,1.17,1,154,657,133,157,,,,64.91,38.99,65.01,1,,,,,,,,,,,,,,46,,11.89,11.98,12.2,3.5,,,,,,,,,,,,,,,,"3,1,4,42,46,3,0,0,0","0,82,17,0,0",,,,,,,,,,,,,,,,,,,,,,,,,,,,,,,,,,,,,,,,,,23.2,11,4,303,61,,1020,0,,0,5,3,,1,0,,,,,Untitled,,"Polar BEAT",,0,,0,168070,250480,30378,,,,,,,,,,,,,,,,,,,,,,,,,,,,,,,,,,,,,,,,,,5,
5964475,3b05d395-3f05-4614-8296-0c7eebfc2305,1544263211,60,1548678649,,0,0,7.55,2274,2279,40,44,,,1,0,0.16,1.01,0.84,,460,133,152,,,,66,39.08,66.39,1,,,,,,,,,,,,,,37,83,12,12.53,12.54,26.5,,,,,,,,,,,,,,,,"1,7,36,27,4,5,19,1,0","0,73,27,0,0",,,,,,120,,,,,,,,,,,,,,,,,,,,,,,,,,,,,,,,,,,,19.6,7,42,200,81,,1014,0,307,0,6,3,,1,0,I1.000|3:50-I1.000|3:50-I1.000|5:05-I1.000|5:22-I1.000|5:34-I1.000|5:57-I1.000|5:27-I0.558|2:55,,Running,,,,"Polar M430",43,0,,0,168070,250480,30378,,,,,,,,,,,,,,,,,,,,,,,,,,,,,,,,,,,,,,,,,,,
5964476,6b0737d2-f2a9-4d9e-909b-fcebc4b0a508,1472810409,120,1548678650,,0,0,15.22,4627,4737,234,234,,,1,2.5,0.58,,,377,1046,,,,,,,40.68,,1,,,,,,,,,,,,,,96,81,12.1,11.99,12.27,,,,,,,,,,,,,,,,,"5,4,11,31,38,8,1,0,0",,,,,,,122,,,,,,,,,,,,,,,,,,,,,,,,,,,,,,,,,,,,,18,6,224,80,,1022,2,,0,3,3,,1,0,,,,,"Aachen Laufen",,"Polar BEAT",,0,,0,168070,250480,30378,,,,,,,,,,,,,,,,,,,,,,,,,,,,,,,,,,,,,,,,,,4,
5964477,26639ddf-3bb5-4144-8449-7285748381bb,1467143928,120,1548678651,,0,0,17.78,5967,6681,118,119,,,1,0.3,0.22,,,,1187,,,,,,,36.7,,1,,,,,,,,,,,,,,123,81,10.81,13.17,13.35,,,,,,,,,,,,,,,,,"32,3,4,8,15,17,5,14,2",,,,,,,110,,,,,,,,,,,,,,,,,,,,,,,,,,,,,,,,,,,,,20,5,217,63,,1014,1,,0,5,3,,1,0,,,,,"Aachen Laufen",,"Polar BEAT",,0,,0,168070,250480,30378,,,,,,,,,,,,,,,,,,,,,,,,,,,,,,,,,,,,,,,,,,,
5964478,6efe1dc2-8432-4e07-9c2a-78ed3411d95f,1421264150,60,1548678652,,0,0,15.01,3909,3909,171,187,,,1,1.8,0.49,,,431,1008,,,,,,,48.63,,1,,,,,,,,,,,,,,81,85,13.99,13.99,14.26,,,,,,,,,,,,,,,,,"1,1,1,7,24,51,12,3,0",,,,,,,136,,,,,,,,,,,,,,,,,,,,,,,,,,,,,,,,,,,,,3,10,220,89,,1015,0,,1,3,3,,1,0,,,,,"Lockerer DL",,"Polar BEAT",,0,,0,168070,250480,30378,,,,,,,,,,,,,,,,,,,,,,,,,,,,,,,,,,,,,,,,,,4,
5964479,37d9585a-473a-44a3-bf25-d23ec51d6840,1513098127,60,1548678652,,0,0,11.21,1897,1905,45,32,,,1,0,0.09,,,,352,130,145,,,,,,,1,,,,,,,,,,,,,,28,,,22.69,,14.5,-16.2,106,92,,1,124,114,,,,,,,,,"10,14,54,21,1,0,0","0,93,7,0,0","89,1,0,1,9",,,,,,,,,,,,,,,,,,,,,,,,,,,,,,,,,,,,,,,,,15.3,4,4,215,72,,,0,,1,5,3,,1,0,,,Cycling,,,,"Polar M430",43,0,,0,168072,,30378,,,,,,,,,,,,,,,,,,,,,,,,,,,,,,,,,,,,,,,,,,,
5964480,1c00ea53-654b-48e6-8f69-09823d8673ce,1469275799,120,1548678653,,0,0,0.73,218,218,4,3,,,1,0,0.17,,,,56,,,,,,,32.08,,1,,,,,,,,,,,,,,4,81,12.19,12.59,12.78,,,,,,,,,,,,,,,,,"0,0,28,29,28,4,9,3,0",,,,,,,124,,,,,,,,,,,,,,,,,,,,,,,,,,,,,,,,,,,,,20,3,341,88,,1019,4,,0,9,3,,1,0,,,,,"Aachen Laufen",,"Polar BEAT",,0,,0,168070,250480,30378,,,,,,,,,,,,,,,,,,,,,,,,,,,,,,,,,,,,,,,,,,,
5964481,cc1907df-d3ce-4e84-937b-5a03c26d7b00,1409171672,120,1548678653,,0,0,15.03,3933,3933,198,205,,,1,1.9,0.54,,,375,995,,,,,,,48.36,,1,,,,,,,,,,,,,,81,82,13.98,13.84,14.2,,,,,,,,,,,,,,,,,"0,1,1,6,27,58,6,1,1",,,,,,,140,,,,,,,,,,,,,,,,,,,,,,,,,,,,,,,,,,,,,17,2,132,81,,1016,0,,1,5,3,,1,0,,,,,"Lockerer DL",,"Polar BEAT",,0,,0,168070,250480,30378,,,,,,,,,,,,,,,,,,,,,,,,,,,,,,,,,,,,,,,,,,4,
5964482,7483a879-0745-4837-b2f3-cc86210b4b09,1491749880,120,1548678654,,0,0,9.17,1269,1309,42,40,,,1,0,0.07,,,,356,,,,,,,,,1,,,,,,,,,,,,,,14,,,26.91,,,,147,128,,1,162,147,,,,,,,,,"7,5,3,79,6,0,0",,"60,29,0,1,10",,,,,,,,,,,,,,,,,,,,,,,,,,,,,,,,,,,,,,,,,,21,1,349,40,,,,,0,3,3,,1,0,,,,,"Eggenstein-Leopoldshafen Radfahren",,"Polar BEAT",,0,,0,168072,,30378,,,,,,,,,,,,,,,,,,,,,,,,,,,,,,,,,,,,,,,,,,,
5964483,cc7c0590-78e9-4697-bf79-aeae82e86b78,1415654725,60,1548678654,,0,0,7.16,1616,1616,58,58,,,1,0.5,0.38,,,,471,,,,,,,54.71,,1,,,,,,,,,,,,,,33,86,16.09,16.07,16.26,,,,,,,,,,,,,,,,,"0,0,0,0,0,20,60,19,0",,,,,,,155,,,,,,,,,,,,,,,,,,,,,,,,,,,,,,,,,,,,,6,3,161,91,,1011,0,,1,5,3,,1,0,,,,,TDL,,"Polar BEAT",,0,,0,168070,250480,30378,,,,,,,,,,,,,,,,,,,,,,,,,,,,,,,,,,,,,,,,,,,
5964484,ae2ce80e-7df0-4192-959c-6778ba9916be,1504551346,120,1548678654,,0,0,0.7,235,236,13,13,,,1,0.9,0.57,1.13,0.93,,45,138,157,,,,55.19,27.93,56.45,1,,,,,,,,,,,,,,4,81,11.09,10.81,11.23,16.2,,,,,,,,,,,,,,,,"10,9,24,54,3,0,0,0,0","2,45,53,0,0",,,,,,110,,,,,,,,,,,,,,,,,,,,,,,,,,,,,,,,,,,,10,16,8,189,80,,1018,0,,0,5,3,,1,0,,,Running,,,,"Polar M430",43,0,,0,168070,250480,30378,,,,,,,,,,,,,,,,,,,,,,,,,,,,,,,,,,,,,,,,,,,
5964485,a20b8e2b-dc8a-493d-94fe-707242fc452f,1477348280,120,1548678655,,0,0,2.27,735,776,26,42,,,1,1.2,0.71,,,,155,,,,,,,33.07,,1,,,,,,,,,,,,,,15,79,11.15,11.27,11.26,,,,,,,,,,,,,,,,,"7,8,28,28,24,5,0,0,0",,,,,,,117,,,,,,,,,,,,,,,,,,,,,,,,,,,,,,,,,,,,,10,0,243,99,,1015,0,,1,9,3,,1,0,,,,,"Aachen Laufen",,"Polar BEAT",,0,,0,168070,250480,30378,,,,,,,,,,,,,,,,,,,,,,,,,,,,,,,,,,,,,,,,,,,
5964486,e602e7ab-4220-4996-8f77-bf9e9a44f638,1368373376,120,1548678655,,0,0,2.22,735,751,4,3,,,1,0,0,,,,156,,,,,,,32.17,,1,,,,,,,,,,,,,,15,,11.06,11.73,11.81,,,,,,,,,,,,,,,,,"11,0,5,34,49,0,0,0,0",,,,,,,,,,,,,,,,,,,,,,,,,,,,,,,,,,,,,,,,,,,,10,12,273,76,,1017,4,,0,5,3,,1,0,,,,,,,"Polar BEAT",,0,,0,168070,250480,30378,,,,,,,,,,,,,,,,,,,,,,,,,,,,,,,,,,,,,,,,,,,
5964487,387c7aaf-5320-4f0c-9e5a-96d304c75a3e,1392750527,60,1548678656,,0,0,2.8,822,835,31,32,,,1,0.7,0.5,1.08,1,,152,139,161,,,,64.55,37.74,65.41,1,,,,,,,,,,,,,,15,81,12.39,12.38,12.59,-5.6,,,,,,,,,,,,,,,,"2,1,12,19,51,15,0,0,0","2,45,52,1,0",,,,,,126,,,,,,,,,,,,,,,,,,,,,,,,,,,,,,,,,,,,20.3,6,6,189,80,,1013,0,,1,4,3,,1,0,,,,,Einlaufen,,"Polar BEAT",,0,,0,168070,250480,30378,,,,,,,,,,,,,,,,,,,,,,,,,,,,,,,,,,,,,,,,,,,
5964488,8898e3e9-dedd-41b8-bc1c-3a73dfe4c9ad,1422181820,60,1548678658,,0,0,32.32,9755,10235,592,592,,,1,3.6,0.54,,,484,2182,,,,,,,43.39,,1,,,,,,,,,,,,,,202,85,12.34,12.3,12.87,,,,,,,,,,,,,,,,,"7,4,10,21,37,19,3,0,0",,,,,,,117,,,,,,,,,,,,,,,,,,,,,,,,,,,,,,,,,,,,,1,6,247,96,,1032,0,,0,5,3,,1,0,,,,,"Sehr langer DL",,"Polar BEAT",,0,,0,168070,250480,30378,,,,,,,,,,,,,,,,,,,,,,,,,,,,,,,,,,,,,,,,,,"4,4,4,5,5",
5964489,e7280891-7052-48bf-bdf5-f653582934a4,1404153963,120,1548678659,,0,0,8.56,2437,2437,134,132,,,1,1.9,0.65,,,285,580,,,,,,,42.1,,1,,,,,,,,,,,,,,50,81,12.98,12.73,13.17,,,,,,,,,,,,,,,,,"0,0,3,24,51,21,1,0,0",,,,,,,130,,,,,,,,,,,,,,,,,,,,,,,,,,,,,,,,,,,,,15,6,332,73,,,1,,0,5,3,,1,0,,,,,"Langsamer DL",,"Polar BEAT",,0,,0,168070,250480,30378,,,,,,,,,,,,,,,,,,,,,,,,,,,,,,,,,,,,,,,,,,5,
5964490,d39d18a3-dd8a-4f08-87a1-398b0cdd9142,1423686979,60,1548678659,,0,0,15,4014,4051,202,208,,,1,2.1,0.54,,,433,1012,,,,,,,47.12,,1,,,,,,,,,,,,,,83,83,13.67,13.69,14.06,,,,,,,,,,,,,,,,,"2,1,2,8,28,50,3,5,0",,,,,,,135,,,,,,,,,,,,,,,,,,,,,,,,,,,,,,,,,,,,,1,2,90,90,,1023,0,,1,3,3,,1,0,,,,,"Aachen Laufen",,"Polar BEAT",,0,,0,168070,250480,30378,,,,,,,,,,,,,,,,,,,,,,,,,,,,,,,,,,,,,,,,,,4,
5964491,b41dc2b0-1b9c-448e-9ec8-c1ba92c5276a,1477078578,120,1548678660,,0,0,13.01,3628,3628,183,190,,,1,2.1,0.58,,,408,881,,,,,,,44.43,,1,,,,,,,,,,,,,,75,80,13.12,12.99,13.37,,,,,,,,,,,,,,,,,"1,0,4,11,54,28,1,0,0",,,,,,,134,,,,,,,,,,,,,,,,,,,,,,,,,,,,,,,,,,,,,7,4,239,90,,1017,0,,1,5,3,,1,0,,,,,"Aachen Laufen",,"Polar BEAT",,0,,0,168070,250480,30378,,,,,,,,,,,,,,,,,,,,,,,,,,,,,,,,,,,,,,,,,,4,
5964492,4102d9a7-fafb-414e-acc2-eaf7b8f17e77,1486414665,60,1548678661,,0,0,2.35,671,860,39,37,,,1,1.7,0.65,,,770,159,,,,,,,38.34,,1,,,,,,,,,,,,,,13,80,12.87,13.32,13.56,,,,,,,,,,,,,,,,,"14,3,8,6,17,40,8,4,0",,,,,,,131,,,,,,,,,,,,,,,,,,,,,,,,,,,,,,,,,,,,,4,1,118,88,,1020,0,,1,5,3,,1,0,,,,,"Aachen Laufen",,"Polar BEAT",,0,,0,168070,250480,30378,,,,,,,,,,,,,,,,,,,,,,,,,,,,,,,,,,,,,,,,,,5,
5964493,2eaadba4-8eeb-4640-b968-addfa79efa9d,1414919889,60,1548678661,,0,0,19.28,6046,6063,211,211,,,1,1.7,0.42,,,301,1304,,,,,,,39.99,,1,,,,,,,,,,,,,,125,81,11.65,11.95,12.17,,,,,,,,,,,,,,,,,"6,3,8,36,40,7,0,0,0",,,,,,,118,,,,,,,,,,,,,,,,,,,,,,,,,,,,,,,,,,,,,12,10,169,88,,1016,,,0,3,3,,1,0,,,,,"Langsamer DL",,"Polar BEAT",,0,,0,168070,250480,30378,,,,,,,,,,,,,,,,,,,,,,,,,,,,,,,,,,,,,,,,,,4,
5964494,5c81e95c-2947-48ca-953a-4d3587c7e60e,1524072366,120,1548678662,,0,0,10.98,1589,1599,43,34,,,1,0,0.09,2.22,,,257,123,159,,,,,,,1,,,,,,,,,,,,,,21,,,26.95,,15.1,-16.7,144,122,,1,181,159,,,,,,,,,"8,13,15,54,2,8,0","17,71,12,0,0","65,22,3,1,10",,,,,,,,,,,,,,,,,,,,,,,,,,,,,,,,,,,,,,,,,18.2,26,8,56,30,,,,,0,3,3,,1,0,,,Cycling,,,,"Polar M430",43,0,,0,168072,,30378,,,,,,,,,,,,,,,,,,,,,,,,,,,,,,,,,,,,,,,,,,,
5964495,e38ae5ab-2918-484f-a3d4-f9f506a74374,1494878008,120,1548678662,,0,0,4.83,1414,2042,67,99,,,1,1.4,0.54,,,,343,,,,,,,39.35,,1,,,,,,,,,,,,,,29,80,12.6,12.75,12.92,,,,,,,,,,,,,,,,,"11,2,9,16,23,23,15,0,0",,,,,,,128,,,,,,,,,,,,,,,,,,,,,,,,,,,,,,,,,,,,,20,2,266,46,,1028,0,,0,5,3,,1,0,,,,,"Aachen Laufen",,"Polar BEAT",,0,,0,168070,250480,30378,,,,,,,,,,,,,,,,,,,,,,,,,,,,,,,,,,,,,,,,,,,
5964496,c2538f80-db76-469c-a055-e31ef133baa7,1479661183,60,1548678662,,0,0,2.51,845,866,32,31,,,1,0.7,0.44,,,,170,,,,,,,31.89,,1,,,,,,,,,,,,,,17,80,10.85,10.85,11.09,,,,,,,,,,,,,,,,,"13,7,26,48,7,0,0,0,0",,,,,,,111,,,,,,,,,,,,,,,,,,,,,,,,,,,,,,,,,,,,,14,9,193,57,,1003,0,,1,4,3,,1,0,,,,,"Darmstadt Laufen",,"Polar BEAT",,0,,0,168070,250480,30378,,,,,,,,,,,,,,,,,,,,,,,,,,,,,,,,,,,,,,,,,,,
5964497,9a05becc-10da-4024-a425-ec100d7d2703,1403297554,120,1548678663,,0,0,4.35,1186,1237,47,32,,,1,0.4,0.3,,,,296,,,,,,,42.51,,1,,,,,,,,,,,,,,24,81,13.47,13.34,13.62,,,,,,,,,,,,,,,,,"1,1,5,12,32,42,7,0,0",,,,,,,136,,,,,,,,,,,,,,,,,,,,,,,,,,,,,,,,,,,,,15,5,334,71,,1021,0,,0,5,3,,1,0,,,,,"Lauf ABC Und Sprints",,"Polar BEAT",,0,,0,168070,250480,30378,,,,,,,,,,,,,,,,,,,,,,,,,,,,,,,,,,,,,,,,,,,
5964498,072cf68f-d360-480a-8821-2198969de865,1457550293,60,1548678663,,0,0,14.49,3663,3663,188,195,,,1,2,0.58,,,451,999,,,,,,,50.2,,1,,,,,,,,,,,,,,76,84,14.45,14.33,14.71,,,,,,,,,,,,,,,,,"0,0,0,2,13,61,23,0,0",,,,,,,141,,,,,,,,,,,,,,,,,,,,,,,,,,,,,,,,,,,,,5,14,124,59,,1005,,,1,5,3,,1,0,,,,,"Aachen Laufen",,"Polar BEAT",,0,,0,168070,250480,30378,,,,,,,,,,,,,,,,,,,,,,,,,,,,,,,,,,,,,,,,,,4,
5964499,839c4e15-9f8f-407e-ad01-6a681f1f3e03,1451391314,60,1548678663,,0,0,4.92,1411,1411,68,69,,,1,1.6,0.57,,,278,336,,,,,,,40.36,,1,,,,,,,,,,,,,,29,80,12.79,12.77,13.04,,,,,,,,,,,,,,,,,"0,2,4,38,37,13,4,3,0",,,,,,,131,,,,,,,,,,,,,,,,,,,,,,,,,,,,,,,,,,,,,9,14,176,69,,1024,,,0,3,3,,1,0,,,,,"Balve Laufen",,"Polar BEAT",,0,,0,168070,250480,30378,,,,,,,,,,,,,,,,,,,,,,,,,,,,,,,,,,,,,,,,,,4,
5964500,504bf682-a249-4c89-b08d-75015b2dc698,1459886247,120,1548678664,,0,0,17.01,5067,6542,135,140,,,1,0.4,0.26,,,,1151,,,,,,,42.03,,1,,,,,,,,,,,,,,105,80,12.23,13.87,14.06,,,,,,,,,,,,,,,,,"22,2,6,8,18,12,14,18,0",,,,,,,126,,,,,,,,,,,,,,,,,,,,,,,,,,,,,,,,,,,,,10,10,242,81,,1010,,,1,5,3,,1,0,,,,,"Aachen Laufen",,"Polar BEAT",,0,,0,168070,250480,30378,,,,,,,,,,,,,,,,,,,,,,,,,,,,,,,,,,,,,,,,,,,
5964501,16e6b169-a451-4bc5-ab9f-12a90f3163f4,1399545814,120,1548678665,,0,0,13,3717,3802,156,156,,,1,1.5,0.43,,,298,876,,,,,,,43.15,,1,,,,,,,,,,,,,,77,83,12.88,12.71,13.02,,,,,,,,,,,,,,,,,"4,1,2,12,58,21,1,0,0",,,,,,,126,,,,,,,,,,,,,,,,,,,,,,,,,,,,,,,,,,,,,11,11,237,75,,1015,3,,0,5,3,,1,0,,,,,"Regenerativer DL ",,"Polar BEAT",,0,,0,168070,250480,30378,,,,,,,,,,,,,,,,,,,,,,,,,,,,,,,,,,,,,,,,,,5,
5964502,047e9093-bc8c-4ea6-8510-d27506f7c765,1516440571,60,1548678665,,0,0,1,342,343,6,4,,,1,0,0.19,1.08,0.82,,76,145,153,,,,50.65,28.43,51.16,1,,,,,,,,,,,,,,7,80,10.64,10.72,10.9,1,,,,,,,,,,,,,,,,"12,11,32,45,0,0,0,0,0","0,17,83,0,0",,,,,,110,,,,,,,,,,,,,,,,,,,,,,,,,,,,,,,,,,,,16.5,4,19,208,87,,1011,,,0,5,3,,1,0,I1.000|5:41-I0.003|0:02,,Running,,,,"Polar M430",43,0,,0,168070,250480,30378,,,,,,,,,,,,,,,,,,,,,,,,,,,,,,,,,,,,,,,,,,,
5964503,92207737-109b-4aef-a355-78c0ac1d34ea,1423389803,60,1548678666,,0,0,30,8771,9585,350,350,,,1,2.3,0.44,,,347,2022,,,,,,,44.84,,1,,,,,,,,,,,,,,182,84,12.5,12.89,13.15,,,,,,,,,,,,,,,,,"7,1,4,13,38,32,5,0,0",,,,,,,122,,,,,,,,,,,,,,,,,,,,,,,,,,,,,,,,,,,,,2,9,342,85,,1031,0,,0,5,3,,1,0,,,,,"Sehr langer DL",,"Polar BEAT",,0,,0,168070,250480,30378,,,,,,,,,,,,,,,,,,,,,,,,,,,,,,,,,,,,,,,,,,"4,5",
5964504,d562075c-6002-4f98-8580-c86b65514c69,1402177455,120,1548678666,,0,0,8.37,2238,2238,148,147,,,1,2.1,0.7,,,351,560,,,,,,,45.25,,1,,,,,,,,,,,,,,46,83,13.89,13.64,14.07,,,,,,,,,,,,,,,,,"0,0,0,12,49,28,7,5,0",,,,,,,135,,,,,,,,,,,,,,,,,,,,,,,,,,,,,,,,,,,,,24,3,147,56,,,0,,1,3,3,,1,0,,,,,"Lockerer DL",,"Polar BEAT",,0,,0,168070,250480,30378,,,,,,,,,,,,,,,,,,,,,,,,,,,,,,,,,,,,,,,,,,5,
5964505,3b2b72f5-bcec-4fe5-976d-16a60a78929b,1469740586,120,1548678667,,0,0,5.14,1654,2831,42,113,,,1,0.9,0.51,,,,353,,,,,,,35.31,,1,,,,,,,,,,,,,,34,79,11.09,11.54,11.59,,,,,,,,,,,,,,,,,"7,14,21,20,27,11,0,0,0",,,,,,,118,,,,,,,,,,,,,,,,,,,,,,,,,,,,,,,,,,,,,19,4,258,73,,1015,0,,1,5,3,,1,0,,,,,"Aachen Laufen",,"Polar BEAT",,0,,0,168070,250480,30378,,,,,,,,,,,,,,,,,,,,,,,,,,,,,,,,,,,,,,,,,,,
5964506,3bf98a44-d7ef-4549-a777-1ce85c227349,1531855184,120,1548678667,,0,0,5.01,2187,2192,86,86,,,1,2.1,0.64,1.08,0.95,215,400,126,144,,,,44.45,24.39,45.4,1,,,,,,,,,,,,,,29,79,8.56,8.46,8.78,3.2,,,,,,,,,,,,,,,,"86,8,3,1,1,1,0,0,0","2,95,3,0,0",,,,,,87,,,,,,,,,,,,,,,,,,,,,,,,,,,,,,,,,,,,11.7,26,12,300,41,,,,,0,3,3,,1,0,I1.000|7:24-I1.000|8:28-I1.000|7:23-I1.000|6:54-I1.000|6:16-I0.022|0:07,,Running,,,,"Polar M430",43,0,,0,168070,250480,30378,,,,,,,,,,,,,,,,,,,,,,,,,,,,,,,,,,,,,,,,,,4,
5964507,da354b96-2c44-43ff-85ec-5e8c1f8b4437,1540974993,60,1548678668,,0,0,10.24,1998,2006,37,44,,,1,0,0.1,2.17,0.46,,316,119,153,,,,,,,1,,,,,,,,,,,,,,23,,,19.64,,17.8,-11.7,84,71,,1,102,94,,,,,,,,,"13,29,58,0,0,0,0","5,79,16,0,0","91,0,0,2,7",,,,,,,,,,,,,,,,,,,,,,,,,,,,,,,,,,,,,,,,,18.2,5,3,213,86,,1016,0,313,0,5,3,,1,0,,,Cycling,,,,"Polar M430",43,0,,0,168072,,30378,,,,,,,,,,,,,,,,,,,,,,,,,,,,,,,,,,,,,,,,,,,
5964508,0e33601f-bfae-48af-860f-1a353b4a4832,1492766536,120,1548678668,,0,0,0.92,973,1010,34,5,,,2,0,0.13,,,951,46,,,,,,,,,1,,,,,,,,,,,,,,20,51,3.49,3.76,5.55,,,,,,,,,,,,,,,,,"100,0,0,0,0,0,0,0,0",,,,,,,56,,,,,,,,,,,,,,,,,,,,,,,,,,,,,,,,,,,,,17,11,288,41,,1009,2,,0,5,3,,1,0,,,,,Laufen,,"Polar BEAT",,0,,0,168070,250480,30378,,,,,,,,,,,,,,,,,,,,,,,,,,,,,,,,,,,,,,,,,,5,
5964509,eed8bd5a-5e8d-4b3d-9d39-433fbd8ef88e,1415304584,60,1548678669,,0,0,1.8,543,543,24,36,,,1,0.9,0.55,,,,120,,,,,,,35.04,,1,,,,,,,,,,,,,,11,84,11.99,12.16,12.29,,,,,,,,,,,,,,,,,"6,1,1,38,53,0,0,0,0",,,,,,,118,,,,,,,,,,,,,,,,,,,,,,,,,,,,,,,,,,,,,5,6,188,90,,1012,0,,1,3,3,,1,0,,,,,Auslaufen,,"Polar BEAT",,0,,0,168070,250480,30378,,,,,,,,,,,,,,,,,,,,,,,,,,,,,,,,,,,,,,,,,,,
5964510,6bf4e9ee-627d-4e3d-87ab-c318ff0f6087,1394652678,60,1548678669,,0,0,5.06,1126,1126,111,111,,,1,0,0,1.18,0.91,,260,164,172,,,,72.63,54.44,74.61,1,,,,,,,,,,,,,,38,88,16.5,16.21,16.74,2.4,,,,,,,,,,,,,,,,"0,0,0,0,0,1,96,3,0","0,2,6,92,0",,,,,,153,,,,,,,,,,,,,,,,,,,,,,,,,,,,,,,,,,,,57.3,13,2,64,55,,1030,0,,1,3,3,,1,0,,,,,"TDL Teil 2",,"Polar BEAT",,0,,0,168070,250480,30378,,,,,,,,,,,,,,,,,,,,,,,,,,,,,,,,,,,,,,,,,,,
5964511,5286a5c8-dc1a-493c-97c8-63e0bc298906,1392320046,60,1548678669,,0,0,3.92,889,889,48,47,,,1,1.2,0.64,1.97,1.93,,196,171,186,,,,66.6,52.27,67.63,1,,,,,,,,,,,,,,35,89,16.02,16.39,16.64,1.5,,,,,,,,,,,,,,,,"11,5,5,5,6,8,11,33,17","0,1,9,80,10",,,,,,149,,,,,,,,,,,,,,,,,,,,,,,,,,,,,,,,,,,,82.8,4,13,262,95,,998,0,,1,5,3,,1,0,,,,,"4 mal Hoch Runter",,"Polar BEAT",,0,,0,168070,250480,30378,,,,,,,,,,,,,,,,,,,,,,,,,,,,,,,,,,,,,,,,,,,
5964512,aabf4257-8f08-4edf-bcc2-459ad390fdd6,1392204071,60,1548678671,,0,0,0.94,278,278,4,26,,,1,0.9,0.57,1.08,1.03,,54,140,158,,,,63.39,33.3,61.89,1,,,,,,,,,,,,,,5,86,11.83,12.57,12.14,-6.5,,,,,,,,,,,,,,,,"14,9,15,8,12,42,0,0,0","0,59,41,0,0",,,,,,118,,,,,,,,,,,,,,,,,,,,,,,,,,,,,,,,,,,,11.8,6,13,207,79,,1009,1,,0,3,3,,1,0,,,,,Auslaufen,,"Polar BEAT",,0,,0,168070,250480,30378,,,,,,,,,,,,,,,,,,,,,,,,,,,,,,,,,,,,,,,,,,,
5964513,f2888275-7c7a-4727-82c9-d22e7bbcfd42,1447875292,60,1548678671,,0,0,1.07,324,324,17,22,,,1,0.7,0.44,,,,73,,,,,,,32.9,,1,,,,,,,,,,,,,,6,81,12.13,12.08,12.34,,,,,,,,,,,,,,,,,"3,2,7,42,37,9,0,0,0",,,,,,,122,,,,,,,,,,,,,,,,,,,,,,,,,,,,,,,,,,,,,11,31,216,75,,1015,,,1,11,3,,1,0,,,,,"Aachen Laufen",,"Polar BEAT",,0,,0,168070,250480,30378,,,,,,,,,,,,,,,,,,,,,,,,,,,,,,,,,,,,,,,,,,,
5964514,5d8202d1-76ec-4ca0-b6f6-1312a1ef0521,1472764951,120,1548678671,,0,0,7,1508,1508,54,54,,,1,0.8,0.46,,,,475,,,,,,,57.71,,1,,,,,,,,,,,,,,31,86,16.83,16.77,16.95,,,,,,,,,,,,,,,,,"0,0,0,0,0,2,65,33,0",,,,,,,162,,,,,,,,,,,,,,,,,,,,,,,,,,,,,,,,,,,,,19,1,304,77,,1023,0,,1,5,3,,1,0,,,,,"Aachen Laufen",,"Polar BEAT",,0,,0,168070,250480,30378,,,,,,,,,,,,,,,,,,,,,,,,,,,,,,,,,,,,,,,,,,,
5964515,3c7d657c-2754-486a-9753-2cc6a2ade863,1429441559,120,1548678672,,0,0,22.83,6443,7472,311,286,,,1,2.3,0.56,,,500,1560,,,,,,,45.81,,1,,,,,,,,,,,,,,133,83,13,12.91,13.22,,,,,,,,,,,,,,,,,"1,2,5,17,43,28,4,0,0",,,,,,,128,,,,,,,,,,,,,,,,,,,,,,,,,,,,,,,,,,,,,10,6,54,57,,1022,,,0,3,3,,1,0,,,,,"Aachen Laufen",,"Polar BEAT",,0,,0,168070,250480,30378,,,,,,,,,,,,,,,,,,,,,,,,,,,,,,,,,,,,,,,,,,"5,5",
5964516,8e710cd1-71f3-4b07-864f-20d446f9b6a2,1400238364,120,1548678673,,0,0,13.65,3598,3598,164,164,,,1,1.7,0.55,,,412,914,,,,,,,47.6,,1,,,,,,,,,,,,,,74,84,13.87,13.8,14,,,,,,,,,,,,,,,,,"1,0,1,8,27,48,15,0,0",,,,,,,135,,,,,,,,,,,,,,,,,,,,,,,,,,,,,,,,,,,,,13,6,41,70,,1033,5,,0,3,3,,1,0,,,,,"Lockerer DL",,"Polar BEAT",,0,,0,168070,250480,30378,,,,,,,,,,,,,,,,,,,,,,,,,,,,,,,,,,,,,,,,,,5,
5964517,08d75f24-004f-4ba6-a6d9-aa6941f5a681,1467924986,120,1548678673,,0,0,1.34,396,396,17,17,,,1,0,0.09,,,,76,,,,,,,34.69,,1,,,,,,,,,,,,,,8,83,12.14,14.12,14.32,,,,,,,,,,,,,,,,,"37,3,4,5,6,7,8,21,11",,,,,,,122,,,,,,,,,,,,,,,,,,,,,,,,,,,,,,,,,,,,,19,1,72,72,,1019,0,,0,5,3,,1,0,,,,,"Aachen Laufen",,"Polar BEAT",,0,,0,168070,250480,30378,,,,,,,,,,,,,,,,,,,,,,,,,,,,,,,,,,,,,,,,,,,
5964518,a4dc11c9-8179-4b53-8982-e605c2e172b4,1397673644,120,1548678673,,0,0,4.52,1380,1380,18,20,,,1,0,0.2,1.05,0.98,,250,142,151,,,,59.86,37.3,60.12,1,,,,,,,,,,,,,,28,83,11.84,11.91,11.93,1.9,,,,,,,,,,,,,,,,"2,3,20,32,35,8,0,0,0","0,29,71,0,0",,,,,,118,,,,,,,,,,,,,,,,,,,,,,,,,,,,,,,,,,,,23.8,12,3,309,64,,1028,1,,0,5,3,,1,0,,,,,Auslaufen,,"Polar BEAT",,0,,0,168070,250480,30378,,,,,,,,,,,,,,,,,,,,,,,,,,,,,,,,,,,,,,,,,,,
5964519,a377b233-2767-47c0-b963-a6d3ef56e448,1401142439,120,1548678674,,0,0,2.51,762,1621,33,37,,,1,1,0.4,,,492,166,,,,,,,35.96,,1,,,,,,,,,,,,,,15,82,12.2,12.19,12.74,,,,,,,,,,,,,,,,,"19,12,10,8,18,23,8,2,0",,,,,,,121,,,,,,,,,,,,,,,,,,,,,,,,,,,,,,,,,,,,,15,1,124,90,,1012,0,,1,5,3,,1,0,,,,,Auslaufen,,"Polar BEAT",,0,,0,168070,250480,30378,,,,,,,,,,,,,,,,,,,,,,,,,,,,,,,,,,,,,,,,,,5,
5964520,aad07ebf-7981-41b0-8f85-1419a07bf74f,1449171456,60,1548678674,,0,0,5.92,1826,2012,61,68,,,1,0.8,0.34,,,396,383,,,,,,,37.44,,1,,,,,,,,,,,,,,37,82,11.84,13.23,13.48,,,,,,,,,,,,,,,,,"16,6,15,20,17,5,5,13,1",,,,,,,119,,,,,,,,,,,,,,,,,,,,,,,,,,,,,,,,,,,,,7,12,171,80,,1025,,,1,5,3,,1,0,,,,,"Aachen Laufen",,"Polar BEAT",,0,,0,168070,250480,30378,,,,,,,,,,,,,,,,,,,,,,,,,,,,,,,,,,,,,,,,,,5,
5964521,bb89df48-95b5-43db-abbd-befa973f552f,1448040623,60,1548678674,,0,0,2.26,535,535,40,46,,,1,0.7,0.38,,,,153,,,,,,,47.22,,1,,,,,,,,,,,,,,11,87,15.32,15.26,15.51,,,,,,,,,,,,,,,,,"0,0,0,0,3,35,60,1,0",,,,,,,146,,,,,,,,,,,,,,,,,,,,,,,,,,,,,,,,,,,,,6,13,247,89,,1003,,,1,5,3,,1,0,,,,,"Aachen Laufen",,"Polar BEAT",,0,,0,168070,250480,30378,,,,,,,,,,,,,,,,,,,,,,,,,,,,,,,,,,,,,,,,,,,
5964522,d233e665-9717-4448-b289-173e9124e406,1405456564,120,1548678675,,0,0,5.23,1665,1718,0,1,,,1,0,0,,,,302,150,188,,,,52.91,35.8,52.89,1,,,,,,,,,,,,,,48,79,11.33,15.69,15.67,0.7,,,,,,,,,,,,,,,,"54,1,1,1,1,1,2,12,28","0,46,8,24,22",,,,,,119,,,,,,,,,,,,,,,,,,,,,,,,,,,,,,,,,,,,72.9,19,2,245,81,,1022,0,,0,5,3,,1,0,,,,,"4x 1000m in 3min + 5min Pause",,"Polar BEAT",,0,,0,168070,250480,30378,,,,,,,,,,,,,,,,,,,,,,,,,,,,,,,,,,,,,,,,,,,
5964523,a69dc5fd-f8c8-4983-8799-2940e47679a1,1421059377,60,1548678675,,0,0,5.81,1752,1752,155,70,,,1,2.5,0.69,1.18,0.96,516,366,157,181,,,,53.12,38.41,55.84,1,,,,,,,,,,,,,,52,,12.87,12.14,13.55,-3.9,,,,,,,,,,,,,,,,"2,6,16,36,26,9,3,2,0","0,7,58,35,0",,,,,,,,,,,,,,,,,,,,,,,,,,,,,,,,,,,,,,,,,,49.5,6,33,220,79,,1020,,,0,5,3,,1,0,,,,,Einlaufen,,"Polar BEAT",,0,,0,168070,250480,30378,,,,,,,,,,,,,,,,,,,,,,,,,,,,,,,,,,,,,,,,,,"4,5",
5964524,2420e47c-c5ab-4ef5-b934-91f576389659,1479657999,60,1548678675,,0,0,9.23,2148,2148,56,58,,,1,0,0.13,,,,615,,,,,,,53.58,,1,,,,,,,,,,,,,,44,86,15.55,15.54,15.62,,,,,,,,,,,,,,,,,"0,0,0,0,1,30,63,6,0",,,,,,,150,,,,,,,,,,,,,,,,,,,,,,,,,,,,,,,,,,,,,14,17,195,56,,1000,,,0,3,3,,1,0,,,,,"Darmstadt Laufen",,"Polar BEAT",,0,,0,168070,250480,30378,,,,,,,,,,,,,,,,,,,,,,,,,,,,,,,,,,,,,,,,,,,
5964525,237cc2fe-d3c9-4209-851e-6c826ee40a8b,1451935425,60,1548678676,,0,0,10.64,2448,2448,74,85,,,1,0.2,0.32,,,,713,,,,,,,54.79,,1,,,,,,,,,,,,,,50,85,15.68,15.69,15.8,,,,,,,,,,,,,,,,,"0,0,0,0,1,19,78,1,0",,,,,,,153,,,,,,,,,,,,,,,,,,,,,,,,,,,,,,,,,,,,,6,14,196,89,,991,,,1,5,3,,1,0,,,,,"Aachen Laufen",,"Polar BEAT",,0,,0,168070,250480,30378,,,,,,,,,,,,,,,,,,,,,,,,,,,,,,,,,,,,,,,,,,,
5964526,20476a93-87c6-4bfb-aa25-1ca51d371883,1495484089,120,1548678676,,0,0,1.27,399,399,17,22,,,1,1.3,1,,,,87,,,,,,,32.18,,1,,,,,,,,,,,,,,8,80,11.47,11.58,11.59,,,,,,,,,,,,,,,,,"15,8,17,18,28,9,4,0,0",,,,,,,119,,,,,,,,,,,,,,,,,,,,,,,,,,,,,,,,,,,,,22,2,104,50,,1015,0,,0,5,3,,1,0,,,,,"Aachen Laufen",,"Polar BEAT",,0,,0,168070,250480,30378,,,,,,,,,,,,,,,,,,,,,,,,,,,,,,,,,,,,,,,,,,,
5964527,c8a42858-92f0-43f8-9553-fca9852284eb,1538503755,120,1548678676,,0,0,15.39,4148,4176,29,29,,,1,0,0.08,,0.68,,1042,153,183,,,,63.25,46.82,63.4,1,,,,,,,,,,,,,,118,81,13.35,14.55,14.61,6.8,,,,,,,,,,,,,,,,"20,2,1,3,13,13,35,13,0","1,24,39,35,2",,,,,,137,,,,,,,,,,,,,,,,,,,,,,,,,,,,,,,,,,,,77,12,22,230,60,,1023,,,0,5,3,,1,0,I4.339|19:41-I1.040|3:47-I1.023|3:46-I0.207|2:14-I1.031|3:38-I0.412|3:50-I1.019|3:43-I1.014|3:40-I0.214|1:34-I1.035|3:39-I0.413|4:12-I1.018|3:41-I1.028|3:41-I0.209|2:26-I1.041|3:29-I0.340|2:38,,Running,,,,"Polar M430",43,0,,0,168070,250480,30378,,,,,,,,,,,,,,,,,,,,,,,,,,,,,,,,,,,,,,,,,,,
5964528,16d5b933-3ff9-43d8-bdee-93e839e0f8f0,1511807189,60,1548678677,,0,0,12.07,3280,3288,146,146,,,1,1.2,0.4,1.07,0.98,,813,154,178,,,,62.05,45.53,62.98,1,,,,,,,,,,,,,,90,83,13.45,13.4,13.68,-0.8,,,,,,,,,,,,,,,,"2,3,2,8,29,51,6,0,0","0,9,65,25,0",,,,,,133,,,,,,,,,,,,,,,,,,,,,,,,,,,,,,,,,,,,56.3,7,15,230,93,,1011,,,1,6,3,,1,0,I1.000|5:14-I1.000|4:51-I1.000|4:40-I1.000|4:27-I1.000|4:41-I1.000|4:21-I1.000|4:16-I1.000|4:10-I1.000|4:14-I1.000|4:12-I1.000|4:24-I1.000|4:59-I0.079|0:21,,Running,,,,"Polar M430",43,0,,0,168070,250480,30378,,,,,,,,,,,,,,,,,,,,,,,,,,,,,,,,,,,,,,,,,,,
5964529,de57f25c-e024-4a8b-9e60-cfa765e03703,1536654229,120,1548678677,,0,0,11.17,3498,3500,323,324,,,1,3.9,0.63,1.01,1.02,553,748,137,153,,,,60.68,38.36,62.85,1,,,,,,,,,,,,,,63,81,12.36,12.17,12.87,-24.9,,,,,,,,,,,,,,,,"21,13,20,11,4,21,10,1,0","1,53,46,0,0",,,,,,118,,,,,,,,,,,,,,,,,,,,,,,,,,,,,,,,,,,,25.4,16,25,226,76,,,0,,0,11,3,,1,0,I1.000|5:40-I1.000|6:11-I1.000|6:40-I1.000|5:45-I1.000|5:54-I1.000|6:08-I1.000|4:42-I1.000|4:08-I1.000|4:15-I1.000|3:57-I1.000|4:09-I0.173|0:50,,Running,,,,"Polar M430",43,0,,0,168070,250480,30378,,,,,,,,,,,,,,,,,,,,,,,,,,,,,,,,,,,,,,,,,,3,
5964530,85304918-4f55-414e-a551-22b2fd786bcd,1530646842,120,1548678678,,0,0,3.01,1385,1387,53,54,,,1,1.6,0.74,1.04,1.1,248,216,115,141,,,,45.98,22.16,46.96,1,,,,,,,,,,,,,,13,78,8.05,8.2,8.31,-8.5,,,,,,,,,,,,,,,,"83,5,8,4,0,0,0,0,0","9,90,1,0,0",,,,,,84,,,,,,,,,,,,,,,,,,,,,,,,,,,,,,,,,,,,7.3,27,6,4,23,,1015,,,0,3,3,,1,0,I1.000|8:43-I1.000|7:49-I1.000|6:29-I0.010|0:07,,Running,,,,"Polar M430",43,0,,0,168070,250480,30378,,,,,,,,,,,,,,,,,,,,,,,,,,,,,,,,,,,,,,,,,,5,
5964531,eb9dc460-d01e-4464-bc20-51df54cac871,1478953082,60,1548678678,,0,0,2.32,768,787,71,22,,,1,1.7,0.56,,,230,156,,,,,,,32.3,,1,,,,,,,,,,,,,,15,79,11.85,10.93,12.33,,,,,,,,,,,,,,,,,"4,22,27,33,13,1,0,0,0",,,,,,,115,,,,,,,,,,,,,,,,,,,,,,,,,,,,,,,,,,,,,3,12,156,83,,1024,,,0,5,3,,1,0,,,,,"Aachen Laufen",,"Polar BEAT",,0,,0,168070,250480,30378,,,,,,,,,,,,,,,,,,,,,,,,,,,,,,,,,,,,,,,,,,4,
5964532,0284316f-fe41-474b-8cc5-7a68ce495288,1431507501,120,1548678678,,0,0,6.35,2034,2066,107,139,,,1,1.9,0.57,,,257,443,,,,,,,35.95,,1,,,,,,,,,,,,,,42,82,11.43,11.63,12.18,,,,,,,,,,,,,,,,,"11,6,17,34,23,6,2,2,0",,,,,,,114,,,,,,,,,,,,,,,,,,,,,,,,,,,,,,,,,,,,,12,5,215,73,,1022,2,,0,3,3,,1,0,,,,,"Aachen Laufen",,"Polar BEAT",,0,,0,168070,250480,30378,,,,,,,,,,,,,,,,,,,,,,,,,,,,,,,,,,,,,,,,,,4,
5964533,7b13eeca-ca1c-44a3-9ce0-dfa932c5e070,1524817822,120,1548678679,,0,0,10.21,1848,1849,36,43,,,1,0,0.12,,0.6,,249,110,128,,,,,,,1,,,,,,,,,,,,,,15,,,21.45,,11.4,-13.6,101,82,,1,116,105,,,,,,,,,"14,14,69,3,0,0,0","19,81,0,0,0","89,1,0,1,8",,,,,,,,,,,,,,,,,,,,,,,,,,,,,,,,,,,,,,,,,6.6,9,8,39,72,,1013,,,0,3,3,,1,0,,,Cycling,,,,"Polar M430",43,0,,0,168072,,30378,,,,,,,,,,,,,,,,,,,,,,,,,,,,,,,,,,,,,,,,,,,
5964534,4a5095f8-6268-4faa-8e52-6c026667f168,1476623915,120,1548678679,,0,0,2.36,736,737,24,23,,,1,0,0.23,,,,159,,,,,,,34.66,,1,,,,,,,,,,,,,,15,79,11.85,11.83,12.13,,,,,,,,,,,,,,,,,"7,7,13,37,22,14,0,0,0",,,,,,,122,,,,,,,,,,,,,,,,,,,,,,,,,,,,,,,,,,,,,15,1,167,75,,,,,0,3,3,,1,0,,,,,"Balve Laufen",,"Polar BEAT",,0,,0,168070,250480,30378,,,,,,,,,,,,,,,,,,,,,,,,,,,,,,,,,,,,,,,,,,,
5964535,fc64b989-7de1-461c-a752-93403709563a,1396896815,120,1548678680,,0,0,10.41,2850,3098,145,128,,,1,1.4,0.46,1.03,1,309,520,154,173,,,,61.49,44.66,62.67,1,,,,,,,,,,,,,,78,82,13.55,13.37,13.83,0.7,,,,,,,,,,,,,,,,"3,3,3,8,24,54,5,0,0","0,13,53,34,0",,,,,,134,,,,,,,,,,,,,,,,,,,,,,,,,,,,,,,,,,,,58.2,20,10,181,55,,1010,0,,0,5,3,,1,0,,,,,"Lockerer DL",,"Polar BEAT",,0,,0,168070,250480,30378,,,,,,,,,,,,,,,,,,,,,,,,,,,,,,,,,,,,,,,,,,5,
5964536,5b0cc21e-b84a-4b18-9aeb-cb99bff2d075,1530886633,120,1548678680,,0,0,4.82,1367,1367,122,132,,,1,2.1,0.62,1.22,0.94,,315,145,164,,,,63.82,40.85,65.66,1,,,,,,,,,,,,,,31,81,12.95,12.76,13.46,9.2,,,,,,,,,,,,,,,,"1,2,5,14,50,26,2,0,0","2,14,81,3,0",,,,,,131,,,,,,,,,,,,,,,,,,,,,,,,,,,,,,,,,,,,36.4,22,11,302,55,,,5,,0,5,3,,1,0,I1.000|4:45-I1.000|4:31-I1.000|4:51-I1.000|4:50-I0.824|3:51,,Running,,,,"Polar M430",43,0,,0,168070,250480,30378,,,,,,,,,,,,,,,,,,,,,,,,,,,,,,,,,,,,,,,,,,,
5964537,46114e13-2bfa-4a0f-950d-2204f956c443,1547371900,60,1548678681,,0,0,3.01,906,907,53,57,,,1,1.5,0.73,1.14,1,,188,134,152,,,,65.47,36.88,66.79,1,,,,,,,,,,,,,,15,80,12.31,12.15,12.5,-8.9,,,,,,,,,,,,,,,,"0,5,17,34,30,15,0,0,0","3,75,22,0,0",,,,,,125,,,,,,,,,,,,,,,,,,,,,,,,,,,,,,,,,,,,16.4,5,18,226,100,,1008,0,318,0,6,3,,1,0,,,Running,,3,,"Polar M430",43,0,,0,168070,250480,30378,,,,,,,,,,,,,,,,,,,,,,,,,,,,,,,,,,,,,,,,,,,
5964539,b7a0f394-2501-4af5-b7ef-e601ccfdb789,1366747833,120,1548678682,,0,0,3.37,924,935,68,66,,,1,1.6,0.58,,,493,232,,,,,,,41.47,,1,,,,,,,,,,,,,,19,,13.61,13.36,14.35,,,,,,,,,,,,,,,,,"3,2,6,16,28,28,14,3,0",,,,,,,,,,,,,,,,,,,,,,,,,,,,,,,,,,,,,,,,,,,,13,6,244,69,,1023,0,,0,5,3,,1,0,,,,,,,"Polar BEAT",,0,,0,168070,250480,30378,,,,,,,,,,,,,,,,,,,,,,,,,,,,,,,,,,,,,,,,,,4,
5964540,bc3c9d96-1eda-4dfa-939f-e4957b7a87ec,1515784294,60,1548678682,,0,0,11.43,1899,1899,37,29,,,1,0,0.07,,,,252,109,125,,,,,,,1,,,,,,,,,,,,,,15,,,22.18,,2.8,-33.9,99,89,,1,113,104,,,,,,,,,"5,17,65,13,0,0,0","7,93,0,0,0","90,0,0,1,9",,,,,,,,,,,,,,,,,,,,,,,,,,,,,,,,,,,,,,,,,5,5,3,81,85,,1026,0,,1,5,3,,1,0,I10.012|26:56-I1.418|4:43,,Cycling,,,,"Polar M430",43,0,,0,168072,,30378,,,,,,,,,,,,,,,,,,,,,,,,,,,,,,,,,,,,,,,,,,,
5964541,43697c7b-fdce-4493-a3ad-02a4181db344,1458673118,60,1548678683,,0,0,16.04,4449,5296,266,264,,,1,2.4,0.55,,,400,1119,,,,,,,45.44,,1,,,,,,,,,,,,,,92,83,13.35,13.22,13.73,,,,,,,,,,,,,,,,,"4,2,5,11,25,44,8,0,0",,,,,,,130,,,,,,,,,,,,,,,,,,,,,,,,,,,,,,,,,,,,,8,10,330,84,,1014,,,1,5,3,,1,0,,,,,"Aachen Laufen",,"Polar BEAT",,0,,0,168070,250480,30378,,,,,,,,,,,,,,,,,,,,,,,,,,,,,,,,,,,,,,,,,,"4,5",
5964542,0ef0aab4-5986-4422-9efe-513627d0314e,1466109061,120,1548678683,,0,0,4.78,1542,1788,148,159,,,1,2.9,0.7,,,978,309,,,,,,,35.05,,1,,,,,,,,,,,,,,32,81,11.67,12.82,14.63,,,,,,,,,,,,,,,,,"23,7,14,12,8,9,22,5,0",,,,,,,115,,,,,,,,,,,,,,,,,,,,,,,,,,,,,,,,,,,,,14,1,228,91,,1002,0,,0,6,3,,1,0,,,,,"Aachen Laufen",,"Polar BEAT",,0,,0,168070,250480,30378,,,,,,,,,,,,,,,,,,,,,,,,,,,,,,,,,,,,,,,,,,"5,5,5,5,5",
5964543,f11ce479-e94f-4d09-9829-00b4c5c21f44,1409774612,120,1548678684,,0,0,15,3936,3965,205,213,,,1,2,0.53,1.03,1.04,358,786,153,183,,,,65.38,48.2,66.45,1,,,,,,,,,,,,,,108,82,13.94,13.91,14.24,2.6,,,,,,,,,,,,,,,,"1,1,1,8,22,56,7,4,0","0,22,45,30,3",,,,,,139,,,,,,,,,,,,,,,,,,,,,,,,,,,,,,,,,,,,82.1,17,5,97,79,,1021,0,,1,5,3,,1,0,,,,,"Lockerer DL",,"Polar BEAT",,0,,0,168070,250480,30378,,,,,,,,,,,,,,,,,,,,,,,,,,,,,,,,,,,,,,,,,,4,
5964544,a7c5e720-2caa-4796-9773-d849a4198d5c,1348517614,120,1548678685,,0,0,38.91,4971,5024,225,225,,,1,0,0.15,1.59,0.62,,1332,133,210,,,,,,,1,,,,,,,,,,,,,,82,,,30.76,,6.3,-30.4,197,153,,1,236,196,,,,,,,,,"10,5,11,23,24,27,0","1,86,11,0,1","50,9,24,12,5",,,,,,,,,,,,,,,,,,,,,,,,,,,,,,,,,,,,,,,,,41.7,18,13,230,75,,1004,0,,1,5,3,,1,0,,,,,,,"Polar BEAT",,0,,0,168072,,30378,,,,,,,,,,,,,,,,,,,,,,,,,,,,,,,,,,,,,,,,,,,
5964545,b0c72a5a-48b6-4089-a489-a0c2a363910a,1393686897,60,1548678685,,0,0,4.96,970,970,25,24,,,1,0,0.04,,,,326,,,,,,,63.18,,1,,,,,,,,,,,,,,20,90,18.46,18.42,18.51,,,,,,,,,,,,,,,,,"0,0,0,0,0,0,7,91,1",,,,,,,170,,,,,,,,,,,,,,,,,,,,,,,,,,,,,,,,,,,,,7,9,176,77,,1001,,,0,4,3,,1,0,,,,,"WK 5k Hardt, Mönchengladbach",,"Polar BEAT",,0,,0,168070,250480,30378,,,,,,,,,,,,,,,,,,,,,,,,,,,,,,,,,,,,,,,,,,,
5964546,a6e64597-3dc0-45a4-9873-38400a92926a,1443643396,120,1548678686,,0,0,5.29,1382,1382,111,112,,,1,2.1,1,,,,357,,,,,,,45.25,,1,,,,,,,,,,,,,,28,84,14.16,14.51,15.08,,,,,,,,,,,,,,,,,"12,9,8,3,1,4,62,0,0",,,,,,,137,,,,,,,,,,,,,,,,,,,,,,,,,,,,,,,,,,,,,12,12,62,62,,1031,,,1,3,3,,1,0,,,,,"Aachen Laufen",,"Polar BEAT",,0,,0,168070,250480,30378,,,,,,,,,,,,,,,,,,,,,,,,,,,,,,,,,,,,,,,,,,,
5964547,1bf6f80e-10b6-469f-bb8d-078c304b2edb,1484330763,60,1548678686,,0,0,10.5,3169,3434,124,223,,,1,1.1,0.5,,,192,713,,,,,,,39.87,,1,,,,,,,,,,,,,,65,81,11.99,12.18,12.42,,,,,,,,,,,,,,,,,"10,5,12,16,34,18,3,0,0",,,,,,,123,,,,,,,,,,,,,,,,,,,,,,,,,,,,,,,,,,,,,0,13,231,97,,1005,0,,1,5,3,,1,0,,,,,"Aachen Laufen",,"Polar BEAT",,0,,0,168070,250480,30378,,,,,,,,,,,,,,,,,,,,,,,,,,,,,,,,,,,,,,,,,,5,
5964548,413660de-5e17-463b-b066-3a94a90d2365,1448037853,60,1548678687,,0,0,10.01,2481,2481,135,131,,,1,1.3,0.4,,,,681,,,,,,,50.03,,1,,,,,,,,,,,,,,51,85,14.74,14.66,14.9,,,,,,,,,,,,,,,,,"0,0,0,4,14,46,33,2,0",,,,,,,142,,,,,,,,,,,,,,,,,,,,,,,,,,,,,,,,,,,,,6,13,243,88,,1003,,,1,5,3,,1,0,,,,,"Aachen Laufen",,"Polar BEAT",,0,,0,168070,250480,30378,,,,,,,,,,,,,,,,,,,,,,,,,,,,,,,,,,,,,,,,,,,
5964549,242d3847-bd15-4d4f-913d-f3b01c0863fa,1473602000,120,1548678687,,0,0,19.8,3026,3214,255,253,,,1,1.9,0.49,,,832,728,,,,,,,,,1,,,,,,,,,,,,,,33,,,26.99,,,,156,129,,1,186,156,,,,,,,,,"16,16,36,13,7,4,8",,"56,10,25,6,3",,,,,,,,,,,,,,,,,,,,,,,,,,,,,,,,,,,,,,,,,,23,2,252,60,,,,,0,3,3,,1,0,,,,,"Balve Radfahren",,"Polar BEAT",,0,,0,168072,,30378,,,,,,,,,,,,,,,,,,,,,,,,,,,,,,,,,,,,,,,,,,"5,5",
5964550,4c9d12fb-9965-44ed-9308-d4e81a7bde4c,1408483040,120,1548678688,,0,0,0.95,349,355,11,16,,,1,1,0.63,,,,63,,,,,,,26.04,,1,,,,,,,,,,,,,,7,81,9.79,10,10.05,,,,,,,,,,,,,,,,,"31,31,13,25,0,0,0,0,0",,,,,,,101,,,,,,,,,,,,,,,,,,,,,,,,,,,,,,,,,,,,,11,3,260,81,,1015,0,,1,5,3,,1,0,,,,,Auslaufen,,"Polar BEAT",,0,,0,168070,250480,30378,,,,,,,,,,,,,,,,,,,,,,,,,,,,,,,,,,,,,,,,,,,
5964551,576af84c-e401-433f-a28c-441d62e8496f,1460229590,120,1548678689,,0,0,47.17,6238,6885,629,644,,,1,2.9,0.47,,,656,1793,,,,,,,,,1,,,,,,,,,,,,,,69,,,31.91,,,,195,158,,1,232,203,,,,,,,,,"9,19,23,17,7,7,18",,"43,24,17,9,6",,,,,,,,,,,,,,,,,,,,,,,,,,,,,,,,,,,,,,,,,,13,8,165,46,,1007,0,,0,5,3,,1,0,,,,,"Aachen Radfahren",,"Polar BEAT",,0,,0,168072,,30378,,,,,,,,,,,,,,,,,,,,,,,,,,,,,,,,,,,,,,,,,,"4,4,4",
5964552,c61e9785-5a22-4698-a417-535ceb889485,1408986986,120,1548678689,,0,0,5,1073,1073,43,45,,,1,0.7,0.44,,,,332,,,,,,,56.75,,1,,,,,,,,,,,,,,22,87,16.88,16.81,16.99,,,,,,,,,,,,,,,,,"0,0,0,0,0,0,73,27,0",,,,,,,161,,,,,,,,,,,,,,,,,,,,,,,,,,,,,,,,,,,,,15,5,184,91,,1012,1,,0,6,3,,1,0,,,,,"TDL ",,"Polar BEAT",,0,,0,168070,250480,30378,,,,,,,,,,,,,,,,,,,,,,,,,,,,,,,,,,,,,,,,,,,
5964553,e280aa2a-9755-45bb-972d-7e94075c3857,1402346361,120,1548678690,,0,0,9.6,3921,5474,147,149,,,1,1.9,0.42,,,162,596,,,,,,,27.68,,1,,,,,,,,,,,,,,81,77,9.04,10.18,10.56,,,,,,,,,,,,,,,,,"69,5,3,3,9,5,4,2,0",,,,,,,95,,,,,,,,,,,,,,,,,,,,,,,,,,,,,,,,,,,,,20,9,14,81,,1017,0,,0,6,3,,1,0,,,,,"Lousberglauf Vorkurs",,"Polar BEAT",,0,,0,168070,250480,30378,,,,,,,,,,,,,,,,,,,,,,,,,,,,,,,,,,,,,,,,,,4,
5964554,39bebc9e-189e-4510-8780-6911bbb12f74,1476819931,120,1548678690,,0,0,6,1661,2158,69,71,,,1,0.7,0.53,,,,408,,,,,,,42.58,,1,,,,,,,,,,,,,,34,81,13.22,13.21,13.49,,,,,,,,,,,,,,,,,"5,3,4,12,31,34,9,2,0",,,,,,,134,,,,,,,,,,,,,,,,,,,,,,,,,,,,,,,,,,,,,10,13,238,91,,1019,,,1,6,3,,1,0,,,,,"Aachen Laufen",,"Polar BEAT",,0,,0,168070,250480,30378,,,,,,,,,,,,,,,,,,,,,,,,,,,,,,,,,,,,,,,,,,,
5964555,a201941e-083c-42f1-972b-f13ac61b6dca,1523095852,120,1548678692,,0,0,15.55,13509,13837,819,804,,,1,7.4,0.82,,,311,1716,104,145,,,,,,,1,,,,,,,,,,,,,,97,,,4.43,,-37.1,,,,,,,,,,,,,,,,"85,15,0,0,0,0","44,56,0,0,0",,,,,,,,,,,,,,,,,,,,,,,,,,,,,,,,,,,,,,,,,,13.2,9,1,141,71,,,,,0,3,3,,1,0,I1.000|12:47-I1.000|13:46-I1.000|14:46-I1.000|14:27-I1.000|20:33-I1.000|19:40-I1.000|19:18-I1.000|14:28-I1.000|13:35-I1.000|14:57-I1.000|13:25-I1.000|14:38-I1.000|12:08-I1.000|12:01-I1.000|11:58-I0.632|8:10,,Hiking,,,,"Polar M430",43,0,,0,168075,,30378,,,,,,,,,,,,,,,,,,,,,,,,,,,,,,,,,,,,,,,,,,"0,2,4",
5964556,f8e4e4f9-c733-475b-8948-4477ea3647d9,1469476887,120,1548678692,,0,0,9.94,2884,2927,132,104,,,1,0.9,0.41,,,209,695,,,,,,,41.59,,1,,,,,,,,,,,,,,59,80,12.81,12.51,12.99,,,,,,,,,,,,,,,,,"2,3,6,18,52,18,1,0,0",,,,,,,129,,,,,,,,,,,,,,,,,,,,,,,,,,,,,,,,,,,,,23,4,251,71,,1020,0,,0,5,3,,1,0,,,,,"Aachen Laufen",,"Polar BEAT",,0,,0,168070,250480,30378,,,,,,,,,,,,,,,,,,,,,,,,,,,,,,,,,,,,,,,,,,"5,5",
5964557,b2ce4fd2-8eef-47b5-9986-4b6eaaee493a,1447788424,60,1548678693,,0,0,9.88,2595,2681,88,88,,,1,0.4,0.39,,,,665,,,,,,,46.71,,1,,,,,,,,,,,,,,53,82,13.8,15.01,15.09,,,,,,,,,,,,,,,,,"16,1,2,3,9,20,25,23,1",,,,,,,139,,,,,,,,,,,,,,,,,,,,,,,,,,,,,,,,,,,,,14,30,219,90,,1007,,,1,6,3,,1,0,,,,,"Aachen Laufen",,"Polar BEAT",,0,,0,168070,250480,30378,,,,,,,,,,,,,,,,,,,,,,,,,,,,,,,,,,,,,,,,,,,
5964558,d8623f09-995f-467e-8496-fcec86e4ef24,1426870327,60,1548678694,,0,0,19.21,5542,6600,309,309,,,1,3.2,0.57,,,341,1327,,,,,,,44.05,,1,,,,,,,,,,,,,,115,83,12.77,12.64,13.23,,,,,,,,,,,,,,,,,"3,3,7,22,36,26,3,0,0",,,,,,,125,,,,,,,,,,,,,,,,,,,,,,,,,,,,,,,,,,,,,7,5,1,85,,1023,1,,0,9,3,,1,0,,,,,"Aachen Laufen",,"Polar BEAT",,0,,0,168070,250480,30378,,,,,,,,,,,,,,,,,,,,,,,,,,,,,,,,,,,,,,,,,,"4,4",
5964559,91447413-1bc1-466b-b231-563f9a5b706a,1462451007,120,1548678694,,0,0,2.71,1004,1005,4,6,,,1,0,0,,,,191,,,,,,,28.65,,1,,,,,,,,,,,,,,20,78,9.72,11.01,11.04,,,,,,,,,,,,,,,,,"21,5,10,34,27,2,1,0,0",,,,,,,104,,,,,,,,,,,,,,,,,,,,,,,,,,,,,,,,,,,,,16,9,107,41,,1024,7,,0,3,3,,1,0,,,,,"Aachen Laufen",,"Polar BEAT",,0,,0,168070,250480,30378,,,,,,,,,,,,,,,,,,,,,,,,,,,,,,,,,,,,,,,,,,,
5964560,6148ddc0-212b-4060-9ba6-34a41273b71f,1464897405,120,1548678694,,0,0,5,1371,2229,74,54,,,1,1.2,0.56,,,,342,,,,,,,42.6,,1,,,,,,,,,,,,,,28,81,13.46,13.42,13.98,,,,,,,,,,,,,,,,,"6,3,5,14,22,30,20,0,0",,,,,,,135,,,,,,,,,,,,,,,,,,,,,,,,,,,,,,,,,,,,,17,6,352,95,,1011,0,,0,6,3,,1,0,,,,,"Aachen Laufen",,"Polar BEAT",,0,,0,168070,250480,30378,,,,,,,,,,,,,,,,,,,,,,,,,,,,,,,,,,,,,,,,,,,
5964561,85e01e11-7e67-4407-b15e-d240a4052a28,1445890848,60,1548678695,,0,0,7.28,2135,2184,76,70,,,1,0.9,0.47,,,,471,,,,,,,40.24,,1,,,,,,,,,,,,,,44,82,12.47,14.14,14.1,,,,,,,,,,,,,,,,,"14,15,28,16,2,1,1,16,8",,,,,,,125,,,,,,,,,,,,,,,,,,,,,,,,,,,,,,,,,,,,,10,9,125,91,,1017,,,1,3,3,,1,0,,,,,"Aachen Laufen",,"Polar BEAT",,0,,0,168070,250480,30378,,,,,,,,,,,,,,,,,,,,,,,,,,,,,,,,,,,,,,,,,,,
5964562,775c6b18-cf86-4656-8f2d-0a2b305d0b1c,1514490133,60,1548678695,,0,0,2.65,752,757,8,21,,,1,0,0.16,,0.9,,162,140,151,,,,66.71,39.06,66.56,1,,,,,,,,,,,,,,14,81,12.57,12.79,12.67,6.7,,,,,,,,,,,,,,,,"2,2,3,10,54,28,0,0,0","0,40,60,0,0",,,,,,131,,,,,,,,,,,,,,,,,,,,,,,,,,,,,,,,,,,,19.8,2,14,235,87,,,0,,1,4,3,,1,0,I1.000|4:39-I1.000|4:49-I0.653|3:10,,Running,,,,"Polar M430",43,0,,0,168070,250480,30378,,,,,,,,,,,,,,,,,,,,,,,,,,,,,,,,,,,,,,,,,,,
5964563,7eb4fa3a-3fda-4089-a45d-4302f4a72f29,1495707071,120,1548678697,,0,0,4.9,1292,1292,69,70,,,1,1.6,0.58,,,284,336,,,,,,,44.55,,1,,,,,,,,,,,,,,26,80,13.9,13.78,14.05,,,,,,,,,,,,,,,,,"0,0,2,4,38,40,16,0,0",,,,,,,142,,,,,,,,,,,,,,,,,,,,,,,,,,,,,,,,,,,,,13,2,309,84,,,3,,0,5,3,,1,0,,,,,"Balve Laufen",,"Polar BEAT",,0,,0,168070,250480,30378,,,,,,,,,,,,,,,,,,,,,,,,,,,,,,,,,,,,,,,,,,4,
5964565,ee29e9e1-72ab-4186-8056-968d39f8a334,1410012357,120,1548678698,,0,0,2.19,742,742,18,20,,,1,0.6,0.46,,,,145,,,,,,,31.28,,1,,,,,,,,,,,,,,15,82,10.73,10.79,10.91,,,,,,,,,,,,,,,,,"13,11,25,42,9,0,0,0,0",,,,,,,108,,,,,,,,,,,,,,,,,,,,,,,,,,,,,,,,,,,,,21,3,250,79,,1013,4,,0,5,3,,1,0,,,,,Auslaufen,,"Polar BEAT",,0,,0,168070,250480,30378,,,,,,,,,,,,,,,,,,,,,,,,,,,,,,,,,,,,,,,,,,,
5964566,,1464989580,120,1548678698,,0,0,,0,0,,,,,0,,,,,,377,,,,,,,,,1,,,,,,,,,,,,,,0,,,,,,,,,,,,,,,,,,,,,,,,,,,,,,,,,,,,,,,,,,,,,,,,,,,,,,,,,,,,,,,,,,,,,,,,,,1,,,0,0,,,,,Gym,,"Polar BEAT",,0,,0,168075,,30378,,,,,,,,,,,,,,,,,,,,,,,,,,,,,,,,,,,,,,,,,,,
5964567,884e5eb6-bae4-44f3-976a-e05a0984aff9,1475098266,120,1548678698,,0,0,0.67,235,235,14,21,,,1,1.3,0.7,,,,45,,,,,,,26.44,,1,,,,,,,,,,,,,,4,77,10.46,10.19,10.95,,,,,,,,,,,,,,,,,"28,22,12,29,9,0,0,0,0",,,,,,,111,,,,,,,,,,,,,,,,,,,,,,,,,,,,,,,,,,,,,18,8,229,75,,1026,0,,1,5,3,,1,0,,,,,"Aachen Laufen",,"Polar BEAT",,0,,0,168070,250480,30378,,,,,,,,,,,,,,,,,,,,,,,,,,,,,,,,,,,,,,,,,,,
5964568,,1415959080,60,1548678698,,0,0,4,0,0,,,,,0,,,,,,267,,,,,,,,,1,,,,,,,,,,,,,,0,,,,,,,,,,,,,,,,,,,,,,,,,,,,,,,,,,,,,,,,,,,,,,,,,,,,,,,,,,,,,,,,,,,,,,,,,,1,,,0,0,,,,,"Lauf ABC + Steigerungen",,"Polar BEAT",,0,,0,168070,250480,30378,,,,,,,,,,,,,,,,,,,,,,,,,,,,,,,,,,,,,,,,,,,
5964569,d711177e-6831-4718-b345-73c0f7319eca,1500726290,120,1548678698,,0,0,7.04,2176,4078,115,99,,,1,1.7,0.6,,,443,472,,,,,,,37.74,,1,,,,,,,,,,,,,,45,79,12.02,11.91,12.4,,,,,,,,,,,,,,,,,"11,7,12,22,31,14,3,0,0",,,,,,,123,,,,,,,,,,,,,,,,,,,,,,,,,,,,,,,,,,,,,23,16,201,53,,1012,,,0,5,3,,1,0,,,,,"Aachen Laufen",,"Polar BEAT",,0,,0,168070,250480,30378,,,,,,,,,,,,,,,,,,,,,,,,,,,,,,,,,,,,,,,,,,4,
5964570,4acaa91f-b73e-4da0-bd8c-2d3cf4d13116,1399126553,120,1548678698,,0,0,0.98,179,179,0,1,,,1,0,0,,,,63,,,,,,,57.8,,1,,,,,,,,,,,,,,3,97,19.84,20.04,20.15,,,,,,,,,,,,,,,,,"0,0,0,0,0,0,0,65,35",,,,,,,169,,,,,,,,,,,,,,,,,,,,,,,,,,,,,,,,,,,,,12,10,32,48,,1025,6,,0,5,3,,1,0,,,,,"1x 1000m",,"Polar BEAT",,0,,0,168070,250480,30378,,,,,,,,,,,,,,,,,,,,,,,,,,,,,,,,,,,,,,,,,,,
5964571,e41fc6db-5723-4151-98d8-e831b2025d55,1522431630,120,1548678699,,0,0,8.14,2590,2591,27,24,,,1,0,0.16,1.14,0.94,,629,151,162,,,,52.47,36.81,52.71,1,,,,,,,,,,,,,,66,81,11.37,11.36,11.45,3.3,,,,,,,,,,,,,,,,"1,6,21,56,15,1,0,0,0","0,6,92,2,0",,,,,,116,,,,,,,,,,,,,,,,,,,,,,,,,,,,,,,,,,,,41.9,13,1,336,59,,,1,,0,4,3,,1,0,I1.000|5:08-I1.000|5:07-I1.000|5:17-I1.000|5:17-I1.000|5:28-I1.000|5:25-I1.000|5:34-I1.000|5:18-I0.145|0:40,,Running,,,,"Polar M430",43,0,,0,168070,250480,30378,,,,,,,,,,,,,,,,,,,,,,,,,,,,,,,,,,,,,,,,,,,
5964572,452c7dbb-3778-4c69-8e21-8e6e795c050b,1430475241,120,1548678700,,0,0,28.66,7503,7543,209,211,,,1,0.8,0.23,,,297,1953,,,,,,,50.85,,1,,,,,,,,,,,,,,155,83,13.9,13.82,13.99,,,,,,,,,,,,,,,,,"0,0,1,3,20,68,7,0,0",,,,,,,138,,,,,,,,,,,,,,,,,,,,,,,,,,,,,,,,,,,,,8,3,299,72,,1010,,,0,4,3,,1,0,,,,,"Menden Laufen",,"Polar BEAT",,0,,0,168070,250480,30378,,,,,,,,,,,,,,,,,,,,,,,,,,,,,,,,,,,,,,,,,,4,
5964573,e84e69cf-2e9b-4877-aef4-c8d9a947dfcc,1416169360,60,1548678700,,0,0,7.64,2512,3295,157,157,,,1,2.3,0.79,1.46,0.92,204,429,143,175,,,,54.14,35.26,55.51,1,,,,,,,,,,,,,,54,82,11.18,11.64,12.52,-3.4,,,,,,,,,,,,,,,,"23,23,17,15,7,3,4,6,2","1,54,26,20,0",,,,,,111,,,,,,,,,,,,,,,,,,,,,,,,,,,,,,,,,,,,36.5,8,3,172,97,,1001,0,,1,5,3,,1,0,,,,,"10x 150m/250 traben + Sprints",,"Polar BEAT",,0,,0,168070,250480,30378,,,,,,,,,,,,,,,,,,,,,,,,,,,,,,,,,,,,,,,,,,5,
5964574,4ec3ebc7-9b12-4a8e-bca0-78894e5e42e0,1466253166,120,1548678701,,0,0,9.92,3321,3759,269,200,,,1,3.4,0.63,,,420,676,,,,,,,35.15,,1,,,,,,,,,,,,,,68,77,11.39,12.42,13.42,,,,,,,,,,,,,,,,,"20,3,9,16,20,22,9,1,0",,,,,,,116,,,,,,,,,,,,,,,,,,,,,,,,,,,,,,,,,,,,,15,7,233,88,,1017,5,,0,6,3,,1,0,,,,,"Aachen Laufen",,"Polar BEAT",,0,,0,168070,250480,30378,,,,,,,,,,,,,,,,,,,,,,,,,,,,,,,,,,,,,,,,,,"4,4,5",
5964575,b2146345-baf1-45cd-95d0-adbf2f746587,1530820217,120,1548678701,,0,0,4.89,1475,1478,69,69,,,1,1.5,0.58,1,0.99,239,302,134,154,,,,65.29,38.01,66.44,1,,,,,,,,,,,,,,24,80,12.21,12.23,12.33,-8.3,,,,,,,,,,,,,,,,"4,4,29,18,18,24,3,0,0","1,83,16,0,0",,,,,,124,,,,,,,,,,,,,,,,,,,,,,,,,,,,,,,,,,,,17.7,25,14,323,47,,1015,,,0,5,3,,1,0,I1.000|5:27-I1.000|5:22-I1.000|5:35-I1.000|4:21-I0.894|3:54,,Running,,,,"Polar M430",43,0,,0,168070,250480,30378,,,,,,,,,,,,,,,,,,,,,,,,,,,,,,,,,,,,,,,,,,5,
5964576,272d3346-9c5b-4c3d-87cd-7aa15f931917,1447267203,60,1548678702,,0,0,10.01,2272,2272,75,82,,,1,0.2,0.28,,,,674,,,,,,,55.45,,1,,,,,,,,,,,,,,47,85,15.92,15.94,16.04,,,,,,,,,,,,,,,,,"0,0,0,1,1,18,65,15,0",,,,,,,155,,,,,,,,,,,,,,,,,,,,,,,,,,,,,,,,,,,,,11,16,221,78,,1025,,,1,4,3,,1,0,,,,,"Aachen Laufen",,"Polar BEAT",,0,,0,168070,250480,30378,,,,,,,,,,,,,,,,,,,,,,,,,,,,,,,,,,,,,,,,,,,
5964577,83631657-99aa-4081-a140-959ca7ccf6d0,1411764775,120,1548678703,,0,0,18.01,4736,4907,156,167,,,1,0.7,0.38,1.04,1,,859,151,210,,,,66.4,48.78,67.06,1,,,,,,,,,,,,,,121,82,13.8,13.88,14.05,-2.6,,,,,,,,,,,,,,,,"2,1,1,2,21,60,13,0,0","0,12,72,16,0",,,,,,139,,,,,,,,,,,,,,,,,,,,,,,,,,,,,,,,,,,,52.2,15,4,218,88,,1026,0,,1,5,3,,1,0,,,,,"Zügiger DL ",,"Polar BEAT",,0,,0,168070,250480,30378,,,,,,,,,,,,,,,,,,,,,,,,,,,,,,,,,,,,,,,,,,,
5964578,2d589e66-7924-4904-b888-1bba947af3f7,1429997079,120,1548678703,,0,0,1.14,357,357,22,23,,,1,1.4,0.7,,,,78,,,,,,,31.9,,1,,,,,,,,,,,,,,7,80,11.79,11.81,12.44,,,,,,,,,,,,,,,,,"5,7,20,25,43,1,0,0,0",,,,,,,120,,,,,,,,,,,,,,,,,,,,,,,,,,,,,,,,,,,,,12,7,188,88,,1007,,,1,5,3,,1,0,,,,,"Essen Laufen",,"Polar BEAT",,0,,0,168070,250480,30378,,,,,,,,,,,,,,,,,,,,,,,,,,,,,,,,,,,,,,,,,,,
5964579,8f79d2bf-491f-41cf-9b05-6e9fa0632269,1512299009,60,1548678703,,0,0,18.15,4280,4280,185,266,,,1,1.4,0.39,1.02,0.92,471,725,120,183,,,,,55.36,,1,,,,,,,,,,,,,,60,86,15.4,15.51,15.6,-18,,,,,,,,,,,,,,,,"0,0,0,3,10,31,42,14,0","15,65,3,17,1",,,,,,148,,,,,,,,,,,,,,,,,,,,,,,,,,,,,,,,,,,,78.8,-1,8,207,93,,1026,,,0,7,3,,1,0,I1.000|3:34-I1.000|4:00-I1.000|3:37-I1.000|3:33-I1.000|3:22-I1.000|3:29-I1.000|4:02-I1.000|3:50-I1.000|3:52-I1.000|4:14-I1.000|3:51-I1.000|4:11-I1.000|4:06-I1.000|3:59-I1.000|4:37-I1.000|4:28-I1.000|4:21-I1.000|3:42-I0.163|0:35,,Running,,,,"Polar M430",43,0,,0,168070,250480,30378,,,,,,,,,,,,,,,,,,,,,,,,18,4280,,,0,"Aachener Winterlauf",,,,,,,0,0,30378,5964579,993,,5,
5964581,15bccdb0-480f-41a7-8812-ef67ff4b616f,1399812678,120,1548678704,,0,0,31.5,7996,8095,438,437,,,1,2.9,0.54,,,444,2104,,,,,,,53.07,,1,,,,,,,,,,,,,,166,85,14.46,14.37,14.72,,,,,,,,,,,,,,,,,"2,1,2,5,16,41,32,2,0",,,,,,,139,,,,,,,,,,,,,,,,,,,,,,,,,,,,,,,,,,,,,12,31,238,68,,1005,,,0,11,3,,1,0,,,,,"Langer zügiger DL ",,"Polar BEAT",,0,,0,168070,250480,30378,,,,,,,,,,,,,,,,,,,,,,,,,,,,,,,,,,,,,,,,,,"4,5,5",
5964582,0ad142e4-b2c9-41ea-a92c-5ba117d5ba90,1432386005,120,1548678705,,0,0,4.94,1145,1145,78,77,,,1,1.5,0.49,,,481,335,,,,,,,51.83,,1,,,,,,,,,,,,,,23,86,15.94,15.84,16.56,,,,,,,,,,,,,,,,,"1,0,1,2,6,22,50,17,0",,,,,,,151,,,,,,,,,,,,,,,,,,,,,,,,,,,,,,,,,,,,,19,4,316,55,,,,,0,3,3,,1,0,,,,,"Balve Laufen",,"Polar BEAT",,0,,0,168070,250480,30378,,,,,,,,,,,,,,,,,,,,,,,,,,,,,,,,,,,,,,,,,,4,
5964583,,1539172800,120,1548678705,,0,0,10,1800,1800,,,,,0,,,,,,385,,,,,,,,,1,,,,,,,,,,,,,,20,,,,,,,,,,,,,,,,,,,,,,,,,,,,,,,,,,,,,,,,,,,,,,,,,,,,,,,,,,,,,,,,,,,,,,,,,,1,,,0,0,,,,,,,"no device name available",,0,,0,168072,,30378,,,,,,,,,,,,,,,,,,,,,,,,,,,,,,,,,,,,,,,,,,,
5964584,e0b7e7b7-1b45-408c-a3b2-be42a7030d15,1548577779,60,1548678706,,0,0,28.29,9846,9888,710,710,,,1,5.2,0.73,1.03,1.03,449,2278,145,177,,,,49.57,36.33,51.11,1,,,,,,,,,,,,,,227,81,11.13,11.1,11.57,10.7,,,,,,,,,,,,,,,,"26,13,16,19,16,9,2,0,0","0,34,47,19,0",,,,,,106,,,,,,,,,,,,,,,,,,,,,,,,,,,,,,,,,,,,54.4,3,20,181,93,,991,0,354,0,6,3,,1,0,,,Running,,,,"Polar M430",43,0,,0,168070,250480,30378,,,,,,,,,,,,,,,,,,,,,,,,,,,,,,,,,,,,,,,,,,"3,3,5,5",
5964585,44061635-0566-4385-9f05-f25eb2f6197f,1455045392,60,1548678707,,0,0,9.61,2622,2825,90,92,,,1,0.8,0.45,,,,652,,,,,,,44.59,,1,,,,,,,,,,,,,,54,82,13.27,13.71,13.97,,,,,,,,,,,,,,,,,"4,3,5,20,33,12,16,6,1",,,,,,,134,,,,,,,,,,,,,,,,,,,,,,,,,,,,,,,,,,,,,2,24,259,95,,986,,,1,6,3,,1,0,,,,,"Aachen Laufen",,"Polar BEAT",,0,,0,168070,250480,30378,,,,,,,,,,,,,,,,,,,,,,,,,,,,,,,,,,,,,,,,,,,
5964586,38c6608a-7098-42e1-be66-145db9e7bb79,1450523798,60,1548678707,,0,0,11.3,3378,3983,202,165,,,1,2.4,0.59,,,444,764,,,,,,,40.54,,1,,,,,,,,,,,,,,70,80,12.48,12.22,12.85,,,,,,,,,,,,,,,,,"5,4,13,26,31,21,0,0,0",,,,,,,125,,,,,,,,,,,,,,,,,,,,,,,,,,,,,,,,,,,,,12,16,194,86,,1022,,,0,5,3,,1,0,,,,,"Aachen Laufen",,"Polar BEAT",,0,,0,168070,250480,30378,,,,,,,,,,,,,,,,,,,,,,,,,,,,,,,,,,,,,,,,,,"4,5",
5964587,b36ac6ef-8668-413b-b310-ee48f8ccf480,1420890666,60,1548678707,,0,0,5.85,1700,2099,149,67,,,1,2.2,0.55,,,458,395,,,,,,,40.15,,1,,,,,,,,,,,,,,35,84,13.17,12.69,13.88,,,,,,,,,,,,,,,,,"9,2,5,15,40,23,6,0,0",,,,,,,123,,,,,,,,,,,,,,,,,,,,,,,,,,,,,,,,,,,,,12,41,240,79,,1013,,,0,11,3,,1,0,,,,,Einlaufen,,"Polar BEAT",,0,,0,168070,250480,30378,,,,,,,,,,,,,,,,,,,,,,,,,,,,,,,,,,,,,,,,,,4,
5964588,1394102b-bcf6-4c7b-b931-7bde977a2be4,1506535606,120,1548678708,,0,0,13.3,3492,3493,190,196,,,1,2.3,0.61,1.03,1.02,410,966,165,185,,,,58.65,47.73,59.66,1,,,,,,,,,,,,,,124,80,13.99,13.86,14.2,3.7,,,,,,,,,,,,,,,,"1,0,2,6,27,50,15,0,0","0,1,37,56,6",,,,,,143,,,,,,,,,,,,,,,,,,,,,,,,,,,,,,,,,,,,103.4,19,2,109,63,,1022,0,,0,5,3,,1,0,I1.000|4:33-I1.000|4:11-I1.000|4:25-I1.000|4:13-I1.000|4:04-I1.000|4:40-I1.000|4:51-I1.000|4:28-I1.000|4:41-I1.000|4:03-I1.000|4:10-I1.000|4:22-I1.000|4:00-I0.308|1:31,,Running,,,,"Polar M430",43,0,,0,168070,250480,30378,,,,,,,,,,,,,,,,,,,,,,,,,,,,,,,,,,,,,,,,,,4,
5964589,d5fec2f0-a6f0-4651-9ee6-044f02c2cd8f,1459076808,120,1548678709,,0,0,20.39,5626,5626,564,564,,,1,5.1,0.74,,,537,1404,,,,,,,46.61,,1,,,,,,,,,,,,,,116,84,13.84,13.35,14.46,,,,,,,,,,,,,,,,,"3,2,5,17,22,40,12,0,0",,,,,,,129,,,,,,,,,,,,,,,,,,,,,,,,,,,,,,,,,,,,,8,18,230,86,,1008,,,0,4,3,,1,0,,,,,"Balve Laufen",,"Polar BEAT",,0,,0,168070,250480,30378,,,,,,,,,,,,,,,,,,,,,,,,,,,,,,,,,,,,,,,,,,"3,4,5",
5964590,9b809959-c0a8-46b8-b4c6-e057f01e4050,1463425938,120,1548678711,,0,0,5.7,1539,1539,113,107,,,1,1.8,0.54,,,355,390,,,,,,,43.72,,1,,,,,,,,,,,,,,31,83,13.94,14.23,14.52,,,,,,,,,,,,,,,,,"7,5,7,19,24,11,13,12,2",,,,,,,134,,,,,,,,,,,,,,,,,,,,,,,,,,,,,,,,,,,,,11,4,306,62,,1021,1,,0,5,3,,1,0,,,,,"Aachen Laufen",,"Polar BEAT",,0,,0,168070,250480,30378,,,,,,,,,,,,,,,,,,,,,,,,,,,,,,,,,,,,,,,,,,4,
5964591,cf4ea6ec-8aba-4152-8c95-226ff4a53613,1413230815,120,1548678712,,0,0,11.79,2657,2657,95,98,,,1,0.5,0.38,1.02,0.99,,628,169,183,,,,68.34,56.51,69.01,1,,,,,,,,,,,,,,102,86,16.08,16.11,16.24,-1.1,,,,,,,,,,,,,,,,"0,0,0,0,1,17,64,16,0","0,1,21,75,3",,,,,,155,,,,,,,,,,,,,,,,,,,,,,,,,,,,,,,,,,,,105.1,15,5,190,80,,1006,0,,1,3,3,,1,0,,,,,TDL,,"Polar BEAT",,0,,0,168070,250480,30378,,,,,,,,,,,,,,,,,,,,,,,,,,,,,,,,,,,,,,,,,,,
5964592,6d0dc560-43eb-4809-94c4-0f60016efe3e,1459286924,120,1548678712,,0,0,4.74,1445,1546,57,67,,,1,1.1,0.53,,,,326,,,,,,,37.47,,1,,,,,,,,,,,,,,30,83,11.91,11.93,12.11,,,,,,,,,,,,,,,,,"3,5,13,36,33,9,1,0,0",,,,,,,119,,,,,,,,,,,,,,,,,,,,,,,,,,,,,,,,,,,,,7,5,186,75,,1010,0,,1,5,3,,1,0,,,,,"Aachen Laufen",,"Polar BEAT",,0,,0,168070,250480,30378,,,,,,,,,,,,,,,,,,,,,,,,,,,,,,,,,,,,,,,,,,,
5964593,f0f03207-5d14-4661-a1b5-6524141a9300,1494274442,120,1548678713,,0,0,12.34,3583,3896,216,199,,,1,2.7,0.61,,,464,854,,,,,,,42.22,,1,,,,,,,,,,,,,,74,80,12.79,12.72,13.12,,,,,,,,,,,,,,,,,"6,5,11,22,26,22,6,2,1",,,,,,,129,,,,,,,,,,,,,,,,,,,,,,,,,,,,,,,,,,,,,10,1,359,84,,1021,0,,0,5,3,,1,0,,,,,"Aachen Laufen",,"Polar BEAT",,0,,0,168070,250480,30378,,,,,,,,,,,,,,,,,,,,,,,,,,,,,,,,,,,,,,,,,,4,
5964594,d6a4121d-a843-452a-9e48-0e0d017df360,1426273214,60,1548678713,,0,0,10.81,3064,3070,132,133,,,1,1,0.39,,,314,730,,,,,,,43,,1,,,,,,,,,,,,,,63,82,12.97,12.82,13.22,,,,,,,,,,,,,,,,,"3,2,5,11,47,30,2,0,0",,,,,,,129,,,,,,,,,,,,,,,,,,,,,,,,,,,,,,,,,,,,,5,6,103,58,,1024,0,,1,5,3,,1,0,,,,,"Aachen Laufen",,"Polar BEAT",,0,,0,168070,250480,30378,,,,,,,,,,,,,,,,,,,,,,,,,,,,,,,,,,,,,,,,,,5,
5964595,716b59c0-7779-4991-ba38-fd7c7d62d8a1,1462909413,120,1548678714,,0,0,6.71,1726,1838,57,70,,,1,0.6,0.39,,,,460,,,,,,,46.73,,1,,,,,,,,,,,,,,35,83,14.1,14.26,14.38,,,,,,,,,,,,,,,,,"1,0,1,7,24,46,13,8,0",,,,,,,141,,,,,,,,,,,,,,,,,,,,,,,,,,,,,,,,,,,,,19,6,113,74,,1007,0,,0,5,3,,1,0,,,,,"Aachen Laufen",,"Polar BEAT",,0,,0,168070,250480,30378,,,,,,,,,,,,,,,,,,,,,,,,,,,,,,,,,,,,,,,,,,,
5964596,bf7c485e-9cc5-4d49-956e-254b9e416620,1431029376,120,1548678714,,0,0,3.33,909,909,70,69,,,1,1.6,0.57,,,469,226,,,,,,,41.65,,1,,,,,,,,,,,,,,18,82,13.64,13.28,14.15,,,,,,,,,,,,,,,,,"0,2,4,17,35,31,11,0,0",,,,,,,134,,,,,,,,,,,,,,,,,,,,,,,,,,,,,,,,,,,,,13,2,241,59,,1019,0,,0,5,3,,1,0,,,,,"Aachen Laufen",,"Polar BEAT",,0,,0,168070,250480,30378,,,,,,,,,,,,,,,,,,,,,,,,,,,,,,,,,,,,,,,,,,4,
5964597,4cb3aa1f-9914-4a49-ad8b-519c28079b8f,1544262057,60,1548678714,,0,0,2.95,964,966,13,12,,,1,0,0.11,1.12,0.81,,216,141,152,,,,55.54,33.45,55.86,1,,,,,,,,,,,,,,19,81,11.06,11.1,11.21,-4.5,,,,,,,,,,,,,,,,"6,9,21,54,10,0,0,0,0","2,25,73,0,0",,,,,,113,,,,,,,,,,,,,,,,,,,,,,,,,,,,,,,,,,,,22.8,7,42,200,81,,1014,0,307,0,6,3,,1,0,I1.000|5:43-I1.000|5:23-I0.956|5:02,,Running,,,,"Polar M430",43,0,,0,168070,250480,30378,,,,,,,,,,,,,,,,,,,,,,,,,,,,,,,,,,,,,,,,,,,
5964598,787fadda-2a2d-4875-8d17-828635af3c6e,1467241014,120,1548678714,,0,0,5,1537,1721,,,,,0,,,,,,345,,,,,,,37.22,,1,,,,,,,,,,,,,,31,80,,11.75,,,,,,,,,,,,,,,,,,"2,0,3,74,21,0,0,0,0",,,,,,,122,,,,,,,,,,,,,,,,,,,,,,,,,,,,,,,,,,,,,,,,,,,,,,1,,,1,0,,,,,Laufen,,"Polar BEAT",,0,,0,168070,250480,30378,,,,,,,,,,,,,,,,,,,,,,,,,,,,,,,,,,,,,,,,,,,
5964599,512b5ada-749e-4110-9ea4-82f0661286a5,1399030735,120,1548678715,,0,0,22.76,6248,6324,306,302,,,1,2.3,0.44,1.05,1.01,458,1236,160,177,,,,58.07,47.29,59.04,1,,,,,,,,,,,,,,200,84,13.41,13.24,13.59,1.5,,,,,,,,,,,,,,,,"1,2,4,12,32,44,5,0,0","0,6,34,60,0",,,,,,130,,,,,,,,,,,,,,,,,,,,,,,,,,,,,,,,,,,,74.3,11,7,348,91,,1017,4,,0,5,3,,1,0,,,,,"Langer Lockerer DL",,"Polar BEAT",,0,,0,168070,250480,30378,,,,,,,,,,,,,,,,,,,,,,,,,,,,,,,,,,,,,,,,,,"5,5",
5964600,7a523798-963d-4f3f-9989-04794a89f5c2,1528137512,120,1548678716,,0,0,6.99,2162,2162,23,24,,,1,0,0.09,1.08,0.89,,443,136,161,,,,62.17,37.69,62.41,1,,,,,,,,,,,,,,39,80,11.67,11.73,11.8,-1.5,,,,,,,,,,,,,,,,"3,5,23,42,18,4,5,0,0","1,48,51,0,0",,,,,,121,,,,,,,,,,,,,,,,,,,,,,,,,,,,,,,,,,,,25,28,17,20,45,,1008,,,0,5,3,,1,0,I1.000|5:27-I1.000|5:30-I1.000|5:14-I1.000|5:09-I1.000|4:56-I1.000|5:20-I0.988|4:28,,Running,,,,"Polar M430",43,0,,0,168070,250480,30378,,,,,,,,,,,,,,,,,,,,,,,,,,,,,,,,,,,,,,,,,,,
5964601,fc8481e7-210c-4d32-b1b8-e6ac0e01f302,1510935942,60,1548678716,,0,0,11.88,3576,3578,49,48,,,1,0,0.1,1.14,0.94,,706,133,151,,,,66.05,40.36,66.4,1,,,,,,,,,,,,,,58,82,12,11.98,12.08,2,,,,,,,,,,,,,,,,"0,0,4,56,40,1,0,0,0","0,94,5,0,0",,,,,,122,,,,,,,,,,,,,,,,,,,,,,,,,,,,,,,,,,,,17.1,6,0,50,89,,,0,,1,4,3,,1,0,I1.000|5:18-I1.000|4:55-I1.000|4:54-I1.000|4:58-I1.000|4:54-I1.000|4:57-I1.000|5:01-I1.000|5:07-I1.000|4:55-I1.000|5:03-I1.000|5:03-I0.876|4:35,,Running,,,,"Polar M430",43,0,,0,168070,250480,30378,,,,,,,,,,,,,,,,,,,,,,,,,,,,,,,,,,,,,,,,,,,
5964602,bdddb494-bdd4-455a-9979-352f160ee2b4,1454613290,60,1548678716,,0,0,0.72,206,242,0,0,,,1,0,0.15,,,,52,,,,,,,33.64,,1,,,,,,,,,,,,,,4,79,12.56,12.64,12.77,,,,,,,,,,,,,,,,,"7,9,11,16,15,22,21,0,0",,,,,,,133,,,,,,,,,,,,,,,,,,,,,,,,,,,,,,,,,,,,,6,16,303,91,,1023,,,1,5,3,,1,0,,,,,"Aachen Laufen",,"Polar BEAT",,0,,0,168070,250480,30378,,,,,,,,,,,,,,,,,,,,,,,,,,,,,,,,,,,,,,,,,,,
5964603,9b79ef33-bd74-4d27-9e08-82b724eee4a7,1429214752,120,1548678717,,0,0,9.82,2734,2734,204,203,,,1,3,0.65,,,558,666,,,,,,,43.61,,1,,,,,,,,,,,,,,56,83,13.46,13.16,14.01,,,,,,,,,,,,,,,,,"2,4,8,17,24,33,11,1,0",,,,,,,130,,,,,,,,,,,,,,,,,,,,,,,,,,,,,,,,,,,,,13,14,37,56,,1013,,,0,5,3,,1,0,,,,,"Aachen Laufen",,"Polar BEAT",,0,,0,168070,250480,30378,,,,,,,,,,,,,,,,,,,,,,,,,,,,,,,,,,,,,,,,,,"4,5",
5964604,e5c681b4-2032-4496-8832-0ed49ea0ba6c,1508264041,120,1548678717,,0,0,10.35,2927,2973,33,34,,,1,0,0.16,0.93,0.91,,691,150,189,,,,61.23,42.98,61.47,1,,,,,,,,,,,,,,83,81,12.79,14.31,14.42,34.3,,,,,,,,,,,,,,,,"19,1,2,4,11,19,35,9,0","1,37,26,12,24",,,,,,131,,,,,,,,,,,,,,,,,,,,,,,,,,,,,,,,,,,,115.3,16,2,76,85,,1019,,,0,5,3,,1,0,I2.338|10:56-I0.597|2:13-I0.603|2:18-I0.597|2:16-I0.595|2:17-I0.614|2:07-I0.127|3:01-I0.590|2:16-I0.611|2:15-I0.598|2:10-I0.086|2:00-I0.597|2:12-I0.606|2:12-I0.603|2:05-I0.172|4:19-I1.004|4:59,,Running,,,,"Polar M430",43,0,,0,168070,250480,30378,,,,,,,,,,,,,,,,,,,,,,,,,,,,,,,,,,,,,,,,,,,
5964605,d621ad9f-8dfa-46da-91d3-32ca9d6ee1cd,1452944094,60,1548678718,,0,0,10.33,3281,3322,262,210,,,1,3.7,0.75,,,513,710,,,,,,,37.51,,1,,,,,,,,,,,,,,68,80,11.96,11.52,12.66,,,,,,,,,,,,,,,,,"6,11,22,28,23,9,0,0,0",,,,,,,118,,,,,,,,,,,,,,,,,,,,,,,,,,,,,,,,,,,,,2,11,300,82,,1023,,,0,6,3,,1,0,,,,,"Aachen Laufen",,"Polar BEAT",,0,,0,168070,250480,30378,,,,,,,,,,,,,,,,,,,,,,,,,,,,,,,,,,,,,,,,,,"4,4,5",
5964606,9615eee7-347d-4c89-965d-d22c09ff33f6,1400429980,120,1548678718,,0,0,1.48,255,255,0,2,,,1,0,0,,,,89,,,,,,,64.34,,1,,,,,,,,,,,,,,5,93,20.87,20.97,20.93,,,,,,,,,,,,,,,,,"0,0,0,0,0,0,0,0,100",,,,,,,187,,,,,,,,,,,,,,,,,,,,,,,,,,,,,,,,,,,,,21,4,61,47,,1012,4,,0,5,3,,1,0,,,,,"WK 1.500m",,"Polar BEAT",,0,,0,168070,250480,30378,,,,,,,,,,,,,,,,,,,,,,,,,,,,,,,,,,,,,,,,,,,
5964607,9952ce98-4c4e-43f3-bd8c-276b9b346b2a,1445768607,60,1548678718,,0,0,5.57,1946,1947,110,112,,,1,1.7,0.54,,,265,379,,,,,,,32.15,,1,,,,,,,,,,,,,,40,83,10.67,10.81,11.24,,,,,,,,,,,,,,,,,"15,10,29,34,11,1,0,0,0",,,,,,,103,,,,,,,,,,,,,,,,,,,,,,,,,,,,,,,,,,,,,11,7,337,94,,1025,,,0,4,3,,1,0,,,,,"Aachen Laufen",,"Polar BEAT",,0,,0,168070,250480,30378,,,,,,,,,,,,,,,,,,,,,,,,,,,,,,,,,,,,,,,,,,4,
5964608,735310d2-b286-4bb6-9847-ed2080f8925c,1424803529,60,1548678719,,0,0,20.74,5551,5740,225,229,,,1,0,0.03,,,,1379,,,,,,,48.34,,1,,,,,,,,,,,,,,115,82,13.53,14.98,15.02,,,,,,,,,,,,,,,,,"18,0,1,0,0,5,73,3,0",,,,,,,137,,,,,,,,,,,,,,,,,,,,,,,,,,,,,,,,,,,,,4,10,226,83,,1012,,,1,5,3,,1,0,,,,,"4x 5km - Alle in ca. 18:50",,"Polar BEAT",,0,,0,168070,250480,30378,,,,,,,,,,,,,,,,,,,,,,,,,,,,,,,,,,,,,,,,,,,
5964609,5f545343-fb0a-42df-8425-2b71427460f8,1516521901,60,1548678719,,0,0,13.67,3445,3445,88,89,,,1,0,0.12,1.11,0.91,,908,159,173,,,,65.12,50.16,65.63,1,,,,,,,,,,,,,,106,85,14.35,14.32,14.44,2.6,,,,,,,,,,,,,,,,"0,0,0,0,11,73,16,0,0","0,3,46,51,0",,,,,,140,,,,,,,,,,,,,,,,,,,,,,,,,,,,,,,,,,,,66,3,9,256,82,,1013,,,0,5,3,,1,0,I1.000|4:23-I1.000|4:18-I1.000|4:12-I1.000|4:18-I1.000|4:07-I1.000|4:17-I1.000|4:14-I1.000|4:16-I1.000|4:05-I1.000|4:07-I1.000|4:03-I1.000|4:08-I1.000|4:06-I0.674|2:51,,Running,,,,"Polar M430",43,0,,0,168070,250480,30378,,,,,,,,,,,,,,,,,,,,,,,,,,,,,,,,,,,,,,,,,,,
5964610,b707019f-fd0f-4830-bbba-7612262497c6,1425206418,60,1548678720,,0,0,33,7986,8308,785,780,,,1,4.4,0.62,,,536,2238,,,,,,,56.29,,1,,,,,,,,,,,,,,165,87,15.31,14.92,15.87,,,,,,,,,,,,,,,,,"0,0,0,0,3,47,49,0,0",,,,,,,142,,,,,,,,,,,,,,,,,,,,,,,,,,,,,,,,,,,,,7,10,224,90,,,1,,0,5,3,,1,0,,,,,"Langer TDL",,"Polar BEAT",,0,,0,168070,250480,30378,,,,,,,,,,,,,,,,,,,,,,,,,,,,,,,,,,,,,,,,,,"4,4,4,4,5,5,5,5,5,5",
5964611,e8ef5ba2-460a-4c9f-b980-bdb3ece3b277,1404417347,120,1548678721,,0,0,12.23,3497,3522,157,134,,,1,1.3,0.5,,,425,838,,,,,,,42.95,,1,,,,,,,,,,,,,,72,81,12.82,12.72,13.05,,,,,,,,,,,,,,,,,"2,1,7,17,50,23,0,0,0",,,,,,,130,,,,,,,,,,,,,,,,,,,,,,,,,,,,,,,,,,,,,25,6,255,44,,1019,0,,0,3,3,,1,0,,,,,"Regenerativer DL Plus Lauf ABC",,"Polar BEAT",,0,,0,168070,250480,30378,,,,,,,,,,,,,,,,,,,,,,,,,,,,,,,,,,,,,,,,,,5,
5964612,5fc81160-ea77-4c71-93f3-9bd9f4cc6b83,1457463622,60,1548678722,,0,0,18.27,4939,5769,195,195,,,1,1.6,0.48,,,,1257,,,,,,,47.3,,1,,,,,,,,,,,,,,102,83,13.45,14.11,14.34,,,,,,,,,,,,,,,,,"9,2,4,11,22,17,27,9,0",,,,,,,134,,,,,,,,,,,,,,,,,,,,,,,,,,,,,,,,,,,,,2,11,193,85,,1017,,,1,5,3,,1,0,,,,,"Aachen Laufen",,"Polar BEAT",,0,,0,168070,250480,30378,,,,,,,,,,,,,,,,,,,,,,,,,,,,,,,,,,,,,,,,,,,
5964613,220e74e7-4a2f-4a10-88aa-a69a834f99a0,1416303293,60,1548678723,,0,0,8.29,2432,2900,94,94,,,1,1.1,0.46,,,,556,,,,,,,40.55,,1,,,,,,,,,,,,,,50,84,12.46,12.53,12.71,,,,,,,,,,,,,,,,,"8,6,5,11,41,26,2,0,0",,,,,,,122,,,,,,,,,,,,,,,,,,,,,,,,,,,,,,,,,,,,,7,2,57,99,,1009,0,,0,5,3,,1,0,,,,,"Locker + Dehnen",,"Polar BEAT",,0,,0,168070,250480,30378,,,,,,,,,,,,,,,,,,,,,,,,,,,,,,,,,,,,,,,,,,,
5964614,03147f20-11c9-49ef-874e-7cb6f7bb9539,1542284248,60,1548678723,,0,0,10.48,2862,2868,45,46,,,1,0,0.08,1.09,0.82,,767,158,184,,,,59.5,44.81,59.81,1,,,,,,,,,,,,,,87,84,13.22,13.47,13.59,5.9,,,,,,,,,,,,,,,,"4,3,3,12,51,8,11,8,0","0,1,63,34,1",,,,,,131,,,,,,,,,,,,,,,,,,,,,,,,,,,,,,,,,,,,73.8,5,8,67,100,,1027,1,258,0,5,3,,1,0,I2.990|14:07-I0.488|2:01-I0.285|1:01-I0.169|1:02-I0.474|2:03-I0.741|3:02-I0.562|2:00-I0.160|1:04-I0.478|2:03-I0.488|2:09-I3.639|17:18,,Running,,,,"Polar M430",43,0,,0,168070,250480,30378,,,,,,,,,,,,,,,,,,,,,,,,,,,,,,,,,,,,,,,,,,,
5964616,ffb3f349-7361-4888-9047-b5ef30fbe8f7,1443086557,120,1548678725,,0,0,8.92,2547,2586,25,25,,,1,0,0.05,,,,607,,,,,,,42.07,,1,,,,,,,,,,,,,,52,83,12.66,13,13.06,,,,,,,,,,,,,,,,,"6,3,7,7,24,46,6,0,0",,,,,,,127,,,,,,,,,,,,,,,,,,,,,,,,,,,,,,,,,,,,,12,15,195,85,,1014,,,0,5,3,,1,0,,,,,"Münster Laufen",,"Polar BEAT",,0,,0,168070,250480,30378,,,,,,,,,,,,,,,,,,,,,,,,,,,,,,,,,,,,,,,,,,,
5964618,1d628ade-5248-4c0d-be4a-5e35214f4549,1416663490,60,1548678726,,0,0,3.73,1147,1225,25,58,,,1,0.5,0.46,,,,248,,,,,,,36.53,,1,,,,,,,,,,,,,,23,83,11.55,11.83,11.73,,,,,,,,,,,,,,,,,"1,8,20,27,38,6,0,0,0",,,,,,,118,,,,,,,,,,,,,,,,,,,,,,,,,,,,,,,,,,,,,13,3,168,84,,1018,1,,0,5,3,,1,0,,,,,Auslaufen,,"Polar BEAT",,0,,0,168070,250480,30378,,,,,,,,,,,,,,,,,,,,,,,,,,,,,,,,,,,,,,,,,,,
5964619,03278c9d-0cd5-49cd-84cf-66ee49588f0e,1433839437,120,1548678726,,0,0,12.79,3914,4066,225,225,,,1,2.5,0.51,,,566,872,,,,,,,39.82,,1,,,,,,,,,,,,,,81,83,12.2,12.01,12.41,,,,,,,,,,,,,,,,,"6,11,15,19,34,15,0,0,0",,,,,,,118,,,,,,,,,,,,,,,,,,,,,,,,,,,,,,,,,,,,,10,19,42,73,,1029,,,0,5,3,,1,0,,,,,"Voeren Sint-Martens-Voeren Laufen",,"Polar BEAT",,0,,0,168070,250480,30378,,,,,,,,,,,,,,,,,,,,,,,,,,,,,,,,,,,,,,,,,,"4,4",
5964620,63588b05-8f8e-4c3a-826d-fb9c05aae88a,1364732106,120,1548678727,,0,0,14.73,4251,4251,392,400,,,1,3.8,0.7,,,403,1031,,,,,,,43.11,,1,,,,,,,,,,,,,,88,,12.95,12.51,13.54,,,,,,,,,,,,,,,,,"0,1,1,19,74,6,0,0,0",,,,,,,,,,,,,,,,,,,,,,,,,,,,,,,,,,,,,,,,,,,,0,6,32,84,,,3,,0,5,3,,1,0,,,,,,,"Polar BEAT",,0,,0,168070,250480,30378,,,,,,,,,,,,,,,,,,,,,,,,,,,,,,,,,,,,,,,,,,"4,5,5,5,5",
5964621,4d527251-b706-4f4f-877b-a0296d6cd4b0,1437919860,120,1548678727,,0,0,18.01,4231,4306,140,141,,,1,0,0.22,,,,1208,,,,,,,55.57,,1,,,,,,,,,,,,,,87,84,15.45,15.62,15.7,,,,,,,,,,,,,,,,,"1,0,0,1,4,30,54,6,3",,,,,,,152,,,,,,,,,,,,,,,,,,,,,,,,,,,,,,,,,,,,,19,16,194,47,,1011,,,0,5,3,,1,0,,,,,"Aachen Laufen",,"Polar BEAT",,0,,0,168070,250480,30378,,,,,,,,,,,,,,,,,,,,,,,,,,,,,,,,,,,,,,,,,,,
5964622,b237d0a9-bc1a-4f71-a629-199453cea6e4,1405077320,120,1548678728,,0,0,13.35,3608,3608,176,176,,,1,2.1,0.59,,,370,885,,,,,,,46.16,,1,,,,,,,,,,,,,,74,83,13.56,13.94,14.18,,,,,,,,,,,,,,,,,"2,1,4,14,33,37,4,2,2",,,,,,,134,,,,,,,,,,,,,,,,,,,,,,,,,,,,,,,,,,,,,18,3,263,92,,1015,4,,0,5,3,,1,0,,,,,"Lockerer DL ",,"Polar BEAT",,0,,0,168070,250480,30378,,,,,,,,,,,,,,,,,,,,,,,,,,,,,,,,,,,,,,,,,,"5,5",
5964623,212bf804-39ba-4d49-8037-63afb2ed3a61,1443731648,120,1548678728,,0,0,6.66,1583,1583,72,73,,,1,0,0.03,,,,443,,,,,,,51.26,,1,,,,,,,,,,,,,,32,88,15.2,16.2,16.26,,,,,,,,,,,,,,,,,"13,9,7,4,2,3,4,58,0",,,,,,,143,,,,,,,,,,,,,,,,,,,,,,,,,,,,,,,,,,,,,9,9,91,70,,1028,,,1,3,3,,1,0,,,,,"Aachen Laufen",,"Polar BEAT",,0,,0,168070,250480,30378,,,,,,,,,,,,,,,,,,,,,,,,,,,,,,,,,,,,,,,,,,,
5964624,e0012f4b-c728-4953-aab0-f5e6533cf197,1470934399,120,1548678729,,0,0,15.45,3061,3666,32,29,,,1,0,0.04,,,,437,,,,,,,,,1,,,,,,,,,,,,,,34,,,19.3,,,,68,59,,1,84,74,,,,,,,,,"19,34,44,2,0,0,0",,"86,1,12,0,0",,,,,,,,,,,,,,,,,,,,,,,,,,,,,,,,,,,,,,,,,,22,9,265,67,,,,,0,3,3,,1,0,,,,,"Vendays-Montalivet Radfahren",,"Polar BEAT",,0,,0,168072,,30378,,,,,,,,,,,,,,,,,,,,,,,,,,,,,,,,,,,,,,,,,,,
5964625,60cee332-537a-4a36-b470-58ba56963c32,1479758181,60,1548678730,,0,0,0.71,228,228,10,18,,,1,0.5,0.43,,,,46,,,,,,,29.44,,1,,,,,,,,,,,,,,4,83,11.15,11.3,11.27,,,,,,,,,,,,,,,,,"10,20,18,28,9,10,5,0,0",,,,,,,113,,,,,,,,,,,,,,,,,,,,,,,,,,,,,,,,,,,,,11,16,173,85,,1000,,,1,6,3,,1,0,,,,,"Aachen Laufen",,"Polar BEAT",,0,,0,168070,250480,30378,,,,,,,,,,,,,,,,,,,,,,,,,,,,,,,,,,,,,,,,,,,
5964626,0727f24a-99ba-4dd7-a5c9-d56afbbf7c1d,1415906060,60,1548678730,,0,0,2.53,724,724,39,40,,,1,1,0.52,,,,167,,,,,,,38.52,,1,,,,,,,,,,,,,,15,82,12.81,12.76,12.92,,,,,,,,,,,,,,,,,"0,0,11,29,27,33,0,0,0",,,,,,,128,,,,,,,,,,,,,,,,,,,,,,,,,,,,,,,,,,,,,7,11,152,92,,1013,,,1,5,3,,1,0,,,,,Einlaufen,,"Polar BEAT",,0,,0,168070,250480,30378,,,,,,,,,,,,,,,,,,,,,,,,,,,,,,,,,,,,,,,,,,,
5964627,219f77aa-bd71-42f8-a851-1c6bd7b44d64,1481892058,60,1548678731,,0,0,9.73,2601,2601,143,137,,,1,1.4,0.54,,,273,657,,,,,,,45.71,,1,,,,,,,,,,,,,,54,82,13.9,13.61,14.08,,,,,,,,,,,,,,,,,"0,4,5,6,22,57,7,0,0",,,,,,,137,,,,,,,,,,,,,,,,,,,,,,,,,,,,,,,,,,,,,6,5,119,79,,1028,1,,0,5,3,,1,0,,,,,"Aachen Laufen",,"Polar BEAT",,0,,0,168070,250480,30378,,,,,,,,,,,,,,,,,,,,,,,,,,,,,,,,,,,,,,,,,,"5,5",
5964628,b2a5415e-0305-41cf-966e-3a5e03a5869d,1402435227,120,1548678731,,0,0,2.18,748,748,15,24,,,1,0.4,0.37,,,,150,,,,,,,30.81,,1,,,,,,,,,,,,,,15,83,10.51,10.81,10.9,,,,,,,,,,,,,,,,,"12,16,25,31,15,0,0,0,0",,,,,,,105,,,,,,,,,,,,,,,,,,,,,,,,,,,,,,,,,,,,,22,2,346,73,,1021,0,,0,5,3,,1,0,,,,,Auslaufen,,"Polar BEAT",,0,,0,168070,250480,30378,,,,,,,,,,,,,,,,,,,,,,,,,,,,,,,,,,,,,,,,,,,
5964629,3a3e8a0f-a16d-49a2-b3f9-a42b4e4ce012,1398452552,120,1548678732,,0,0,7.12,2741,3763,186,201,,,1,2.1,0.43,1.5,1.12,506,341,134,157,,,,48.32,29.07,49.75,1,,,,,,,,,,,,,,46,73,9.67,13.28,14.79,19.2,,,,,,,,,,,,,,,,"33,11,15,16,11,5,4,1,2","1,68,31,0,0",,,,,,107,,,,,,,,,,,,,,,,,,,,,,,,,,,,,,,,,,,,21.3,18,7,214,69,,1010,0,,0,6,3,,1,0,,,,,"Regenerativer DL",,"Polar BEAT",,0,,0,168070,250480,30378,,,,,,,,,,,,,,,,,,,,,,,,,,,,,,,,,,,,,,,,,,4,
5964630,6605f788-3484-4816-981e-9e2e8ed80c3b,1426333833,60,1548678732,,0,0,6.51,1915,2413,122,87,,,1,1.8,0.63,,,459,441,,,,,,,39.82,,1,,,,,,,,,,,,,,39,82,12.75,12.39,13.05,,,,,,,,,,,,,,,,,"4,2,9,22,45,18,0,0,0",,,,,,,124,,,,,,,,,,,,,,,,,,,,,,,,,,,,,,,,,,,,,5,7,44,71,,1026,3,,0,5,3,,1,0,,,,,"Aachen Laufen",,"Polar BEAT",,0,,0,168070,250480,30378,,,,,,,,,,,,,,,,,,,,,,,,,,,,,,,,,,,,,,,,,,4,
5964631,36244042-4be7-4c2a-ba14-9f5b14dd930f,1396991450,120,1548678733,,0,0,2.05,621,621,24,24,,,1,0.6,0.41,1.06,1.03,,106,140,151,,,,61.54,35.35,62.43,1,,,,,,,,,,,,,,12,81,11.99,12.04,12.16,-1.2,,,,,,,,,,,,,,,,"7,2,3,24,65,0,0,0,0","0,49,51,0,0",,,,,,122,,,,,,,,,,,,,,,,,,,,,,,,,,,,,,,,,,,,16,7,9,260,74,,1023,0,,1,5,3,,1,0,,,,,Auslaufen,,"Polar BEAT",,0,,0,168070,250480,30378,,,,,,,,,,,,,,,,,,,,,,,,,,,,,,,,,,,,,,,,,,,
5964632,96d73981-795f-4a27-9bfa-606a9a22ceb1,1458993192,60,1548678733,,0,0,11.07,2700,2742,267,282,,,1,3.5,0.77,,,745,760,,,,,,,51.32,,1,,,,,,,,,,,,,,56,85,15.18,15.11,16.22,,,,,,,,,,,,,,,,,"1,0,1,1,19,42,24,11,2",,,,,,,145,,,,,,,,,,,,,,,,,,,,,,,,,,,,,,,,,,,,,12,21,179,62,,1015,,,0,5,3,,1,0,,,,,"Sundern Laufen",,"Polar BEAT",,0,,0,168070,250480,30378,,,,,,,,,,,,,,,,,,,,,,,,,,,,,,,,,,,,,,,,,,"4,5",
5964633,87cf8078-65fa-4010-b951-1901993cdc53,1505559337,120,1548678733,,0,0,4.01,791,792,58,40,,,1,0.9,0.49,1.29,1.74,,131,122,152,,,,,,,1,,,,,,,,,,,,,,10,,,21.72,,39,27,122,113,,1,139,133,,,,,,,,,"42,18,16,19,2,3,1","19,61,21,0,0","81,8,1,2,8",,,,,,,,,,,,,,,,,,,,,,,,,,,,,,,,,,,,,,,,,14.6,12,6,231,85,,1012,2,,0,3,3,,1,0,,,Cycling,,,,"Polar M430",43,0,,0,168072,,30378,,,,,,,,,,,,,,,,,,,,,,,,,,,,,,,,,,,,,,,,,,,
5964634,da3b6ee0-98cb-4ee7-aedd-149d9d7166b7,1391883602,60,1548678733,,0,0,1.14,341,342,16,17,,,1,0.1,0.29,1.01,0.98,,64,149,168,,,,57.65,33.59,58.59,1,,,,,,,,,,,,,,8,83,12.29,12.26,12.51,-10.2,,,,,,,,,,,,,,,,"7,3,1,22,67,0,0,0,0","0,8,79,13,0",,,,,,121,,,,,,,,,,,,,,,,,,,,,,,,,,,,,,,,,,,,19.1,6,23,192,85,,989,,,1,5,3,,1,0,,,,,Finnbahn,,"Polar BEAT",,0,,0,168070,250480,30378,,,,,,,,,,,,,,,,,,,,,,,,,,,,,,,,,,,,,,,,,,,
5964635,ce7c06e9-e418-4802-afec-b1cc6f9c5997,1509280722,60,1548678734,,0,0,11.02,3150,3152,33,32,,,1,0,0.04,,0.95,,752,149,163,,,,60.97,42.64,61.21,1,,,,,,,,,,,,,,77,81,12.62,12.66,12.71,5.7,,,,,,,,,,,,,,,,"0,2,4,15,60,17,1,0,0","1,10,86,3,0",,,,,,130,,,,,,,,,,,,,,,,,,,,,,,,,,,,,,,,,,,,42.6,12,7,293,77,,1015,,,0,6,3,,1,0,I1.000|5:07-I1.000|4:40-I1.000|4:40-I1.000|4:58-I1.000|4:36-I1.000|4:35-I1.000|4:44-I1.000|4:35-I1.000|4:44-I1.000|4:51-I1.000|4:52-I0.023|0:09,,Running,,,,"Polar M430",43,0,,0,168070,250480,30378,,,,,,,,,,,,,,,,,,,,,,,,,,,,,,,,,,,,,,,,,,,
5964636,91125885-21d1-47c9-b7a7-5bf4b11bf6c0,1496953764,120,1548678734,,0,0,2.7,1005,1016,45,43,,,1,0,0.15,,,,140,,,,,,,28.49,,1,,,,,,,,,,,,,,20,81,9.73,10.02,10.16,,,,,,,,,,,,,,,,,"44,11,10,14,15,5,0,0,0",,,,,,,100,,,,,,,,,,,,,,,,,,,,,,,,,,,,,,,,,,,,,22,7,228,57,,1013,0,,0,5,3,,1,0,,,,,"Aachen Laufen",,"Polar BEAT",,0,,0,168070,250480,30378,,,,,,,,,,,,,,,,,,,,,,,,,,,,,,,,,,,,,,,,,,,
5964637,d3d88442-e967-4779-8bc5-49d8521e4335,1525708773,120,1548678734,,0,0,5.29,1523,1523,31,32,,,1,0,0.15,1.12,0.9,,361,149,168,,,,60.44,40.35,60.86,1,,,,,,,,,,,,,,37,80,12.55,12.62,12.77,-1.2,,,,,,,,,,,,,,,,"2,1,4,27,49,16,1,1,1","1,8,88,3,0",,,,,,130,,,,,,,,,,,,,,,,,,,,,,,,,,,,,,,,,,,,37.2,25,21,32,30,,1012,,,0,3,3,,1,0,I1.000|5:00-I1.000|4:53-I1.000|4:51-I1.000|4:52-I1.000|4:29-I0.292|1:17,,Running,,,,"Polar M430",43,0,,0,168070,250480,30378,,,,,,,,,,,,,,,,,,,,,,,,,,,,,,,,,,,,,,,,,,,
5964638,727aaea5-5e71-4e11-b0e8-520feaf5381f,1444166265,120,1548678734,,0,0,2.29,717,717,26,29,,,1,0.7,0.47,,,,157,,,,,,,34.41,,1,,,,,,,,,,,,,,14,87,11.68,11.63,11.81,,,,,,,,,,,,,,,,,"4,3,20,38,34,3,0,0,0",,,,,,,110,,,,,,,,,,,,,,,,,,,,,,,,,,,,,,,,,,,,,16,11,167,88,,1004,,,1,5,3,,1,0,,,,,"Aachen Laufen",,"Polar BEAT",,0,,0,168070,250480,30378,,,,,,,,,,,,,,,,,,,,,,,,,,,,,,,,,,,,,,,,,,,
5964639,cee14e6f-de19-4ecb-9d58-47d17fbd20a1,1532545636,120,1548678735,,0,0,10.33,2141,2141,48,40,,,1,0,0.1,2.67,0.61,,268,105,128,,,,,,,1,,,,,,,,,,,,,,15,,,18.49,,-0.2,-39.7,81,66,,1,106,93,,,,,,,,,"11,59,29,1,0,0,0","31,69,0,0,0","86,0,11,1,1",,,,,,,,,,,,,,,,,,,,,,,,,,,,,,,,,,,,,,,,,5.3,33,7,21,29,,,1,,0,3,3,,1,0,,,Cycling,,,,"Polar M430",43,0,,0,168072,,30378,,,,,,,,,,,,,,,,,,,,,,,,,,,,,,,,,,,,,,,,,,,
5964640,1cff1f11-3319-4d8b-9190-347af92ecd3f,1406237042,120,1548678735,,0,0,2.37,814,814,1,0,,,1,0,0,,,,139,131,137,,,,57.14,31,57.2,1,,,,,,,,,,,,,,12,81,10.53,10.54,10.58,-2.3,,,,,,,,,,,,,,,,"3,15,59,23,0,0,0,0,0","0,100,0,0,0",,,,,,108,,,,,,,,,,,,,,,,,,,,,,,,,,,,,,,,,,,,11.8,18,5,99,82,,1015,0,,0,5,3,,1,0,,,,,Auslaufen,,"Polar BEAT",,0,,0,168070,250480,30378,,,,,,,,,,,,,,,,,,,,,,,,,,,,,,,,,,,,,,,,,,,
5964641,534d947a-bfb8-4e04-8ac1-5553b9d16b2d,1467404998,120,1548678737,,0,0,15.38,3393,3393,380,380,,,1,3.4,0.61,,,513,1046,,,,,,,59.04,,1,,,,,,,,,,,,,,70,85,16.8,16.43,17.39,,,,,,,,,,,,,,,,,"0,0,0,0,1,12,61,26,0",,,,,,,160,,,,,,,,,,,,,,,,,,,,,,,,,,,,,,,,,,,,,20,16,202,66,,1014,,,0,3,3,,1,0,,,,,"Sundern Laufen",,"Polar BEAT",,0,,0,168070,250480,30378,,,,,,,,,,,,,,,,,,,,,,,,,,,,,,,,,,,,,,,,,,"4,5,5,5,5,5",
5964642,ee9cde36-23c8-4bb0-a7c6-66adf0098fc8,1484943218,60,1548678738,,0,0,12.96,3867,3891,190,198,,,1,2.2,0.66,,,382,892,,,,,,,41.05,,1,,,,,,,,,,,,,,80,79,12.27,12.14,12.47,,,,,,,,,,,,,,,,,"1,3,6,33,54,4,0,0,0",,,,,,,127,,,,,,,,,,,,,,,,,,,,,,,,,,,,,,,,,,,,,-1,3,85,73,,1033,0,,1,5,3,,1,0,,,,,Laufen,,"Polar BEAT",,0,,0,168070,250480,30378,,,,,,,,,,,,,,,,,,,,,,,,,,,,,,,,,,,,,,,,,,4,
5964643,e66b12ca-28d3-4076-82ce-7fe370c6471b,1408704546,120,1548678739,,0,0,17.01,5434,5690,322,321,,,1,3.4,0.62,,,428,1130,,,,,,,38.74,,1,,,,,,,,,,,,,,112,82,11.65,11.84,12.64,,,,,,,,,,,,,,,,,"15,10,13,22,24,13,2,0,1",,,,,,,115,,,,,,,,,,,,,,,,,,,,,,,,,,,,,,,,,,,,,15,9,208,68,,1013,3,,0,5,3,,1,0,,,,,"Langsamer DL",,"Polar BEAT",,0,,0,168070,250480,30378,,,,,,,,,,,,,,,,,,,,,,,,,,,,,,,,,,,,,,,,,,"4,4,5,5",
5964644,0a0fdbab-5ea0-4699-93ea-7a57cf859a3e,1468759080,120,1548678739,,0,0,31.24,4908,5050,552,550,,,1,3.7,0.44,,,798,1205,,,,,,,,,1,,,,,,,,,,,,,,54,,,28.82,,,,190,148,,1,288,238,,,,,,,,,"27,17,18,13,9,7,8",,"50,22,10,10,7",,,,,,,,,,,,,,,,,,,,,,,,,,,,,,,,,,,,,,,,,,21,7,256,86,,,5,,0,5,3,,1,0,,,,,"Balve Radfahren",,"Polar BEAT",,0,,0,168072,,30378,,,,,,,,,,,,,,,,,,,,,,,,,,,,,,,,,,,,,,,,,,"3,4,4",
5964645,588d4ad1-d19f-4027-a193-2172dc61c193,1505849171,120,1548678740,,0,0,2.78,623,625,32,41,,,1,0.4,0.37,1.15,1.59,,46,90,110,,,,,,,1,,,,,,,,,,,,,,2,,,23,,36.4,-23.2,126,96,,1,144,124,,,,,,,,,"46,24,6,11,6,7,1","87,13,0,0,0","79,8,4,3,6",,,,,,,,,,,,,,,,,,,,,,,,,,,,,,,,,,,,,,,,,1.3,11,2,285,87,,1021,,,0,5,3,,1,0,,,Cycling,,,,"Polar M430",43,0,,0,168072,,30378,,,,,,,,,,,,,,,,,,,,,,,,,,,,,,,,,,,,,,,,,,,
5964646,8353c3df-2220-4c05-ab62-7bb62df283d6,1348062132,120,1548678741,,0,0,30.13,3617,3619,718,716,,,1,4.6,0.65,1.27,0.72,1093,1258,142,167,,,,,,,1,,,,,,,,,,,,,,75,,,31.88,,-10.8,-28.6,374,260,,1,485,364,,,,,,,,,"2,7,17,13,44,10,7","1,42,48,10,0","47,15,9,6,23",,,,,,,,,,,,,,,,,,,,,,,,,,,,,,,,,,,,,,,,,37.2,12,13,263,71,,1019,4,,0,5,3,,1,0,,,,,,,"Polar BEAT",,0,,0,168072,,30378,,,,,,,,,,,,,,,,,,,,,,,,,,,,,,,,,,,,,,,,,,"4,4,4,5,5,5,5,5,5,5,5",
5964647,140c659f-142a-4b6e-be57-e887e909b006,1409487230,120,1548678741,,0,0,2.9,857,857,25,26,,,1,0,0.21,,,,192,,,,,,,37.56,,1,,,,,,,,,,,,,,17,81,12.34,12.4,12.58,,,,,,,,,,,,,,,,,"4,2,7,22,47,18,0,0,0",,,,,,,125,,,,,,,,,,,,,,,,,,,,,,,,,,,,,,,,,,,,,15,6,225,79,,,4,,0,5,3,,1,0,,,,,Einlaufen,,"Polar BEAT",,0,,0,168070,250480,30378,,,,,,,,,,,,,,,,,,,,,,,,,,,,,,,,,,,,,,,,,,,
5964648,4a3a4698-b821-4558-b66f-a3894fa95a01,1464724657,120,1548678742,,0,0,5.14,1435,1467,73,62,,,1,1.1,0.55,,,,355,,,,,,,41.77,,1,,,,,,,,,,,,,,29,81,13.18,13.26,13.71,,,,,,,,,,,,,,,,,"10,3,2,7,22,41,14,1,0",,,,,,,133,,,,,,,,,,,,,,,,,,,,,,,,,,,,,,,,,,,,,18,1,107,79,,1012,0,,0,5,3,,1,0,,,,,"Aachen Laufen",,"Polar BEAT",,0,,0,168070,250480,30378,,,,,,,,,,,,,,,,,,,,,,,,,,,,,,,,,,,,,,,,,,,
5964649,5533e057-7638-4431-a7c5-5ef55fd7172f,1394566642,60,1548678742,,0,0,8.34,2173,2214,97,97,,,1,0,0.03,0.59,0.56,,438,159,179,,,,62.49,46.64,63.39,1,,,,,,,,,,,,,,71,84,13.94,15.64,15.71,16.4,,,,,,,,,,,,,,,,"25,1,1,1,2,2,22,46,0","0,21,15,64,0",,,,,,137,,,,,,,,,,,,,,,,,,,,,,,,,,,,,,,,,,,,73.1,9,10,36,76,,1031,,,1,3,3,,1,0,,,,,"2x 2000m + 4x 1000m",,"Polar BEAT",,0,,0,168070,250480,30378,,,,,,,,,,,,,,,,,,,,,,,,,,,,,,,,,,,,,,,,,,,
5964650,a050079a-b89b-4a63-bf25-e98d674fdcae,1411677516,120,1548678742,,0,0,7.37,2131,2187,0,1,,,1,0,0.06,0.38,,,419,159,186,,,,54.95,40.95,54.94,1,,,,,,,,,,,,,,72,81,12.62,14.88,14.9,12.8,,,,,,,,,,,,,,,,"32,5,2,3,6,7,8,33,3","0,24,15,45,17",,,,,,128,,,,,,,,,,,,,,,,,,,,,,,,,,,,,,,,,,,,87.9,13,6,238,79,,1022,0,,1,5,3,,1,0,,,,,"3x (500,300,500,300,200) ",,"Polar BEAT",,0,,0,168070,250480,30378,,,,,,,,,,,,,,,,,,,,,,,,,,,,,,,,,,,,,,,,,,,
5964651,c0bfac59-0d81-4475-ab6c-61d015951e2b,1502996542,120,1548678742,,0,0,1.51,533,534,8,60,,,1,0.6,0.47,1.02,1.01,,106,134,154,,,,53.77,28.73,51.85,1,,,,,,,,,,,,,,9,81,9.82,10.23,9.94,-4.1,,,,,,,,,,,,,,,,"17,22,36,16,9,0,0,0,0","5,67,28,0,0",,,,,,105,,,,,,,,,,,,,,,,,,,,,,,,,,,,,,,,,,,,14.6,20,21,210,82,,1015,,,0,5,1,,1,0,I1.000|6:08-I0.517|2:46,,Running,,,,"Polar M430",43,0,,0,168070,250480,30378,,,,,,,,,,,,,,,,,,,,,,,,,,,,,,,,,,,,,,,,,,,
5964652,d2afe314-c540-4940-a756-eb01a836d17a,1470951062,120,1548678743,,0,0,14.02,3855,3931,69,70,,,1,0,0.19,,,,961,,,,,,,45.42,,1,,,,,,,,,,,,,,80,80,13.16,13.36,13.46,,,,,,,,,,,,,,,,,"2,3,11,8,15,54,7,0,0",,,,,,,136,,,,,,,,,,,,,,,,,,,,,,,,,,,,,,,,,,,,,19,7,307,74,,,0,,1,3,3,,1,0,,,,,"Naujac-sur-Mer Laufen",,"Polar BEAT",,0,,0,168070,250480,30378,,,,,,,,,,,,,,,,,,,,,,,,,,,,,,,,,,,,,,,,,,,
5964653,395813c3-810c-4446-a984-58b64d82a182,1423916097,60,1548678743,,0,0,4.99,978,978,25,25,,,1,0,0.2,,,,338,,,,,,,63.04,,1,,,,,,,,,,,,,,20,90,18.41,18.4,18.51,,,,,,,,,,,,,,,,,"0,0,0,0,0,0,10,87,3",,,,,,,170,,,,,,,,,,,,,,,,,,,,,,,,,,,,,,,,,,,,,9,7,136,73,,,1,,0,5,3,,1,0,,,,,"WK 5k Mönchengladbach Hardt",,"Polar BEAT",,0,,0,168070,250480,30378,,,,,,,,,,,,,,,,,,,,,,,,,,,,,,,,,,,,,,,,,,,
5964654,7f15a3b4-8b45-403b-94e4-bd1a53f1a1a4,1542371420,60,1548678745,,0,0,16.95,13340,13447,858,855,,,1,7.3,0.77,,,387,1833,105,133,,,,,,,1,,,,,,,,,,,,,,97,,,5.11,,6.1,,,,,,,,,,,,,,,,"56,44,0,0,0,0","33,67,0,0,0",,,,,,,,,,,,,,,,,,,,,,,,,,,,,,,,,,,,,,,,,,7.6,6,0,,92,,,1,,0,5,3,,1,0,I1.000|11:21-I1.000|11:19-I1.000|10:51-I1.000|13:31-I1.000|11:53-I1.000|12:22-I1.000|17:00-I1.000|14:31-I1.000|12:50-I1.000|13:09-I1.000|12:45-I1.000|14:05-I1.000|11:34-I1.000|11:57-I1.000|13:15-I1.000|10:40-I1.000|21:05,,Hiking,,,,"Polar M430",43,0,,0,168075,,30378,,,,,,,,,,,,,,,,,,,,,,,,,,,,,,,,,,,,,,,,,,"1,2,4,4,4",
5964655,26f9ef48-6c66-41c9-b378-d171df62f160,1415652607,60,1548678746,,0,0,3.77,1280,1971,57,36,,,1,0.8,0.41,,,,252,,,,,,,32.51,,1,,,,,,,,,,,,,,26,80,10.98,10.9,11.34,,,,,,,,,,,,,,,,,"22,10,18,34,16,1,0,0,0",,,,,,,110,,,,,,,,,,,,,,,,,,,,,,,,,,,,,,,,,,,,,7,3,163,89,,1011,0,,1,3,3,,1,0,,,,,Einlaufen,,"Polar BEAT",,0,,0,168070,250480,30378,,,,,,,,,,,,,,,,,,,,,,,,,,,,,,,,,,,,,,,,,,,
5964656,76f878bb-2540-433e-affd-c51ba8e544d7,1423162055,60,1548678746,,0,0,14.46,4252,5219,144,147,,,1,0.9,0.45,,,,947,,,,,,,42.12,,1,,,,,,,,,,,,,,88,82,12.41,13.4,13.58,,,,,,,,,,,,,,,,,"16,5,11,13,18,16,6,13,2",,,,,,,124,,,,,,,,,,,,,,,,,,,,,,,,,,,,,,,,,,,,,-2,16,40,78,,1024,,,1,5,3,,1,0,,,,,"6x Hoch Runter",,"Polar BEAT",,0,,0,168070,250480,30378,,,,,,,,,,,,,,,,,,,,,,,,,,,,,,,,,,,,,,,,,,,
5964657,a384bb19-4c0f-4afe-aa72-a1348d5d78b9,1482964378,60,1548678747,,0,0,1.91,780,829,19,20,,,1,1,0.58,,,,127,,,,,,,24.8,,1,,,,,,,,,,,,,,16,79,8.9,9.41,9.62,,,,,,,,,,,,,,,,,"48,22,13,12,4,0,0,0,0",,,,,,,93,,,,,,,,,,,,,,,,,,,,,,,,,,,,,,,,,,,,,-1,2,140,92,,1044,0,,1,5,3,,1,0,,,,,"Aachen Laufen",,"Polar BEAT",,0,,0,168070,250480,30378,,,,,,,,,,,,,,,,,,,,,,,,,,,,,,,,,,,,,,,,,,,
5964658,72d7dcd1-85c6-4896-945a-0823026049af,1480115610,60,1548678747,,0,0,1.91,666,947,30,30,,,1,1,0.47,,,,137,,,,,,,29.86,,1,,,,,,,,,,,,,,13,79,10.71,10.79,10.96,,,,,,,,,,,,,,,,,"24,17,18,26,6,2,6,1,0",,,,,,,109,,,,,,,,,,,,,,,,,,,,,,,,,,,,,,,,,,,,,4,3,93,90,,1020,0,,1,4,3,,1,0,,,,,"Aachen Laufen",,"Polar BEAT",,0,,0,168070,250480,30378,,,,,,,,,,,,,,,,,,,,,,,,,,,,,,,,,,,,,,,,,,,
5964659,2aba3ba0-595a-4b92-880f-de644399996c,1461181975,120,1548678747,,0,0,5.07,1418,3789,101,102,,,1,1.5,0.52,,,,347,,,,,,,41.65,,1,,,,,,,,,,,,,,29,81,13.28,13.25,13.81,,,,,,,,,,,,,,,,,"8,2,2,6,23,55,4,0,0",,,,,,,132,,,,,,,,,,,,,,,,,,,,,,,,,,,,,,,,,,,,,13,8,59,46,,1027,0,,0,3,3,,1,0,,,,,"Aachen Laufen",,"Polar BEAT",,0,,0,168070,250480,30378,,,,,,,,,,,,,,,,,,,,,,,,,,,,,,,,,,,,,,,,,,,
5964660,ee5b6571-6c73-4b56-80e0-b7a978e4947c,1463081689,120,1548678748,,0,0,18,5419,6706,222,231,,,1,2.3,0.46,,,640,1233,,,,,,,41.7,,1,,,,,,,,,,,,,,112,80,12.15,12.81,13.17,,,,,,,,,,,,,,,,,"13,2,5,9,27,39,6,0,0",,,,,,,125,,,,,,,,,,,,,,,,,,,,,,,,,,,,,,,,,,,,,22,3,99,51,,998,0,,0,5,3,,1,0,,,,,"Aachen Laufen",,"Polar BEAT",,0,,0,168070,250480,30378,,,,,,,,,,,,,,,,,,,,,,,,,,,,,,,,,,,,,,,,,,"4,5",
5964661,9282f2d4-6b3d-438d-b319-7d9881e6ba7b,1459283599,120,1548678749,,0,0,8.64,2415,2484,0,0,,,1,0,0,,,,554,,,,,,,43.04,,1,,,,,,,,,,,,,,50,79,12.84,15.13,15.19,,,,,,,,,,,,,,,,,"29,1,1,2,2,2,31,32,0",,,,,,,136,,,,,,,,,,,,,,,,,,,,,,,,,,,,,,,,,,,,,8,3,200,75,,1010,0,,1,5,3,,1,0,,,,,"Aachen Laufen",,"Polar BEAT",,0,,0,168070,250480,30378,,,,,,,,,,,,,,,,,,,,,,,,,,,,,,,,,,,,,,,,,,,
5964662,7bedc440-27cc-48aa-b6ff-0aaafdf22aa7,1541924831,60,1548678749,,0,0,13.68,4264,4264,64,64,,,1,0,0.16,1.13,0.93,,991,144,163,,,,57.31,39.18,57.64,1,,,,,,,,,,,,,,91,83,11.59,11.58,11.67,-2.1,,,,,,,,,,,,,,,,"1,1,9,70,18,0,0,0,0","0,19,80,1,0",,,,,,116,,,,,,,,,,,,,,,,,,,,,,,,,,,,,,,,,,,,33.3,11,11,196,92,,1012,0,282,0,6,3,,1,0,I1.000|5:25-I1.000|5:13-I1.000|5:06-I1.000|5:10-I1.000|5:09-I1.000|5:03-I1.000|5:05-I1.000|5:18-I1.000|5:10-I1.000|5:10-I1.000|5:16-I1.000|5:22-I1.000|5:04-I0.687|3:33,,Running,,,,"Polar M430",43,0,,0,168070,250480,30378,,,,,,,,,,,,,,,,,,,,,,,,,,,,,,,,,,,,,,,,,,,
5964663,5d85ed87-36fd-4ae2-b917-2846eeea742f,1472913229,120,1548678750,,0,0,4.19,1298,1321,45,61,,,1,0.7,0.47,,,,281,,,,,,,36.49,,1,,,,,,,,,,,,,,26,81,11.74,12.09,12.16,,,,,,,,,,,,,,,,,"13,2,7,27,28,19,3,1,0",,,,,,,120,,,,,,,,,,,,,,,,,,,,,,,,,,,,,,,,,,,,,23,5,242,58,,1017,4,,0,5,3,,1,0,,,,,"Aachen Laufen",,"Polar BEAT",,0,,0,168070,250480,30378,,,,,,,,,,,,,,,,,,,,,,,,,,,,,,,,,,,,,,,,,,,
5964664,edfb5d50-1ba8-4927-917d-e4f56002feaa,1444163552,120,1548678750,,0,0,8.62,2363,2548,0,1,,,1,0,0,,,,539,,,,,,,44.03,,1,,,,,,,,,,,,,,49,82,13.17,14.44,14.48,,,,,,,,,,,,,,,,,"19,1,1,1,1,23,50,4,0",,,,,,,133,,,,,,,,,,,,,,,,,,,,,,,,,,,,,,,,,,,,,16,10,161,88,,1003,,,1,5,3,,1,0,,,,,"Aachen Laufen",,"Polar BEAT",,0,,0,168070,250480,30378,,,,,,,,,,,,,,,,,,,,,,,,,,,,,,,,,,,,,,,,,,,
5964665,79006dd0-c788-4df4-afa3-de4dcc644d01,1400529994,120,1548678750,,0,0,1.83,515,539,36,38,,,1,1.1,0.89,,,,103,,,,,,,37.97,,1,,,,,,,,,,,,,,10,70,13.08,16.1,16.43,,,,,,,,,,,,,,,,,"39,0,1,1,1,2,2,48,7",,,,,,,152,,,,,,,,,,,,,,,,,,,,,,,,,,,,,,,,,,,,,24,5,184,39,,1006,0,,0,5,3,,1,0,,,,,"2x 800m",,"Polar BEAT",,0,,0,168070,250480,30378,,,,,,,,,,,,,,,,,,,,,,,,,,,,,,,,,,,,,,,,,,,
5964666,25b01fac-8ee3-4d8a-a184-7e5d462a362a,1438632281,120,1548678752,,0,0,10.01,2330,2330,115,119,,,1,1.2,0.44,,,,672,,,,,,,53.84,,1,,,,,,,,,,,,,,48,83,15.65,15.54,15.79,,,,,,,,,,,,,,,,,"0,0,0,0,1,36,56,7,0",,,,,,,155,,,,,,,,,,,,,,,,,,,,,,,,,,,,,,,,,,,,,28,4,229,38,,1012,,,0,3,3,,1,0,,,,,"Aachen Laufen",,"Polar BEAT",,0,,0,168070,250480,30378,,,,,,,,,,,,,,,,,,,,,,,,,,,,,,,,,,,,,,,,,,,
5964667,0c60cb79-ab23-40a9-891e-ca0a80e18c21,1410291882,120,1548678753,,0,0,3.14,877,1003,54,21,,,1,1.1,0.62,,,,210,,,,,,,40.36,,1,,,,,,,,,,,,,,18,81,13.48,13.11,13.74,,,,,,,,,,,,,,,,,"5,1,3,15,27,45,4,0,0",,,,,,,133,,,,,,,,,,,,,,,,,,,,,,,,,,,,,,,,,,,,,16,4,6,78,,1020,0,,0,5,3,,1,0,,,,,Einlaufen,,"Polar BEAT",,0,,0,168070,250480,30378,,,,,,,,,,,,,,,,,,,,,,,,,,,,,,,,,,,,,,,,,,,
5964668,,1540644885,120,1548678753,,0,0,17.56,4651,4651,,,,,0,,,,,,882,,,,,,,48.28,,1,,,,,,,,,,,,,,96,,,,,,,,,,,,,,,,,,,,,,,,,,,,,,,,,,,,,,,,,,,,,,,,,,,,,,,,,,,,,,,,,,,,,,,,,,1,,,0,0,,,Running,,,,"Polar M430",43,0,,0,168070,250480,30378,,,,,,,,,,,,,,,,,,,,,,,,,,,,,,,,,,,,,,,,,,,
5964669,2890c978-040c-46b6-bf82-bd0c09d99afa,1547019675,60,1548678753,,0,0,7.89,2381,2382,32,32,,,1,0,0.13,1.08,0.9,,531,141,166,,,,61.27,39.1,61.58,1,,,,,,,,,,,,,,49,82,11.97,11.95,12.07,14.4,,,,,,,,,,,,,,,,"1,1,2,53,43,0,0,0,0","1,45,51,4,0",,,,,,121,,,,,,,,,,,,,,,,,,,,,,,,,,,,,,,,,,,,40.1,3,9,280,89,,1015,0,421,1,6,3,,1,0,I1.000|4:51-I1.000|5:01-I1.000|5:01-I1.000|5:10-I1.000|5:04-I1.000|5:04-I1.000|5:08-I0.887|4:25,,Running,,,,"Polar M430",43,0,,0,168070,250480,30378,,,,,,,,,,,,,,,,,,,,,,,,,,,,,,,,,,,,,,,,,,,
5964670,5abf0507-b280-4600-8616-2b082cf21cd4,1495490852,120,1548678753,,0,0,1.09,384,425,24,4,,,1,0.7,0.44,,,,74,,,,,,,27.75,,1,,,,,,,,,,,,,,7,80,10.93,10.49,11.4,,,,,,,,,,,,,,,,,"31,17,14,26,13,0,0,0,0",,,,,,,106,,,,,,,,,,,,,,,,,,,,,,,,,,,,,,,,,,,,,19,2,119,57,,1016,0,,1,5,3,,1,0,,,,,"Aachen Laufen",,"Polar BEAT",,0,,0,168070,250480,30378,,,,,,,,,,,,,,,,,,,,,,,,,,,,,,,,,,,,,,,,,,,
5964671,9ded7043-e562-4ab3-abb3-9fc88bea8136,1458158660,60,1548678754,,0,0,12.63,3367,3367,177,174,,,1,2.2,0.58,,,423,875,,,,,,,46.71,,1,,,,,,,,,,,,,,69,83,13.78,13.64,13.99,,,,,,,,,,,,,,,,,"1,1,2,4,35,46,10,0,0",,,,,,,136,,,,,,,,,,,,,,,,,,,,,,,,,,,,,,,,,,,,,4,15,61,63,,1028,,,1,3,3,,1,0,,,,,"Aachen Laufen",,"Polar BEAT",,0,,0,168070,250480,30378,,,,,,,,,,,,,,,,,,,,,,,,,,,,,,,,,,,,,,,,,,4,
5964672,e1152dc3-524a-4353-8cdf-72b0103bb589,1500926674,120,1548678754,,0,0,13,3396,3402,184,189,,,1,2.2,0.6,,,376,889,,,,,,,47.93,,1,,,,,,,,,,,,,,70,81,14.03,13.86,14.25,,,,,,,,,,,,,,,,,"0,0,1,4,25,60,10,0,0",,,,,,,142,,,,,,,,,,,,,,,,,,,,,,,,,,,,,,,,,,,,,15,4,268,86,,1011,0,,0,5,3,,1,0,,,,,"Aachen Laufen",,"Polar BEAT",,0,,0,168070,250480,30378,,,,,,,,,,,,,,,,,,,,,,,,,,,,,,,,,,,,,,,,,,4,
5964673,de581fb0-006f-489c-a2d0-950997545da5,1480017615,60,1548678755,,0,0,1.8,700,890,35,33,,,1,0.6,0.44,,,2363,125,,,,,,,26.14,,1,,,,,,,,,,,,,,14,78,9.26,9.71,9.77,,,,,,,,,,,,,,,,,"26,39,21,14,0,0,0,0,0",,,,,,,99,,,,,,,,,,,,,,,,,,,,,,,,,,,,,,,,,,,,,6,9,53,93,,1020,0,,1,5,3,,1,0,,,,,"Aachen Laufen",,"Polar BEAT",,0,,0,168070,250480,30378,,,,,,,,,,,,,,,,,,,,,,,,,,,,,,,,,,,,,,,,,,5,
5964674,f1dcae91-9e69-43b0-adab-812e15bfb8ce,1419857763,60,1548678756,,0,0,11.58,3383,3717,334,335,,,1,4.1,0.7,,,637,778,,,,,,,41.72,,1,,,,,,,,,,,,,,70,83,13.13,12.55,13.82,,,,,,,,,,,,,,,,,"1,6,11,26,25,29,2,0,0",,,,,,,124,,,,,,,,,,,,,,,,,,,,,,,,,,,,,,,,,,,,,1,7,338,92,,,0,,0,5,3,,1,0,,,,,"Langsamer DL",,"Polar BEAT",,0,,0,168070,250480,30378,,,,,,,,,,,,,,,,,,,,,,,,,,,,,,,,,,,,,,,,,,3,
5964675,074fffff-2bab-4c2c-9dca-cf00f0e70e59,1483369035,60,1548678756,,0,0,0.66,213,213,13,4,,,1,0.5,0.39,,,,47,,,,,,,29.06,,1,,,,,,,,,,,,,,4,81,11.72,11.31,12.08,,,,,,,,,,,,,,,,,"16,5,8,51,8,11,0,0,0",,,,,,,115,,,,,,,,,,,,,,,,,,,,,,,,,,,,,,,,,,,,,1,7,272,95,,1025,0,,0,7,3,,1,0,,,,,"Aachen Laufen",,"Polar BEAT",,0,,0,168070,250480,30378,,,,,,,,,,,,,,,,,,,,,,,,,,,,,,,,,,,,,,,,,,,
5964676,61ccab1e-02c0-4a3e-abf3-dabcef5bf73d,1525004152,120,1548678756,,0,0,3.59,1201,1201,18,16,,,1,0,0.06,1.03,0.77,,207,123,148,,,,63.42,32.99,63.86,1,,,,,,,,,,,,,,15,80,10.82,10.9,11.03,4.1,,,,,,,,,,,,,,,,"10,16,24,33,16,0,0,0,0","4,68,28,0,0",,,,,,112,,,,,,,,,,,,,,,,,,,,,,,,,,,,,,,,,,,,15.3,22,11,69,55,,1006,,,0,3,3,,1,0,I1.000|5:49-I1.000|5:25-I1.000|5:37-I0.600|3:11,,Running,,,,"Polar M430",43,0,,0,168070,250480,30378,,,,,,,,,,,,,,,,,,,,,,,,,,,,,,,,,,,,,,,,,,,
5964677,15f6fa0c-abd9-4e53-a4fb-5d50747db7c5,1396108869,60,1548678756,,0,0,4.96,1023,1024,1,0,,,1,0,0,,,,333,,,,,,,59.39,,1,,,,,,,,,,,,,,21,88,17.46,17.48,17.49,,,,,,,,,,,,,,,,,"0,0,0,0,0,0,28,72,0",,,,,,,165,,,,,,,,,,,,,,,,,,,,,,,,,,,,,,,,,,,,,19,8,101,37,,1017,2,,0,5,3,,1,0,,,,,"WK 10.000m (nach 5.000m DNF)",,"Polar BEAT",,0,,0,168070,250480,30378,,,,,,,,,,,,,,,,,,,,,,,,,,,,,,,,,,,,,,,,,,,
5964678,0cf373f0-57bb-4522-b756-f7de6355de01,1473795710,120,1548678757,,0,0,4.32,1269,1297,57,39,,,1,0.9,0.51,,,,292,,,,,,,38.93,,1,,,,,,,,,,,,,,26,81,12.6,12.46,12.96,,,,,,,,,,,,,,,,,"7,3,7,14,36,33,1,0,0",,,,,,,126,,,,,,,,,,,,,,,,,,,,,,,,,,,,,,,,,,,,,28,2,101,51,,1012,0,,0,3,3,,1,0,,,,,"Aachen Laufen",,"Polar BEAT",,0,,0,168070,250480,30378,,,,,,,,,,,,,,,,,,,,,,,,,,,,,,,,,,,,,,,,,,,
5964679,57bda910-f032-427c-93fd-d0ab51bde1d6,1393498194,60,1548678757,,0,0,4.43,1371,1512,42,30,,,1,0.1,0.23,1.28,1.08,,256,151,174,,,,54.29,36.66,55.11,1,,,,,,,,,,,,,,36,81,11.78,12.38,12.78,2.5,,,,,,,,,,,,,,,,"16,2,3,11,42,27,0,0,0","0,11,62,27,0",,,,,,120,,,,,,,,,,,,,,,,,,,,,,,,,,,,,,,,,,,,42.9,6,21,182,78,,1015,,,0,5,3,,1,0,,,,,"Einlaufen ",,"Polar BEAT",,0,,0,168070,250480,30378,,,,,,,,,,,,,,,,,,,,,,,,,,,,,,,,,,,,,,,,,,,
5964680,96b974ac-e6a7-41ef-bf5e-5d991fdb10a1,1366063213,120,1548678758,,0,0,2.1,3310,3377,47,17,,,1,1.3,0.48,,,46,143,,,,,,,,,1,,,,,,,,,,,,,,68,,2.33,7.82,8.29,,,,,,,,,,,,,,,,,"83,1,4,6,3,2,1,1,0",,,,,,,,,,,,,,,,,,,,,,,,,,,,,,,,,,,,,,,,,,,,12,0,101,85,,1021,0,,1,5,3,,1,0,,,,,,,"Polar BEAT",,0,,0,168070,250480,30378,,,,,,,,,,,,,,,,,,,,,,,,,,,,,,,,,,,,,,,,,,5,
5964681,2bac8e0d-befe-490e-a8e2-65a5e0125f29,1394885557,60,1548678759,,0,0,8.4,2988,6120,117,151,,,1,1.7,0.57,1.29,1,437,510,140,179,,,,50.47,32.32,51.09,1,,,,,,,,,,,,,,61,79,10.23,11,11.42,-21.4,,,,,,,,,,,,,,,,"23,6,15,30,20,3,1,1,0","0,45,48,7,0",,,,,,107,,,,,,,,,,,,,,,,,,,,,,,,,,,,,,,,,,,,41.1,8,10,308,82,,1024,3,,0,5,3,,1,0,,,,,"Lauf ABC + Auslaufen",,"Polar BEAT",,0,,0,168070,250480,30378,,,,,,,,,,,,,,,,,,,,,,,,,,,,,,,,,,,,,,,,,,4,
5964682,fad15295-15f4-4a33-a891-a759557ff477,1472766911,120,1548678759,,0,0,5.19,1795,1847,85,73,,,1,1.2,0.43,,,,353,,,,,,,32.41,,1,,,,,,,,,,,,,,37,79,10.76,11.6,12.01,,,,,,,,,,,,,,,,,"16,5,16,19,28,16,0,0,0",,,,,,,110,,,,,,,,,,,,,,,,,,,,,,,,,,,,,,,,,,,,,17,1,294,82,,1024,0,,1,5,3,,1,0,,,,,"Aachen Laufen",,"Polar BEAT",,0,,0,168070,250480,30378,,,,,,,,,,,,,,,,,,,,,,,,,,,,,,,,,,,,,,,,,,,
5964683,5ce9f88d-5b47-49ed-9911-a3f90ffd6268,1406668622,120,1548678759,,0,0,2.24,741,754,22,28,,,1,0.1,0.28,,,,152,,,,,,,32.22,,1,,,,,,,,,,,,,,15,82,10.94,11.02,11.16,,,,,,,,,,,,,,,,,"9,14,20,49,8,0,0,0,0",,,,,,,111,,,,,,,,,,,,,,,,,,,,,,,,,,,,,,,,,,,,,19,5,293,99,,1011,0,,0,5,3,,1,0,,,,,Auslaufen,,"Polar BEAT",,0,,0,168070,250480,30378,,,,,,,,,,,,,,,,,,,,,,,,,,,,,,,,,,,,,,,,,,,
5964684,554acaa5-192d-4b67-b8b3-47e2f076bdc7,1456428322,60,1548678760,,0,0,12.35,3687,4075,145,145,,,1,1.2,0.43,,,568,858,,,,,,,40.87,,1,,,,,,,,,,,,,,76,82,12.26,12.24,12.51,,,,,,,,,,,,,,,,,"4,2,7,27,51,8,0,0,0",,,,,,,123,,,,,,,,,,,,,,,,,,,,,,,,,,,,,,,,,,,,,1,7,233,90,,1016,,,1,5,3,,1,0,,,,,"Aachen Laufen",,"Polar BEAT",,0,,0,168070,250480,30378,,,,,,,,,,,,,,,,,,,,,,,,,,,,,,,,,,,,,,,,,,5,
5964685,1869dddf-5b4f-42f8-8cb7-692b6aecc40a,1480853082,60,1548678760,,0,0,18.42,4253,4253,191,272,,,1,1.4,0.4,,,513,1232,,,,,,,56.79,,1,,,,,,,,,,,,,,88,84,15.69,15.72,15.81,,,,,,,,,,,,,,,,,"0,0,0,1,5,21,60,12,0",,,,,,,155,,,,,,,,,,,,,,,,,,,,,,,,,,,,,,,,,,,,,3,14,115,57,,1026,,,0,3,3,,1,0,,,,,"Stolberg (Rheinland) Laufen",,"Polar BEAT",,0,,0,168070,250480,30378,,,,,,,,,,,,,,,,,,,,,,,,18,4253,,,0,"54. Aachener Winterlauf",,,,,,,0,0,30378,5964685,995,,5,
5964686,3c18d316-c2da-46ea-b405-631a06b9a40f,1465935129,120,1548678761,,0,0,12.48,3847,4859,46,44,,,1,0,0.15,,,,797,,,,,,,39.41,,1,,,,,,,,,,,,,,79,77,11.77,13.63,13.72,,,,,,,,,,,,,,,,,"28,2,4,14,14,7,8,18,4",,,,,,,126,,,,,,,,,,,,,,,,,,,,,,,,,,,,,,,,,,,,,15,4,246,84,,1000,0,,0,6,3,,1,0,,,,,"Aachen Laufen",,"Polar BEAT",,0,,0,168070,250480,30378,,,,,,,,,,,,,,,,,,,,,,,,,,,,,,,,,,,,,,,,,,,
5964687,3fb1a726-b096-4330-8bbc-4c4aa79e728f,1421955253,60,1548678762,,0,0,5.54,1446,1448,47,50,,,1,0,0.01,,,,328,,,,,,,45.42,,1,,,,,,,,,,,,,,30,87,13.83,15.18,15.18,,,,,,,,,,,,,,,,,"19,12,10,4,5,5,9,24,12",,,,,,,132,,,,,,,,,,,,,,,,,,,,,,,,,,,,,,,,,,,,,-1,5,9,92,,1021,0,,1,4,3,,1,0,,,,,"5x 500/200",,"Polar BEAT",,0,,0,168070,250480,30378,,,,,,,,,,,,,,,,,,,,,,,,,,,,,,,,,,,,,,,,,,,
5964688,f5382d7f-681b-4da0-a883-6f29fcfc8d72,1535652403,120,1548678762,,0,0,8.77,2694,2694,28,29,,,1,0,0.07,1.29,0.92,,614,143,164,,,,58.88,38.56,59.1,1,,,,,,,,,,,,,,60,80,11.73,13.04,13.13,27.3,,,,,,,,,,,,,,,,"14,0,0,3,29,53,1,0,0","2,28,62,9,0",,,,,,122,,,,,,,,,,,,,,,,,,,,,,,,,,,,,,,,,,,,46.2,19,5,98,73,,1020,,,0,5,3,,1,0,I1.000|4:32-I1.000|4:29-I1.000|4:28-I1.000|4:29-I1.000|4:19-I1.000|4:22-I1.000|4:22-I1.000|4:21-I0.766|9:33,,Running,,,,"Polar M430",43,0,,0,168070,250480,30378,,,,,,,,,,,,,,,,,,,,,,,,,,,,,,,,,,,,,,,,,,,
5964689,87a798bf-2f81-4169-b896-e538710161e7,1393066366,60,1548678763,,0,0,13.46,5533,5582,269,179,,,1,2.8,0.52,1.98,1.72,407,707,143,169,,,,41.09,28.22,42.45,1,,,,,,,,,,,,,,119,80,9.07,11.21,11.92,41.7,,,,,,,,,,,,,,,,"31,2,8,21,24,12,1,0,0","1,25,67,7,0",,,,,,91,,,,,,,,,,,,,,,,,,,,,,,,,,,,,,,,,,,,38,4,19,209,88,,1013,,,0,5,3,,1,0,,,,,"Lockerer DL mit Lauf ABC",,"Polar BEAT",,0,,0,168070,250480,30378,,,,,,,,,,,,,,,,,,,,,,,,,,,,,,,,,,,,,,,,,,"4,5",
5964690,ebaf6715-6436-43cc-9314-00e9f4ecaa55,1513367681,60,1548678766,,0,0,13.11,4035,4038,181,199,,,1,2.1,0.57,1.04,1.05,357,813,135,158,,,,63.12,39.63,64.09,1,,,,,,,,,,,,,,69,82,11.91,11.85,12.07,1.9,,,,,,,,,,,,,,,,"4,4,19,29,37,6,0,0,0","0,75,24,0,0",,,,,,119,,,,,,,,,,,,,,,,,,,,,,,,,,,,,,,,,,,,24.2,3,1,120,92,,1000,0,,1,5,3,,1,0,I1.000|4:50-I1.000|4:41-I1.000|4:58-I1.000|4:46-I1.000|4:38-I1.000|5:03-I1.000|5:53-I1.000|5:11-I1.000|5:30-I1.000|4:45-I1.000|5:34-I1.000|5:38-I1.000|5:18-I0.116|0:37,,Running,,,,"Polar M430",43,0,,0,168070,250480,30378,,,,,,,,,,,,,,,,,,,,,,,,,,,,,,,,,,,,,,,,,,4,
5964691,ac902316-2e2a-413b-b89f-aceec4a7768a,1517301904,60,1548678766,,0,0,11.36,1784,1784,34,41,,,1,0,0.11,,,,316,128,151,,,,,,,1,,,,,,,,,,,,,,26,,,23.86,,4.4,-20.3,112,99,,1,127,117,,,,,,,,,"6,17,34,42,1,0,0","3,75,21,0,0","86,4,0,1,9",,,,,,,,,,,,,,,,,,,,,,,,,,,,,,,,,,,,,,,,,21.4,6,0,248,87,,,0,,0,5,3,,1,0,I1.312|4:52-I10.045|24:53,,Cycling,,,,"Polar M430",43,0,,0,168072,,30378,,,,,,,,,,,,,,,,,,,,,,,,,,,,,,,,,,,,,,,,,,,
5964692,eaa21d5b-68e5-4726-b372-8da093c9f820,1529180680,120,1548678767,,0,0,3.03,1361,1368,16,16,,,1,0,0.2,1.13,0.97,,376,166,195,,,,29.87,22.85,30.07,1,,,,,,,,,,,,,,50,83,8.05,8.17,8.3,11.6,,,,,,,,,,,,,,,,"87,7,2,2,2,0,0,0,0","0,7,20,59,14",,,,,,80,,,,,,,,,,,,,,,,,,,,,,,,,,,,,,,,,,,,104.7,25,4,289,44,,,,,0,3,3,,1,0,I1.000|7:36-I1.000|7:14-I1.000|7:46-I0.029|0:12,,Running,,,,"Polar M430",43,0,,0,168070,250480,30378,,,,,,,,,,,,,,,,,,,,,,,,,,,,,,,,,,,,,,,,,,,
5964693,ef6a6676-2bb8-4bc7-a989-c2c3f8c67935,1412713933,120,1548678767,,0,0,8.75,2190,2218,0,0,,,1,0,0,,,,470,162,184,,,,63.93,49.04,63.93,1,,,,,,,,,,,,,,77,85,14.39,15.92,15.96,8.2,,,,,,,,,,,,,,,,"19,0,1,1,1,1,43,35,0","0,17,7,72,4",,,,,,141,,,,,,,,,,,,,,,,,,,,,,,,,,,,,,,,,,,,87.3,12,9,217,83,,1006,0,,1,5,3,,1,0,,,,,"5,5,2,2 Außenrunden",,"Polar BEAT",,0,,0,168070,250480,30378,,,,,,,,,,,,,,,,,,,,,,,,,,,,,,,,,,,,,,,,,,,
5964694,8f2c9963-5db6-40fc-b6a5-65972cc006d1,1432590112,120,1548678768,,0,0,9.01,3132,4384,143,142,,,1,1.6,0.51,,,395,617,,,,,,,33.39,,1,,,,,,,,,,,,,,65,80,10.61,10.84,11.45,,,,,,,,,,,,,,,,,"25,27,18,9,12,6,1,0,1",,,,,,,108,,,,,,,,,,,,,,,,,,,,,,,,,,,,,,,,,,,,,12,7,332,71,,1017,0,,1,5,3,,1,0,,,,,"Aachen Laufen",,"Polar BEAT",,0,,0,168070,250480,30378,,,,,,,,,,,,,,,,,,,,,,,,,,,,,,,,,,,,,,,,,,"5,5",
5964695,b9816c5e-f971-45bb-8910-81383b6dd983,1544037968,60,1548678769,,0,0,11.72,2389,2394,63,49,,,1,0,0.17,2.51,,,331,110,130,,,,,,,1,,,,,,,,,,,,,,20,,,19.05,,20.4,-5,84,69,,1,103,93,,,,,,,,,"17,39,44,0,0,0,0","19,81,0,0,0","86,0,10,2,2",,,,,,,,,,,,,,,,,,,,,,,,,,,,,,,,,,,,,,,,,6.3,5,4,233,93,,,0,,1,5,3,,1,0,,,Cycling,,,,"Polar M430",43,0,,0,168072,,30378,,,,,,,,,,,,,,,,,,,,,,,,,,,,,,,,,,,,,,,,,,,
5964696,368eb2f7-01ae-48a7-9bcb-b723ea334cbc,1512032899,60,1548678770,,0,0,4.1,820,828,16,9,,,1,0,0.11,2.03,,,117,114,126,,,,,,,1,,,,,,,,,,,,,,7,,,19.5,,11.7,-13.4,93,79,,1,103,95,,,,,,,,,"23,21,55,0,0,0,0","14,86,0,0,0","95,0,0,0,5",,,,,,,,,,,,,,,,,,,,,,,,,,,,,,,,,,,,,,,,,5.6,2,3,240,93,,,0,,0,7,3,,1,0,,,Cycling,,,,"Polar M430",43,0,,0,168072,,30378,,,,,,,,,,,,,,,,,,,,,,,,,,,,,,,,,,,,,,,,,,,
5964697,bc70777d-c0d3-41f4-923a-aba729b956f4,1420571418,60,1548678770,,0,0,10.56,2924,3547,102,104,,,1,1.1,0.45,1.14,1.14,,553,153,179,,,,61.18,44.11,61.9,1,,,,,,,,,,,,,,81,,13.14,13.97,14.07,6.9,,,,,,,,,,,,,,,,"10,4,8,21,12,10,26,10,0","0,26,36,38,0",,,,,,,,,,,,,,,,,,,,,,,,,,,,,,,,,,,,,,,,,,86.2,2,11,205,86,,1023,,,1,5,3,,1,0,,,,,"Aachen Laufen",,"Polar BEAT",,0,,0,168070,250480,30378,,,,,,,,,,,,,,,,,,,,,,,,,,,,,,,,,,,,,,,,,,,
5964698,fc387866-babb-499f-8895-206dd801526e,1526407844,120,1548678770,,0,0,10.77,2804,2804,35,36,,,1,0,0.09,1.12,0.95,,718,157,183,,,,63.69,47.47,63.94,1,,,,,,,,,,,,,,86,83,13.86,14.24,14.32,6.5,,,,,,,,,,,,,,,,"1,2,4,16,21,23,28,6,0","1,14,42,38,6",,,,,,139,,,,,,,,,,,,,,,,,,,,,,,,,,,,,,,,,,,,96.1,20,15,27,47,,1012,,,0,5,3,,1,0,I1.000|4:50-I1.000|5:02-I1.000|4:13-I1.000|3:43-I1.000|4:00-I1.000|3:41-I1.000|4:05-I1.000|3:39-I1.000|4:20-I1.000|5:02-I0.774|4:09,,Running,,,,"Polar M430",43,0,,0,168070,250480,30378,,,,,,,,,,,,,,,,,,,,,,,,,,,,,,,,,,,,,,,,,,,
5964699,3768dbca-a09d-42ee-8036-f2e5c937a94e,1458722522,60,1548678771,,0,0,1.11,389,389,16,13,,,1,1.1,0.64,,,,78,,,,,,,27.98,,1,,,,,,,,,,,,,,8,82,10.58,10.22,10.74,,,,,,,,,,,,,,,,,"23,24,30,14,7,1,1,1,0",,,,,,,104,,,,,,,,,,,,,,,,,,,,,,,,,,,,,,,,,,,,,6,12,326,91,,1014,,,0,5,3,,1,0,,,,,"Aachen Laufen",,"Polar BEAT",,0,,0,168070,250480,30378,,,,,,,,,,,,,,,,,,,,,,,,,,,,,,,,,,,,,,,,,,,
5964700,c99be2a7-27bd-49d9-9a8a-499f43e979d9,1519718670,60,1548678771,,0,0,9.03,1470,1549,25,21,,,1,0,0.08,,,,412,150,165,,,,,,,1,,,,,,,,,,,,,,36,,,24.53,,-14.6,,,,,,,,,,,,,,,,"7,3,6,20,47,16","0,18,72,9,0",,,,,,,,,,,,,,,,,,,,,,,,,,,,,,,,,,,,,,,,,,39.3,-9,15,50,72,,1018,,,0,2,1,,1,0,I1.000|4:36-I1.000|2:42-I1.000|2:36-I1.000|0:00-I1.000|1:18-I1.000|2:33-I1.000|2:31-I1.000|2:37-I1.000|1:47-I1.000|3:40-I0.432|6:13,,Hiking,,,,"Polar M430",43,0,,0,168075,,30378,,,,,,,,,,,,,,,,,,,,,,,,,,,,,,,,,,,,,,,,,,,
5964701,3f53ebbb-1fb7-4653-b46a-2a30fa23aaa6,1412339749,120,1548678771,,0,0,2.42,766,767,42,37,,,1,1.3,0.5,,,327,158,,,,,,,34.15,,1,,,,,,,,,,,,,,15,78,11.53,13.24,13.42,,,,,,,,,,,,,,,,,"27,1,2,5,8,30,22,6,0",,,,,,,122,,,,,,,,,,,,,,,,,,,,,,,,,,,,,,,,,,,,,21,6,136,60,,1025,,,0,4,3,,1,0,,,,,Einlaufen,,"Polar BEAT",,0,,0,168070,250480,30378,,,,,,,,,,,,,,,,,,,,,,,,,,,,,,,,,,,,,,,,,,5,
5964702,674f91a7-c6b5-45eb-8b5e-3bc7ea415ddd,1403173604,120,1548678771,,0,0,9.87,2714,2724,208,208,,,1,2.1,0.84,,,,618,,,,,,,44.27,,1,,,,,,,,,,,,,,56,81,13.17,15.01,15.66,,,,,,,,,,,,,,,,,"29,5,2,2,2,3,28,30,0",,,,,,,135,,,,,,,,,,,,,,,,,,,,,,,,,,,,,,,,,,,,,15,6,308,75,,1022,3,,0,5,3,,1,0,,,,,"2x 4x ( 1.000m + 200m Trab )",,"Polar BEAT",,0,,0,168070,250480,30378,,,,,,,,,,,,,,,,,,,,,,,,,,,,,,,,,,,,,,,,,,,
5964703,76fd0d00-8aa1-4a44-8c6b-9df6702e4c69,1519144349,60,1548678772,,0,0,10.82,1635,1635,56,43,,,1,0,0.11,1.96,,,325,134,152,,,,,,,1,,,,,,,,,,,,,,28,,,25.44,,2.7,-11.9,138,116,,1,159,142,,,,,,,,,"10,9,15,62,5,0,0","4,40,56,0,0","76,13,0,1,10",,,,,,,,,,,,,,,,,,,,,,,,,,,,,,,,,,,,,,,,,23,3,11,31,58,,1017,,,0,3,3,,1,0,,,Cycling,,,,"Polar M430",43,0,,0,168072,,30378,,,,,,,,,,,,,,,,,,,,,,,,,,,,,,,,,,,,,,,,,,,
5964704,ba6dc09d-a9c6-4d6e-8327-d3b138b4e819,1544636262,60,1548678772,,0,0,13.77,3883,3886,169,173,,,1,1.9,0.47,1.13,0.94,330,894,145,164,,,,64.28,44.05,65.23,1,,,,,,,,,,,,,,87,82,12.96,12.87,13.24,6.3,,,,,,,,,,,,,,,,"1,2,5,17,43,30,3,0,0","0,27,71,1,0",,,,,,130,,,,,,,,,,,,,,,,,,,,,,,,,,,,,,,,,,,,36.1,0,4,53,91,,1025,0,312,1,5,3,,1,0,I1.000|5:04-I1.000|4:47-I1.000|4:38-I1.000|4:33-I1.000|4:47-I1.000|4:42-I1.000|4:25-I1.000|4:22-I1.000|4:26-I1.000|4:38-I1.000|4:52-I1.000|5:02-I1.000|4:55-I0.770|3:36,,Running,,,,"Polar M430",43,0,,0,168070,250480,30378,,,,,,,,,,,,,,,,,,,,,,,,,,,,,,,,,,,,,,,,,,"4,5,5",
5964705,c2e0cb3e-49e1-4709-9c93-1fe19a5a97b8,1453145035,60,1548678773,,0,0,13.72,3483,3602,136,143,,,1,0.9,0.35,,,,941,,,,,,,49.75,,1,,,,,,,,,,,,,,72,82,14.34,14.34,14.55,,,,,,,,,,,,,,,,,"1,0,0,5,14,48,31,0,0",,,,,,,144,,,,,,,,,,,,,,,,,,,,,,,,,,,,,,,,,,,,,-4,7,128,80,,1017,,,1,5,3,,1,0,,,,,"Aachen Laufen",,"Polar BEAT",,0,,0,168070,250480,30378,,,,,,,,,,,,,,,,,,,,,,,,,,,,,,,,,,,,,,,,,,,
5964706,7fa1ad9a-0164-4029-8755-d9446e0bd973,1446489697,60,1548678773,,0,0,10.02,2350,2350,84,91,,,1,0.8,0.42,,,,674,,,,,,,53.37,,1,,,,,,,,,,,,,,48,85,15.43,15.47,15.62,,,,,,,,,,,,,,,,,"1,1,1,1,3,28,57,8,0",,,,,,,150,,,,,,,,,,,,,,,,,,,,,,,,,,,,,,,,,,,,,8,7,136,82,,1025,,,1,3,3,,1,0,,,,,"Aachen Laufen",,"Polar BEAT",,0,,0,168070,250480,30378,,,,,,,,,,,,,,,,,,,,,,,,,,,,,,,,,,,,,,,,,,,
5964707,5aab0687-4da7-45f0-bff4-e7622b1613a8,1473111238,120,1548678774,,0,0,6.39,2502,2556,38,48,,,1,0,0.28,,,,426,,,,,,,28.28,,1,,,,,,,,,,,,,,51,77,9.24,9.56,9.58,,,,,,,,,,,,,,,,,"41,28,21,7,2,0,1,0,0",,,,,,,100,,,,,,,,,,,,,,,,,,,,,,,,,,,,,,,,,,,,,17,0,202,82,,1024,0,,1,5,3,,1,0,,,,,"Aachen Laufen",,"Polar BEAT",,0,,0,168070,250480,30378,,,,,,,,,,,,,,,,,,,,,,,,,,,,,,,,,,,,,,,,,,,
5964708,724aead8-21c0-49a3-a4bd-850ce3128fba,1538676413,120,1548678774,,0,0,4.35,1230,1230,29,29,,,1,0.1,0.28,1.13,0.91,,271,139,155,,,,67.62,40.73,68.18,1,,,,,,,,,,,,,,23,81,12.8,12.79,12.96,-0.3,,,,,,,,,,,,,,,,"0,1,2,13,63,21,0,0,0","1,52,48,0,0",,,,,,131,,,,,,,,,,,,,,,,,,,,,,,,,,,,,,,,,,,,21.6,18,17,4,47,,1025,,,0,3,3,,1,0,I1.000|4:43-I1.000|4:27-I1.000|4:46-I1.000|4:49-I0.351|1:46,,Running,,,,"Polar M430",43,0,,0,168070,250480,30378,,,,,,,,,,,,,,,,,,,,,,,,,,,,,,,,,,,,,,,,,,,
5964709,cb31e2cc-5d18-448b-beff-cb280f6bf3dc,1406063696,120,1548678774,,0,0,1.44,460,461,8,12,,,1,0,0.16,,,,94,,,,,,,32.03,,1,,,,,,,,,,,,,,9,81,11.25,11.61,11.58,,,,,,,,,,,,,,,,,"15,3,19,18,44,0,0,0,0",,,,,,,116,,,,,,,,,,,,,,,,,,,,,,,,,,,,,,,,,,,,,22,4,12,75,,1018,0,,0,3,3,,1,0,,,,,Auslaufen,,"Polar BEAT",,0,,0,168070,250480,30378,,,,,,,,,,,,,,,,,,,,,,,,,,,,,,,,,,,,,,,,,,,
5964710,b61b6f1e-d72c-4688-a53a-a24898937421,1392321141,60,1548678774,,0,0,5.52,1694,1694,65,48,,,1,1.1,0.49,1.06,1.05,,309,142,165,,,,59.48,37.51,60.57,1,,,,,,,,,,,,,,34,82,11.96,12.01,12.17,-10.6,,,,,,,,,,,,,,,,"1,10,19,43,13,3,11,0,0","0,39,58,3,0",,,,,,119,,,,,,,,,,,,,,,,,,,,,,,,,,,,,,,,,,,,28.8,4,13,262,95,,998,0,,1,5,3,,1,0,,,,,"Auslaufen lang",,"Polar BEAT",,0,,0,168070,250480,30378,,,,,,,,,,,,,,,,,,,,,,,,,,,,,,,,,,,,,,,,,,,
5964711,f0e514d5-00ed-4567-b879-6d5d3fe480ca,1457186349,60,1548678775,,0,0,3.84,1799,1863,36,36,,,1,0.5,0.42,,,,257,,,,,,,21.98,,1,,,,,,,,,,,,,,37,74,7.78,9.85,9.95,,,,,,,,,,,,,,,,,"46,4,14,19,16,0,0,0,0",,,,,,,87,,,,,,,,,,,,,,,,,,,,,,,,,,,,,,,,,,,,,5,3,15,79,,996,,,0,5,3,,1,0,,,,,"Herten Laufen",,"Polar BEAT",,0,,0,168070,250480,30378,,,,,,,,,,,,,,,,,,,,,,,,,,,,,,,,,,,,,,,,,,,
5964712,6239b4d0-6c5e-43fc-aab5-106e7a81fb4d,1464902157,120,1548678775,,0,0,5.27,1442,1727,60,82,,,1,1,0.5,,,,359,,,,,,,42.84,,1,,,,,,,,,,,,,,29,82,13.27,13.36,13.42,,,,,,,,,,,,,,,,,"4,2,5,7,30,41,11,0,0",,,,,,,134,,,,,,,,,,,,,,,,,,,,,,,,,,,,,,,,,,,,,16,2,347,98,,1012,0,,0,6,3,,1,0,,,,,"Aachen Laufen",,"Polar BEAT",,0,,0,168070,250480,30378,,,,,,,,,,,,,,,,,,,,,,,,,,,,,,,,,,,,,,,,,,,
5964713,,1548247800,60,1548678775,,0,0,10,1800,1800,,,,,0,,,,,,385,,,,,,,,,1,,,,,,,,,,,,,,20,,,,,,,,,,,,,,,,,,,,,,,,,,,,,,,,,,,,,,,,,,,,,,,,,,,,,,,,,,,,,,,,,,,,,,,,,,1,,,0,0,,,,,,,"no device name available",,0,,0,168072,,30378,,,,,,,,,,,,,,,,,,,,,,,,,,,,,,,,,,,,,,,,,,,
5964715,904d6453-51ab-4743-aaf4-b0d190936201,1394136111,60,1548678777,,0,0,4.02,1286,1320,32,65,,,1,0.6,0.45,1.05,1.03,,234,142,161,,,,56.51,35.04,56.49,1,,,,,,,,,,,,,,26,82,11.13,11.36,11.3,-3.6,,,,,,,,,,,,,,,,"4,14,20,38,19,4,0,0,0","0,49,51,0,0",,,,,,114,,,,,,,,,,,,,,,,,,,,,,,,,,,,,,,,,,,,28.7,6,7,157,66,,1028,,,1,3,3,,1,0,,,,,Auslaufen,,"Polar BEAT",,0,,0,168070,250480,30378,,,,,,,,,,,,,,,,,,,,,,,,,,,,,,,,,,,,,,,,,,,
5964716,0fce1940-fcd6-4cbf-9781-0b13a619432f,1404069567,120,1548678778,,0,0,10.94,3221,3498,335,336,,,1,4.1,0.72,,,653,733,,,,,,,41.17,,1,,,,,,,,,,,,,,66,82,12.99,12.45,13.8,,,,,,,,,,,,,,,,,"3,10,11,19,29,26,2,0,0",,,,,,,124,,,,,,,,,,,,,,,,,,,,,,,,,,,,,,,,,,,,,15,4,219,78,,,1,,0,5,3,,1,0,,,,,"Langsamer DL ",,"Polar BEAT",,0,,0,168070,250480,30378,,,,,,,,,,,,,,,,,,,,,,,,,,,,,,,,,,,,,,,,,,3,
5964717,87bae7b0-a35b-46ac-944a-1c3e3567c3e5,1422264796,60,1548678778,,0,0,8.12,2438,2482,90,90,,,1,0.8,0.47,,,,551,,,,,,,39.41,,1,,,,,,,,,,,,,,50,84,12.16,12.08,12.31,,,,,,,,,,,,,,,,,"4,3,10,28,46,10,0,0,0",,,,,,,119,,,,,,,,,,,,,,,,,,,,,,,,,,,,,,,,,,,,,3,9,215,98,,1023,0,,0,6,3,,1,0,,,,,"Aachen Laufen",,"Polar BEAT",,0,,0,168070,250480,30378,,,,,,,,,,,,,,,,,,,,,,,,,,,,,,,,,,,,,,,,,,,
5964718,9aab38bd-2872-4a61-a27f-cc78a3ce748c,1366829798,120,1548678779,,0,0,4.75,2742,2763,41,60,,,1,0,0.26,,,,325,,,,,,,17.08,,1,,,,,,,,,,,,,,56,,6.28,10.62,10.67,,,,,,,,,,,,,,,,,"57,2,4,10,10,12,3,2,1",,,,,,,,,,,,,,,,,,,,,,,,,,,,,,,,,,,,,,,,,,,,21,10,266,46,,1024,1,,0,3,3,,1,0,,,,,,,"Polar BEAT",,0,,0,168070,250480,30378,,,,,,,,,,,,,,,,,,,,,,,,,,,,,,,,,,,,,,,,,,,
5964719,c966246a-3012-4923-abda-08a81651cbe7,1453028217,60,1548678780,,0,0,23.42,6501,6679,347,345,,,1,2.3,0.47,,,359,1618,,,,,,,46.79,,1,,,,,,,,,,,,,,135,82,13.26,13.43,13.78,,,,,,,,,,,,,,,,,"6,1,3,7,27,45,11,0,0",,,,,,,132,,,,,,,,,,,,,,,,,,,,,,,,,,,,,,,,,,,,,-1,8,348,87,,1027,,,0,5,3,,1,0,,,,,"Aachen Laufen",,"Polar BEAT",,0,,0,168070,250480,30378,,,,,,,,,,,,,,,,,,,,,,,,,,,,,,,,,,,,,,,,,,"4,4,5",
5964720,2738a198-4e68-4d4a-81a2-d04cf1092086,1455822568,60,1548678780,,0,0,2.15,619,619,54,43,,,1,1.5,0.62,,,437,151,,,,,,,37.64,,1,,,,,,,,,,,,,,12,81,13.18,12.47,13.82,,,,,,,,,,,,,,,,,"2,1,5,23,44,24,0,0,0",,,,,,,129,,,,,,,,,,,,,,,,,,,,,,,,,,,,,,,,,,,,,1,5,184,72,,1017,,,1,3,3,,1,0,,,,,"Aachen Laufen",,"Polar BEAT",,0,,0,168070,250480,30378,,,,,,,,,,,,,,,,,,,,,,,,,,,,,,,,,,,,,,,,,,5,
5964721,,1402959619,120,1548678780,,0,0,7,0,0,,,,,0,,,,,,,,,,,,,,,1,,,,,,,,,,,,,,0,,,,,,,,,,,,,,,,,,,,,,,,,,,,,,,,,,,,,,,,,,,,,,,,,,,,,,,,,,,,,,,,,,,,,,,,,,1,,,0,0,,,,,"Lousberglauf Vorkurs",,"Polar BEAT",,0,,0,168070,250480,30378,,,,,,,,,,,,,,,,,,,,,,,,,,,,,,,,,,,,,,,,,,,
5964723,c65afe2a-031b-41ae-905e-78d97e6ed4c5,1363024246,60,1548678780,,0,0,8.85,2896,3118,45,45,,,1,0,0.27,,,,622,,,,,,,35.81,,1,,,,,,,,,,,,,,60,,11.12,11.81,11.99,,,,,,,,,,,,,,,,,"20,8,10,23,21,11,4,2,1",,,,,,,,,,,,,,,,,,,,,,,,,,,,,,,,,,,,,,,,,,,,5,9,54,87,,1001,0,,0,4,3,,1,0,,,,,,,"Polar BEAT",,0,,0,168070,250480,30378,,,,,,,,,,,,,,,,,,,,,,,,,,,,,,,,,,,,,,,,,,,
5964724,9c8aab9b-fe07-4058-8a87-0068bcb73710,1416512099,60,1548678781,,0,0,6.95,1851,1853,0,3,,,1,0,0.07,,,,415,,,,,,,44.95,,1,,,,,,,,,,,,,,38,84,13.63,15.17,15.18,,,,,,,,,,,,,,,,,"28,1,3,6,5,6,9,37,5",,,,,,,134,,,,,,,,,,,,,,,,,,,,,,,,,,,,,,,,,,,,,5,11,95,90,,1026,,,1,5,3,,1,0,,,,,"5x (300,500,300) + 2 min pause",,"Polar BEAT",,0,,0,168070,250480,30378,,,,,,,,,,,,,,,,,,,,,,,,,,,,,,,,,,,,,,,,,,,
5964725,0db81e70-1a29-4336-b97e-b7e34e13e57f,1363889514,60,1548678781,,0,0,11.74,3498,3565,12,13,,,1,0,0,,,,821,,,,,,,40.81,,1,,,,,,,,,,,,,,72,,12.11,12.41,12.41,,,,,,,,,,,,,,,,,"8,4,5,14,45,20,3,2,0",,,,,,,,,,,,,,,,,,,,,,,,,,,,,,,,,,,,,,,,,,,,4,8,330,64,,1018,0,,1,5,3,,1,0,,,,,,,"Polar BEAT",,0,,0,168070,250480,30378,,,,,,,,,,,,,,,,,,,,,,,,,,,,,,,,,,,,,,,,,,,
5964726,343ef4fc-0550-4c95-8959-f8cc8bd1b81b,1401974752,120,1548678782,,0,0,16.08,4596,4808,216,215,,,1,2,0.41,,,312,1090,,,,,,,43.9,,1,,,,,,,,,,,,,,95,83,12.82,12.73,13.08,,,,,,,,,,,,,,,,,"3,1,3,17,49,25,2,0,0",,,,,,,126,,,,,,,,,,,,,,,,,,,,,,,,,,,,,,,,,,,,,14,12,234,73,,1013,6,,0,5,3,,1,0,,,,,"Regenerativer DL",,"Polar BEAT",,0,,0,168070,250480,30378,,,,,,,,,,,,,,,,,,,,,,,,,,,,,,,,,,,,,,,,,,4,
5964727,c4dc6685-5ad3-4d4c-a352-7c385996df09,1476822455,120,1548678783,,0,0,11.77,3005,3152,102,101,,,1,1.1,0.5,,,,765,,,,,,,48.87,,1,,,,,,,,,,,,,,62,81,14.18,15.22,15.39,,,,,,,,,,,,,,,,,"15,1,1,1,3,16,47,17,1",,,,,,,145,,,,,,,,,,,,,,,,,,,,,,,,,,,,,,,,,,,,,10,7,243,93,,1019,0,,1,6,3,,1,0,,,,,"Aachen Laufen",,"Polar BEAT",,0,,0,168070,250480,30378,,,,,,,,,,,,,,,,,,,,,,,,,,,,,,,,,,,,,,,,,,,
5964728,f9ab08d8-d44c-4dee-9b3b-9b8c47171935,1470596888,120,1548678784,,0,0,9.42,2571,2573,101,95,,,1,1,0.4,,,,651,,,,,,,44.51,,1,,,,,,,,,,,,,,53,80,13.37,13.33,13.53,,,,,,,,,,,,,,,,,"1,3,5,6,29,54,2,0,0",,,,,,,137,,,,,,,,,,,,,,,,,,,,,,,,,,,,,,,,,,,,,24,8,248,65,,1024,1,,0,5,3,,1,0,,,,,"Aachen Laufen",,"Polar BEAT",,0,,0,168070,250480,30378,,,,,,,,,,,,,,,,,,,,,,,,,,,,,,,,,,,,,,,,,,,
5964729,26cf1611-4951-4875-9510-61e06d229bb2,1394210968,60,1548678784,,0,0,4.37,1159,1159,42,25,,,1,0.2,0.26,0.98,0.95,,226,148,161,,,,67.5,43.92,68.63,1,,,,,,,,,,,,,,27,83,13.89,13.76,14.1,2.4,,,,,,,,,,,,,,,,"2,1,1,6,24,56,10,0,0","1,8,91,0,0",,,,,,136,,,,,,,,,,,,,,,,,,,,,,,,,,,,,,,,,,,,30,12,5,260,55,,1026,0,,0,5,3,,1,0,,,,,"Einlaufen mit Lauf ABC",,"Polar BEAT",,0,,0,168070,250480,30378,,,,,,,,,,,,,,,,,,,,,,,,,,,,,,,,,,,,,,,,,,,
5964730,982999e1-3449-4a7d-b25b-75fe45357e8c,1535011435,120,1548678784,,0,0,9.1,1199,1199,33,42,,,1,0,0.09,,0.61,,234,134,161,,,,,,,1,,,,,,,,,,,,,,20,,,27.96,,4.8,-13.9,153,132,,1,167,150,,,,,,,,,"2,3,9,59,28,0,0","0,85,15,0,0","51,37,0,0,11",,,,,,,,,,,,,,,,,,,,,,,,,,,,,,,,,,,,,,,,,16.7,20,8,209,72,,,,,0,3,3,,1,0,,,Cycling,,,,"Polar M430",43,0,,0,168072,,30378,,,,,,,,,,,,,,,,,,,,,,,,,,,,,,,,,,,,,,,,,,,
5964731,bf50e680-4754-4246-869d-e781d825a938,1497388977,120,1548678785,,0,0,1.89,689,689,15,16,,,1,0.7,0.47,,,,127,,,,,,,28.32,,1,,,,,,,,,,,,,,14,79,9.98,10.06,10.19,,,,,,,,,,,,,,,,,"20,25,39,15,1,0,0,0,0",,,,,,,104,,,,,,,,,,,,,,,,,,,,,,,,,,,,,,,,,,,,,17,3,8,67,,1020,0,,0,5,3,,1,0,,,,,"Aachen Laufen",,"Polar BEAT",,0,,0,168070,250480,30378,,,,,,,,,,,,,,,,,,,,,,,,,,,,,,,,,,,,,,,,,,,
5964732,77833169-ec92-408f-bfb0-25742de82765,1502908525,120,1548678785,,0,0,12.75,3439,3443,157,161,,,1,0.6,0.4,1.02,1,191,834,153,172,,,,63.2,46.11,64.13,1,,,,,,,,,,,,,,93,81,13.59,13.58,13.85,-6.2,,,,,,,,,,,,,,,,"4,0,1,6,35,44,7,2,0","0,10,63,27,0",,,,,,137,,,,,,,,,,,,,,,,,,,,,,,,,,,,,,,,,,,,59.1,23,1,123,65,,1020,1,,0,5,3,,1,0,I1.000|4:54-I1.000|4:46-I1.000|4:24-I1.000|5:09-I1.000|5:13-I1.000|4:31-I1.000|4:29-I1.000|4:21-I1.000|4:19-I1.000|4:03-I1.000|4:21-I1.000|4:15-I0.761|2:38,,Running,,,,"Polar M430",43,0,,0,168070,250480,30378,,,,,,,,,,,,,,,,,,,,,,,,,,,,,,,,,,,,,,,,,,5,
5964733,ed3a3898-271a-4812-b5ab-48c00cc49b31,1395774569,60,1548678785,,0,0,2.88,811,811,25,23,,,1,0.1,0.28,1.03,0.87,,180,148,164,,,,62.67,39.7,63.4,1,,,,,,,,,,,,,,20,81,12.93,12.85,13.15,7,,,,,,,,,,,,,,,,"1,1,0,20,52,26,0,0,0","4,11,77,8,0",,,,,,132,,,,,,,,,,,,,,,,,,,,,,,,,,,,,,,,,,,,33.9,6,4,74,67,,1011,0,,1,5,3,,1,0,,,,,Einlaufen,,"Polar BEAT",,0,,0,168070,250480,30378,,,,,,,,,,,,,,,,,,,,,,,,,,,,,,,,,,,,,,,,,,,
5964734,20613468-58ed-49a2-aac4-2bcacca57d13,1415302139,60,1548678786,,0,0,8.37,2112,2113,316,297,,,1,4.7,0.73,,,1127,510,,,,,,,48.44,,1,,,,,,,,,,,,,,43,86,15.4,14.73,16.8,,,,,,,,,,,,,,,,,"3,1,3,11,18,16,38,10,0",,,,,,,138,,,,,,,,,,,,,,,,,,,,,,,,,,,,,,,,,,,,,6,6,188,88,,1013,0,,1,3,3,,1,0,,,,,"15x Dreieck",,"Polar BEAT",,0,,0,168070,250480,30378,,,,,,,,,,,,,,,,,,,,,,,,,,,,,,,,,,,,,,,,,,"5,5,5,5,5,5,5,5,5,5,5,5,5",
5964735,966ee86b-4557-482e-a903-12a582e13131,1453492655,60,1548678786,,0,0,1.22,398,398,10,8,,,1,0.2,0.34,,,,79,,,,,,,30.69,,1,,,,,,,,,,,,,,8,77,11.22,11.14,11.27,,,,,,,,,,,,,,,,,"5,15,22,45,10,4,0,0,0",,,,,,,119,,,,,,,,,,,,,,,,,,,,,,,,,,,,,,,,,,,,,1,20,177,92,,1023,,,1,7,3,,1,0,,,,,"Aachen Laufen",,"Polar BEAT",,0,,0,168070,250480,30378,,,,,,,,,,,,,,,,,,,,,,,,,,,,,,,,,,,,,,,,,,,
5964736,51a2c063-cdd1-46e3-b7ce-6f5314f13d36,1465647184,120,1548678787,,0,0,13.1,3924,4507,217,216,,,1,2.9,0.61,,,330,901,,,,,,,40.9,,1,,,,,,,,,,,,,,81,80,12.38,12.16,12.77,,,,,,,,,,,,,,,,,"3,4,11,29,38,13,1,0,0",,,,,,,125,,,,,,,,,,,,,,,,,,,,,,,,,,,,,,,,,,,,,19,2,87,64,,1010,6,,0,5,3,,1,0,,,,,"Aachen Laufen",,"Polar BEAT",,0,,0,168070,250480,30378,,,,,,,,,,,,,,,,,,,,,,,,,,,,,,,,,,,,,,,,,,"4,4,5",
5964737,11f114b2-137d-4634-a95a-69de07a8801c,1509387736,60,1548678787,,0,0,5.82,1386,1388,12,12,,,1,0,0.03,,,,377,164,181,,,,66.77,50.74,66.94,1,,,,,,,,,,,,,,48,84,15.12,15.49,15.54,9.5,,,,,,,,,,,,,,,,"1,1,3,10,5,11,62,8,0","0,4,32,64,0",,,,,,150,,,,,,,,,,,,,,,,,,,,,,,,,,,,,,,,,,,,75.1,8,0,0,74,,,0,,1,3,3,,1,0,I5.017|18:53-I0.803|4:16,,Running,,,,"Polar M430",43,0,,0,168070,250480,30378,,,,,,,,,,,,,,,,,,,,,,,,,,,,,,,,,,,,,,,,,,,
5964738,756c6b02-af9b-4d7f-92e3-1b6a42565733,1415733270,60,1548678787,,0,0,2.29,677,677,26,33,,,1,0.9,0.61,,,,155,,,,,,,36.75,,1,,,,,,,,,,,,,,14,81,12.22,12.26,12.34,,,,,,,,,,,,,,,,,"0,1,7,34,52,6,0,0,0",,,,,,,125,,,,,,,,,,,,,,,,,,,,,,,,,,,,,,,,,,,,,11,7,116,85,,1003,0,,1,5,3,,1,0,,,,,Einlaufen,,"Polar BEAT",,0,,0,168070,250480,30378,,,,,,,,,,,,,,,,,,,,,,,,,,,,,,,,,,,,,,,,,,,
5964739,f0bd8703-d778-476b-8bb2-10328c12a0cf,1415179900,60,1548678788,,0,0,5.23,1608,2412,55,54,,,1,0.6,0.31,,,,357,,,,,,,37.31,,1,,,,,,,,,,,,,,33,82,11.93,11.9,12.04,,,,,,,,,,,,,,,,,"6,6,17,22,42,7,0,0,0",,,,,,,119,,,,,,,,,,,,,,,,,,,,,,,,,,,,,,,,,,,,,7,4,190,96,,1002,0,,0,5,3,,1,0,,,,,"Lauf ABC",,"Polar BEAT",,0,,0,168070,250480,30378,,,,,,,,,,,,,,,,,,,,,,,,,,,,,,,,,,,,,,,,,,,
5964740,cb4ce085-3275-4034-9968-61a921a54753,1481738548,60,1548678788,,0,0,5.12,1545,1562,53,62,,,1,1,0.57,,,,346,,,,,,,38.1,,1,,,,,,,,,,,,,,32,79,12.03,12.18,12.29,,,,,,,,,,,,,,,,,"7,2,11,34,23,22,2,0,0",,,,,,,126,,,,,,,,,,,,,,,,,,,,,,,,,,,,,,,,,,,,,8,5,128,83,,1025,0,,1,5,3,,1,0,,,,,"Aachen Laufen",,"Polar BEAT",,0,,0,168070,250480,30378,,,,,,,,,,,,,,,,,,,,,,,,,,,,,,,,,,,,,,,,,,,
5964741,b9a1e781-c584-4e8f-869e-0d1cfa429dec,1466188307,120,1548678791,,0,0,16.15,4461,5216,198,207,,,1,1.4,0.41,,,484,1124,,,,,,,45.69,,1,,,,,,,,,,,,,,92,80,13.21,13.16,13.42,,,,,,,,,,,,,,,,,"2,1,3,9,42,39,4,0,0",,,,,,,136,,,,,,,,,,,,,,,,,,,,,,,,,,,,,,,,,,,,,16,3,215,79,,1010,2,,0,6,3,,1,0,,,,,"Aachen Laufen",,"Polar BEAT",,0,,0,168070,250480,30378,,,,,,,,,,,,,,,,,,,,,,,,,,,,,,,,,,,,,,,,,,5,
5964742,e7b46594-cd87-4ea5-a140-14186bd6c4db,1527185263,120,1548678791,,0,0,13.72,3386,3387,48,49,,,1,0,0.01,,,,925,163,179,,,,64.47,51.4,64.74,1,,,,,,,,,,,,,,115,84,14.61,14.67,14.73,4.1,,,,,,,,,,,,,,,,"0,0,0,1,13,49,36,1,0","0,2,31,67,0",,,,,,145,,,,,,,,,,,,,,,,,,,,,,,,,,,,,,,,,,,,84.4,23,6,27,62,,1017,,,0,3,3,,1,0,I1.000|4:30-I1.000|4:24-I1.000|4:20-I1.000|4:16-I1.000|4:01-I1.000|4:09-I1.000|3:59-I1.000|3:54-I1.000|3:54-I1.000|4:00-I1.000|4:01-I1.000|3:49-I1.000|4:17-I0.722|2:54,,Running,,,,"Polar M430",43,0,,0,168070,250480,30378,,,,,,,,,,,,,,,,,,,,,,,,,,,,,,,,,,,,,,,,,,,
5964743,6b86d74f-ed1a-4b2d-81c5-6a7cf6369270,1443119239,120,1548678791,,0,0,1.99,508,508,0,0,,,1,0,0,,,,125,,,,,,,42.77,,1,,,,,,,,,,,,,,10,86,14.1,14.64,14.67,,,,,,,,,,,,,,,,,"20,4,4,5,6,6,19,38,0",,,,,,,137,,,,,,,,,,,,,,,,,,,,,,,,,,,,,,,,,,,,,15,14,211,72,,1016,,,0,4,3,,1,0,,,,,"Münster Laufen",,"Polar BEAT",,0,,0,168070,250480,30378,,,,,,,,,,,,,,,,,,,,,,,,,,,,,,,,,,,,,,,,,,,
5964744,c53153e8-b247-41e9-9a95-c53f2dff1473,1412885579,120,1548678791,,0,0,3.3,985,985,64,63,,,1,1.6,0.57,1.06,0.96,433,187,141,162,,,,62.11,37.51,63.63,1,,,,,,,,,,,,,,19,83,12.46,12.25,13.1,-0.7,,,,,,,,,,,,,,,,"3,4,15,32,27,15,4,0,0","1,53,45,1,0",,,,,,121,,,,,,,,,,,,,,,,,,,,,,,,,,,,,,,,,,,,21.7,13,9,201,90,,1010,0,,1,5,3,,1,0,,,,,Einlaufen,,"Polar BEAT",,0,,0,168070,250480,30378,,,,,,,,,,,,,,,,,,,,,,,,,,,,,,,,,,,,,,,,,,4,
5964745,91dd53f3-0151-4b7a-b8da-de36c27a25e1,1455478848,60,1548678792,,0,0,15.16,4297,4370,209,210,,,1,2.2,0.53,,,420,1037,,,,,,,44.12,,1,,,,,,,,,,,,,,89,81,12.94,13.46,13.8,,,,,,,,,,,,,,,,,"9,1,1,8,26,43,12,1,0",,,,,,,131,,,,,,,,,,,,,,,,,,,,,,,,,,,,,,,,,,,,,1,11,298,94,,996,,,1,4,3,,1,0,,,,,"Aachen Laufen",,"Polar BEAT",,0,,0,168070,250480,30378,,,,,,,,,,,,,,,,,,,,,,,,,,,,,,,,,,,,,,,,,,4,
5964746,38fc686d-0f34-4085-95af-eca92862a72a,1413745587,120,1548678792,,0,0,5.08,1045,1045,122,111,,,1,1.9,1,,,,346,,,,,,,59.68,,1,,,,,,,,,,,,,,21,88,17.95,17.52,18.15,,,,,,,,,,,,,,,,,"0,0,0,0,0,0,17,83,0",,,,,,,166,,,,,,,,,,,,,,,,,,,,,,,,,,,,,,,,,,,,,19,7,223,85,,1016,0,,1,6,3,,1,0,,,,,"TDL 5k",,"Polar BEAT",,0,,0,168070,250480,30378,,,,,,,,,,,,,,,,,,,,,,,,,,,,,,,,,,,,,,,,,,,
5964747,d282988c-f85d-4e3d-9cdc-ac6739a845f5,1468156352,120,1548678793,,0,0,5.2,1639,1649,107,108,,,1,1.3,0.53,,,,308,,,,,,,36.21,,1,,,,,,,,,,,,,,34,76,11.79,14.09,14.53,,,,,,,,,,,,,,,,,"46,2,2,3,3,4,5,30,6",,,,,,,125,,,,,,,,,,,,,,,,,,,,,,,,,,,,,,,,,,,,,28,9,213,52,,1011,8,,0,3,3,,1,0,,,,,"Aachen Laufen",,"Polar BEAT",,0,,0,168070,250480,30378,,,,,,,,,,,,,,,,,,,,,,,,,,,,,,,,,,,,,,,,,,,
5964748,74ec7c20-3160-4277-9f56-9da3b271a8c5,1459705600,120,1548678794,,0,0,22.02,5415,5812,330,302,,,1,2.6,0.51,,,471,1513,,,,,,,53.57,,1,,,,,,,,,,,,,,112,84,15.06,14.92,15.2,,,,,,,,,,,,,,,,,"2,0,1,3,16,36,32,10,0",,,,,,,145,,,,,,,,,,,,,,,,,,,,,,,,,,,,,,,,,,,,,19,7,182,61,,1008,1,,0,5,3,,1,0,,,,,"Aachen Laufen",,"Polar BEAT",,0,,0,168070,250480,30378,,,,,,,,,,,,,,,,,,,,,,,,,,,,,,,,,,,,,,,,,,"4,5,5",
5964749,288f8480-9931-441b-889f-d99a67121e95,1473714905,120,1548678795,,0,0,3.11,847,847,9,42,,,1,0.4,0.42,,,,214,,,,,,,41.53,,1,,,,,,,,,,,,,,17,82,12.95,13.33,13.04,,,,,,,,,,,,,,,,,"0,0,5,4,40,49,2,0,0",,,,,,,134,,,,,,,,,,,,,,,,,,,,,,,,,,,,,,,,,,,,,22,1,105,72,,1016,0,,1,3,3,,1,0,,,,,"Aachen Laufen",,"Polar BEAT",,0,,0,168070,250480,30378,,,,,,,,,,,,,,,,,,,,,,,,,,,,,,,,,,,,,,,,,,,
5964750,d1b92217-62bf-4cf4-ab91-159d8480a64d,1508685577,120,1548678795,,0,0,20.1,5441,5447,315,321,,,1,3.1,0.59,1.05,0.99,373,1349,154,181,,,,62.35,47.59,63.54,1,,,,,,,,,,,,,,153,83,13.63,13.52,13.95,-0.9,,,,,,,,,,,,,,,,"2,2,6,12,25,36,16,1,0","0,10,57,32,0",,,,,,134,,,,,,,,,,,,,,,,,,,,,,,,,,,,,,,,,,,,70.1,11,22,249,80,,1013,,,0,5,3,,1,0,I1.000|4:47-I1.000|4:31-I1.000|4:21-I1.000|4:38-I1.000|4:42-I1.000|4:41-I1.000|5:28-I1.000|4:27-I1.000|4:44-I1.000|4:15-I1.000|4:46-I1.000|4:03-I1.000|4:08-I1.000|4:11-I1.000|4:17-I1.000|4:17-I1.000|4:01-I1.000|4:40-I1.000|4:23-I1.000|4:43-I0.101|0:44,,Running,,,,"Polar M430",43,0,,0,168070,250480,30378,,,,,,,,,,,,,,,,,,,,,,,,,,,,,,,,,,,,,,,,,,"4,5,5,5",
5964751,b7b805d7-105e-487e-9c2e-bb6889df2fe5,1417430205,60,1548678796,,0,0,10.01,2414,2414,111,104,,,1,1.3,0.6,,,457,664,,,,,,,51.65,,1,,,,,,,,,,,,,,50,85,15.18,15.07,15.28,,,,,,,,,,,,,,,,,"0,0,0,2,13,32,50,3,0",,,,,,,146,,,,,,,,,,,,,,,,,,,,,,,,,,,,,,,,,,,,,2,12,57,92,,1012,,,0,4,3,,1,0,,,,,TDL,,"Polar BEAT",,0,,0,168070,250480,30378,,,,,,,,,,,,,,,,,,,,,,,,,,,,,,,,,,,,,,,,,,5,
5964752,,1452337380,60,1548678796,,0,0,7,0,0,,,,,0,,,,,,447,,,,,,,,,1,,,,,,,,,,,,,,0,,,,,,,,,,,,,,,,,,,,,,,,,,,,,,,,,,,,,,,,,,,,,,,,,,,,,,,,,,,,,,,,,,,,,,,,,,1,,,0,0,,,,,"Lousberg locker",,"Polar BEAT",,0,,0,168070,250480,30378,,,,,,,,,,,,,,,,,,,,,,,,,,,,,,,,,,,,,,,,,,,
5964753,377cdcba-6012-4360-8610-96500b0c55cb,1497547378,120,1548678797,,0,0,11.4,3588,3669,327,328,,,1,4,0.69,,,602,771,,,,,,,38.19,,1,,,,,,,,,,,,,,74,79,12.17,11.66,12.72,,,,,,,,,,,,,,,,,"6,14,14,32,25,8,0,0,0",,,,,,,121,,,,,,,,,,,,,,,,,,,,,,,,,,,,,,,,,,,,,25,5,238,58,,,3,,0,5,3,,1,0,,,,,"Balve Laufen",,"Polar BEAT",,0,,0,168070,250480,30378,,,,,,,,,,,,,,,,,,,,,,,,,,,,,,,,,,,,,,,,,,3,
5964754,6b34aba9-4d4c-4b25-80aa-0817f5a0c5f9,1547211416,60,1548678797,,0,0,5.08,1401,1401,7,4,,,1,0,0.05,,,,357,152,161,,,,62.04,42.35,62.19,1,,,,,,,,,,,,,,36,82,13.07,13.13,13.15,-2,,,,,,,,,,,,,,,,"0,1,3,8,52,32,5,0,0","0,2,97,1,0",,,,,,133,,,,,,,,,,,,,,,,,,,,,,,,,,,,,,,,,,,,34.5,0,22,200,86,,1027,1,328,0,4,3,,1,0,I1.000|4:31-I1.000|4:38-I1.000|4:46-I1.000|4:34-I1.000|4:29-I0.086|0:24,,Running,,,,"Polar M430",43,0,,0,168070,250480,30378,,,,,,,,,,,,,,,,,,,,,,,,,,,,,,,,,,,,,,,,,,,
5964755,c0a92b59-b1c6-4ef2-9ed3-479b74be2bd3,1541323413,60,1548678797,,0,0,1.01,327,328,4,8,,,1,0,0.2,0.98,0.93,,68,136,155,,,,58.76,30.29,58.76,1,,,,,,,,,,,,,,6,83,11.08,11.21,11.16,8.6,,,,,,,,,,,,,,,,"4,1,28,61,5,0,0,0,0","6,47,46,0,0",,,,,,112,,,,,,,,,,,,,,,,,,,,,,,,,,,,,,,,,,,,12.4,10,2,23,86,,1018,1,277,0,5,3,,1,0,I1.000|5:24-I0.015|0:05,,Running,,,,"Polar M430",43,0,,0,168070,250480,30378,,,,,,,,,,,,,,,,,,,,,,,,,,,,,,,,,,,,,,,,,,,
5964756,,1465583820,120,1548678797,,0,0,,0,0,,,,,0,,,,,,377,,,,,,,,,1,,,,,,,,,,,,,,0,,,,,,,,,,,,,,,,,,,,,,,,,,,,,,,,,,,,,,,,,,,,,,,,,,,,,,,,,,,,,,,,,,,,,,,,,,1,,,0,0,,,,,Gym,,"Polar BEAT",,0,,0,168075,,30378,,,,,,,,,,,,,,,,,,,,,,,,,,,,,,,,,,,,,,,,,,,
5964757,ebafcc62-6ddc-4c9c-9d79-9c07a0f5cbd2,1504460563,120,1548678798,,0,0,1.23,439,442,19,26,,,1,0,0.18,1.27,0.88,,86,136,154,,,,52.1,27.72,52.73,1,,,,,,,,,,,,,,7,77,10.13,10.31,10.47,-14.2,,,,,,,,,,,,,,,,"17,23,26,19,14,0,0,0,0","3,52,45,0,0",,,,,,109,,,,,,,,,,,,,,,,,,,,,,,,,,,,,,,,,,,,13.9,19,2,202,57,,1014,1,,0,5,3,,1,0,I1.000|6:13-I0.237|1:10,,Running,,,,"Polar M430",43,0,,0,168070,250480,30378,,,,,,,,,,,,,,,,,,,,,,,,,,,,,,,,,,,,,,,,,,,
5964758,745de2ce-b654-48d0-a406-e57fdb3866ef,1516373247,60,1548678798,,0,0,10.92,1935,1967,45,38,,,1,0,0.09,,,,302,117,133,,,,,,,1,,,,,,,,,,,,,,19,,,22.57,,24.2,-15.2,106,86,,1,127,114,,,,,,,,,"14,11,51,24,0,0,0","5,95,0,0,0","90,1,0,1,8",,,,,,,,,,,,,,,,,,,,,,,,,,,,,,,,,,,,,,,,,7.9,6,4,244,73,,,0,,0,5,3,,1,0,,,Cycling,,,,"Polar M430",43,0,,0,168072,,30378,,,,,,,,,,,,,,,,,,,,,,,,,,,,,,,,,,,,,,,,,,,
5964759,995b2491-0069-4b48-9a0d-622a2bb82cd9,1515139461,60,1548678799,,0,0,11.16,1626,1627,20,34,,,1,0,0.05,,,,281,137,169,,,,,,,1,,,,,,,,,,,,,,31,,,26.4,,12.4,-15.1,128,110,,1,146,132,,,,,,,,,"8,9,19,51,14,0,0","6,52,31,12,0","66,25,0,0,9",,,,,,,,,,,,,,,,,,,,,,,,,,,,,,,,,,,,,,,,,39.2,9,8,212,81,,,0,,0,5,3,,1,0,,,Cycling,,,,"Polar M430",43,0,,0,168072,,30378,,,,,,,,,,,,,,,,,,,,,,,,,,,,,,,,,,,,,,,,,,,
5964760,485f0408-ea6f-42c7-9546-2b791c2e4959,1424377462,60,1548678799,,0,0,2.21,773,773,28,22,,,1,1,0.54,,,,147,,,,,,,30.16,,1,,,,,,,,,,,,,,16,83,10.48,10.41,10.96,,,,,,,,,,,,,,,,,"17,23,32,23,5,1,0,0,0",,,,,,,103,,,,,,,,,,,,,,,,,,,,,,,,,,,,,,,,,,,,,1,8,199,85,,1025,0,,1,5,3,,1,0,,,,,"Aachen Laufen",,"Polar BEAT",,0,,0,168070,250480,30378,,,,,,,,,,,,,,,,,,,,,,,,,,,,,,,,,,,,,,,,,,,
5964761,2e852f13-fc9b-494e-bd51-e57964412eea,1407271221,120,1548678799,,0,0,6.56,1713,1723,0,2,,,1,0,0,,,,390,,,,,,,45.85,,1,,,,,,,,,,,,,,35,81,13.91,16.36,16.41,,,,,,,,,,,,,,,,,"32,1,1,2,2,2,3,48,10",,,,,,,142,,,,,,,,,,,,,,,,,,,,,,,,,,,,,,,,,,,,,21,1,256,61,,1019,0,,0,3,3,,1,0,,,,,"5x 1.000m, 500, 300",,"Polar BEAT",,0,,0,168070,250480,30378,,,,,,,,,,,,,,,,,,,,,,,,,,,,,,,,,,,,,,,,,,,
5964762,6dc8ac42-b4a9-4a01-b842-4ccb09def2f9,1445459089,120,1548678800,,0,0,12.6,3516,3516,174,175,,,1,2.1,0.6,,,394,862,,,,,,,44.28,,1,,,,,,,,,,,,,,73,82,13.15,13.08,13.39,,,,,,,,,,,,,,,,,"1,2,3,17,45,28,1,2,0",,,,,,,131,,,,,,,,,,,,,,,,,,,,,,,,,,,,,,,,,,,,,10,14,207,85,,1018,,,1,5,3,,1,0,,,,,"Aachen Laufen",,"Polar BEAT",,0,,0,168070,250480,30378,,,,,,,,,,,,,,,,,,,,,,,,,,,,,,,,,,,,,,,,,,4,
5964763,29dc882a-d3c2-409b-9996-9349bc76a1bf,1400585223,120,1548678800,,0,0,4.07,1303,1788,83,105,,,1,1.8,0.6,,,,276,,,,,,,35.03,,1,,,,,,,,,,,,,,27,83,11.45,11.42,11.73,,,,,,,,,,,,,,,,,"7,2,24,51,8,6,2,0,0",,,,,,,113,,,,,,,,,,,,,,,,,,,,,,,,,,,,,,,,,,,,,21,7,164,56,,1011,4,,0,5,3,,1,0,,,,,Auslaufen,,"Polar BEAT",,0,,0,168070,250480,30378,,,,,,,,,,,,,,,,,,,,,,,,,,,,,,,,,,,,,,,,,,,
5964764,74daeab8-3c6d-44f5-82c2-9a067d8b5d27,1418898932,60,1548678802,,0,0,13.26,3866,3866,294,294,,,1,3.8,0.7,,,547,890,,,,,,,42.25,,1,,,,,,,,,,,,,,80,83,12.94,12.54,13.36,,,,,,,,,,,,,,,,,"5,1,8,20,39,27,0,0,0",,,,,,,124,,,,,,,,,,,,,,,,,,,,,,,,,,,,,,,,,,,,,10,6,228,98,,,0,,0,5,3,,1,0,,,,,"Langsamer DL",,"Polar BEAT",,0,,0,168070,250480,30378,,,,,,,,,,,,,,,,,,,,,,,,,,,,,,,,,,,,,,,,,,"4,4,5,5",
5964765,859dd8a6-30e5-48f1-98f3-e12553da485d,1502991953,120,1548678802,,0,0,4.1,764,852,64,39,,,1,0.8,0.5,1.41,0.94,,109,114,150,,,,,,,1,,,,,,,,,,,,,,8,,,21.37,,39.1,29.6,127,121,,1,146,144,,,,,,,,,"18,42,30,4,2,2,1","28,57,15,0,0","83,4,4,0,9",,,,,,,,,,,,,,,,,,,,,,,,,,,,,,,,,,,,,,,,,10.5,20,18,229,83,,1015,,,0,5,3,,1,0,,,Cycling,,,,"Polar M430",43,0,,0,168072,,30378,,,,,,,,,,,,,,,,,,,,,,,,,,,,,,,,,,,,,,,,,,,
5964766,8eb3ae73-feec-4c7f-a7dd-e4f7aa53a249,1349002742,120,1548678805,,0,0,19.63,6323,6410,72,73,,,1,0,0.17,,,,1355,,,,,,,38.81,,1,,,,,,,,,,,,,,131,,11.23,11.96,12.04,,,,,,,,,,,,,,,,,"13,6,12,25,27,12,3,1,1",,,,,,,,,,,,,,,,,,,,,,,,,,,,,,,,,,,,,,,,,,,,10,7,68,94,,1023,2,,0,4,3,,1,0,,,,,,,"Polar BEAT",,0,,0,168070,250480,30378,,,,,,,,,,,,,,,,,,,,,,,,,,,,,,,,,,,,,,,,,,,
5964767,b8dfff41-9adc-4b31-9a54-0b0412f7509d,1444073648,120,1548678805,,0,0,4.67,1401,1401,77,79,,,1,1.2,0.4,,,,320,,,,,,,38.15,,1,,,,,,,,,,,,,,29,86,12.26,12.08,12.51,,,,,,,,,,,,,,,,,"0,0,16,36,38,9,0,0,0",,,,,,,116,,,,,,,,,,,,,,,,,,,,,,,,,,,,,,,,,,,,,14,10,137,87,,1008,,,1,5,3,,1,0,,,,,"Aachen Laufen",,"Polar BEAT",,0,,0,168070,250480,30378,,,,,,,,,,,,,,,,,,,,,,,,,,,,,,,,,,,,,,,,,,,
5964768,031ef470-71f4-46ba-822b-bc79611d9196,1509952772,60,1548678805,,0,0,11.64,3190,3194,49,50,,,1,0,0.1,1.1,0.95,,783,152,164,,,,62.52,44.96,62.84,1,,,,,,,,,,,,,,83,82,13.18,13.18,13.26,1.1,,,,,,,,,,,,,,,,"0,0,1,5,55,38,0,0,0","0,8,89,3,0",,,,,,133,,,,,,,,,,,,,,,,,,,,,,,,,,,,,,,,,,,,42.5,4,1,5,87,,,0,,0,5,3,,1,0,I1.000|4:58-I1.000|4:34-I1.000|4:39-I1.000|4:40-I1.000|4:34-I1.000|4:30-I1.000|4:36-I1.000|4:26-I1.000|4:21-I1.000|4:27-I1.000|4:28-I0.645|3:02,,Running,,,,"Polar M430",43,0,,0,168070,250480,30378,,,,,,,,,,,,,,,,,,,,,,,,,,,,,,,,,,,,,,,,,,,
5964769,88fadd1f-2458-41c0-b783-89fcdc0300a2,1469565796,120,1548678806,,0,0,4.93,1540,1580,50,69,,,1,0.9,0.47,,,,341,,,,,,,36.49,,1,,,,,,,,,,,,,,31,80,11.59,11.68,11.76,,,,,,,,,,,,,,,,,"6,3,11,41,34,5,0,0,0",,,,,,,120,,,,,,,,,,,,,,,,,,,,,,,,,,,,,,,,,,,,,20,0,54,73,,1020,0,,0,5,3,,1,0,,,,,"Aachen Laufen",,"Polar BEAT",,0,,0,168070,250480,30378,,,,,,,,,,,,,,,,,,,,,,,,,,,,,,,,,,,,,,,,,,,
5964770,6a78f6a6-e3ff-4b6e-ab30-e216549d7ad7,1440849087,120,1548678806,,0,0,11.87,3256,3300,173,173,,,1,2,0.54,,,426,814,,,,,,,44.98,,1,,,,,,,,,,,,,,67,83,13.43,13.44,13.78,,,,,,,,,,,,,,,,,"3,2,3,13,37,30,9,2,1",,,,,,,132,,,,,,,,,,,,,,,,,,,,,,,,,,,,,,,,,,,,,21,9,133,64,,1023,,,0,3,3,,1,0,,,,,"Balve Laufen",,"Polar BEAT",,0,,0,168070,250480,30378,,,,,,,,,,,,,,,,,,,,,,,,,,,,,,,,,,,,,,,,,,"5,5",
5964771,0b3b417a-b05f-4762-8db3-aac7e55863df,1470519163,120,1548678807,,0,0,6,1269,1269,20,21,,,1,0,0,,,,413,,,,,,,58.42,,1,,,,,,,,,,,,,,26,86,17.05,17.11,17.12,,,,,,,,,,,,,,,,,"0,0,0,0,0,1,54,45,0",,,,,,,165,,,,,,,,,,,,,,,,,,,,,,,,,,,,,,,,,,,,,18,2,309,75,,1029,0,,1,5,3,,1,0,,,,,"Eschweiler Laufen",,"Polar BEAT",,0,,0,168070,250480,30378,,,,,,,,,,,,,,,,,,,,,,,,,,,,,,,,,,,,,,,,,,,
5964772,2dccd861-295d-462f-8f01-f3f423ce746a,1401708167,120,1548678807,,0,0,10,2312,2321,132,125,,,1,1.7,0.62,,,425,656,,,,,,,54.26,,1,,,,,,,,,,,,,,48,86,15.79,15.64,16.1,,,,,,,,,,,,,,,,,"0,0,0,0,3,22,69,6,0",,,,,,,151,,,,,,,,,,,,,,,,,,,,,,,,,,,,,,,,,,,,,18,2,316,50,,1020,6,,0,3,3,,1,0,,,,,TDL,,"Polar BEAT",,0,,0,168070,250480,30378,,,,,,,,,,,,,,,,,,,,,,,,,,,,,,,,,,,,,,,,,,"5,5",
5964773,2bd57c0e-4190-4bc6-a837-0d6cabd1aede,1399727647,120,1548678807,,0,0,3.3,911,911,71,70,,,1,1.7,0.63,,,460,221,,,,,,,41.08,,1,,,,,,,,,,,,,,18,82,13.45,13.1,14.03,,,,,,,,,,,,,,,,,"0,2,1,19,41,30,6,0,0",,,,,,,133,,,,,,,,,,,,,,,,,,,,,,,,,,,,,,,,,,,,,11,10,209,91,,1011,5,,0,6,3,,1,0,,,,,"Einlaufen + Lauf ABC ",,"Polar BEAT",,0,,0,168070,250480,30378,,,,,,,,,,,,,,,,,,,,,,,,,,,,,,,,,,,,,,,,,,4,
5964774,aa9eed53-81ca-40c6-98e1-0d88f39b81af,1392389089,60,1548678808,,0,0,9.62,2801,2838,137,141,,,1,1.6,0.46,1.07,0.98,305,503,148,168,,,,60.14,41.33,61.17,1,,,,,,,,,,,,,,67,82,12.62,12.48,12.9,0.2,,,,,,,,,,,,,,,,"3,3,6,23,43,22,0,0,0","0,22,68,10,0",,,,,,126,,,,,,,,,,,,,,,,,,,,,,,,,,,,,,,,,,,,40.3,7,11,180,76,,1003,1,,0,5,3,,1,0,,,,,"Sehr lockerer DL",,"Polar BEAT",,0,,0,168070,250480,30378,,,,,,,,,,,,,,,,,,,,,,,,,,,,,,,,,,,,,,,,,,4,
5964775,4bdda90a-f811-4cc7-b294-3650aab872eb,1409258492,120,1548678808,,0,0,8.59,2613,2632,0,2,,,1,0,0.01,,,,470,,,,,,,38.95,,1,,,,,,,,,,,,,,54,79,12.04,14.61,14.6,,,,,,,,,,,,,,,,,"48,3,2,2,3,3,5,11,23",,,,,,,125,,,,,,,,,,,,,,,,,,,,,,,,,,,,,,,,,,,,,19,4,173,83,,1014,0,,1,5,3,,1,0,,,,,"10x 400m+ 500 300 500 300 200",,"Polar BEAT",,0,,0,168070,250480,30378,,,,,,,,,,,,,,,,,,,,,,,,,,,,,,,,,,,,,,,,,,,
5964777,e7f360ae-47cd-42e8-95a6-fa59b2c4a3ad,1462046908,120,1548678809,,0,0,3.33,1071,1225,29,30,,,1,0,0.18,,,,227,,,,,,,34.38,,1,,,,,,,,,,,,,,22,82,11.3,11.47,11.65,,,,,,,,,,,,,,,,,"14,4,12,28,40,1,0,0,0",,,,,,,114,,,,,,,,,,,,,,,,,,,,,,,,,,,,,,,,,,,,,7,4,21,86,,1021,0,,0,5,3,,1,0,,,,,"Aachen Laufen",,"Polar BEAT",,0,,0,168070,250480,30378,,,,,,,,,,,,,,,,,,,,,,,,,,,,,,,,,,,,,,,,,,,
5964778,9a7ea7ef-8c60-4e6d-8d90-da271cb988d5,1450532517,60,1548678810,,0,0,5.82,1872,2105,50,85,,,1,0.8,0.45,,,,398,,,,,,,35.58,,1,,,,,,,,,,,,,,38,79,11.1,11.87,11.88,,,,,,,,,,,,,,,,,"13,2,11,24,33,16,0,0,0",,,,,,,118,,,,,,,,,,,,,,,,,,,,,,,,,,,,,,,,,,,,,13,16,192,81,,1021,,,0,5,3,,1,0,,,,,"Aachen Laufen",,"Polar BEAT",,0,,0,168070,250480,30378,,,,,,,,,,,,,,,,,,,,,,,,,,,,,,,,,,,,,,,,,,,
5964779,a61c906f-42b6-4b30-988f-c9f0d577d7e2,1451215434,60,1548678810,,0,0,15.97,4606,4607,370,368,,,1,4.7,0.77,,,689,1093,,,,,,,43.41,,1,,,,,,,,,,,,,,95,80,13,13.33,14.34,,,,,,,,,,,,,,,,,"8,0,3,10,25,44,10,0,0",,,,,,,130,,,,,,,,,,,,,,,,,,,,,,,,,,,,,,,,,,,,,11,22,206,72,,1023,,,0,3,3,,1,0,,,,,"Balve Laufen",,"Polar BEAT",,0,,0,168070,250480,30378,,,,,,,,,,,,,,,,,,,,,,,,,,,,,,,,,,,,,,,,,,"4,4,5",
5964780,8478e0ac-211b-4bc0-9c9f-0442f4a17035,1445888599,60,1548678811,,0,0,5.03,1569,2009,88,68,,,1,1.2,0.44,,,,343,,,,,,,36.59,,1,,,,,,,,,,,,,,32,82,11.91,11.67,12.12,,,,,,,,,,,,,,,,,"7,3,18,33,33,6,0,0,0",,,,,,,117,,,,,,,,,,,,,,,,,,,,,,,,,,,,,,,,,,,,,10,9,121,89,,1017,,,1,3,3,,1,0,,,,,"Aachen Laufen",,"Polar BEAT",,0,,0,168070,250480,30378,,,,,,,,,,,,,,,,,,,,,,,,,,,,,,,,,,,,,,,,,,,
5964781,1c6929da-6c10-4067-8bcb-348d5849ec2d,1407584780,120,1548678812,,0,0,20.25,6041,6141,337,337,,,1,2.8,0.58,1.11,0.87,440,871,135,153,,,,65.6,42.55,66.95,1,,,,,,,,,,,,,,103,83,12.32,12.34,12.93,0.3,,,,,,,,,,,,,,,,"8,5,12,20,31,18,4,1,0","0,69,31,0,0",,,,,,121,,,,,,,,,,,,,,,,,,,,,,,,,,,,,,,,,,,,22.1,18,9,242,79,,1012,4,,0,5,3,,1,0,,,,,"Langsamer Langer DL",,"Polar BEAT",,0,,0,168070,250480,30378,,,,,,,,,,,,,,,,,,,,,,,,,,,,,,,,,,,,,,,,,,4,
5964782,4b7ba449-f15e-4418-979b-f0e59d900b10,1503169480,120,1548678813,,0,0,3.26,1130,1143,52,51,,,1,0.7,0.38,0.98,0.88,,218,135,157,,,,54.5,31.42,55.6,1,,,,,,,,,,,,,,19,78,10.68,11.12,11.46,-1.1,,,,,,,,,,,,,,,,"22,20,22,26,3,1,2,5,0","2,68,30,0,0",,,,,,111,,,,,,,,,,,,,,,,,,,,,,,,,,,,,,,,,,,,15.3,15,5,248,88,,1020,0,,0,6,3,,1,0,I2.298|13:33-I0.413|1:22-I0.552|4:10,,Running,,,,"Polar M430",43,0,,0,168070,250480,30378,,,,,,,,,,,,,,,,,,,,,,,,,,,,,,,,,,,,,,,,,,,
5964783,2ca7191d-1724-474b-981c-0c143f6fe6c4,1544551838,60,1548678813,,0,0,15.36,3875,3896,54,53,,,1,0,0.11,1.15,0.91,,970,151,181,,,,69.9,50.54,70.21,1,,,,,,,,,,,,,,103,83,14.31,14.55,14.63,7,,,,,,,,,,,,,,,,"0,1,3,6,13,50,17,9,0","0,23,51,26,0",,,,,,143,,,,,,,,,,,,,,,,,,,,,,,,,,,,,,,,,,,,76.8,3,6,249,80,,1024,0,315,1,6,3,,1,0,I8.501|36:33-I0.991|3:35-I0.434|2:00-I1.036|3:37-I0.455|2:03-I1.042|3:41-I0.463|1:56-I1.024|3:42-I1.414|7:51,,Running,,,,"Polar M430",43,0,,0,168070,250480,30378,,,,,,,,,,,,,,,,,,,,,,,,,,,,,,,,,,,,,,,,,,,
5964784,17bdeb88-c370-452d-99fe-ea2d40edb7ae,1531160751,120,1548678814,,0,0,14.01,4189,4189,48,51,,,1,0,0.03,1.15,0.95,,965,143,155,,,,60.87,41.2,61.12,1,,,,,,,,,,,,,,88,80,12.06,12.09,12.15,7.8,,,,,,,,,,,,,,,,"0,1,5,42,48,3,0,0,0","0,19,81,0,0",,,,,,125,,,,,,,,,,,,,,,,,,,,,,,,,,,,,,,,,,,,29.6,27,12,9,36,,1019,,,0,5,3,,1,0,I1.000|5:01-I1.000|4:47-I1.000|4:55-I1.000|5:02-I1.000|4:49-I1.000|4:54-I1.000|5:06-I1.000|4:58-I1.000|5:03-I1.000|5:14-I1.000|5:11-I1.000|5:04-I1.000|4:51-I1.000|4:53-I0.014|0:04,,Running,,,,"Polar M430",43,0,,0,168070,250480,30378,,,,,,,,,,,,,,,,,,,,,,,,,,,,,,,,,,,,,,,,,,,
5964785,24dbe4e2-aeb9-4a41-abb2-3f85e399977f,1396987771,120,1548678814,,0,0,3.33,950,950,65,65,,,1,1.6,0.58,1.11,1.04,441,169,146,166,,,,62.79,39.57,64.31,1,,,,,,,,,,,,,,21,81,13,12.72,13.53,-5.4,,,,,,,,,,,,,,,,"0,2,8,29,31,22,8,0,0","1,34,54,11,0",,,,,,130,,,,,,,,,,,,,,,,,,,,,,,,,,,,,,,,,,,,28.1,8,10,258,73,,1022,0,,0,5,3,,1,0,,,,,Einlaufen,,"Polar BEAT",,0,,0,168070,250480,30378,,,,,,,,,,,,,,,,,,,,,,,,,,,,,,,,,,,,,,,,,,5,
5964786,77118d51-2ee1-42d1-9d0c-7ad720635c29,1400840807,120,1548678815,,0,0,10,2334,2354,115,108,,,1,1.1,0.49,,,486,659,,,,,,,53.66,,1,,,,,,,,,,,,,,48,86,15.66,15.53,15.79,,,,,,,,,,,,,,,,,"0,1,0,0,5,23,65,6,0",,,,,,,149,,,,,,,,,,,,,,,,,,,,,,,,,,,,,,,,,,,,,15,5,208,81,,1010,4,,0,5,3,,1,0,,,,,TDL,,"Polar BEAT",,0,,0,168070,250480,30378,,,,,,,,,,,,,,,,,,,,,,,,,,,,,,,,,,,,,,,,,,5,
5964787,01b04808-11de-48b9-a135-11d9b79c7fd2,1401574832,120,1548678817,,0,0,4.76,1285,1285,52,58,,,1,1.6,0.66,,,,276,,,,,,,43.26,,1,,,,,,,,,,,,,,26,83,13.5,15.67,15.91,,,,,,,,,,,,,,,,,"23,9,9,6,4,4,6,22,18",,,,,,,134,,,,,,,,,,,,,,,,,,,,,,,,,,,,,,,,,,,,,15,0,292,62,,,0,,1,3,3,,1,0,,,,,"2x (800,400,200,100)",,"Polar BEAT",,0,,0,168070,250480,30378,,,,,,,,,,,,,,,,,,,,,,,,,,,,,,,,,,,,,,,,,,,
5964788,073aa147-db20-4dac-803a-968f642b5c8a,1392555004,60,1548678819,,0,0,7.8,1687,1698,46,47,,,1,0,0.13,,,,503,,,,,,,57.8,,1,,,,,,,,,,,,,,35,87,16.72,17.13,17.25,,,,,,,,,,,,,,,,,"4,0,0,0,0,0,56,34,5",,,,,,,159,,,,,,,,,,,,,,,,,,,,,,,,,,,,,,,,,,,,,9,28,246,60,,1008,,,0,5,3,,1,0,,,,,"WK 8k",,"Polar BEAT",,0,,0,168070,250480,30378,,,,,,,,,,,,,,,,,,,,,,,,,,,,,,,,,,,,,,,,,,,
5964789,68a90da0-6ae3-4734-b639-1571c5d39a25,1403901121,120,1548678820,,0,0,15.28,3258,3258,372,374,,,1,3.8,0.66,,,1130,1022,,,,,,,61.39,,1,,,,,,,,,,,,,,67,86,17.34,16.93,17.9,,,,,,,,,,,,,,,,,"0,0,0,1,2,6,46,46,0",,,,,,,164,,,,,,,,,,,,,,,,,,,,,,,,,,,,,,,,,,,,,17,1,217,76,,,0,,0,3,3,,1,0,,,,,"WK 15k Sorpe Abendlauf",,"Polar BEAT",,0,,0,168070,250480,30378,,,,,,,,,,,,,,,,,,,,,,,,,,,,,,,,,,,,,,,,,,"5,5,5,5",
5964790,ecf2be81-4cc2-4352-96ad-d93b9b300f55,1399120551,120,1548678820,,0,0,9.42,2820,3117,122,124,,,1,1.3,0.3,,,349,627,,,,,,,39.94,,1,,,,,,,,,,,,,,58,82,12.36,12.18,12.89,,,,,,,,,,,,,,,,,"3,6,8,34,35,11,3,0,0",,,,,,,122,,,,,,,,,,,,,,,,,,,,,,,,,,,,,,,,,,,,,11,10,31,50,,1025,6,,0,3,3,,1,0,,,,,"Einlaufen + Lauf ABC ",,"Polar BEAT",,0,,0,168070,250480,30378,,,,,,,,,,,,,,,,,,,,,,,,,,,,,,,,,,,,,,,,,,"4,5",
5964791,aea63f4c-a47a-4fe6-8f2b-d301b236a25e,1431939084,120,1548678821,,0,0,5.78,1907,1907,102,89,,,1,1.9,0.51,,,238,392,,,,,,,34.51,,1,,,,,,,,,,,,,,39,82,11.19,11,11.61,,,,,,,,,,,,,,,,,"11,10,22,45,12,0,0,0,0",,,,,,,111,,,,,,,,,,,,,,,,,,,,,,,,,,,,,,,,,,,,,12,8,225,74,,1014,2,,0,5,3,,1,0,,,,,"Aachen Laufen",,"Polar BEAT",,0,,0,168070,250480,30378,,,,,,,,,,,,,,,,,,,,,,,,,,,,,,,,,,,,,,,,,,4,
5964792,57af5311-505f-4f32-a5b7-38a68b87aae0,1545743374,60,1548678822,,0,0,11.69,3567,3570,259,303,,,1,3.3,0.67,1,0.99,453,866,151,181,,,,55.25,39.68,56.51,1,,,,,,,,,,,,,,91,81,12.45,12.34,12.79,1.9,,,,,,,,,,,,,,,,"13,13,11,13,18,24,8,1,0","0,17,69,14,0",,,,,,121,,,,,,,,,,,,,,,,,,,,,,,,,,,,,,,,,,,,55.8,5,16,255,82,,1035,0,264,0,4,3,,1,0,I1.000|5:35-I1.000|4:42-I1.000|4:34-I1.000|4:57-I1.000|5:53-I1.000|4:40-I1.000|4:39-I1.000|6:07-I1.000|4:26-I1.000|5:13-I1.000|6:01-I0.693|2:44,,Running,,,,"Polar M430",43,0,,0,168070,250480,30378,,,,,,,,,,,,,,,,,,,,,,,,,,,,,,,,,,,,,,,,,,"4,4,5",
5964793,f5682da5-e5fd-494d-9e46-e3e2d5c247c5,1526205916,120,1548678823,,0,0,20.57,6323,6326,67,64,,,1,0,0.1,1.09,0.98,,1468,147,160,,,,56.75,41.14,56.99,1,,,,,,,,,,,,,,146,80,11.75,11.83,11.91,1.9,,,,,,,,,,,,,,,,"3,3,9,46,38,3,0,0,0","0,8,92,0,0",,,,,,122,,,,,,,,,,,,,,,,,,,,,,,,,,,,,,,,,,,,37.8,16,4,251,88,,,3,,0,4,3,,1,0,I1.000|5:05-I1.000|5:01-I1.000|5:04-I1.000|5:00-I1.000|5:05-I1.000|5:08-I1.000|4:58-I1.000|5:06-I1.000|5:03-I1.000|4:52-I1.000|5:10-I1.000|4:56-I1.000|5:20-I1.000|5:03-I1.000|5:04-I1.000|5:06-I1.000|5:05-I1.000|4:55-I1.000|5:09-I1.000|6:24-I0.568|2:54,,Running,,,,"Polar M430",43,0,,0,168070,250480,30378,,,,,,,,,,,,,,,,,,,,,,,,,,,,,,,,,,,,,,,,,,,
5964794,5d5e853e-cb7a-4cfc-a6d5-fb2820b7003e,1508003406,120,1548678823,,0,0,6.16,1919,1921,110,107,,,1,1.7,0.51,1.08,0.97,,401,138,172,,,,60.52,37.09,61.9,1,,,,,,,,,,,,,,36,81,11.89,11.98,12.26,0.5,,,,,,,,,,,,,,,,"7,9,21,35,15,4,8,1,0","1,56,39,4,0",,,,,,119,,,,,,,,,,,,,,,,,,,,,,,,,,,,,,,,,,,,31.2,20,6,213,67,,1026,,,0,3,3,,1,0,I1.000|5:50-I1.000|5:19-I1.000|4:47-I1.000|4:08-I1.000|5:37-I1.000|5:26-I0.163|0:54,,Running,,,,"Polar M430",43,0,,0,168070,250480,30378,,,,,,,,,,,,,,,,,,,,,,,,,,,,,,,,,,,,,,,,,,,
5964795,a221e031-53a8-4643-a02f-5d67e1cf6655,1500380957,120,1548678823,,0,0,0.62,212,212,8,5,,,1,0,0,,,,42,,,,,,,27.01,,1,,,,,,,,,,,,,,4,79,10.75,10.55,10.94,,,,,,,,,,,,,,,,,"5,23,40,32,0,0,0,0,0",,,,,,,111,,,,,,,,,,,,,,,,,,,,,,,,,,,,,,,,,,,,,29,9,177,34,,1019,9,,0,3,3,,1,0,,,,,"Aix-en-Provence Laufen",,"Polar BEAT",,0,,0,168070,250480,30378,,,,,,,,,,,,,,,,,,,,,,,,,,,,,,,,,,,,,,,,,,,
5964796,9a062a91-1639-4c46-8870-58eb8bf8325f,1535794036,120,1548678824,,0,0,7.56,2382,2382,37,40,,,1,0,0.19,1.1,0.93,,508,136,149,,,,60.76,37.06,61.1,1,,,,,,,,,,,,,,42,81,11.46,11.48,11.57,-1.9,,,,,,,,,,,,,,,,"2,6,15,54,21,1,0,0,0","2,73,25,0,0",,,,,,118,,,,,,,,,,,,,,,,,,,,,,,,,,,,,,,,,,,,18.2,14,15,30,77,,,2,,0,3,3,,1,0,I1.000|5:10-I1.000|5:04-I1.000|5:26-I1.000|5:12-I1.000|5:21-I1.000|5:30-I1.000|5:08-I0.561|2:52,,Running,,,,"Polar M430",43,0,,0,168070,250480,30378,,,,,,,,,,,,,,,,,,,,,,,,,,,,,,,,,,,,,,,,,,,
5964797,3b6030e4-bccd-4553-8c29-eb518aa26046,1408567245,120,1548678824,,0,0,12.65,3330,3330,176,173,,,1,2,0.54,,,417,854,,,,,,,47.41,,1,,,,,,,,,,,,,,69,83,13.98,13.83,14.11,,,,,,,,,,,,,,,,,"1,1,3,6,27,44,19,0,0",,,,,,,137,,,,,,,,,,,,,,,,,,,,,,,,,,,,,,,,,,,,,11,4,242,91,,1017,,,1,5,3,,1,0,,,,,"Lockerer DL",,"Polar BEAT",,0,,0,168070,250480,30378,,,,,,,,,,,,,,,,,,,,,,,,,,,,,,,,,,,,,,,,,,4,
5964798,ef9f0a58-6519-4f99-bd98-f63bad495cba,1409145805,120,1548678825,,0,0,9.65,2803,2803,127,128,,,1,1.2,0.59,,,425,663,,,,,,,41.45,,1,,,,,,,,,,,,,,58,81,12.61,12.45,12.81,,,,,,,,,,,,,,,,,"1,0,6,29,48,15,1,0,0",,,,,,,128,,,,,,,,,,,,,,,,,,,,,,,,,,,,,,,,,,,,,18,6,119,77,,1016,5,,0,5,3,,1,0,,,,,"Regenerativer DL ",,"Polar BEAT",,0,,0,168070,250480,30378,,,,,,,,,,,,,,,,,,,,,,,,,,,,,,,,,,,,,,,,,,5,
5964799,aa4b28e3-75e2-4968-98ab-c048d84fae5d,1438891921,120,1548678825,,0,0,3.34,991,991,61,61,,,1,1.5,0.58,,,423,221,,,,,,,37.81,,1,,,,,,,,,,,,,,20,82,12.51,12.24,13.04,,,,,,,,,,,,,,,,,"2,6,9,29,33,21,0,0,0",,,,,,,123,,,,,,,,,,,,,,,,,,,,,,,,,,,,,,,,,,,,,24,6,292,49,,1015,,,0,3,3,,1,0,,,,,"Aachen Laufen",,"Polar BEAT",,0,,0,168070,250480,30378,,,,,,,,,,,,,,,,,,,,,,,,,,,,,,,,,,,,,,,,,,5,
5964800,2ca22c7e-6de6-4ddf-90ea-796d491ffcdb,1526580543,120,1548678826,,0,0,15.08,3685,3685,41,40,,,1,0,0.04,,,,1056,168,180,,,,62.39,52.37,62.6,1,,,,,,,,,,,,,,139,84,14.77,14.82,14.87,6.9,,,,,,,,,,,,,,,,"0,0,0,2,8,47,41,2,0","0,2,25,73,0",,,,,,146,,,,,,,,,,,,,,,,,,,,,,,,,,,,,,,,,,,,103.5,19,6,21,62,,1018,,,0,5,3,,1,0,I1.000|4:18-I1.000|4:21-I1.000|4:25-I1.000|4:08-I1.000|3:58-I1.000|3:54-I1.000|3:59-I1.000|3:50-I1.000|4:06-I1.000|4:02-I1.000|3:53-I1.000|3:46-I1.000|4:04-I1.000|4:04-I1.000|4:12-I0.088|0:24,,Running,,,,"Polar M430",43,0,,0,168070,250480,30378,,,,,,,,,,,,,,,,,,,,,,,,,,,,,,,,,,,,,,,,,,,
5964801,f0658bc8-1b6f-4a15-8c8d-22b83f4f9440,1401826306,120,1548678826,,0,0,3.35,906,906,67,69,,,1,1.7,0.64,,,442,216,,,,,,,42.12,,1,,,,,,,,,,,,,,18,82,13.68,13.51,14.34,,,,,,,,,,,,,,,,,"5,1,2,17,21,33,22,0,0",,,,,,,135,,,,,,,,,,,,,,,,,,,,,,,,,,,,,,,,,,,,,15,6,235,81,,1013,,,0,5,3,,1,0,,,,,Einlaufen,,"Polar BEAT",,0,,0,168070,250480,30378,,,,,,,,,,,,,,,,,,,,,,,,,,,,,,,,,,,,,,,,,,4,
5964802,526ab5af-822d-4daa-b0c6-82373363adb3,1438288198,120,1548678826,,0,0,2.79,775,785,28,39,,,1,0.8,0.43,,,,149,,,,,,,40.21,,1,,,,,,,,,,,,,,16,81,13.25,15.46,15.46,,,,,,,,,,,,,,,,,"35,5,4,3,4,5,6,11,29",,,,,,,133,,,,,,,,,,,,,,,,,,,,,,,,,,,,,,,,,,,,,12,5,281,90,,1019,,,0,5,3,,1,0,,,,,"Aachen Laufen",,"Polar BEAT",,0,,0,168070,250480,30378,,,,,,,,,,,,,,,,,,,,,,,,,,,,,,,,,,,,,,,,,,,
5964803,99088fcb-5489-4c67-93aa-b924dfd26690,1501095550,120,1548678827,,0,0,11.27,3503,3536,180,230,,,1,1.4,0.57,0.96,0.81,,661,147,187,,,,55.98,38.72,56.78,1,,,,,,,,,,,,,,84,82,11.81,13.61,13.78,21,,,,,,,,,,,,,,,,"25,12,18,13,7,2,3,14,7","0,36,41,21,2",,,,,,118,,,,,,,,,,,,,,,,,,,,,,,,,,,,,,,,,,,,57.5,22,6,232,59,,1009,1,,0,5,3,,1,0,I0.982|3:11-I0.592|3:28-I0.503|1:34-I0.507|3:12-I0.508|1:31-I0.534|3:20-I0.497|1:33-I0.517|3:12-I0.502|1:32-I0.519|3:17-I0.500|1:34-I0.519|3:17-I0.513|1:32-I0.507|3:10-I0.543|1:44-I0.178|5:17-I2.842|16:35,,Running,,,,"Polar M430",43,0,,0,168070,250480,30378,,,,,,,,,,,,,,,,,,,,,,,,,,,,,,,,,,,,,,,,,,,
5964804,b07ca49e-3482-436a-bad2-3ead77fcde94,1513758338,60,1548678827,,0,0,6.21,1541,1549,4,4,,,1,0,0,,,,394,158,175,,,,66.98,48.53,67.03,1,,,,,,,,,,,,,,47,84,14.52,14.56,14.57,2,,,,,,,,,,,,,,,,"0,0,1,1,6,61,31,0,0","1,5,48,46,0",,,,,,144,,,,,,,,,,,,,,,,,,,,,,,,,,,,,,,,,,,,61.2,8,3,240,100,,1031,,,1,9,3,,1,0,I3.019|13:01-I3.196|12:51,,Running,,,,"Polar M430",43,0,,0,168070,250480,30378,,,,,,,,,,,,,,,,,,,,,,,,,,,,,,,,,,,,,,,,,,,
5964806,fc45028f-5362-4341-83db-0b7306507ea5,1473284005,120,1548678827,,0,0,13,3462,3505,185,188,,,1,2.3,0.67,,,417,877,,,,,,,46.87,,1,,,,,,,,,,,,,,71,83,13.78,13.72,14.05,,,,,,,,,,,,,,,,,"1,0,4,6,28,47,12,2,0",,,,,,,136,,,,,,,,,,,,,,,,,,,,,,,,,,,,,,,,,,,,,20,2,91,68,,1016,0,,1,3,3,,1,0,,,,,"Aachen Laufen",,"Polar BEAT",,0,,0,168070,250480,30378,,,,,,,,,,,,,,,,,,,,,,,,,,,,,,,,,,,,,,,,,,4,
5964807,c55aae98-7aa9-42a8-b4f1-25b68aabdc51,1394134399,60,1548678828,,0,0,4.35,1199,1205,5,8,,,1,0,0.02,0.53,0.67,,253,162,185,,,,56.75,41.97,56.78,1,,,,,,,,,,,,,,41,84,13.2,14.79,14.79,5.8,,,,,,,,,,,,,,,,"30,6,5,5,4,5,6,28,11","0,17,23,48,11",,,,,,130,,,,,,,,,,,,,,,,,,,,,,,,,,,,,,,,,,,,74.5,6,7,157,66,,1028,,,1,3,3,,1,0,,,,,"2x ( 500 300 500 300 )",,"Polar BEAT",,0,,0,168070,250480,30378,,,,,,,,,,,,,,,,,,,,,,,,,,,,,,,,,,,,,,,,,,,
5964808,9d9a22e1-b636-461a-b684-aa46e4a598f8,1541854703,60,1548678828,,0,0,1.71,537,538,15,8,,,1,0.7,0.53,1.2,0.72,,104,131,149,,,,63.82,33.29,64.84,1,,,,,,,,,,,,,,8,82,11.61,11.69,12.03,-0.4,,,,,,,,,,,,,,,,"7,3,4,52,26,7,0,0,0","4,86,9,0,0",,,,,,117,,,,,,,,,,,,,,,,,,,,,,,,,,,,,,,,,,,,11.4,11,5,110,84,,,1,,0,5,3,,1,0,I1.000|5:26-I0.714|3:34,,Running,,,,"Polar M430",43,0,,0,168070,250480,30378,,,,,,,,,,,,,,,,,,,,,,,,,,,,,,,,,,,,,,,,,,,
5964810,ab839ca4-38fd-4b89-9c25-919e11fc4b70,1526828809,120,1548678831,,0,0,15.03,4642,4647,46,44,,,1,0,0.06,1.05,0.95,,1019,142,171,,,,59.01,39.9,59.25,1,,,,,,,,,,,,,,95,81,11.69,11.81,11.86,4.9,,,,,,,,,,,,,,,,"3,3,18,45,23,4,3,0,0","0,35,63,2,0",,,,,,120,,,,,,,,,,,,,,,,,,,,,,,,,,,,,,,,,,,,35.3,17,20,46,82,,1019,,,0,6,3,,1,0,I1.000|5:22-I1.000|5:12-I1.000|5:11-I1.000|5:04-I1.000|4:57-I1.000|5:13-I1.000|5:00-I1.000|5:03-I1.000|5:12-I1.000|5:18-I1.000|5:14-I1.000|5:30-I1.000|5:29-I1.000|4:02-I1.000|5:30-I0.026|0:12,,Running,,,,"Polar M430",43,0,,0,168070,250480,30378,,,,,,,,,,,,,,,,,,,,,,,,,,,,,,,,,,,,,,,,,,,
5964812,6057503c-bc86-4bf7-80e8-646b71c1cc00,1505916662,120,1548678832,,0,0,7.9,6491,6859,183,46,,,1,1.6,0.36,,,140,905,109,136,,,,,,,1,,,,,,,,,,,,,,54,,,5.36,,6.5,,,,,,,,,,,,,,,,"47,52,1,0,0,0","23,77,0,0,0",,,,,,,,,,,,,,,,,,,,,,,,,,,,,,,,,,,,,,,,,,8.2,15,8,246,68,,1022,3,,0,5,3,,1,0,I1.000|12:21-I1.000|13:10-I1.000|14:02-I1.000|14:45-I1.000|12:09-I1.000|16:01-I1.000|14:37-I1.000|17:15,,Hiking,,,,"Polar M430",43,0,,0,168075,,30378,,,,,,,,,,,,,,,,,,,,,,,,,,,,,,,,,,,,,,,,,,4,
5964813,f6001191-70d0-4717-8bb7-b24aaab7dc09,1537003982,120,1548678832,,0,0,4.02,1336,1336,17,24,,,1,0,0.1,1.06,0.88,,254,130,151,,,,60.04,33.48,60.23,1,,,,,,,,,,,,,,20,80,10.81,11,11.04,-1.1,,,,,,,,,,,,,,,,"8,12,32,32,13,3,0,0,0","3,80,17,0,0",,,,,,113,,,,,,,,,,,,,,,,,,,,,,,,,,,,,,,,,,,,16.1,16,9,209,73,,1025,,,0,3,3,,1,0,I1.000|5:43-I1.000|5:23-I1.000|5:35-I1.000|5:30-I0.021|0:07,,Running,,,,"Polar M430",43,0,,0,168070,250480,30378,,,,,,,,,,,,,,,,,,,,,,,,,,,,,,,,,,,,,,,,,,,
5964814,502b97fc-7f5a-45a6-ac90-daf3cd08ee41,1503646815,120,1548678832,,0,0,0.39,173,175,9,0,,,1,0.7,0.48,1.55,1.2,,30,128,148,,,,42.81,19.03,45.26,1,,,,,,,,,,,,,,2,82,8.67,8.09,9.3,-26.6,,,,,,,,,,,,,,,,"71,12,12,5,0,0,0,0,0","13,50,36,0,0",,,,,,82,,,,,,,,,,,,,,,,,,,,,,,,,,,,,,,,,,,,4.9,13,2,113,91,,1019,0,,0,5,3,,1,0,,,Running,,,,"Polar M430",43,0,,0,168070,250480,30378,,,,,,,,,,,,,,,,,,,,,,,,,,,,,,,,,,,,,,,,,,,
5964815,,1428923340,120,1548678832,,0,0,15,0,0,,,,,0,,,,,,1019,,,,,,,,,1,,,,,,,,,,,,,,0,,,,,,,,,,,,,,,,,,,,,,,,,,,,,,,,,,,,,,,,,,,,,,,,,,,,,,,,,,,,,,,,,,,,,,,,,,1,,,0,0,,,,,Laufen,,"Polar BEAT",,0,,0,168070,250480,30378,,,,,,,,,,,,,,,,,,,,,,,,,,,,,,,,,,,,,,,,,,,
5964816,c28aa550-79ec-4c01-9e56-fd7c5f4396cd,1510250921,60,1548678833,,0,0,11.9,3084,3084,40,39,,,1,0,0.08,,0.96,,802,158,170,,,,63.48,48.06,63.75,1,,,,,,,,,,,,,,91,82,13.93,13.99,14.05,0.3,,,,,,,,,,,,,,,,"1,1,1,4,17,67,10,0,0","0,3,61,35,0",,,,,,141,,,,,,,,,,,,,,,,,,,,,,,,,,,,,,,,,,,,55.4,7,2,212,94,,1025,,,1,9,3,,1,0,I1.000|4:59-I1.000|4:30-I1.000|4:08-I1.000|4:14-I1.000|4:17-I1.000|4:23-I1.000|4:05-I1.000|4:18-I1.000|4:12-I1.000|4:10-I1.000|4:14-I0.898|3:56,,Running,,,,"Polar M430",43,0,,0,168070,250480,30378,,,,,,,,,,,,,,,,,,,,,,,,,,,,,,,,,,,,,,,,,,,
5964817,b1f5cd84-f6a2-4acf-bd53-155c2c694d81,1431166277,120,1548678834,,0,0,3.96,1542,1543,93,42,,,1,1.7,0.49,,,233,268,,,,,,,27.65,,1,,,,,,,,,,,,,,32,77,9.72,10.76,11.85,,,,,,,,,,,,,,,,,"20,10,22,28,18,2,0,0,0",,,,,,,100,,,,,,,,,,,,,,,,,,,,,,,,,,,,,,,,,,,,,15,14,240,74,,1017,3,,0,5,3,,1,0,,,,,"Aachen Laufen",,"Polar BEAT",,0,,0,168070,250480,30378,,,,,,,,,,,,,,,,,,,,,,,,,,,,,,,,,,,,,,,,,,4,
5964818,873b9a05-0d9f-45fa-8fc3-7859ae3eee49,1431077452,120,1548678835,,0,0,7.26,2246,2320,99,110,,,1,1.4,0.53,,,357,508,,,,,,,37.77,,1,,,,,,,,,,,,,,46,82,12.01,11.93,12.32,,,,,,,,,,,,,,,,,"8,3,8,28,48,6,0,0,0",,,,,,,118,,,,,,,,,,,,,,,,,,,,,,,,,,,,,,,,,,,,,12,7,146,62,,1016,,,0,5,3,,1,0,,,,,"Aachen Laufen",,"Polar BEAT",,0,,0,168070,250480,30378,,,,,,,,,,,,,,,,,,,,,,,,,,,,,,,,,,,,,,,,,,5,
5964819,95e5e16c-a169-4cdd-94a9-1428bdbc8d4d,1436884769,120,1548678835,,0,0,10.18,2473,2473,217,218,,,1,2.7,1,,,,677,,,,,,,51.27,,1,,,,,,,,,,,,,,51,84,15.02,15.78,16.41,,,,,,,,,,,,,,,,,"12,2,3,5,7,4,25,42,0",,,,,,,147,,,,,,,,,,,,,,,,,,,,,,,,,,,,,,,,,,,,,19,19,257,82,,1018,,,0,5,3,,1,0,,,,,"Aachen Laufen",,"Polar BEAT",,0,,0,168070,250480,30378,,,,,,,,,,,,,,,,,,,,,,,,,,,,,,,,,,,,,,,,,,,
5964820,604bb1ca-3f74-41d4-96df-0870a35c1626,1477078083,120,1548678835,,0,0,0.69,183,183,13,17,,,1,1.3,1,,,,47,,,,,,,36.54,,1,,,,,,,,,,,,,,3,82,13.92,13.88,13.72,,,,,,,,,,,,,,,,,"16,9,3,9,14,24,15,1,9",,,,,,,138,,,,,,,,,,,,,,,,,,,,,,,,,,,,,,,,,,,,,7,4,239,90,,1017,0,,1,5,3,,1,0,,,,,"Aachen Laufen",,"Polar BEAT",,0,,0,168070,250480,30378,,,,,,,,,,,,,,,,,,,,,,,,,,,,,,,,,,,,,,,,,,,
5964821,55bef69d-2a09-41c8-9312-8eef5f3c49a7,1417547520,60,1548678836,,0,0,15.53,4144,4635,144,145,,,1,1.4,0.51,,,,1032,,,,,,,47.4,,1,,,,,,,,,,,,,,86,84,13.6,14.4,14.61,,,,,,,,,,,,,,,,,"8,1,9,10,13,16,35,8,0",,,,,,,134,,,,,,,,,,,,,,,,,,,,,,,,,,,,,,,,,,,,,0,6,26,95,,1016,0,,1,5,3,,1,0,,,,,"Dreifach + Doppel",,"Polar BEAT",,0,,0,168070,250480,30378,,,,,,,,,,,,,,,,,,,,,,,,,,,,,,,,,,,,,,,,,,,
5964823,0e66da12-14a8-4bcf-8e10-41e0c9a4b8a5,1408531358,120,1548678838,,0,0,18.58,5277,5372,220,219,,,1,2,0.53,,,406,1272,,,,,,,44.74,,1,,,,,,,,,,,,,,109,82,12.9,12.78,13.04,,,,,,,,,,,,,,,,,"1,1,6,12,53,25,1,0,0",,,,,,,129,,,,,,,,,,,,,,,,,,,,,,,,,,,,,,,,,,,,,14,5,224,74,,1017,3,,0,3,3,,1,0,,,,,"Regenerativer DL",,"Polar BEAT",,0,,0,168070,250480,30378,,,,,,,,,,,,,,,,,,,,,,,,,,,,,,,,,,,,,,,,,,4,
5964824,286804d3-82c2-41d2-8b6b-508f83315fb3,1407703619,120,1548678838,,0,0,2.58,848,865,45,26,,,1,1,0.47,1.12,1.03,413,153,137,156,,,,57.16,32.87,58.91,1,,,,,,,,,,,,,,15,79,11.35,11.37,11.91,7.7,,,,,,,,,,,,,,,,"11,10,12,31,35,0,0,0,0","1,52,47,0,0",,,,,,116,,,,,,,,,,,,,,,,,,,,,,,,,,,,,,,,,,,,19.1,19,12,247,86,,1004,0,,0,6,3,,1,0,,,,,Einlaufen,,"Polar BEAT",,0,,0,168070,250480,30378,,,,,,,,,,,,,,,,,,,,,,,,,,,,,,,,,,,,,,,,,,5,
5964825,99c9d0ba-eb6e-44b2-8230-e0c0fdb2b196,1420482137,60,1548678839,,0,0,13.66,3798,4114,169,169,,,1,1.4,0.41,,,593,926,,,,,,,44.75,,1,,,,,,,,,,,,,,78,84,13.17,13.15,13.42,,,,,,,,,,,,,,,,,"2,2,5,11,39,34,7,0,0",,,,,,,128,,,,,,,,,,,,,,,,,,,,,,,,,,,,,,,,,,,,,2,3,190,86,,1032,0,,1,5,3,,1,0,,,,,"Lockerer DL",,"Polar BEAT",,0,,0,168070,250480,30378,,,,,,,,,,,,,,,,,,,,,,,,,,,,,,,,,,,,,,,,,,5,
5964826,02dc0c80-7345-4e2d-93e7-56ccfd403d52,1535195802,120,1548678840,,0,0,8.68,2614,2615,32,33,,,1,0,0.02,1.06,0.91,,600,143,160,,,,60.34,39.44,60.6,1,,,,,,,,,,,,,,54,81,11.99,12.04,12.12,-4.5,,,,,,,,,,,,,,,,"0,1,10,46,32,9,1,0,0","1,37,63,0,0",,,,,,123,,,,,,,,,,,,,,,,,,,,,,,,,,,,,,,,,,,,27,14,12,230,83,,,3,,0,5,3,,1,0,I1.000|5:10-I1.000|5:07-I1.000|5:18-I1.000|5:20-I1.000|4:56-I1.000|5:05-I1.000|4:59-I1.000|4:24-I0.685|3:19,,Running,,,,"Polar M430",43,0,,0,168070,250480,30378,,,,,,,,,,,,,,,,,,,,,,,,,,,,,,,,,,,,,,,,,,,
5964827,bda88ed7-dc9d-4dc4-a3a8-6bfaa6587ac1,1421956859,60,1548678840,,0,0,2.49,799,799,31,32,,,1,0.5,0.43,,,,166,,,,,,,33.7,,1,,,,,,,,,,,,,,16,83,11.3,11.44,11.71,,,,,,,,,,,,,,,,,"12,5,20,30,34,0,0,0,0",,,,,,,113,,,,,,,,,,,,,,,,,,,,,,,,,,,,,,,,,,,,,-1,5,9,92,,1021,0,,1,4,3,,1,0,,,,,Auslaufen,,"Polar BEAT",,0,,0,168070,250480,30378,,,,,,,,,,,,,,,,,,,,,,,,,,,,,,,,,,,,,,,,,,,
5964828,d1d88c20-87db-4a04-a4e7-dd1293120812,1402518075,120,1548678842,,0,0,10.57,4066,4122,138,116,,,1,1.6,0.43,,,236,708,,,,,,,29.96,,1,,,,,,,,,,,,,,84,77,9.52,10.86,11.22,,,,,,,,,,,,,,,,,"21,7,17,32,22,1,0,0,0",,,,,,,101,,,,,,,,,,,,,,,,,,,,,,,,,,,,,,,,,,,,,20,4,356,59,,1027,0,,0,5,3,,1,0,,,,,"Regenerativer DL",,"Polar BEAT",,0,,0,168070,250480,30378,,,,,,,,,,,,,,,,,,,,,,,,,,,,,,,,,,,,,,,,,,"5,5",
5964829,822db0be-31d0-45c0-ab73-27b3e47cabe1,1444813944,120,1548678845,,0,0,7.05,2505,2522,127,124,,,1,2,0.57,,,474,479,,,,,,,31.98,,1,,,,,,,,,,,,,,52,85,10.52,10.24,10.8,,,,,,,,,,,,,,,,,"20,24,35,17,2,1,0,0,0",,,,,,,99,,,,,,,,,,,,,,,,,,,,,,,,,,,,,,,,,,,,,2,4,353,94,,1020,,,0,5,3,,1,0,,,,,"Aachen Laufen",,"Polar BEAT",,0,,0,168070,250480,30378,,,,,,,,,,,,,,,,,,,,,,,,,,,,,,,,,,,,,,,,,,"5,5",
5964830,c618c56d-9f32-46b1-898d-d961bab463f2,1515929575,60,1548678845,,0,0,16.71,4217,4219,65,61,,,1,0,0.04,1.01,0.91,,1125,161,178,,,,63.85,50.86,64.18,1,,,,,,,,,,,,,,137,84,14.32,14.43,14.49,2.4,,,,,,,,,,,,,,,,"2,1,2,3,3,59,30,0,0","0,13,10,77,0",,,,,,142,,,,,,,,,,,,,,,,,,,,,,,,,,,,,,,,,,,,76.4,1,5,128,88,,1022,,,0,3,3,,1,0,I0.471|2:45-I15.752|1:04:40-I0.488|2:55,,Running,,,,"Polar M430",43,0,,0,168070,250480,30378,,,,,,,,,,,,,,,,,,,,,,,,,,,,,,,,,,,,,,,,,,,
5964831,9d01f710-7caf-49ae-8b24-9e6b0589efa3,1402919352,120,1548678846,,0,0,5.02,1094,1094,103,115,,,1,2,1,,,,332,,,,,,,55.75,,1,,,,,,,,,,,,,,22,87,16.74,16.54,17.02,,,,,,,,,,,,,,,,,"0,0,0,0,0,0,84,16,0",,,,,,,158,,,,,,,,,,,,,,,,,,,,,,,,,,,,,,,,,,,,,15,6,351,69,,1024,4,,0,5,3,,1,0,,,,,"kurzer TDL",,"Polar BEAT",,0,,0,168070,250480,30378,,,,,,,,,,,,,,,,,,,,,,,,,,,,,,,,,,,,,,,,,,,
5964832,2ae9cc2b-a8e3-4278-8279-d7002fa0044c,1539511355,120,1548678847,,0,0,6.02,1726,1727,17,20,,,1,0,0.13,1.09,0.95,,435,151,165,,,,59.67,40.86,59.84,1,,,,,,,,,,,,,,44,82,12.6,12.68,12.75,0.3,,,,,,,,,,,,,,,,"0,3,5,25,40,25,2,0,0","1,4,91,4,0",,,,,,128,,,,,,,,,,,,,,,,,,,,,,,,,,,,,,,,,,,,38.6,12,6,105,100,,1015,1,286,0,3,3,,1,0,I1.000|5:04-I1.000|4:52-I1.000|4:42-I1.000|4:48-I1.000|4:41-I1.000|4:32-I0.025|0:10,,Running,,,,"Polar M430",43,0,,0,168070,250480,30378,,,,,,,,,,,,,,,,,,,,,,,,,,,,,,,,,,,,,,,,,,,
5964833,6d1871e2-5b51-4ece-a56a-2621d653968c,1536583841,120,1548678847,,0,0,3.74,1247,1247,13,12,,,1,0,0.05,1.08,0.87,,244,130,147,,,,59.8,33.2,60.08,1,,,,,,,,,,,,,,18,80,10.84,10.85,10.93,-2.9,,,,,,,,,,,,,,,,"7,12,35,35,10,0,0,0,0","2,96,2,0,0",,,,,,112,,,,,,,,,,,,,,,,,,,,,,,,,,,,,,,,,,,,12.9,26,11,226,36,,,,,0,3,3,,1,0,I1.000|5:34-I1.000|5:36-I1.000|5:34-I0.749|4:03,,Running,,,,"Polar M430",43,0,,0,168070,250480,30378,,,,,,,,,,,,,,,,,,,,,,,,,,,,,,,,,,,,,,,,,,,
5964834,bec483ee-c43d-486d-9644-803e58a31fe2,1454973281,60,1548678848,,0,0,11,2766,2773,105,105,,,1,0.8,0.39,,,,756,,,,,,,49.5,,1,,,,,,,,,,,,,,57,84,14.47,14.48,14.66,,,,,,,,,,,,,,,,,"1,1,2,3,15,48,28,3,0",,,,,,,142,,,,,,,,,,,,,,,,,,,,,,,,,,,,,,,,,,,,,7,40,233,69,,999,,,1,11,3,,1,0,,,,,"Aachen Laufen",,"Polar BEAT",,0,,0,168070,250480,30378,,,,,,,,,,,,,,,,,,,,,,,,,,,,,,,,,,,,,,,,,,,
5964835,0c722835-f9f4-4240-b2b8-eec144f4ffee,1444678242,120,1548678849,,0,0,14.63,3561,3761,211,215,,,1,2.2,0.6,,,523,985,,,,,,,52.48,,1,,,,,,,,,,,,,,73,85,15.06,14.99,15.28,,,,,,,,,,,,,,,,,"1,0,1,3,10,35,43,6,0",,,,,,,145,,,,,,,,,,,,,,,,,,,,,,,,,,,,,,,,,,,,,7,6,53,79,,1017,,,1,3,3,,1,0,,,,,"Aachen Laufen",,"Polar BEAT",,0,,0,168070,250480,30378,,,,,,,,,,,,,,,,,,,,,,,,,,,,,,,,,,,,,,,,,,"5,5",
5964836,0ae7914b-bb09-4954-b2de-593961de572d,1349380496,120,1548678849,,0,0,0.05,13,13,0,1,,,1,1.2,1,,,,3,,,,,,,33.71,,1,,,,,,,,,,,,,,0,,12.02,12.73,12.02,,,,,,,,,,,,,,,,,"0,0,0,0,100,0,0,0,0",,,,,,,,,,,,,,,,,,,,,,,,,,,,,,,,,,,,,,,,,,,,11,16,278,87,,1018,0,,1,5,3,,1,0,,,,,,,"Polar BEAT",,0,,0,168070,250480,30378,,,,,,,,,,,,,,,,,,,,,,,,,,,,,,,,,,,,,,,,,,,
5964837,8e3b0350-d6bc-446d-92f7-5d053e87fa32,1522346941,120,1548678850,,0,0,14,4031,4034,48,50,,,1,0,0.04,1.1,0.88,,1063,159,183,,,,55.24,43.05,55.46,1,,,,,,,,,,,,,,125,82,12.53,12.93,13.01,12.1,,,,,,,,,,,,,,,,"3,3,11,30,22,18,10,2,0","0,4,51,42,3",,,,,,127,,,,,,,,,,,,,,,,,,,,,,,,,,,,,,,,,,,,100,10,9,238,53,,1006,,,0,5,3,,1,0,I1.000|4:36-I1.000|4:16-I1.000|4:24-I1.000|4:25-I1.000|4:17-I1.000|4:04-I1.000|4:01-I1.000|4:31-I1.000|5:13-I1.000|5:22-I1.000|5:32-I1.000|5:13-I1.000|5:17-I1.000|6:04-I0.002|0:02,,Running,,,,"Polar M430",43,0,,0,168070,250480,30378,,,,,,,,,,,,,,,,,,,,,,,,,,,,,,,,,,,,,,,,,,,
5964838,bb002df7-19ef-40d7-ba44-0a6cdfe4b3df,1475350148,120,1548678851,,0,0,0.65,220,220,13,9,,,1,1.1,0.69,,,,45,,,,,,,27.46,,1,,,,,,,,,,,,,,4,80,11,10.78,11.47,,,,,,,,,,,,,,,,,"9,26,26,27,12,0,0,0,0",,,,,,,111,,,,,,,,,,,,,,,,,,,,,,,,,,,,,,,,,,,,,14,5,212,81,,1009,0,,1,6,3,,1,0,,,,,"Aachen Laufen",,"Polar BEAT",,0,,0,168070,250480,30378,,,,,,,,,,,,,,,,,,,,,,,,,,,,,,,,,,,,,,,,,,,
5964839,6a7fe048-be9f-4896-9d93-da5b88c3c315,1514113636,60,1548678852,,0,0,11.23,3106,3107,329,330,,,1,3.9,0.7,1.1,1.01,649,825,160,173,,,,57.53,44.37,59.61,1,,,,,,,,,,,,,,98,83,13.91,13.48,14.46,-7.2,,,,,,,,,,,,,,,,"1,7,11,18,19,18,24,1,0","1,2,44,54,0",,,,,,131,,,,,,,,,,,,,,,,,,,,,,,,,,,,,,,,,,,,68.1,8,28,250,81,,1024,,,0,4,1,,1,0,I1.000|5:02-I1.000|5:08-I1.000|5:48-I1.000|4:54-I1.000|4:56-I1.000|5:14-I1.000|4:19-I1.000|3:48-I1.000|3:48-I1.000|3:51-I1.000|4:03-I0.232|0:57,,Running,,,,"Polar M430",43,0,,0,168070,250480,30378,,,,,,,,,,,,,,,,,,,,,,,,,,,,,,,,,,,,,,,,,,3,
5964840,3d4e6828-a874-492f-b7ee-e4149e30c2d7,1431262832,120,1548678852,,0,0,9.79,2152,2152,143,143,,,1,1.7,0.45,,,984,662,,,,,,,57.49,,1,,,,,,,,,,,,,,44,88,16.72,16.63,16.92,,,,,,,,,,,,,,,,,"0,0,0,1,6,13,44,34,1",,,,,,,155,,,,,,,,,,,,,,,,,,,,,,,,,,,,,,,,,,,,,16,2,257,59,,1027,6,,0,5,3,,1,0,,,,,"Stolberg (Rheinland) Laufen",,"Polar BEAT",,0,,0,168070,250480,30378,,,,,,,,,,,,,,,,,,,,,,,,,,,,,,,,,,,,,,,,,,5,
5964841,0d4a4fdb-6b48-4353-96d6-5a0dd728618f,1508169745,120,1548678853,,0,0,9.32,2201,2203,70,81,,,1,0.2,0.33,1.09,1,,659,173,190,,,,62.22,52.7,62.71,1,,,,,,,,,,,,,,95,84,15.31,15.31,15.45,10,,,,,,,,,,,,,,,,"0,0,0,1,3,30,65,1,0","0,2,19,39,40",,,,,,151,,,,,,,,,,,,,,,,,,,,,,,,,,,,,,,,,,,,143.3,25,6,176,56,,1021,1,,0,5,3,,1,0,I8.019|31:22-I1.300|5:24,,Running,,,,"Polar M430",43,0,,0,168070,250480,30378,,,,,,,,,,,,,,,,,,,,,,,,,,,,,,,,,,,,,,,,,,,
5964843,a1b1deca-6819-46fe-b682-173d9ba241b0,1452625126,60,1548678854,,0,0,18.11,5396,6117,190,188,,,1,1.3,0.43,,,280,1223,,,,,,,42.23,,1,,,,,,,,,,,,,,112,83,12.16,12.75,13.17,,,,,,,,,,,,,,,,,"12,7,17,21,18,6,14,5,0",,,,,,,121,,,,,,,,,,,,,,,,,,,,,,,,,,,,,,,,,,,,,4,18,208,84,,1000,,,1,5,3,,1,0,,,,,"Aachen Laufen",,"Polar BEAT",,0,,0,168070,250480,30378,,,,,,,,,,,,,,,,,,,,,,,,,,,,,,,,,,,,,,,,,,5,
5964845,821b6784-4192-45a2-9df4-565e3ccbcc95,1530209269,120,1548678857,,0,0,12.18,3249,3250,40,37,,,1,0,0.07,1.16,0.89,,773,146,170,,,,68.24,46.55,68.54,1,,,,,,,,,,,,,,78,83,13.55,13.65,13.74,10.6,,,,,,,,,,,,,,,,"0,0,2,11,29,45,12,0,0","2,31,41,26,0",,,,,,136,,,,,,,,,,,,,,,,,,,,,,,,,,,,,,,,,,,,53.8,24,13,84,47,,1017,,,0,4,3,,1,0,I1.000|4:40-I1.000|4:25-I1.000|4:19-I1.000|4:24-I1.000|4:22-I1.000|4:20-I1.000|4:22-I1.000|4:00-I1.000|4:10-I1.000|4:15-I1.000|4:39-I1.000|5:19-I0.187|0:58,,Running,,,,"Polar M430",43,0,,0,168070,250480,30378,,,,,,,,,,,,,,,,,,,,,,,,,,,,,,,,,,,,,,,,,,,
5964846,20b95314-d8d3-484a-b6a0-3933a9e9cc95,1412515023,120,1548678860,,0,0,22.78,5624,5624,122,121,,,1,0,0.17,1.06,0.99,,1177,158,174,,,,67.4,53.47,67.86,1,,,,,,,,,,,,,,170,83,14.67,14.63,14.78,0.3,,,,,,,,,,,,,,,,"0,0,0,0,12,52,36,0,0","0,1,52,46,0",,,,,,146,,,,,,,,,,,,,,,,,,,,,,,,,,,,,,,,,,,,60.7,13,0,270,94,,,2,,0,9,3,,1,0,,,,,"Langer Tempo Lauf",,"Polar BEAT",,0,,0,168070,250480,30378,,,,,,,,,,,,,,,,,,,,,,,,,,,,,,,,,,,,,,,,,,,
5964847,d9d90944-92f5-4bed-b04a-d25ef20e1364,1477428683,120,1548678861,,0,0,2.37,739,766,32,29,,,1,0.7,0.4,,,,162,,,,,,,34.68,,1,,,,,,,,,,,,,,15,80,11.81,11.75,11.98,,,,,,,,,,,,,,,,,"4,8,30,27,15,16,0,0,0",,,,,,,120,,,,,,,,,,,,,,,,,,,,,,,,,,,,,,,,,,,,,8,1,44,97,,1026,0,,1,5,3,,1,0,,,,,"Aachen Laufen",,"Polar BEAT",,0,,0,168070,250480,30378,,,,,,,,,,,,,,,,,,,,,,,,,,,,,,,,,,,,,,,,,,,
5964848,8f4d7cee-6c9d-498f-90fe-ccc2c0ac9f16,1392230729,60,1548678862,,0,0,10,2835,2865,156,157,,,1,1.7,0.53,,,311,663,,,,,,,42.75,,1,,,,,,,,,,,,,,58,83,13,12.95,13.3,,,,,,,,,,,,,,,,,"4,2,4,12,36,37,5,0,0",,,,,,,127,,,,,,,,,,,,,,,,,,,,,,,,,,,,,,,,,,,,,6,18,181,67,,1000,0,,1,5,3,,1,0,,,,,"Locker DL Lousberg",,"Polar BEAT",,0,,0,168070,250480,30378,,,,,,,,,,,,,,,,,,,,,,,,,,,,,,,,,,,,,,,,,,5,
5964849,316dcc98-b2e1-486b-ab34-ab16ac06b026,1507474914,120,1548678864,,0,0,9.42,2594,2595,140,128,,,1,1.1,0.43,1.04,0.97,276,674,158,179,,,,58.89,44.05,60.07,1,,,,,,,,,,,,,,79,82,13.46,13.19,13.61,5.1,,,,,,,,,,,,,,,,"0,1,6,9,40,37,6,0,0","0,7,50,44,0",,,,,,133,,,,,,,,,,,,,,,,,,,,,,,,,,,,,,,,,,,,72.9,12,6,284,93,,1018,2,,0,6,3,,1,0,I1.000|4:51-I1.000|5:01-I1.000|4:21-I1.000|4:06-I1.000|4:33-I1.000|4:23-I1.000|4:50-I1.000|4:42-I1.000|4:38-I0.424|1:51,,Running,,,,"Polar M430",43,0,,0,168070,250480,30378,,,,,,,,,,,,,,,,,,,,,,,,,,,,,,,,,,,,,,,,,,"5,5",
5964850,d9594b30-2915-49be-b2db-7993b1c8765b,1511546760,60,1548678864,,0,0,9.47,2754,2756,133,124,,,1,1.2,0.47,1.05,0.95,269,647,148,167,,,,60.23,41.34,61.35,1,,,,,,,,,,,,,,66,80,12.72,12.48,12.97,3.7,,,,,,,,,,,,,,,,"1,4,8,16,54,17,0,0,0","0,27,61,12,0",,,,,,129,,,,,,,,,,,,,,,,,,,,,,,,,,,,,,,,,,,,47.9,6,1,180,95,,1013,0,,1,5,3,,1,0,I1.000|5:09-I1.000|5:08-I1.000|5:17-I1.000|4:33-I1.000|4:46-I1.000|4:40-I1.000|4:57-I1.000|4:44-I1.000|4:37-I0.473|2:08,,Running,,,,"Polar M430",43,0,,0,168070,250480,30378,,,,,,,,,,,,,,,,,,,,,,,,,,,,,,,,,,,,,,,,,,"5,5",
5964851,a0cc9ce7-e47a-4bee-bd84-1ae1efde5efe,1516124969,60,1548678864,,0,0,1.38,360,360,4,8,,,1,0,0.15,1.09,0.94,,76,142,157,,,,72.73,40.05,72.73,1,,,,,,,,,,,,,,7,82,13.68,13.86,13.78,3.3,,,,,,,,,,,,,,,,"1,1,1,2,14,73,9,0,0","0,36,64,0,0",,,,,,140,,,,,,,,,,,,,,,,,,,,,,,,,,,,,,,,,,,,17.9,6,24,247,79,,1000,,,1,6,3,,1,0,I1.000|4:23-I0.383|1:38,,Running,,,,"Polar M430",43,0,,0,168070,250480,30378,,,,,,,,,,,,,,,,,,,,,,,,,,,,,,,,,,,,,,,,,,,
5964852,19d31738-f21d-4dac-873f-a619f50d094d,1464123827,120,1548678865,,0,0,2.56,906,951,2,0,,,1,0,0,,,,179,,,,,,,30.12,,1,,,,,,,,,,,,,,18,78,10.2,11.4,11.47,,,,,,,,,,,,,,,,,"18,2,7,34,30,8,0,0,0",,,,,,,109,,,,,,,,,,,,,,,,,,,,,,,,,,,,,,,,,,,,,11,5,347,82,,1017,0,,0,5,3,,1,0,,,,,"Aachen Laufen",,"Polar BEAT",,0,,0,168070,250480,30378,,,,,,,,,,,,,,,,,,,,,,,,,,,,,,,,,,,,,,,,,,,
5964853,4cce63f1-a73d-4ba1-84e0-842f8a47ea7b,1335100378,120,1548678866,,0,0,28.54,9209,10197,404,405,,,1,2.5,0.5,,,503,1954,,,,,,,39.78,,1,,,,,,,,,,,,,,191,,11.37,12.4,12.72,,,,,,,,,,,,,,,,,"20,6,10,18,20,15,7,3,2",,,,,,,,,,,,,,,,,,,,,,,,,,,,,,,,,,,,,,,,,,,,10,15,237,66,,1006,5,,0,5,3,,1,0,,,,,,,"Polar BEAT",,0,,0,168070,250480,30378,,,,,,,,,,,,,,,,,,,,,,,,,,,,,,,,,,,,,,,,,,"4,4",
5964854,10d0cb99-0fbb-44f9-981e-412d1198c7a8,1538379790,120,1548678868,,0,0,10.79,1627,1629,37,50,,,1,0,0.11,,0.66,,309,133,173,,,,,,,1,,,,,,,,,,,,,,29,,,26.27,,-0.5,-40.8,134,111,,1,168,152,,,,,,,,,"10,16,13,44,14,3,0","10,54,26,10,0","75,14,1,1,10",,,,,,,,,,,,,,,,,,,,,,,,,,,,,,,,,,,,,,,,,39.9,9,7,186,83,,,0,,0,5,3,,1,0,,,Cycling,,,,"Polar M430",43,0,,0,168072,,30378,,,,,,,,,,,,,,,,,,,,,,,,,,,,,,,,,,,,,,,,,,,
5964855,e0c30d9f-c0e6-4675-9dc7-41061f5a5bc1,1418325594,60,1548678868,,0,0,3.01,601,601,28,21,,,1,0.7,0.47,,,,203,,,,,,,58.98,,1,,,,,,,,,,,,,,12,89,18.28,18.09,18.43,,,,,,,,,,,,,,,,,"0,0,0,0,0,0,11,89,0",,,,,,,169,,,,,,,,,,,,,,,,,,,,,,,,,,,,,,,,,,,,,5,14,240,92,,1011,0,,1,5,3,,1,0,,,,,"3k Tempo",,"Polar BEAT",,0,,0,168070,250480,30378,,,,,,,,,,,,,,,,,,,,,,,,,,,,,,,,,,,,,,,,,,,
5964857,703b4533-d00d-45b0-96c4-16ea8e76aafd,1456767368,60,1548678872,,0,0,13.38,3746,3758,222,234,,,1,2.6,0.51,,,373,924,,,,,,,44.32,,1,,,,,,,,,,,,,,77,84,13.22,12.99,13.53,,,,,,,,,,,,,,,,,"1,2,5,18,40,30,5,0,0",,,,,,,128,,,,,,,,,,,,,,,,,,,,,,,,,,,,,,,,,,,,,3,16,14,56,,1023,,,0,3,3,,1,0,,,,,"Aachen Laufen",,"Polar BEAT",,0,,0,168070,250480,30378,,,,,,,,,,,,,,,,,,,,,,,,,,,,,,,,,,,,,,,,,,"4,5,5,5",
5964858,ea86ff36-d0ca-4ab1-82e5-1886818600f8,1397992104,120,1548678873,,0,0,20,5079,5081,514,492,,,1,4.8,0.71,1.25,0.94,478,1182,164,173,,,,61.67,51.22,63.72,1,,,,,,,,,,,,,,173,84,14.64,14.23,15.22,1,,,,,,,,,,,,,,,,"1,0,0,1,16,63,20,0,0","0,1,18,81,0",,,,,,141,,,,,,,,,,,,,,,,,,,,,,,,,,,,,,,,,,,,76.4,15,16,78,67,,,,,0,3,3,,1,0,,,,,"Züggiger DL",,"Polar BEAT",,0,,0,168070,250480,30378,,,,,,,,,,,,,,,,,,,,,,,,,,,,,,,,,,,,,,,,,,"4,4,4,5,5,5,5",
5964859,bb532f92-76b8-442d-a4f4-e035f137dd69,1476132566,120,1548678873,,0,0,0.75,252,253,13,7,,,1,0.1,0.27,,,,53,,,,,,,28.11,,1,,,,,,,,,,,,,,5,81,11.09,10.65,11.21,,,,,,,,,,,,,,,,,"15,11,32,27,15,0,0,0,0",,,,,,,110,,,,,,,,,,,,,,,,,,,,,,,,,,,,,,,,,,,,,8,1,4,92,,1023,0,,1,5,3,,1,0,,,,,"Aachen Laufen",,"Polar BEAT",,0,,0,168070,250480,30378,,,,,,,,,,,,,,,,,,,,,,,,,,,,,,,,,,,,,,,,,,,
5964860,c13a9c86-ddc7-4cbb-b23d-cfd9a1466e43,1451497966,60,1548678874,,0,0,2.79,760,760,,,,,0,,,,,,188,,,,,,,41.12,,1,,,,,,,,,,,,,,15,81,,13.41,,,,,,,,,,,,,,,,,,"0,1,1,31,34,12,21,0,0",,,,,,,136,,,,,,,,,,,,,,,,,,,,,,,,,,,,,,,,,,,,,,,,,,,,,,1,,,1,0,,,,,,,"Polar BEAT",,0,,0,168070,250480,30378,,,,,,,,,,,,,,,,,,,,,,,,,,,,,,,,,,,,,,,,,,,
5964861,b406a184-a988-4c73-bb94-e9b150eb0522,1493471619,120,1548678874,,0,0,3.27,1036,1036,68,67,,,1,1.7,0.69,,,395,228,,,,,,,34.95,,1,,,,,,,,,,,,,,21,80,11.76,11.52,12.13,,,,,,,,,,,,,,,,,"6,12,26,29,15,9,3,0,0",,,,,,,118,,,,,,,,,,,,,,,,,,,,,,,,,,,,,,,,,,,,,11,4,357,55,,1019,5,,0,5,3,,1,0,,,,,"Aachen Laufen",,"Polar BEAT",,0,,0,168070,250480,30378,,,,,,,,,,,,,,,,,,,,,,,,,,,,,,,,,,,,,,,,,,5,
5964862,335af722-7a4d-48ad-9fea-0bb4d32291b8,1546623638,60,1548678874,,0,0,1.92,629,629,59,8,,,1,1.3,0.58,1.14,1.01,292,136,139,154,,,,56.37,32.1,60.38,1,,,,,,,,,,,,,,12,81,12.11,11.05,12.32,2.9,,,,,,,,,,,,,,,,"6,9,26,51,9,0,0,0,0","4,28,68,0,0",,,,,,113,,,,,,,,,,,,,,,,,,,,,,,,,,,,,,,,,,,,20.2,2,14,272,85,,1034,0,256,1,5,3,,1,0,I1.000|5:28-I0.919|5:02,,Running,,,,"Polar M430",43,0,,0,168070,250480,30378,,,,,,,,,,,,,,,,,,,,,,,,,,,,,,,,,,,,,,,,,,5,
5964863,0ce810e3-c4a4-456b-9317-b238c39ba4cc,1498598657,120,1548678874,,0,0,0.91,263,263,0,0,,,1,0,0,,,,66,,,,,,,34.06,,1,,,,,,,,,,,,,,5,80,12.4,12.53,12.53,,,,,,,,,,,,,,,,,"0,0,2,12,78,9,0,0,0",,,,,,,130,,,,,,,,,,,,,,,,,,,,,,,,,,,,,,,,,,,,,24,10,129,72,,1005,0,,1,3,3,,1,0,,,,,"Aix-en-Provence Laufen",,"Polar BEAT",,0,,0,168070,250480,30378,,,,,,,,,,,,,,,,,,,,,,,,,,,,,,,,,,,,,,,,,,,
5964865,6c3d0d84-29ac-4dff-ac87-6444b466351c,1450377939,60,1548678877,,0,0,17.46,5368,6417,204,216,,,1,1.4,0.45,,,,1158,,,,,,,40.6,,1,,,,,,,,,,,,,,111,82,11.76,12.44,12.98,,,,,,,,,,,,,,,,,"15,11,20,18,16,5,4,10,1",,,,,,,119,,,,,,,,,,,,,,,,,,,,,,,,,,,,,,,,,,,,,13,17,185,83,,1022,,,1,5,3,,1,0,,,,,"Aachen Laufen",,"Polar BEAT",,0,,0,168070,250480,30378,,,,,,,,,,,,,,,,,,,,,,,,,,,,,,,,,,,,,,,,,,,
5964866,3514c927-25b0-49cd-aca4-7bb31f8b1d4e,1463401653,120,1548678878,,0,0,11.93,3107,3188,229,231,,,1,3.2,0.66,,,620,822,,,,,,,47.79,,1,,,,,,,,,,,,,,64,83,14.33,14.09,14.53,,,,,,,,,,,,,,,,,"3,2,4,10,15,31,34,1,0",,,,,,,139,,,,,,,,,,,,,,,,,,,,,,,,,,,,,,,,,,,,,9,7,281,64,,,5,,0,5,3,,1,0,,,,,"Balve Laufen",,"Polar BEAT",,0,,0,168070,250480,30378,,,,,,,,,,,,,,,,,,,,,,,,,,,,,,,,,,,,,,,,,,"4,5",
5964868,df0dd848-d40a-448d-80d1-c36a4e24edb8,1504342539,120,1548678882,,0,0,6.64,2151,2153,80,80,,,1,1.2,0.54,1,0.99,284,415,133,155,,,,60.32,35.57,61.22,1,,,,,,,,,,,,,,35,80,11.26,11.19,11.45,-3.6,,,,,,,,,,,,,,,,"4,10,23,50,14,0,0,0,0","1,69,30,0,0",,,,,,116,,,,,,,,,,,,,,,,,,,,,,,,,,,,,,,,,,,,24,13,3,19,78,,1019,1,,0,5,3,,1,0,I1.000|5:23-I1.000|5:33-I1.000|5:35-I1.000|5:20-I1.000|5:17-I1.000|5:07-I0.637|3:38,,Running,,,,"Polar M430",43,0,,0,168070,250480,30378,,,,,,,,,,,,,,,,,,,,,,,,,,,,,,,,,,,,,,,,,,5,
5964869,40d4d610-3df5-465a-b207-ed4b8d736fe6,1481580206,60,1548678883,,0,0,4.21,1261,1261,12,15,,,1,0,0.04,,,,275,,,,,,,37.98,,1,,,,,,,,,,,,,,26,81,12.04,12.27,12.27,,,,,,,,,,,,,,,,,"16,12,10,14,15,19,13,2,0",,,,,,,124,,,,,,,,,,,,,,,,,,,,,,,,,,,,,,,,,,,,,4,4,179,88,,1027,0,,1,5,3,,1,0,,,,,"Aachen Laufen",,"Polar BEAT",,0,,0,168070,250480,30378,,,,,,,,,,,,,,,,,,,,,,,,,,,,,,,,,,,,,,,,,,,
5964870,56e3bbf8-0a50-468c-8942-e472edaaf9c7,1394371892,60,1548678884,,0,0,10,2070,2072,18,18,,,1,0,0.08,,,,668,,,,,,,61.76,,1,,,,,,,,,,,,,,42,88,17.42,17.49,17.57,,,,,,,,,,,,,,,,,"0,0,0,0,0,2,31,65,1",,,,,,,165,,,,,,,,,,,,,,,,,,,,,,,,,,,,,,,,,,,,,19,6,130,27,,,,,0,3,3,,1,0,,,,,"WK 10km Bayer Kreuz",,"Polar BEAT",,0,,0,168070,250480,30378,,,,,,,,,,,,,,,,,,,,,,,,,,,,,,,,,,,,,,,,,,,
5964871,,1531179120,120,1548678884,,0,0,10,1800,1800,,,,,0,,,,,,385,,,,,,,,,1,,,,,,,,,,,,,,20,,,,,,,,,,,,,,,,,,,,,,,,,,,,,,,,,,,,,,,,,,,,,,,,,,,,,,,,,,,,,,,,,,,,,,,,,,1,,,0,0,,,,,,,"no device name available",,0,,0,168072,,30378,,,,,,,,,,,,,,,,,,,,,,,,,,,,,,,,,,,,,,,,,,,
5964872,87fffe0d-d3b3-460d-9f1a-3e161e4ae806,1458920140,60,1548678885,,0,0,14.48,3771,3776,310,311,,,1,3.9,0.57,,,652,996,,,,,,,48.49,,1,,,,,,,,,,,,,,78,83,14.4,14.13,14.87,,,,,,,,,,,,,,,,,"0,1,6,14,20,31,28,1,0",,,,,,,139,,,,,,,,,,,,,,,,,,,,,,,,,,,,,,,,,,,,,7,13,259,91,,1011,,,0,4,3,,1,0,,,,,"Balve Laufen",,"Polar BEAT",,0,,0,168070,250480,30378,,,,,,,,,,,,,,,,,,,,,,,,,,,,,,,,,,,,,,,,,,"4,4",
5964873,4e5c53da-5d92-4bda-9fe7-2788ea6abe0e,1413403617,120,1548678885,,0,0,15.06,4114,4171,191,198,,,1,1.9,0.54,0.99,1.05,393,743,147,172,,,,65.66,46.02,66.66,1,,,,,,,,,,,,,,95,82,13.42,13.32,13.57,0.2,,,,,,,,,,,,,,,,"2,1,3,9,35,40,9,0,0","0,29,64,6,0",,,,,,134,,,,,,,,,,,,,,,,,,,,,,,,,,,,,,,,,,,,38.9,12,4,172,87,,1007,,,1,4,3,,1,0,,,,,"Lockerer DL",,"Polar BEAT",,0,,0,168070,250480,30378,,,,,,,,,,,,,,,,,,,,,,,,,,,,,,,,,,,,,,,,,,4,
5964874,52ce19de-591e-437e-a66b-acac708f6896,1445115764,120,1548678886,,0,0,9.75,2091,2091,166,169,,,1,2,0.63,,,,653,,,,,,,59.16,,1,,,,,,,,,,,,,,43,86,17.17,16.89,17.3,,,,,,,,,,,,,,,,,"0,0,0,0,0,5,56,39,0",,,,,,,163,,,,,,,,,,,,,,,,,,,,,,,,,,,,,,,,,,,,,5,7,149,93,,1018,,,1,4,3,,1,0,,,,,"Simmerath Laufen",,"Polar BEAT",,0,,0,168070,250480,30378,,,,,,,,,,,,,,,,,,,,,,,,,,,,,,,,,,,,,,,,,,,
5964875,119d8871-e058-42d8-8ba4-943037f052a8,1505928346,120,1548678886,,0,0,1.39,1299,1342,1,117,,,1,1.1,0.87,,,,134,96,118,,,,,,,1,,,,,,,,,,,,,,6,,,5.15,,27.6,,,,,,,,,,,,,,,,"59,39,2,0,0,0","56,44,0,0,0",,,,,,,,,,,,,,,,,,,,,,,,,,,,,,,,,,,,,,,,,,3.9,16,11,264,66,,1020,,,0,5,3,,1,0,I1.000|11:12-I0.408|11:11,,Hiking,,,,"Polar M430",43,0,,0,168075,,30378,,,,,,,,,,,,,,,,,,,,,,,,,,,,,,,,,,,,,,,,,,,
5964876,9fe0470d-c733-48c8-8f7a-05c897190c11,1348688039,120,1548678889,,0,0,37.69,4387,4582,155,157,,,1,0,0.15,,,,1477,131,163,,,,,,,1,,,,,,,,,,,,,,69,,,33.8,,15.3,-31.6,226,178,,1,262,228,,,,,,,,,"11,1,2,9,41,25,12","7,79,14,0,0","41,22,11,15,10",,,,,,,,,,,,,,,,,,,,,,,,,,,,,,,,,,,,,,,,,19.9,20,6,331,61,,1001,0,,1,5,3,,1,0,,,,,,,"Polar BEAT",,0,,0,168072,,30378,,,,,,,,,,,,,,,,,,,,,,,,,,,,,,,,,,,,,,,,,,,
5964877,ab7611cb-87df-4a4f-a3fb-3bdd5fe3ebf7,1465163976,120,1548678890,,0,0,9.86,2970,2970,116,111,,,1,1.3,0.39,,,522,684,,,,,,,39.78,,1,,,,,,,,,,,,,,61,80,12.12,12.03,12.32,,,,,,,,,,,,,,,,,"1,4,11,35,44,5,1,0,0",,,,,,,124,,,,,,,,,,,,,,,,,,,,,,,,,,,,,,,,,,,,,19,2,259,83,,1020,0,,1,5,3,,1,0,,,,,"Aachen Laufen",,"Polar BEAT",,0,,0,168070,250480,30378,,,,,,,,,,,,,,,,,,,,,,,,,,,,,,,,,,,,,,,,,,"5,5",
5964878,ec344a8f-4fac-4cf2-a68c-7c0a50411e57,1453313690,60,1548678894,,0,0,17.31,5298,5586,255,258,,,1,2.5,0.58,,,258,1204,,,,,,,40.78,,1,,,,,,,,,,,,,,110,79,12.02,12.73,13.05,,,,,,,,,,,,,,,,,"12,3,3,9,35,35,4,0,0",,,,,,,124,,,,,,,,,,,,,,,,,,,,,,,,,,,,,,,,,,,,,0,7,227,87,,1021,,,1,5,3,,1,0,,,,,"Aachen Laufen",,"Polar BEAT",,0,,0,168070,250480,30378,,,,,,,,,,,,,,,,,,,,,,,,,,,,,,,,,,,,,,,,,,"4,5",
5964879,4275894f-9e2a-427e-aa74-c94288e0c9d6,1438464654,120,1548678894,,0,0,7.08,1454,1455,16,20,,,1,0,0,,,,486,,,,,,,61.08,,1,,,,,,,,,,,,,,30,87,17.51,17.63,17.61,,,,,,,,,,,,,,,,,"0,0,0,0,0,1,34,64,1",,,,,,,168,,,,,,,,,,,,,,,,,,,,,,,,,,,,,,,,,,,,,17,7,340,59,,1017,,,1,3,3,,1,0,,,,,"Eschweiler Laufen",,"Polar BEAT",,0,,0,168070,250480,30378,,,,,,,,,,,,,,,,,,,,,,,,,,,,,,,,,,,,,,,,,,,
5964880,,1393695014,60,1548678894,,0,0,3,0,0,,,,,0,,,,,,,,,,,,,,,1,,,,,,,,,,,,,,0,,,,,,,,,,,,,,,,,,,,,,,,,,,,,,,,,,,,,,,,,,,,,,,,,,,,,,,,,,,,,,,,,,,,,,,,,,1,,,0,0,,,,,Auslaufen,,"Polar BEAT",,0,,0,168070,250480,30378,,,,,,,,,,,,,,,,,,,,,,,,,,,,,,,,,,,,,,,,,,,
5964881,9c2a9d5e-2994-4b38-91b1-be438010ba25,1493841732,120,1548678894,,0,0,10,2720,2765,146,143,,,1,1,0.46,,,262,701,,,,,,,44.87,,1,,,,,,,,,,,,,,56,81,13.57,13.36,13.79,,,,,,,,,,,,,,,,,"1,2,4,10,30,47,7,0,0",,,,,,,136,,,,,,,,,,,,,,,,,,,,,,,,,,,,,,,,,,,,,12,11,81,82,,1019,,,0,4,3,,1,0,,,,,"Aachen Laufen",,"Polar BEAT",,0,,0,168070,250480,30378,,,,,,,,,,,,,,,,,,,,,,,,,,,,,,,,,,,,,,,,,,"5,5",
5964882,c5aa5763-3c76-44a4-93bd-ad7c7ca7dbd5,1416341801,60,1548678896,,0,0,2.01,645,646,16,40,,,1,1.1,0.8,,,,136,,,,,,,33.03,,1,,,,,,,,,,,,,,13,83,11.01,11.32,11.17,,,,,,,,,,,,,,,,,"5,5,18,54,18,0,0,0,0",,,,,,,113,,,,,,,,,,,,,,,,,,,,,,,,,,,,,,,,,,,,,7,4,24,100,,1012,0,,1,5,3,,1,0,,,,,Auslaufen,,"Polar BEAT",,0,,0,168070,250480,30378,,,,,,,,,,,,,,,,,,,,,,,,,,,,,,,,,,,,,,,,,,,
5964883,8a997545-8d36-4bc2-8af9-3ad9da625d49,1445966497,60,1548678896,,0,0,5.94,1715,1813,61,61,,,1,1,0.49,,,,414,,,,,,,40.49,,1,,,,,,,,,,,,,,35,83,12.6,12.57,12.82,,,,,,,,,,,,,,,,,"3,2,4,16,59,16,0,0,0",,,,,,,125,,,,,,,,,,,,,,,,,,,,,,,,,,,,,,,,,,,,,13,9,129,77,,1014,,,1,5,3,,1,0,,,,,"Aachen Laufen",,"Polar BEAT",,0,,0,168070,250480,30378,,,,,,,,,,,,,,,,,,,,,,,,,,,,,,,,,,,,,,,,,,,
5964885,f302a9ed-8753-4c78-a785-e331b84852b5,1443733434,120,1548678897,,0,0,3.3,1026,1026,61,59,,,1,1.7,0.69,,,409,223,,,,,,,35.76,,1,,,,,,,,,,,,,,21,84,12.01,11.64,12.37,,,,,,,,,,,,,,,,,"1,5,25,42,16,12,0,0,0",,,,,,,115,,,,,,,,,,,,,,,,,,,,,,,,,,,,,,,,,,,,,9,9,91,70,,1028,,,1,3,3,,1,0,,,,,"Aachen Laufen",,"Polar BEAT",,0,,0,168070,250480,30378,,,,,,,,,,,,,,,,,,,,,,,,,,,,,,,,,,,,,,,,,,5,
5964887,fa897076-0b0e-444f-b0dd-4ab8a7757f8b,1492510050,120,1548678900,,0,0,15,4280,4304,295,295,,,2,2.1,0.52,,,314,1078,,,,,,,43.74,,1,,,,,,,,,,,,,,88,78,13.06,12.92,13.35,,,,,,,,,,,,,,,,,"4,1,4,19,40,28,4,0,0",,,,,,,135,,,,,,,,,,,,,,,,,,,,,,,,,,,,,,,,,,,,,17,37,260,67,,1002,1,,0,11,3,,1,0,,,,,Laufen,,"Polar BEAT",,0,,0,168070,250480,30378,,,,,,,,,,,,,,,,,,,,,,,,,,,,,,,,,,,,,,,,,,"4,5",
5964888,e59f8390-bc47-4e2f-aa36-af5931a7895d,1508954837,120,1548678900,,0,0,10.61,2819,2820,129,134,,,1,1.3,0.49,1.09,1,,733,158,181,,,,61.55,46.31,62.44,1,,,,,,,,,,,,,,86,81,13.73,13.69,13.92,3.4,,,,,,,,,,,,,,,,"0,1,1,7,35,42,14,0,0","0,5,55,40,0",,,,,,139,,,,,,,,,,,,,,,,,,,,,,,,,,,,,,,,,,,,82.6,16,11,240,87,,1023,,,1,5,1,,1,0,I1.000|4:55-I1.000|4:30-I1.000|4:40-I1.000|4:19-I1.000|4:35-I1.000|4:38-I1.000|4:08-I1.000|4:16-I1.000|3:57-I1.000|4:02-I0.610|3:00,,Running,,,,"Polar M430",43,0,,0,168070,250480,30378,,,,,,,,,,,,,,,,,,,,,,,,,,,,,,,,,,,,,,,,,,,
5964889,f737cdba-22fe-4180-8ede-123cfd07f080,1501157080,120,1548678901,,0,0,12.03,3525,3527,157,160,,,1,1.6,0.45,1.07,1.01,733,676,147,174,,,,60.21,41.69,61.16,1,,,,,,,,,,,,,,83,81,12.48,12.38,12.71,0.9,,,,,,,,,,,,,,,,"1,2,6,29,50,12,0,0,0","0,22,69,9,0",,,,,,126,,,,,,,,,,,,,,,,,,,,,,,,,,,,,,,,,,,,45.7,18,10,249,74,,1009,5,,0,5,3,,1,0,I1.000|5:14-I1.000|4:46-I1.000|5:04-I1.000|5:22-I1.000|4:36-I1.000|4:36-I1.000|4:31-I1.000|4:44-I1.000|4:43-I1.000|5:07-I1.000|4:54-I1.000|4:58-I0.035|0:12,,Running,,,,"Polar M430",43,0,,0,168070,250480,30378,,,,,,,,,,,,,,,,,,,,,,,,,,,,,,,,,,,,,,,,,,5,
5964890,523196e7-7933-4aa8-b4d0-f62a1954f57f,1475876738,120,1548678903,,0,0,6.32,1876,2260,80,78,,,1,1.4,0.49,,,891,428,,,,,,,39.33,,1,,,,,,,,,,,,,,38,81,12.35,12.74,12.85,,,,,,,,,,,,,,,,,"10,5,13,17,29,16,7,4,0",,,,,,,125,,,,,,,,,,,,,,,,,,,,,,,,,,,,,,,,,,,,,11,4,36,88,,1021,0,,1,5,3,,1,0,,,,,"Aachen Laufen",,"Polar BEAT",,0,,0,168070,250480,30378,,,,,,,,,,,,,,,,,,,,,,,,,,,,,,,,,,,,,,,,,,5,
5964891,fb5bcb27-1dda-4544-8228-a71f9bddb47d,1363967496,60,1548678904,,0,0,11.85,3109,3121,12,13,,,1,0,0.02,,,,821,,,,,,,47.36,,1,,,,,,,,,,,,,,64,,13.72,13.82,13.84,,,,,,,,,,,,,,,,,"1,0,1,5,25,54,12,1,0",,,,,,,,,,,,,,,,,,,,,,,,,,,,,,,,,,,,,,,,,,,,7,10,65,48,,1014,1,,0,3,3,,1,0,,,,,,,"Polar BEAT",,0,,0,168070,250480,30378,,,,,,,,,,,,,,,,,,,,,,,,,,,,,,,,,,,,,,,,,,,
5964892,ce8438e9-d634-49a2-b1f5-02c6ef866a73,1368106551,120,1548678904,,0,0,8.12,2620,2798,107,108,,,1,1,0.33,,,449,509,,,,,,,36.2,,1,,,,,,,,,,,,,,54,,11.34,12.95,13.29,,,,,,,,,,,,,,,,,"34,1,5,24,13,4,3,5,11",,,,,,,,,,,,,,,,,,,,,,,,,,,,,,,,,,,,,,,,,,,,15,12,247,61,,1014,6,,0,5,3,,1,0,,,,,,,"Polar BEAT",,0,,0,168070,250480,30378,,,,,,,,,,,,,,,,,,,,,,,,,,,,,,,,,,,,,,,,,,5,
5964893,f377b715-8a8e-4858-805d-4e64e83303dc,1523037350,120,1548678905,,0,0,3.91,1233,1234,16,20,,,1,0,0.18,1.06,0.91,,277,145,153,,,,55.99,35.57,56.2,1,,,,,,,,,,,,,,27,81,11.42,11.5,11.59,-0.8,,,,,,,,,,,,,,,,"4,7,18,52,16,2,2,0,0","2,15,83,0,0",,,,,,117,,,,,,,,,,,,,,,,,,,,,,,,,,,,,,,,,,,,29.3,18,7,72,38,,,,,0,3,3,,1,0,I1.000|5:45-I1.000|4:57-I1.000|5:13-I0.911|4:40,,Running,,,,"Polar M430",43,0,,0,168070,250480,30378,,,,,,,,,,,,,,,,,,,,,,,,,,,,,,,,,,,,,,,,,,,
5964894,07b751be-d041-4e50-b5b0-e1ecead9d834,1367706188,120,1548678907,,0,0,18.12,5566,5567,233,231,,,1,1.5,0.39,,,211,1274,,,,,,,40.76,,1,,,,,,,,,,,,,,115,,12,11.8,12.22,,,,,,,,,,,,,,,,,"3,4,13,44,29,7,1,0,0",,,,,,,,,,,,,,,,,,,,,,,,,,,,,,,,,,,,,,,,,,,,11,6,261,71,,1022,0,,1,5,3,,1,0,,,,,,,"Polar BEAT",,0,,0,168070,250480,30378,,,,,,,,,,,,,,,,,,,,,,,,,,,,,,,,,,,,,,,,,,"5,5,5",
5964895,c84f31db-8d3b-45ed-af4f-468c289e488e,1496262146,120,1548678908,,0,0,6.41,1842,1842,119,116,,,1,2.1,0.65,,,249,429,,,,,,,40.9,,1,,,,,,,,,,,,,,38,79,12.89,12.92,13.22,,,,,,,,,,,,,,,,,"3,7,16,27,16,15,13,2,1",,,,,,,132,,,,,,,,,,,,,,,,,,,,,,,,,,,,,,,,,,,,,22,4,348,55,,1021,0,,0,5,3,,1,0,,,,,"Aachen Laufen",,"Polar BEAT",,0,,0,168070,250480,30378,,,,,,,,,,,,,,,,,,,,,,,,,,,,,,,,,,,,,,,,,,4,
5964896,c7339aa1-7b20-45e6-9257-1897eb9f7191,1463824583,120,1548678912,,0,0,2.64,741,1495,21,20,,,1,0,0.23,,,,184,,,,,,,39.54,,1,,,,,,,,,,,,,,15,82,12.96,13.41,13.32,,,,,,,,,,,,,,,,,"11,4,4,11,36,12,16,6,0",,,,,,,130,,,,,,,,,,,,,,,,,,,,,,,,,,,,,,,,,,,,,17,2,191,81,,,,,0,3,3,,1,0,,,,,"Balve Laufen",,"Polar BEAT",,0,,0,168070,250480,30378,,,,,,,,,,,,,,,,,,,,,,,,,,,,,,,,,,,,,,,,,,,
5964897,55684fd0-e11d-4e46-adb0-7d4363bc7b65,1500580693,120,1548678914,,0,0,4.11,1315,1391,55,56,,,1,1.3,0.56,,,370,286,,,,,,,35.08,,1,,,,,,,,,,,,,,27,77,11.45,11.7,11.93,,,,,,,,,,,,,,,,,"8,11,19,29,22,7,5,0,0",,,,,,,122,,,,,,,,,,,,,,,,,,,,,,,,,,,,,,,,,,,,,26,5,234,45,,1012,0,,0,5,3,,1,0,,,,,"Aix-en-Provence Laufen",,"Polar BEAT",,0,,0,168070,250480,30378,,,,,,,,,,,,,,,,,,,,,,,,,,,,,,,,,,,,,,,,,,5,
5964898,8dd94714-13ee-4063-829a-15b12ab3516d,1394565148,60,1548678914,,0,0,3.35,964,964,73,72,,,1,1.7,0.64,1.12,0.98,452,179,139,156,,,,66.17,39.19,67.98,1,,,,,,,,,,,,,,18,83,12.91,12.54,13.43,1.9,,,,,,,,,,,,,,,,"0,0,4,30,48,18,0,0,0","1,51,48,0,0",,,,,,126,,,,,,,,,,,,,,,,,,,,,,,,,,,,,,,,,,,,19.1,9,10,36,76,,1031,,,1,3,3,,1,0,,,,,Einlaufen,,"Polar BEAT",,0,,0,168070,250480,30378,,,,,,,,,,,,,,,,,,,,,,,,,,,,,,,,,,,,,,,,,,4,
5964899,58932e16-2d57-446c-99a6-bc0fe100017f,1528999598,120,1548678915,,0,0,10.74,2815,2815,63,65,,,1,0,0.15,1.1,0.9,,625,144,159,,,,71.01,47.09,71.51,1,,,,,,,,,,,,,,51,83,13.77,13.92,14.04,9.1,,,,,,,,,,,,,,,,"2,1,5,6,15,59,8,3,1","1,35,64,0,0",,,,,,138,,,,,,,,,,,,,,,,,,,,,,,,,,,,,,,,,,,,35.8,21,6,274,47,,1016,,,0,5,3,,1,0,I8.238|35:38-I0.123|0:55-I0.173|0:51-I0.205|0:41-I0.203|1:02-I0.205|0:40-I0.197|1:01-I0.203|0:39-I0.204|1:05-I0.200|0:39-I0.204|1:04-I0.217|0:38-I0.369|2:07,,Running,,,,"Polar M430",43,0,,0,168070,250480,30378,,,,,,,,,,,,,,,,,,,,,,,,,,,,,,,,,,,,,,,,,,,
5964900,6461e8b2-10c5-4efa-ab87-99ca393c1b0f,1368375573,120,1548678917,,0,0,1.58,281,281,0,2,,,1,0,0,,,,94,,,,,,,62.51,,1,,,,,,,,,,,,,,5,,20.14,20.32,20.29,,,,,,,,,,,,,,,,,"0,0,0,0,0,0,0,44,56",,,,,,,,,,,,,,,,,,,,,,,,,,,,,,,,,,,,,,,,,,,,10,12,273,76,,1017,4,,0,5,3,,1,0,,,,,,,"Polar BEAT",,0,,0,168070,250480,30378,,,,,,,,,,,,,,,,,,,,,,,,,,,,,,,,,,,,,,,,,,,
5964901,8f7ce6e2-f988-448a-8c3d-604760d08dd5,1491755682,120,1548678918,,0,0,8.36,3218,3696,26,28,,,1,0,0.07,,,,312,,,,,,,,,1,,,,,,,,,,,,,,35,,,11.02,,,,33,28,,1,49,44,,,,,,,,,"91,8,1,0,0,0,0",,"91,5,4,0,0",,,,,,,,,,,,,,,,,,,,,,,,,,,,,,,,,,,,,,,,,,22,2,31,32,,1020,,,0,3,3,,1,0,,,,,"Karlsruhe Radfahren",,"Polar BEAT",,0,,0,168072,,30378,,,,,,,,,,,,,,,,,,,,,,,,,,,,,,,,,,,,,,,,,,,
5964902,c934187c-d45f-4004-ab88-f2e0001c3c76,1431461414,120,1548678918,,0,0,3.28,955,955,62,62,,,1,1.7,0.63,,,438,222,,,,,,,38.59,,1,,,,,,,,,,,,,,19,82,12.74,12.56,13.4,,,,,,,,,,,,,,,,,"6,6,14,15,28,23,6,2,0",,,,,,,126,,,,,,,,,,,,,,,,,,,,,,,,,,,,,,,,,,,,,16,17,299,51,,1020,,,0,5,3,,1,0,,,,,"Aachen Laufen",,"Polar BEAT",,0,,0,168070,250480,30378,,,,,,,,,,,,,,,,,,,,,,,,,,,,,,,,,,,,,,,,,,4,
5964903,,1368482739,120,1548678918,,0,0,,45218,45218,,,,,0,,,,,,11053,,,,,,,,,1,,,,,,,,,,,,,,939,,,,,,,,,,,,,,,,,,,,,,,,,,,,,,,,,,,,,,,,,,,,,,,,,,,,,,,,,,,,,,,,,,,,,,,,,,1,,,0,0,,,,,,,"Polar BEAT",,0,,0,168070,250480,30378,,,,,,,,,,,,,,,,,,,,,,,,,,,,,,,,,,,,,,,,,,,
5964904,49aabedf-36f4-4072-a4e7-f7b1348970ae,1362589681,60,1548678922,,0,0,9.79,2835,3034,4,5,,,1,0,0,,,,683,,,,,,,41.64,,1,,,,,,,,,,,,,,58,,12.43,13.86,13.88,,,,,,,,,,,,,,,,,"12,4,9,13,20,23,9,5,4",,,,,,,,,,,,,,,,,,,,,,,,,,,,,,,,,,,,,,,,,,,,13,8,74,51,,1001,0,,0,5,3,,1,0,,,,,,,"Polar BEAT",,0,,0,168070,250480,30378,,,,,,,,,,,,,,,,,,,,,,,,,,,,,,,,,,,,,,,,,,,
5964905,8d7a3fdc-3edc-45ab-ad3a-df8fb6ab281b,1405541051,120,1548678923,,0,0,15.01,3989,4043,197,201,,,1,1.8,0.53,1.07,1.05,542,812,157,188,,,,62.09,47.5,63.08,1,,,,,,,,,,,,,,119,81,13.75,13.78,14.13,4.3,,,,,,,,,,,,,,,,"2,1,1,6,31,52,4,5,0","0,8,52,34,5",,,,,,139,,,,,,,,,,,,,,,,,,,,,,,,,,,,,,,,,,,,89.2,25,4,299,56,,1021,0,,0,3,3,,1,0,,,,,"Lockerer DL",,"Polar BEAT",,0,,0,168070,250480,30378,,,,,,,,,,,,,,,,,,,,,,,,,,,,,,,,,,,,,,,,,,4,
5964906,59597227-915b-45de-a935-0db1a18b6d9a,1450723414,60,1548678923,,0,0,10.01,2266,2283,71,80,,,1,0.3,0.34,,,,674,,,,,,,55.62,,1,,,,,,,,,,,,,,47,85,15.95,15.98,16.1,,,,,,,,,,,,,,,,,"0,0,0,0,2,17,69,12,0",,,,,,,156,,,,,,,,,,,,,,,,,,,,,,,,,,,,,,,,,,,,,10,34,216,76,,1021,,,1,11,3,,1,0,,,,,"Aachen Laufen",,"Polar BEAT",,0,,0,168070,250480,30378,,,,,,,,,,,,,,,,,,,,,,,,,,,,,,,,,,,,,,,,,,,
5964907,876cd5de-08ee-40de-913c-5d23b2865e65,1462630972,120,1548678924,,0,0,4,1030,1030,82,70,,,1,1.8,0.6,,,,276,,,,,,,45.19,,1,,,,,,,,,,,,,,21,83,14.43,14.06,14.79,,,,,,,,,,,,,,,,,"0,0,0,3,19,63,16,0,0",,,,,,,140,,,,,,,,,,,,,,,,,,,,,,,,,,,,,,,,,,,,,24,10,117,38,,,,,0,3,3,,1,0,,,,,"Sundern Laufen",,"Polar BEAT",,0,,0,168070,250480,30378,,,,,,,,,,,,,,,,,,,,,,,,,,,,,,,,,,,,,,,,,,,
5964908,11be22b9-9dae-48f1-9229-1e20dc6f88b4,1424611768,60,1548678929,,0,0,20.66,4504,4504,116,116,,,1,0,0.19,,,,1400,,,,,,,61.24,,1,,,,,,,,,,,,,,93,89,16.58,16.59,16.69,,,,,,,,,,,,,,,,,"0,0,0,0,0,10,57,33,0",,,,,,,155,,,,,,,,,,,,,,,,,,,,,,,,,,,,,,,,,,,,,5,8,223,71,,1012,,,0,5,3,,1,0,,,,,"WK HM Porz",,"Polar BEAT",,0,,0,168070,250480,30378,,,,,,,,,,,,,,,,,,,,,,,,21.1,4504,,,0,"3. Lauf Winterlaufserie Porz",,,,,,,0,0,30378,5964908,5689,,,
5964909,c31a766a-0f7f-44e6-9d42-58927a7f23d1,1502825478,120,1548678930,,0,0,1,367,367,26,22,,,1,1.2,0.6,0.91,0.92,,76,138,156,,,,49.44,26.22,51.28,1,,,,,,,,,,,,,,7,79,10.53,9.98,10.5,-4.2,,,,,,,,,,,,,,,,"48,5,16,19,12,0,0,0,0","6,48,47,0,0",,,,,,103,,,,,,,,,,,,,,,,,,,,,,,,,,,,,,,,,,,,13.6,22,7,234,81,,1016,0,,0,5,3,,1,0,I1.000|6:05-I0.011|0:03,,Running,,,,"Polar M430",43,0,,0,168070,250480,30378,,,,,,,,,,,,,,,,,,,,,,,,,,,,,,,,,,,,,,,,,,,
5964910,a875286f-edb1-4776-b3fd-884a5270f1c3,1421695913,60,1548678931,,0,0,14.89,4309,4697,207,207,,,1,2.3,0.46,,,348,1008,,,,,,,43,,1,,,,,,,,,,,,,,89,83,12.72,12.71,13.13,,,,,,,,,,,,,,,,,"7,3,5,12,37,29,5,1,0",,,,,,,125,,,,,,,,,,,,,,,,,,,,,,,,,,,,,,,,,,,,,0,0,268,94,,1012,0,,1,5,3,,1,0,,,,,"Aachen Laufen",,"Polar BEAT",,0,,0,168070,250480,30378,,,,,,,,,,,,,,,,,,,,,,,,,,,,,,,,,,,,,,,,,,"5,5,5",
5964911,936b32f0-5219-43a2-9905-7ad060bcd4c0,1510078219,60,1548678932,,0,0,13.38,4045,4061,32,33,,,1,0,0.05,,0.94,,955,150,192,,,,56.39,40.53,56.55,1,,,,,,,,,,,,,,106,82,11.93,13.38,13.44,21.2,,,,,,,,,,,,,,,,"16,5,8,7,17,32,7,7,1","0,28,45,25,2",,,,,,121,,,,,,,,,,,,,,,,,,,,,,,,,,,,,,,,,,,,90.1,7,1,308,88,,1017,,,1,5,3,,1,0,I1.000|5:01-I1.000|4:29-I1.000|4:26-I1.000|4:18-I1.000|4:11-I1.000|4:21-I1.000|4:07-I1.000|4:04-I1.000|4:07-I1.000|3:51-I1.000|4:08-I1.000|5:07-I1.000|6:01-I0.379|9:32,,Running,,,,"Polar M430",43,0,,0,168070,250480,30378,,,,,,,,,,,,,,,,,,,,,,,,,,,,,,,,,,,,,,,,,,,
5964912,ba9635d6-4c6d-40b4-8fe0-36c0bf9ad0a8,1501415528,120,1548678932,,0,0,2.95,1022,1024,24,24,,,1,0.2,0.34,1.03,1,,192,145,158,,,,49.86,31.22,50.36,1,,,,,,,,,,,,,,22,80,10.49,10.58,10.71,0.1,,,,,,,,,,,,,,,,"14,16,34,32,5,0,0,0,0","1,22,77,0,0",,,,,,108,,,,,,,,,,,,,,,,,,,,,,,,,,,,,,,,,,,,28.4,23,18,227,62,,1008,4,,0,5,3,,1,0,I1.000|5:59-I1.000|5:32-I0.947|5:43,,Running,,,,"Polar M430",43,0,,0,168070,250480,30378,,,,,,,,,,,,,,,,,,,,,,,,,,,,,,,,,,,,,,,,,,,
5964913,da38cf8b-4ecc-46cf-b613-ea66fb3d3c21,1425722466,60,1548678935,,0,0,38.02,11181,11768,509,509,,,1,2.5,0.47,,,309,2648,,,,,,,45.15,,1,,,,,,,,,,,,,,232,83,12.5,12.46,12.81,,,,,,,,,,,,,,,,,"4,2,7,17,50,19,1,0,0",,,,,,,123,,,,,,,,,,,,,,,,,,,,,,,,,,,,,,,,,,,,,6,8,193,70,,1032,1,,0,5,3,,1,0,,,,,"Sehr sehr langer DL",,"Polar BEAT",,0,,0,168070,250480,30378,,,,,,,,,,,,,,,,,,,,,,,,,,,,,,,,,,,,,,,,,,"5,5,5,5,5",
5964914,524c31bd-4650-474e-ae20-b0e9d625b8ef,1537378507,120,1548678935,,0,0,12.08,3608,3614,16,18,,,1,0,0.03,0.69,,,791,142,183,,,,61.51,40.78,61.59,1,,,,,,,,,,,,,,82,80,12.15,13.65,13.66,10.9,,,,,,,,,,,,,,,,"29,5,4,19,7,2,18,17,0","1,60,8,29,2",,,,,,126,,,,,,,,,,,,,,,,,,,,,,,,,,,,,,,,,,,,72,29,11,269,34,,1019,,,0,3,3,,1,0,I3.169|16:31-I1.052|3:47-I0.209|1:58-I1.052|3:46-I0.209|2:11-I1.057|3:46-I0.224|2:28-I1.043|3:37-I0.208|2:22-I1.051|3:33-I0.216|2:30-I1.063|3:29-I1.520|10:22,,Running,,,,"Polar M430",43,0,,0,168070,250480,30378,,,,,,,,,,,,,,,,,,,,,,,,,,,,,,,,,,,,,,,,,,,
5964915,53cbe259-4404-4a8f-b0a8-d0b88c3ba885,1407106450,120,1548678937,,0,0,2.53,911,912,24,41,,,1,0.8,0.56,1.01,0.99,,149,123,135,,,,57.91,29.48,58.11,1,,,,,,,,,,,,,,11,82,10,10.06,10.12,-0.5,,,,,,,,,,,,,,,,"18,34,32,16,1,0,0,0,0","0,100,0,0,0",,,,,,102,,,,,,,,,,,,,,,,,,,,,,,,,,,,,,,,,,,,9,17,2,195,95,,1014,0,,1,6,3,,1,0,,,,,Auslaufen,,"Polar BEAT",,0,,0,168070,250480,30378,,,,,,,,,,,,,,,,,,,,,,,,,,,,,,,,,,,,,,,,,,,
5964916,3097a056-534d-401d-9b4d-2f48c6f59475,1481468675,60,1548678938,,0,0,19.31,5392,5428,338,322,,,1,3.2,0.59,,,501,1301,,,,,,,45.77,,1,,,,,,,,,,,,,,111,83,13.31,13.16,13.63,,,,,,,,,,,,,,,,,"4,2,5,18,27,31,12,0,0",,,,,,,129,,,,,,,,,,,,,,,,,,,,,,,,,,,,,,,,,,,,,7,9,256,78,,1024,0,,0,5,3,,1,0,,,,,"Aachen Laufen",,"Polar BEAT",,0,,0,168070,250480,30378,,,,,,,,,,,,,,,,,,,,,,,,,,,,,,,,,,,,,,,,,,"4,5,5,5",
5964917,c673a55d-e551-4b95-8553-651ad008e4cc,1469565265,120,1548678939,,0,0,1.16,290,290,0,0,,,1,0,0,,,,79,,,,,,,41.19,,1,,,,,,,,,,,,,,6,84,14.38,15.19,15.21,,,,,,,,,,,,,,,,,"0,1,15,18,7,3,46,10,0",,,,,,,143,,,,,,,,,,,,,,,,,,,,,,,,,,,,,,,,,,,,,20,0,54,73,,1020,0,,0,5,3,,1,0,,,,,"Aachen Laufen",,"Polar BEAT",,0,,0,168070,250480,30378,,,,,,,,,,,,,,,,,,,,,,,,,,,,,,,,,,,,,,,,,,,
5964918,713da4b8-a76f-4bb0-9ddd-c69d36f13618,1453746859,60,1548678943,,0,0,8,1952,2686,171,174,,,1,2.7,0.76,,,,548,,,,,,,50.25,,1,,,,,,,,,,,,,,40,83,15.16,14.82,15.43,,,,,,,,,,,,,,,,,"1,1,1,1,1,45,51,0,0",,,,,,,148,,,,,,,,,,,,,,,,,,,,,,,,,,,,,,,,,,,,,10,16,190,63,,1025,,,1,3,3,,1,0,,,,,"Aachen Laufen",,"Polar BEAT",,0,,0,168070,250480,30378,,,,,,,,,,,,,,,,,,,,,,,,,,,,,,,,,,,,,,,,,,,
5964919,5d3cb3af-98a9-4830-91c6-5bb7478a8df9,1422385919,60,1548678947,,0,0,15.51,4196,4699,165,165,,,1,1.3,0.45,,,,1026,,,,,,,46.65,,1,,,,,,,,,,,,,,87,85,13.34,14.01,14.42,,,,,,,,,,,,,,,,,"3,6,12,25,16,7,19,12,1",,,,,,,130,,,,,,,,,,,,,,,,,,,,,,,,,,,,,,,,,,,,,4,6,261,94,,1024,0,,1,5,3,,1,0,,,,,"5x Sprint Runde",,"Polar BEAT",,0,,0,168070,250480,30378,,,,,,,,,,,,,,,,,,,,,,,,,,,,,,,,,,,,,,,,,,,
5964920,768ac032-40f0-42a9-ba60-81250f6872de,1497111559,120,1548678949,,0,0,3.47,1257,1268,67,65,,,1,1.5,0.53,,,,191,,,,,,,29.93,,1,,,,,,,,,,,,,,26,75,10,12.32,13.32,,,,,,,,,,,,,,,,,"56,2,2,3,3,4,7,18,5",,,,,,,110,,,,,,,,,,,,,,,,,,,,,,,,,,,,,,,,,,,,,24,7,224,46,,1019,5,,0,5,3,,1,0,,,,,"Aachen Laufen",,"Polar BEAT",,0,,0,168070,250480,30378,,,,,,,,,,,,,,,,,,,,,,,,,,,,,,,,,,,,,,,,,,,
5964921,,1419537600,60,1548678949,,0,0,5,0,0,,,,,0,,,,,,329,,,,,,,,,1,,,,,,,,,,,,,,0,,,,,,,,,,,,,,,,,,,,,,,,,,,,,,,,,,,,,,,,,,,,,,,,,,,,,,,,,,,,,,,,,,,,,,,,,,1,,,0,0,,,,,"Lockerer DL",,"Polar BEAT",,0,,0,168070,250480,30378,,,,,,,,,,,,,,,,,,,,,,,,,,,,,,,,,,,,,,,,,,,
5964922,db77b3e1-ff78-42d7-85ce-2b8ceb33d249,1470268643,120,1548678950,,0,0,1.01,190,190,4,13,,,1,0.9,0.6,,,,52,,,,,,,56.04,,1,,,,,,,,,,,,,,3,89,18.7,19.32,19.3,,,,,,,,,,,,,,,,,"0,0,0,0,0,0,2,66,32",,,,,,,179,,,,,,,,,,,,,,,,,,,,,,,,,,,,,,,,,,,,,17,10,234,95,,1012,0,,1,6,3,,1,0,,,,,"Aachen Laufen",,"Polar BEAT",,0,,0,168070,250480,30378,,,,,,,,,,,,,,,,,,,,,,,,,,,,,,,,,,,,,,,,,,,
5964923,1db9d47c-c1c8-428e-88a7-41428bbeed2c,1403734565,120,1548678950,,0,0,4,1535,1535,0,0,,,1,0,0,,,,269,,,,,,,28.16,,1,,,,,,,,,,,,,,31,80,9.38,9.39,9.41,,,,,,,,,,,,,,,,,"35,63,2,0,0,0,0,0,0",,,,,,,98,,,,,,,,,,,,,,,,,,,,,,,,,,,,,,,,,,,,,13,0,,83,,,0,,1,5,3,,1,0,,,,,Auslaufen,,"Polar BEAT",,0,,0,168070,250480,30378,,,,,,,,,,,,,,,,,,,,,,,,,,,,,,,,,,,,,,,,,,,
5964924,f2562aa6-c0b0-4bb5-b4d8-64f5c7297162,1429738694,120,1548678953,,0,0,3.82,1019,1048,57,54,,,1,1.3,0.58,,,,256,,,,,,,43.22,,1,,,,,,,,,,,,,,21,82,13.76,13.64,13.97,,,,,,,,,,,,,,,,,"2,0,1,6,33,44,13,0,0",,,,,,,137,,,,,,,,,,,,,,,,,,,,,,,,,,,,,,,,,,,,,9,7,15,73,,1025,,,1,3,3,,1,0,,,,,"Aachen Laufen",,"Polar BEAT",,0,,0,168070,250480,30378,,,,,,,,,,,,,,,,,,,,,,,,,,,,,,,,,,,,,,,,,,,
5964925,a9b89677-8b24-4112-8b9e-03b495e79854,1466691521,120,1548678953,,0,0,6.85,2349,2383,115,86,,,1,1.7,0.56,,,358,471,,,,,,,33.3,,1,,,,,,,,,,,,,,48,79,10.83,10.62,11.25,,,,,,,,,,,,,,,,,"11,18,42,22,4,2,0,0,0",,,,,,,111,,,,,,,,,,,,,,,,,,,,,,,,,,,,,,,,,,,,,30,2,193,60,,1016,7,,0,5,3,,1,0,,,,,"Voeren Sint-Martens-Voeren Laufen",,"Polar BEAT",,0,,0,168070,250480,30378,,,,,,,,,,,,,,,,,,,,,,,,,,,,,,,,,,,,,,,,,,"5,5",
5964926,b6421243-4254-4483-a151-4202f88aae84,1545243858,60,1548678959,,0,0,0.58,215,216,0,2,,,1,0,0,1.07,0.84,,38,126,132,,,,54.39,24.43,54.16,1,,,,,,,,,,,,,,2,82,9.7,9.7,9.69,-0.4,,,,,,,,,,,,,,,,"18,56,18,8,0,0,0,0,0","5,95,0,0,0",,,,,,99,,,,,,,,,,,,,,,,,,,,,,,,,,,,,,,,,,,,4.8,5,5,155,97,,,0,,1,5,3,,1,0,,,Running,,,,"Polar M430",43,0,,0,168070,250480,30378,,,,,,,,,,,,,,,,,,,,,,,,,,,,,,,,,,,,,,,,,,,
5964927,4ced2ec4-287a-4020-9737-c54cba5c3e5c,1456050568,60,1548678960,,0,0,23.11,6865,6886,331,333,,,1,2.4,0.47,,,747,1604,,,,,,,43.2,,1,,,,,,,,,,,,,,142,83,12.41,12.32,12.7,,,,,,,,,,,,,,,,,"5,4,8,23,41,18,2,0,0",,,,,,,122,,,,,,,,,,,,,,,,,,,,,,,,,,,,,,,,,,,,,10,30,238,92,,1014,,,0,11,3,,1,0,,,,,"Aachen Laufen",,"Polar BEAT",,0,,0,168070,250480,30378,,,,,,,,,,,,,,,,,,,,,,,,,,,,,,,,,,,,,,,,,,4,
5964929,e1a459ba-ba01-4e46-af9c-0cd0a735c332,1494446993,120,1548678964,,0,0,13.01,3557,3557,185,191,,,1,2.1,0.58,,,391,917,,,,,,,45.46,,1,,,,,,,,,,,,,,73,80,13.44,13.36,13.64,,,,,,,,,,,,,,,,,"1,2,3,12,44,30,6,2,0",,,,,,,137,,,,,,,,,,,,,,,,,,,,,,,,,,,,,,,,,,,,,16,9,65,44,,1005,,,0,3,3,,1,0,,,,,"Aachen Laufen",,"Polar BEAT",,0,,0,168070,250480,30378,,,,,,,,,,,,,,,,,,,,,,,,,,,,,,,,,,,,,,,,,,4,
5964930,96dfa459-05ef-4a0a-b819-47d8b3f7cd11,1503836126,120,1548678965,,0,0,0.35,70,70,0,2,,,1,0.4,0.41,,,,9,120,140,,,,,48.51,,1,,,,,,,,,,,,,,0,89,17.56,17.95,18.04,26.1,,,,,,,,,,,,,,,,"0,0,0,0,0,0,11,89,0","23,77,0,0,0",,,,,,169,,,,,,,,,,,,,,,,,,,,,,,,,,,,,,,,,,,,1.3,21,4,55,72,,1019,4,,0,5,3,,1,0,,,Running,,,,"Polar M430",43,0,,0,168070,250480,30378,,,,,,,,,,,,,,,,,,,,,,,,,,,,,,,,,,,,,,,,,,,
5964931,481a26af-0541-4626-b876-45b823841d29,1498855328,120,1548678966,,0,0,14.6,4582,5158,283,283,,,1,2.9,0.52,,,398,1004,,,,,,,39.07,,1,,,,,,,,,,,,,,95,78,11.9,11.6,12.32,,,,,,,,,,,,,,,,,"5,4,16,41,31,3,0,0,0",,,,,,,123,,,,,,,,,,,,,,,,,,,,,,,,,,,,,,,,,,,,,20,23,261,59,,1013,0,,0,5,3,,1,0,,,,,"Aix-en-Provence Laufen",,"Polar BEAT",,0,,0,168070,250480,30378,,,,,,,,,,,,,,,,,,,,,,,,,,,,,,,,,,,,,,,,,,"4,4,5,5",
5964932,7fccf584-3a5b-406c-a28d-ebe0ef6d4cba,1507132930,120,1548678967,,0,0,11.1,2830,2832,148,139,,,1,1.8,0.53,1.06,0.99,,728,157,176,,,,65.36,48.74,66.5,1,,,,,,,,,,,,,,84,82,14.38,14.28,14.52,-0.6,,,,,,,,,,,,,,,,"0,1,2,8,18,38,33,0,0","1,3,55,42,0",,,,,,143,,,,,,,,,,,,,,,,,,,,,,,,,,,,,,,,,,,,65.4,14,25,254,68,,1021,,,0,5,3,,1,0,I1.000|5:03-I1.000|4:27-I1.000|4:22-I1.000|4:28-I1.000|4:11-I1.000|4:24-I1.000|3:55-I1.000|3:57-I1.000|4:02-I1.000|3:55-I1.000|3:57-I0.099|0:30,,Running,,,,"Polar M430",43,0,,0,168070,250480,30378,,,,,,,,,,,,,,,,,,,,,,,,,,,,,,,,,,,,,,,,,,,
5964933,fbc05e07-09b7-414d-af09-3ec2d5e40ffc,1531298776,120,1548678968,,0,0,10.98,1817,1818,38,45,,,1,0,0.09,1.74,0.58,,328,128,162,,,,,,,1,,,,,,,,,,,,,,28,,,23.8,,14.1,-7.4,114,96,,1,134,122,,,,,,,,,"20,6,24,49,1,0,0","11,57,31,1,0","84,6,0,1,9",,,,,,,,,,,,,,,,,,,,,,,,,,,,,,,,,,,,,,,,,27.5,16,6,261,78,,1017,,,0,5,3,,1,0,,,Cycling,,,,"Polar M430",43,0,,0,168072,,30378,,,,,,,,,,,,,,,,,,,,,,,,,,,,,,,,,,,,,,,,,,,
5964936,2f441927-9486-4f71-8af8-bf124108c836,1493099631,120,1548678974,,0,0,3.34,4172,5263,583,106,,,2,6.1,0.84,,,493,102,,,,,,,,,1,,,,,,,,,,,,,,86,46,3.45,3.33,5.81,,,,,,,,,,,,,,,,,"100,0,0,0,0,0,0,0,0",,,,,,,52,,,,,,,,,,,,,,,,,,,,,,,,,,,,,,,,,,,,,15,8,59,63,,1017,6,,0,5,3,,1,0,,,,,Laufen,,"Polar BEAT",,0,,0,168070,250480,30378,,,,,,,,,,,,,,,,,,,,,,,,,,,,,,,,,,,,,,,,,,0,
5964937,1324dd71-eadc-47d5-b6db-165c4c0f9bb9,1401221677,120,1548678975,,0,0,4.76,1417,1604,27,24,,,1,0,0.21,,,,315,,,,,,,38.55,,1,,,,,,,,,,,,,,29,82,12.17,12.29,12.48,,,,,,,,,,,,,,,,,"7,4,12,20,35,18,3,0,0",,,,,,,123,,,,,,,,,,,,,,,,,,,,,,,,,,,,,,,,,,,,,13,9,243,96,,1012,0,,0,4,3,,1,0,,,,,Einlaufen,,"Polar BEAT",,0,,0,168070,250480,30378,,,,,,,,,,,,,,,,,,,,,,,,,,,,,,,,,,,,,,,,,,,
5964938,2a1eb7c8-0fac-4a02-8c00-248ee861eb3b,1483011908,60,1548678976,,0,0,1.71,561,817,9,16,,,1,0,0.24,,,,118,,,,,,,31.67,,1,,,,,,,,,,,,,,11,80,10.93,11.12,11.18,,,,,,,,,,,,,,,,,"9,4,38,30,13,6,0,0,0",,,,,,,114,,,,,,,,,,,,,,,,,,,,,,,,,,,,,,,,,,,,,0,1,145,94,,1040,1,,0,3,3,,1,0,,,,,"Aachen Laufen",,"Polar BEAT",,0,,0,168070,250480,30378,,,,,,,,,,,,,,,,,,,,,,,,,,,,,,,,,,,,,,,,,,,
5964939,e3c5a4c3-2201-4894-a131-4ca80ac32893,1505658656,120,1548678977,,0,0,0.19,69,73,5,4,,,1,0,0,1.4,,,9,111,125,,,,63.83,23.12,66.34,1,,,,,,,,,,,,,,0,81,10.66,9.87,10.77,16.3,,,,,,,,,,,,,,,,"19,41,16,10,14,0,0,0,0","25,75,0,0,0",,,,,,102,,,,,,,,,,,,,,,,,,,,,,,,,,,,,,,,,,,,0.7,15,4,237,66,,1013,4,,0,5,3,,1,0,,,Running,,,,"Polar M430",43,0,,0,168070,250480,30378,,,,,,,,,,,,,,,,,,,,,,,,,,,,,,,,,,,,,,,,,,,
5964940,89c298f7-3a1f-461e-88af-05b4a0a3f463,1460205821,120,1548678977,,0,0,8.5,2454,2506,143,107,,,1,2.3,0.64,,,382,571,,,,,,,41.39,,1,,,,,,,,,,,,,,50,81,12.9,13.2,13.88,,,,,,,,,,,,,,,,,"12,2,3,9,27,30,15,2,0",,,,,,,128,,,,,,,,,,,,,,,,,,,,,,,,,,,,,,,,,,,,,13,5,188,52,,1008,5,,0,5,3,,1,0,,,,,"Aachen Laufen",,"Polar BEAT",,0,,0,168070,250480,30378,,,,,,,,,,,,,,,,,,,,,,,,,,,,,,,,,,,,,,,,,,5,
5964941,9893d077-a0fb-474d-8423-ec4d77948fb2,1501848978,120,1548678980,,0,0,8.87,2580,2580,128,125,,,1,1.9,0.55,1.02,1,339,568,145,174,,,,61.86,41.15,62.99,1,,,,,,,,,,,,,,58,82,12.66,12.6,12.95,10,,,,,,,,,,,,,,,,"2,2,15,18,37,22,4,0,0","0,34,55,11,0",,,,,,126,,,,,,,,,,,,,,,,,,,,,,,,,,,,,,,,,,,,47.4,20,12,241,68,,1014,5,,0,5,3,,1,0,I1.000|4:44-I1.000|4:19-I1.000|4:36-I1.000|4:31-I1.000|4:51-I1.000|4:33-I1.000|5:10-I1.000|5:38-I0.871|4:37,,Running,,,,"Polar M430",43,0,,0,168070,250480,30378,,,,,,,,,,,,,,,,,,,,,,,,,,,,,,,,,,,,,,,,,,4,
5964942,387d44cf-b02b-422c-b49e-09038c326194,1524040125,120,1548678982,,0,0,10.88,1785,1785,32,44,,,1,0,0.11,,0.7,,332,134,159,,,,,,,1,,,,,,,,,,,,,,30,,,22.97,,9.3,2.8,108,91,,1,125,112,,,,,,,,,"9,10,51,29,0,0,0","1,71,29,0,0","86,4,0,1,9",,,,,,,,,,,,,,,,,,,,,,,,,,,,,,,,,,,,,,,,,19.6,14,8,20,71,,1028,,,0,3,3,,1,0,,,Cycling,,,,"Polar M430",43,0,,0,168072,,30378,,,,,,,,,,,,,,,,,,,,,,,,,,,,,,,,,,,,,,,,,,,
5964943,603a3bef-4800-4e36-aa36-680ebbb16f60,1523383835,120,1548678983,,0,0,10.83,2745,2745,30,29,,,1,0,0.06,1.11,0.96,,784,167,184,,,,60.17,48.99,60.38,1,,,,,,,,,,,,,,103,84,14.24,14.27,14.35,5.6,,,,,,,,,,,,,,,,"0,0,0,1,18,56,25,0,0","0,3,25,67,5",,,,,,141,,,,,,,,,,,,,,,,,,,,,,,,,,,,,,,,,,,,106.4,12,12,228,68,,1013,0,,0,4,3,,1,0,I1.000|4:42-I1.000|4:23-I1.000|4:12-I1.000|4:16-I1.000|4:05-I1.000|4:20-I1.000|4:13-I1.000|3:57-I1.000|4:10-I1.000|4:06-I0.831|3:23,,Running,,,,"Polar M430",43,0,,0,168070,250480,30378,,,,,,,,,,,,,,,,,,,,,,,,,,,,,,,,,,,,,,,,,,,
5964944,467c709e-3183-4517-a35c-10fb4c95bb30,1465416177,120,1548678983,,0,0,2.35,744,750,17,16,,,1,0,0,,,,159,,,,,,,34.05,,1,,,,,,,,,,,,,,15,77,11.51,12.2,12.33,,,,,,,,,,,,,,,,,"13,3,9,20,25,29,0,0,0",,,,,,,123,,,,,,,,,,,,,,,,,,,,,,,,,,,,,,,,,,,,,19,13,343,61,,1020,,,0,5,3,,1,0,,,,,"Köln Laufen",,"Polar BEAT",,0,,0,168070,250480,30378,,,,,,,,,,,,,,,,,,,,,,,,,,,,,,,,,,,,,,,,,,,
5964945,28bc2711-8c5f-4f0b-8969-84a1b66c34a1,1538300505,120,1548678984,,0,0,16.02,4626,4633,58,60,,,1,0,0.04,1.1,0.87,,1018,140,159,,,,65.29,43.36,65.57,1,,,,,,,,,,,,,,91,81,12.5,12.68,12.75,-13.8,,,,,,,,,,,,,,,,"0,0,3,41,43,3,10,0,0","1,34,65,0,0",,,,,,128,,,,,,,,,,,,,,,,,,,,,,,,,,,,,,,,,,,,28.9,8,5,30,74,,1019,,,0,5,3,,1,0,I1.000|5:02-I1.000|5:05-I1.000|4:57-I1.000|4:58-I1.000|4:57-I1.000|4:55-I1.000|4:59-I1.000|4:56-I1.000|4:55-I1.000|5:00-I1.000|4:30-I1.000|3:41-I1.000|3:53-I1.000|5:09-I1.000|5:07-I1.000|5:06-I0.020|0:05,,Running,,,,"Polar M430",43,0,,0,168070,250480,30378,,,,,,,,,,,,,,,,,,,,,,,,,,,,,,,,,,,,,,,,,,,
5964946,5e5bc155-9ab7-4ebb-aa79-f79fce7e14a4,1478955107,60,1548678984,,0,0,2.52,900,901,34,38,,,1,0,0.12,,,,144,,,,,,,29.76,,1,,,,,,,,,,,,,,18,79,10.71,12.12,12.2,,,,,,,,,,,,,,,,,"42,2,2,2,7,23,14,8,0",,,,,,,106,,,,,,,,,,,,,,,,,,,,,,,,,,,,,,,,,,,,,4,7,164,82,,1023,1,,0,5,3,,1,0,,,,,"Raeren Hauset Laufen",,"Polar BEAT",,0,,0,168070,250480,30378,,,,,,,,,,,,,,,,,,,,,,,,,,,,,,,,,,,,,,,,,,,
5964947,56504a6e-9b5f-4a9a-bfe5-9ed7a74b1445,1462395877,120,1548678984,,0,0,5.01,1172,1606,44,50,,,1,0.8,0.44,,,,343,,,,,,,51.32,,1,,,,,,,,,,,,,,24,84,15.54,15.58,15.81,,,,,,,,,,,,,,,,,"1,1,1,2,2,27,59,9,0",,,,,,,153,,,,,,,,,,,,,,,,,,,,,,,,,,,,,,,,,,,,,12,2,69,53,,1027,0,,1,3,3,,1,0,,,,,"Aachen Laufen",,"Polar BEAT",,0,,0,168070,250480,30378,,,,,,,,,,,,,,,,,,,,,,,,,,,,,,,,,,,,,,,,,,,
5964948,ba8f694a-5857-40fd-8a2e-fc6bca41c86e,1467801432,120,1548678984,,0,0,0.78,227,227,,,,,0,,,,,,54,,,,,,,33.26,,1,,,,,,,,,,,,,,4,81,,12.4,,,,,,,,,,,,,,,,,,"3,3,2,2,91,0,0,0,0",,,,,,,127,,,,,,,,,,,,,,,,,,,,,,,,,,,,,,,,,,,,,,,,,,,,,,1,,,1,0,,,,,Laufen,,"Polar BEAT",,0,,0,168070,250480,30378,,,,,,,,,,,,,,,,,,,,,,,,,,,,,,,,,,,,,,,,,,,
5964949,f99180cd-3343-48f0-8cf6-7597ad46b9d3,1401660795,120,1548678985,,0,0,5.42,1524,1877,59,59,,,1,0.7,0.34,,,,367,,,,,,,41.55,,1,,,,,,,,,,,,,,31,81,12.95,12.98,13.26,,,,,,,,,,,,,,,,,"5,1,3,11,37,39,4,0,0",,,,,,,132,,,,,,,,,,,,,,,,,,,,,,,,,,,,,,,,,,,,,13,1,25,65,,1021,0,,1,3,3,,1,0,,,,,Auslaufen,,"Polar BEAT",,0,,0,168070,250480,30378,,,,,,,,,,,,,,,,,,,,,,,,,,,,,,,,,,,,,,,,,,,
5964950,e6a038b9-e8b8-4722-a74d-aa6aeb46ebb1,1495482149,120,1548678986,,0,0,3.47,982,982,67,70,,,1,1.8,0.94,,,,223,,,,,,,40.06,,1,,,,,,,,,,,,,,20,80,12.89,13.91,14.48,,,,,,,,,,,,,,,,,"22,3,7,3,11,8,37,10,0",,,,,,,133,,,,,,,,,,,,,,,,,,,,,,,,,,,,,,,,,,,,,23,3,99,46,,1015,0,,0,5,3,,1,0,,,,,"Aachen Laufen",,"Polar BEAT",,0,,0,168070,250480,30378,,,,,,,,,,,,,,,,,,,,,,,,,,,,,,,,,,,,,,,,,,,
5964951,0f92e518-f483-4514-a9d0-a1ea822deff1,1360689434,60,1548678987,,0,0,,7837,7837,,,,,0,,,,,,1676,120,210,,,,,,,1,,,,,,,,,,,,,,98,,,,,,,,,,,,,,,,,,,,,,"7,90,1,1,2",,,,,,,,,,,,,,,,,,,,,,,,,,,,,,,,,,,,,,,,,,41.9,,,,,,,,,,1,,,1,0,,,,,,,"Polar BEAT",,0,,0,168072,,30378,,,,,,,,,,,,,,,,,,,,,,,,,,,,,,,,,,,,,,,,,,,
5964952,d12297e9-048e-471d-a2d7-589e6becf90c,1409508439,120,1548678988,,0,0,10.01,2728,2728,269,272,,,1,3.5,0.78,1.25,0.91,339,516,146,159,,,,66.45,44.77,68.64,1,,,,,,,,,,,,,,62,83,13.64,13.36,14.27,-13.3,,,,,,,,,,,,,,,,"0,0,1,18,42,26,13,0,0","0,8,92,0,0",,,,,,133,,,,,,,,,,,,,,,,,,,,,,,,,,,,,,,,,,,,34.7,14,5,276,84,,,1,,0,5,3,,1,0,,,,,"Lockerer DL",,"Polar BEAT",,0,,0,168070,250480,30378,,,,,,,,,,,,,,,,,,,,,,,,,,,,,,,,,,,,,,,,,,"4,5,5,5",
5964953,ee0b8df9-f247-4a82-b779-1f541635bba0,1408194930,120,1548678990,,0,0,1.66,592,592,71,4,,,1,2.1,0.76,,,408,109,,,,,,,28.68,,1,,,,,,,,,,,,,,12,80,11.72,10.27,12.51,,,,,,,,,,,,,,,,,"21,24,24,32,0,0,0,0,0",,,,,,,105,,,,,,,,,,,,,,,,,,,,,,,,,,,,,,,,,,,,,17,7,266,76,,1021,5,,0,5,3,,1,0,,,,,"Einlaufen + Lauf ABC ",,"Polar BEAT",,0,,0,168070,250480,30378,,,,,,,,,,,,,,,,,,,,,,,,,,,,,,,,,,,,,,,,,,4,
5964954,0f12b424-c34d-4e2f-a917-d4b2451a00c0,1475092491,120,1548678994,,0,0,0.8,377,386,11,9,,,1,1.4,1,,,,52,,,,,,,19.08,,1,,,,,,,,,,,,,,7,70,7.94,9.32,9.73,,,,,,,,,,,,,,,,,"48,15,11,24,1,0,0,0,0",,,,,,,91,,,,,,,,,,,,,,,,,,,,,,,,,,,,,,,,,,,,,19,8,226,70,,1026,0,,1,5,3,,1,0,,,,,"Aachen Laufen",,"Polar BEAT",,0,,0,168070,250480,30378,,,,,,,,,,,,,,,,,,,,,,,,,,,,,,,,,,,,,,,,,,,
5964955,6cdb9600-121c-4992-b057-f7f2ed45be25,1334751107,120,1548678997,,0,0,7.24,1963,2020,159,176,,,1,2,0.52,,,310,498,,,,,,,44.12,,1,,,,,,,,,,,,,,40,,13.88,13.9,14.39,,,,,,,,,,,,,,,,,"10,6,8,13,18,18,15,8,4",,,,,,,,,,,,,,,,,,,,,,,,,,,,,,,,,,,,,,,,,,,,10,21,191,62,,994,4,,0,5,3,,1,0,,,,,,,"Polar BEAT",,0,,0,168070,250480,30378,,,,,,,,,,,,,,,,,,,,,,,,,,,,,,,,,,,,,,,,,,4,
5964956,2aaaa91f-32d1-4246-9736-81bbd569eb74,1533762627,120,1548678998,,0,0,6.17,2238,2239,29,28,,,1,0,0.1,1.15,0.91,,399,123,146,,,,57.39,30.93,57.74,1,,,,,,,,,,,,,,28,80,9.96,10.05,10.15,0.5,,,,,,,,,,,,,,,,"26,28,28,16,2,0,0,0,0","3,95,2,0,0",,,,,,103,,,,,,,,,,,,,,,,,,,,,,,,,,,,,,,,,,,,12,26,7,333,55,,,0,,1,5,3,,1,0,I1.000|7:03-I1.000|5:57-I1.000|5:23-I1.000|6:10-I1.000|5:54-I1.000|5:50-I0.169|1:03,,Running,,,,"Polar M430",43,0,,0,168070,250480,30378,,,,,,,,,,,,,,,,,,,,,,,,,,,,,,,,,,,,,,,,,,,
5964957,717b9b3a-2c46-4e4a-915a-82970569b7cb,1420372497,60,1548679001,,0,0,18.83,5867,5955,305,308,,,1,2.8,0.59,,,568,1264,,,,,,,40.21,,1,,,,,,,,,,,,,,121,82,11.87,12.78,13.19,,,,,,,,,,,,,,,,,"16,2,4,17,24,27,10,1,0",,,,,,,117,,,,,,,,,,,,,,,,,,,,,,,,,,,,,,,,,,,,,3,11,291,91,,1036,,,0,5,3,,1,0,,,,,"Lockerer DL",,"Polar BEAT",,0,,0,168070,250480,30378,,,,,,,,,,,,,,,,,,,,,,,,,,,,,,,,,,,,,,,,,,"4,5,5",
5964958,4955eb9f-77fe-4195-bb35-14c633bba5a9,1530384722,120,1548679002,,0,0,3.54,1752,1754,55,56,,,1,1.6,0.68,1.3,0.86,260,387,142,177,,,,32.93,20.42,33.55,1,,,,,,,,,,,,,,39,83,7.43,7.54,7.75,21.2,,,,,,,,,,,,,,,,"98,2,0,0,0,0,0,0,0","1,48,20,31,0",,,,,,73,,,,,,,,,,,,,,,,,,,,,,,,,,,,,,,,,,,,57.6,25,23,76,22,,,,,0,3,3,,1,0,I1.000|8:03-I1.000|9:28-I1.000|7:32-I0.537|4:13,,Running,,,,"Polar M430",43,0,,0,168070,250480,30378,,,,,,,,,,,,,,,,,,,,,,,,,,,,,,,,,,,,,,,,,,5,
5964959,338cd787-b470-4fe3-8ef1-0cc2c235c91f,1501333822,120,1548679003,,0,0,3.92,1240,1240,47,61,,,1,1,0.54,1.12,1.06,,273,144,163,,,,56.28,35.45,56.86,1,,,,,,,,,,,,,,27,82,11.46,11.48,11.72,-1.9,,,,,,,,,,,,,,,,"2,7,27,38,22,3,1,0,0","3,28,68,1,0",,,,,,116,,,,,,,,,,,,,,,,,,,,,,,,,,,,,,,,,,,,30.3,22,12,233,68,,1013,5,,0,5,3,,1,0,I1.000|5:27-I1.000|5:08-I1.000|5:22-I0.927|4:44,,Running,,,,"Polar M430",43,0,,0,168070,250480,30378,,,,,,,,,,,,,,,,,,,,,,,,,,,,,,,,,,,,,,,,,,,
5964960,441227ed-de00-4089-bf8e-4bf0e3bd3f34,1400706925,120,1548679004,,0,0,10.05,2093,2093,106,108,,,1,1,0.46,,,,689,,,,,,,61.35,,1,,,,,,,,,,,,,,43,87,17.46,17.38,17.57,,,,,,,,,,,,,,,,,"0,0,0,0,0,1,43,52,3",,,,,,,166,,,,,,,,,,,,,,,,,,,,,,,,,,,,,,,,,,,,,22,9,116,51,,1007,,,1,4,3,,1,0,,,,,"WK 10k Unicup Dortmund",,"Polar BEAT",,0,,0,168070,250480,30378,,,,,,,,,,,,,,,,,,,,,,,,10,2093,,,0,"30. Campuslauf Dortmund",,,,,,,0,0,30378,5964960,5951,,,
5964961,9d3dc511-aba4-4724-bd12-fad023f0e860,1462703913,120,1548679005,,0,0,14.08,3724,3724,305,298,,,1,4.1,0.63,,,632,971,,,,,,,47.53,,1,,,,,,,,,,,,,,77,84,14.27,14.12,14.78,,,,,,,,,,,,,,,,,"0,4,10,12,24,18,25,7,0",,,,,,,135,,,,,,,,,,,,,,,,,,,,,,,,,,,,,,,,,,,,,21,9,94,41,,,,,0,3,3,,1,0,,,,,"Balve Laufen",,"Polar BEAT",,0,,0,168070,250480,30378,,,,,,,,,,,,,,,,,,,,,,,,,,,,,,,,,,,,,,,,,,"4,4",
5964962,3e3a2df8-1018-41c3-98cf-76786640be3b,1394478473,60,1548679006,,0,0,11.07,2981,3007,192,207,,,1,2,0.57,1.07,1.02,306,593,154,171,,,,62.76,45.72,64,1,,,,,,,,,,,,,,82,83,13.74,13.59,14.01,-7.1,,,,,,,,,,,,,,,,"3,2,6,10,22,41,13,2,0","0,7,66,27,0",,,,,,134,,,,,,,,,,,,,,,,,,,,,,,,,,,,,,,,,,,,50.7,13,2,21,52,,1025,0,,1,3,3,,1,0,,,,,"Lockerer DL ",,"Polar BEAT",,0,,0,168070,250480,30378,,,,,,,,,,,,,,,,,,,,,,,,,,,,,,,,,,,,,,,,,,5,
5964963,9840c97f-424b-4018-afed-ad84ab23ad9d,1410612775,120,1548679010,,0,0,6.49,2200,2202,105,81,,,1,1.7,0.56,,,373,428,,,,,,,33.65,,1,,,,,,,,,,,,,,45,81,10.98,11.25,11.84,,,,,,,,,,,,,,,,,"13,10,20,27,24,6,1,0,0",,,,,,,109,,,,,,,,,,,,,,,,,,,,,,,,,,,,,,,,,,,,,16,6,31,81,,1025,3,,0,4,3,,1,0,,,,,Einlaufen,,"Polar BEAT",,0,,0,168070,250480,30378,,,,,,,,,,,,,,,,,,,,,,,,,,,,,,,,,,,,,,,,,,4,
5964966,537c0a38-a9f1-4514-9f0d-710ed8a41e91,1541013417,60,1548679017,,0,0,12.7,3767,3770,42,40,,,1,0,0.06,1.06,0.86,,853,142,157,,,,62.03,41.27,62.3,1,,,,,,,,,,,,,,78,80,12.17,12.18,12.25,3.7,,,,,,,,,,,,,,,,"1,1,4,36,50,8,0,0,0","1,28,71,0,0",,,,,,126,,,,,,,,,,,,,,,,,,,,,,,,,,,,,,,,,,,,29.3,9,18,20,76,,1012,,,1,2,1,,1,0,I1.000|4:49-I1.000|4:46-I1.000|4:54-I1.000|4:48-I1.000|4:48-I1.000|4:56-I1.000|4:55-I1.000|5:05-I1.000|5:02-I1.000|4:59-I1.000|5:06-I1.000|5:08-I0.703|3:37,,Running,,,,"Polar M430",43,0,,0,168070,250480,30378,,,,,,,,,,,,,,,,,,,,,,,,,,,,,,,,,,,,,,,,,,,
5964967,2c8abbe5-f8c0-44a9-97be-b91a1152161e,1468441019,120,1548679027,,0,0,3.51,1562,1723,,,,,0,,,,,,237,,,,,,,23.31,,1,,,,,,,,,,,,,,32,72,,10.58,,,,,,,,,,,,,,,,,,"42,4,7,23,15,2,7,0,0",,,,,,,94,,,,,,,,,,,,,,,,,,,,,,,,,,,,,,,,,,,,,,,,,,,,,,1,,,1,0,,,,,Laufen,,"Polar BEAT",,0,,0,168070,250480,30378,,,,,,,,,,,,,,,,,,,,,,,,,,,,,,,,,,,,,,,,,,,
6021596,0bcdfe15-ba41-47f9-9c2d-1b8377c5c264,1548958200,60,1549025645,,0,0,4.5,1393,1415,28,30,,,1,0,0.13,1.07,0.93,,313,141,162,,,,59.38,36.68,59.8,1,,,,,,,,,,,,,,28,80,11.67,11.84,12.01,0,,,,,,,,,,,,,,,,"3,4,15,36,38,3,2,0,0","1,47,50,1,0",,,,,,121,,,,,,,,,,,,,,,,,,,,,,,,,,,,,,,,,,,,27.4,0,13,41,85,,997,0,344,1,5,3,,1,0,,,Running,,,,"Polar M430",43,0,,0,168070,250480,30378,,,,,,,,,,,,,,,,,,,,,,,,,,,,,,,,,,,,,,,,,,,
6021597,77b3c7ae-e206-48b7-bb89-9dd442d8b965,1548868368,60,1549025646,,0,0,0.64,216,216,4,0,,,1,0,0.05,1.17,,,41,130,141,,,,58.91,27.51,59.82,1,,,,,,,,,,,,,,3,82,10.87,10.77,10.92,11.1,,,,,,,,,,,,,,,,"11,6,30,53,0,0,0,0,0","5,90,5,0,0",,,,,,108,,,,,,,,,,,,,,,,,,,,,,,,,,,,,,,,,,,,6.1,3,22,215,78,,998,0,375,0,4,3,,1,0,,,Running,,,,"Polar M430",43,0,,0,168070,250480,30378,,,,,,,,,,,,,,,,,,,,,,,,,,,,,,,,,,,,,,,,,,,
6021598,47650292-fad7-4471-9fb5-7fb1ac36b088,1548868616,60,1549025647,,0,0,25.46,6546,6560,109,114,,,1,0,0.16,1.16,0.89,,1671,152,171,,,,67.66,51.47,68,1,,,,,,,,,,,,,,172,82,14.03,14.09,14.19,2.5,,,,,,,,,,,,,,,,"0,0,0,3,20,60,16,0,0","0,11,73,16,0",,,,,,142,,,,,,,,,,,,,,,,,,,,,,,,,,,,,,,,,,,,55.2,3,22,215,78,,998,0,375,1,4,3,,1,0,I13.226|55:26-I12.232|53:55,,Running,,,,"Polar M430",43,0,,0,168070,250480,30378,,,,,,,,,,,,,,,,,,,,,,,,,,,,,,,,,,,,,,,,,,,
6021599,fb826a46-c433-443a-95a6-3aba796e1186,1548774107,60,1549025648,,0,0,4.09,1029,1034,16,8,,,1,0,0.1,1.23,0.94,,255,150,165,,,,70.77,46.5,71.29,1,,,,,,,,,,,,,,26,82,14.43,14.51,14.71,13.2,,,,,,,,,,,,,,,,"0,0,0,1,25,48,17,8,0","3,3,93,1,0",,,,,,145,,,,,,,,,,,,,,,,,,,,,,,,,,,,,,,,,,,,35.3,5,5,192,56,,1006,1,346,0,5,3,,1,0,,,Running,,,,"Polar M430",43,0,,0,168070,250480,30378,,,,,,,,,,,,,,,,,,,,,,,,,,,,,,,,,,,,,,,,,,,
6021600,108ef9b9-e803-48e8-9607-6a351bc2b96d,1548775409,60,1549025649,,0,0,3.55,1041,1077,16,24,,,1,0,0.23,1.05,0.9,,244,144,161,,,,61.8,38.5,61.97,1,,,,,,,,,,,,,,22,81,12.25,12.33,12.42,1.1,,,,,,,,,,,,,,,,"0,0,3,37,50,10,0,0,0","1,30,69,0,0",,,,,,126,,,,,,,,,,,,,,,,,,,,,,,,,,,,,,,,,,,,28.9,5,10,181,57,,1006,0,337,0,5,3,,1,0,,,Running,,,,"Polar M430",43,0,,0,168070,250480,30378,,,,,,,,,,,,,,,,,,,,,,,,,,,,,,,,,,,,,,,,,,,
6080205,260e298c-f596-40f6-9c79-70f1920ef1f5,1549188893,60,1549437724,,0,0,8.78,2884,3088,217,222,,,1,3.5,0.81,1.07,1.02,480,708,145,164,,,,53.24,35.63,54.83,1,,,,,,,,,,,,,,65,82,11.56,11.34,11.89,-6.7,,,,,,,,,,,,,,,,"18,12,13,20,29,7,1,0,0","0,29,67,4,0",,,,,,111,,,,,,,,,,,,,,,,,,,,,,,,,,,,,,,,,,,,40.1,1,12,311,75,,1016,0,374,0,5,3,,1,0,,,Running,,,,"Polar M430",43,0,,0,168070,250480,30378,,,,,,,,,,,,,,,,,,,,,,,,,,,,,,,,,,,,,,,,,,"4,4,5",
6080206,1dadd5a2-6097-4924-bd10-bd2613b777e8,1549300112,60,1549437724,,0,0,14.45,3756,3756,69,71,,,1,0,0.18,1.11,0.93,,948,152,168,,,,66.75,48.59,67.14,1,,,,,,,,,,,,,,97,81,13.9,13.89,14,6.5,,,,,,,,,,,,,,,,"0,0,0,1,15,78,5,0,0","0,7,82,11,0",,,,,,142,,,,,,,,,,,,,,,,,,,,,,,,,,,,,,,,,,,,45.5,5,4,153,55,,1029,0,348,1,5,3,,1,0,I0.490|2:22-I6.668|28:28-I0.004|0:01-I6.686|29:01-I0.598|2:45,,Running,,,,"Polar M430",43,0,,0,168070,250480,30378,,,,,,,,,,,,,,,,,,,,,,,,,,,,,,,,,,,,,,,,,,,
6083658,2cfcc4bc-65b4-4618-ada4-34451b067e79,1549467840,60,1549468684,1549469357,0,0,14.39,3538,3669,70,72,,,1,0,0.15,1.08,0.93,,825,143,163,,,,77.58,51.81,78.04,1,,,,,,,,,,,,,,74,83,14.68,14.69,14.8,6.4,,,,,,,,,,,,,,,,"0,0,0,1,8,54,36,1,0","0,35,64,1,0",,,,,,147,,,,,,,,,,,,,,,,,,,,,,,,,,,,,,,,,,,,32.5,6,4,189,58,,1025,0,296,0,3,3,,1,0,I0.387|1:36-I6.391|26:14-I0.269|1:02-I6.652|26:51-I0.671|3:13,,Running,,,,"Polar M430",43,0,,0,168070,250480,30378,,,,,,,,,,,,,,,,,,,,,,,,,,,,,,,,,,,,,,,,,,,
6092786,33fe34da-e1f0-4972-857c-102fd50c6899,1549561758,60,1549564207,,0,0,14.61,3925,4265,48,50,,,1,0,0.07,1.12,0.88,,953,148,159,,,,66.43,46.81,66.69,1,,,,,,,,,,,,,,88,82,13.43,13.51,13.59,0.4,,,,,,,,,,,,,,,,"1,1,1,4,28,64,1,0,0","0,4,95,0,0",,,,,,136,,,,,,,,,,,,,,,,,,,,,,,,,,,,,,,,,,,,34.2,6,14,215,92,,1017,0,371,1,5,3,,1,0,I1.000|4:42-I1.000|4:41-I1.000|4:41-I1.000|4:42-I1.000|4:24-I1.000|4:20-I1.000|4:18-I1.000|4:18-I1.000|4:20-I1.000|4:26-I1.000|4:28-I1.000|4:22-I1.000|4:22-I1.000|4:19-I0.609|3:08,,Running,,,,"Polar M430",43,0,,0,168070,250480,30378,,,,,,,,,,,,,,,,,,,,,,,,,,,,,,,,,,,,,,,,,,,
6147219,e96ec7bd-c14b-4d18-9c3b-d75fa9fb8c3a,1549655864,60,1549882924,,0,0,6.31,2136,2137,34,36,,,1,0,0.2,1.13,0.9,,468,140,155,,,,53.65,33.65,53.99,1,,,,,,,,,,,,,,39,79,10.68,10.68,10.81,-0.7,,,,,,,,,,,,,,,,"3,16,53,24,3,1,0,0,0","0,45,55,0,0",,,,,,112,,,,,,,,,,,,,,,,,,,,,,,,,,,,,,,,,,,,24.3,8,11,195,62,,1013,0,344,1,4,3,,1,0,I1.000|5:47-I1.000|5:32-I1.000|5:46-I1.000|5:42-I1.000|5:44-I1.000|5:24-I0.314|1:43,,Running,,,,"Polar M430",43,0,,0,168070,250480,30378,,,,,,,,,,,,,,,,,,,,,,,,,,,,,,,,,,,,,,,,,,,
6147221,a333a0e7-2994-4202-8d09-8e07e306156b,1549793401,60,1549882925,,0,0,20.99,6813,7682,490,489,,,1,4.5,0.77,1.09,1.05,423,1474,138,166,,,,57.53,38.66,59.2,1,,,,,,,,,,,,,,125,82,11.71,11.57,12.05,0.8,,,,,,,,,,,,,,,,"16,14,21,18,16,12,3,0,0","1,47,49,4,0",,,,,,113,,,,,,,,,,,,,,,,,,,,,,,,,,,,,,,,,,,,39.8,7,23,184,81,,998,0,396,0,6,3,,1,0,I1.000|6:04-I1.000|4:56-I1.000|5:23-I1.000|5:47-I1.000|5:03-I1.000|4:41-I1.000|5:39-I1.000|5:57-I1.000|5:30-I1.000|5:47-I1.000|6:22-I1.000|6:06-I1.000|7:26-I1.000|5:46-I1.000|6:55-I1.000|5:17-I1.000|4:37-I1.000|4:20-I1.000|4:13-I1.000|4:12-I0.989|4:21,,Running,,,,"Polar M430",43,0,,0,168070,250480,30378,,,,,,,,,,,,,,,,,,,,,,,,,,,,,,,,,,,,,,,,,,"3,4,5,5",
6153570,ca732020-0a8e-43b4-8baf-8e0fbc737907,1549910914,60,1549913047,,0,0,12.29,3532,4103,42,42,,,1,0,0.07,1.15,0.97,,830,146,160,,,,62.23,42.71,62.49,1,,,,,,,,,,,,,,77,80,12.58,12.55,12.67,3.7,,,,,,,,,,,,,,,,"0,0,2,18,70,10,0,0,0","0,19,81,0,0",,,,,,130,,,,,,,,,,,,,,,,,,,,,,,,,,,,,,,,,,,,37.7,6,12,248,72,,1026,0,418,1,5,3,,1,0,I1.000|4:41-I1.000|4:52-I1.000|4:46-I1.000|4:48-I1.000|4:45-I1.000|4:42-I1.000|4:45-I1.000|4:53-I1.000|4:53-I1.000|4:52-I1.000|4:40-I1.000|4:56-I0.287|1:26,,Running,,,,"Polar M430",43,0,,0,168070,250480,30378,,,,,,,,,,,,,,,,,,,,,,,,,,,,,,,,,,,,,,,,,,,
6227092,8f4bde29-8354-48c7-8499-0666b5031df1,1550074706,60,1550238724,,0,0,14.62,3654,3939,76,76,,,1,0,0.18,1.07,0.91,,856,145,177,,,,74.65,50.9,75.13,1,,,,,,,,,,,,,,87,83,14.45,14.56,14.66,21.6,,,,,,,,,,,,,,,,"0,0,2,7,4,53,33,1,0","1,49,14,37,0",,,,,,145,,,,,,,,,,,,,,,,,,,,,,,,,,,,,,,,,,,,88.8,9,4,333,48,,1036,1,268,0,3,3,,1,0,I7.290|31:06-I6.664|26:25-I0.668|3:30,,Running,,,,"Polar M430",43,0,,0,168070,250480,30378,,,,,,,,,,,,,,,,,,,,,,,,,,,,,,,,,,,,,,,,,,,
6227251,74575892-1c3b-43a8-9f02-aed8748fc0c6,1550167669,60,1550239210,,0,0,13.71,3399,3417,51,52,,,1,0,0.1,1.08,0.91,,904,158,179,,,,67.06,51.13,67.36,1,,,,,,,,,,,,,,100,83,14.56,14.65,14.74,-2,,,,,,,,,,,,,,,,"0,0,1,2,15,49,31,3,0","1,4,43,52,0",,,,,,146,,,,,,,,,,,,,,,,,,,,,,,,,,,,,,,,,,,,67,11,8,31,47,,1036,0,287,1,5,3,,1,0,I1.000|4:46-I1.000|4:21-I1.000|4:26-I1.000|4:12-I1.000|4:06-I1.000|4:09-I1.000|4:07-I1.000|4:06-I1.000|4:09-I1.000|3:58-I1.000|3:56-I1.000|3:57-I1.000|3:40-I0.711|2:49,,Running,,,,"Polar M430",43,0,,0,168070,250480,30378,,,,,,,,,,,,,,,,,,,,,,,,,,,,,,,,,,,,,,,,,,,
6227252,2be47630-7c6c-4e92-a35d-8d8c686dae93,1550236265,60,1550239211,,0,0,12.67,3906,4182,37,36,,,1,0,0.1,1.08,0.91,,920,145,156,,,,57.57,39.45,57.79,1,,,,,,,,,,,,,,82,81,11.72,11.77,11.84,2.8,,,,,,,,,,,,,,,,"1,3,13,54,27,1,0,1,0","1,7,92,0,0",,,,,,120,,,,,,,,,,,,,,,,,,,,,,,,,,,,,,,,,,,,29.5,8,7,66,63,,1033,2,287,0,3,3,,1,0,I1.000|5:28-I1.000|5:16-I1.000|4:40-I1.000|5:00-I1.000|5:05-I1.000|5:08-I1.000|5:10-I1.000|5:12-I1.000|5:11-I1.000|5:19-I1.000|5:13-I1.000|5:03-I0.669|3:34,,Running,,,,"Polar M430",43,0,,0,168070,250480,30378,,,,,,,,,,,,,,,,,,,,,,,,,,,,,,,,,,,,,,,,,,,
6227253,59612ac3-38e6-48ee-8a9b-89aa590ab994,1549994776,60,1550239212,,0,0,11.85,3130,3163,32,32,,,1,0,0.1,,0.92,,798,153,168,,,,64.85,46.99,65.07,1,,,,,,,,,,,,,,82,82,13.67,13.66,13.73,10.5,,,,,,,,,,,,,,,,"0,0,0,3,26,70,1,0,0","0,15,52,32,0",,,,,,139,,,,,,,,,,,,,,,,,,,,,,,,,,,,,,,,,,,,55.1,5,14,194,70,,1037,0,308,1,5,3,,1,0,I1.000|4:26-I1.000|4:28-I1.000|4:20-I1.000|4:21-I1.000|4:20-I1.000|4:19-I1.000|4:29-I1.000|4:35-I1.000|4:28-I1.000|4:21-I1.000|4:19-I0.857|3:49,,Running,,,,"Polar M430",43,0,,0,168070,250480,30378,,,,,,,,,,,,,,,,,,,,,,,,,,,,,,,,,,,,,,,,,,,
6248747,4a12fb35-c110-4d7e-894d-e59606597925,1550391844,60,1550399530,,0,0,30.62,9603,10555,850,849,,,1,5.5,0.8,1.08,1.03,570,2209,144,162,,,,56.88,41.33,58.83,1,,,,,,,,,,,,,,198,82,12.32,11.87,12.75,-5.2,,,,,,,,,,,,,,,,"11,13,18,20,21,14,3,0,0","0,32,67,1,0",,,,,,117,,,,,,,,,,,,,,,,,,,,,,,,,,,,,,,,,,,,38.5,-2,1,178,87,,1025,0,268,0,3,3,,1,0,I16.882|1:28:55-I7.882|46:39-I5.854|25:49,,Running,,,,"Polar M430",43,0,,0,168070,250480,30378,,,,,,,,,,,,,,,,,,,,,,,,,,,,,,,,,,,,,,,,,,"3,4,4,5,5",
6265827,d8b1e5d6-91c4-4e15-9a57-b31d506a2853,1550493814,60,1550495044,,0,0,10.01,3144,3191,28,28,,,1,0,0.04,1.11,0.9,,668,137,154,,,,60.46,37.92,60.67,1,,,,,,,,,,,,,,53,81,11.49,11.5,11.58,5.2,,,,,,,,,,,,,,,,"1,4,16,62,18,0,0,0,0","1,87,13,0,0",,,,,,118,,,,,,,,,,,,,,,,,,,,,,,,,,,,,,,,,,,,20.2,11,4,205,48,,1021,2,284,0,3,3,,1,0,I1.000|5:09-I1.000|5:06-I1.000|5:07-I1.000|5:12-I1.000|5:11-I1.000|5:23-I1.000|5:21-I1.000|5:15-I1.000|5:23-I1.000|5:18-I0.013|0:04,,Running,,,,"Polar M430",43,0,,0,168070,250480,30378,,,,,,,,,,,,,,,,,,,,,,,,,,,,,,,,,,,,,,,,,,,
6287541,d038e350-4b09-41d7-87d9-a6f148082ab6,1550599748,60,1550602571,,0,0,19.23,4826,4882,82,83,,,1,0,0.08,1.14,0.93,,1268,157,173,,,,66.65,51.76,67,1,,,,,,,,,,,,,,137,84,14.38,14.5,14.62,4.3,,,,,,,,,,,,,,,,"0,0,2,5,14,44,33,2,0","0,7,43,49,0",,,,,,142,,,,,,,,,,,,,,,,,,,,,,,,,,,,,,,,,,,,64.7,9,14,187,72,,1022,0,357,1,5,3,,1,0,I4.396|19:07-I3.042|11:24-I1.016|4:40-I2.990|11:43-I1.005|4:50-I3.007|12:21-I0.742|4:06-I3.008|12:19-I0.017|0:05,,Running,,,,"Polar M430",43,0,,0,168070,250480,30378,,,,,,,,,,,,,,,,,,,,,,,,,,,,,,,,,,,,,,,,,,,
6302177,150099dc-b718-48de-b01a-b879752e82f9,1550681752,60,1550682964,,0,0,15.04,3734,3753,72,72,,,1,0,0.16,1.04,0.88,,955,153,168,,,,70.02,51.4,70.44,1,,,,,,,,,,,,,,97,82,14.56,16.41,16.43,11.7,,,,,,,,,,,,,,,,"0,0,0,0,10,81,6,2,1","0,12,77,11,0",,,,,,147,,,,,,,,,,,,,,,,,,,,,,,,,,,,,,,,,,,,48.1,13,9,192,56,,1025,0,325,0,5,3,,1,0,I1.000|4:31-I1.000|2:37-I1.000|3:46-I1.000|4:14-I1.000|4:18-I1.000|4:15-I1.000|4:20-I1.000|4:19-I1.000|4:14-I1.000|4:10-I1.000|4:13-I1.000|4:18-I1.000|4:20-I1.000|4:18-I1.000|4:15-I0.047|0:12,,Running,,,,"Polar M430",43,0,,0,168070,250480,30378,,,,,,,,,,,,,,,,,,,,,,,,,,,,,,,,,,,,,,,,,,,
6317324,5a109be4-0423-4a4f-902c-6d4c744859e4,1550772534,60,1550773448,,0,0,13.77,3404,3404,58,58,,,1,0,0.09,,0.93,,933,161,174,,,,65.5,51.32,65.84,1,,,,,,,,,,,,,,104,84,14.6,14.59,14.68,4.5,,,,,,,,,,,,,,,,"0,0,0,0,3,68,28,0,0","0,1,35,64,0",,,,,,144,,,,,,,,,,,,,,,,,,,,,,,,,,,,,,,,,,,,62.4,12,13,202,66,,1029,0,342,1,3,3,,1,0,I1.000|4:21-I1.000|4:07-I1.000|4:02-I1.000|4:06-I1.000|4:02-I1.000|4:04-I1.000|3:59-I1.000|4:07-I1.000|4:08-I1.000|4:06-I1.000|4:08-I1.000|4:07-I1.000|4:10-I0.766|3:18,,Running,,,,"Polar M430",43,0,,0,168070,250480,30378,,,,,,,,,,,,,,,,,,,,,,,,,,,,,,,,,,,,,,,,,,,
6328953,dcd59358-cbd3-4c1c-87bb-1c2a5b93d071,1550843423,60,1550846765,,0,0,10.8,3387,3884,33,36,,,1,0,0.07,1.11,0.9,,658,130,144,,,,64.5,38.2,64.73,1,,,,,,,,,,,,,,48,80,11.51,11.5,11.57,-0.4,,,,,,,,,,,,,,,,"0,2,12,71,15,0,0,0,0","1,92,7,0,0",,,,,,120,,,,,,,,,,,,,,,,,,,,,,,,,,,,,,,,,,,,16.7,13,12,18,62,,1035,2,284,0,5,3,,1,0,I1.000|5:20-I1.000|5:04-I1.000|5:08-I1.000|5:10-I1.000|5:16-I1.000|5:17-I1.000|5:16-I1.000|5:18-I1.000|5:16-I1.000|5:17-I0.805|4:14,,Running,,,,"Polar M430",43,0,,0,168070,250480,30378,,,,,,,,,,,,,,,,,,,,,,,,,,,,,,,,,,,,,,,,,,,
6349136,7e8c7764-a403-4a4d-abef-b90e38c1e18e,1550990796,60,1550999769,,0,0,36,11098,11807,953,954,,,1,5.5,0.81,1.2,1.03,512,2148,129,168,,,,66.48,42.57,68.67,1,,,,,,,,,,,,,,166,83,12.47,12.21,12.87,-9.9,,,,,,,,,,,,,,,,"11,7,20,26,19,10,5,2,0","3,61,32,4,0",,,,,,117,,,,,,,,,,,,,,,,,,,,,,,,,,,,,,,,,,,,51.7,1,6,54,48,,1039,0,269,0,3,3,,1,0,I1.000|6:16-I1.000|5:16-I1.000|5:05-I1.000|5:33-I1.000|5:26-I1.000|5:14-I1.000|4:51-I1.000|5:15-I1.000|4:48-I1.000|4:41-I1.000|5:25-I1.000|5:11-I1.000|4:59-I1.000|4:49-I1.000|5:26-I1.000|4:56-I1.000|5:34-I1.000|5:31-I1.000|5:47-I1.000|5:20-I1.000|5:25-I1.000|4:39-I1.000|4:33-I1.000|4:19-I1.000|5:50-I1.000|6:33-I1.000|6:01-I1.000|6:44-I1.000|6:16-I1.000|6:11-I1.000|4:31-I1.000|4:06-I1.000|3:52-I1.000|3:32-I1.000|3:42-I1.000|3:55-I0.005|0:03,,Running,,,,"Polar M430",43,0,,0,168070,250480,30378,,,,,,,,,,,,,,,,,,,,,,,,,,,,,,,,,,,,,,,,,,"2,3,4,5,5",
6372556,3445ec0d-2c88-42d4-a70e-082aaa080a91,1551115943,60,1551118687,,0,0,11.33,3839,5011,36,36,,,1,0,0.02,1.05,0.98,,867,143,170,,,,52.17,35.01,52.37,1,,,,,,,,,,,,,,80,81,10.66,10.81,10.86,17,,,,,,,,,,,,,,,,"11,18,37,26,5,2,2,0,0","1,43,43,13,0",,,,,,109,,,,,,,,,,,,,,,,,,,,,,,,,,,,,,,,,,,,46.3,13,11,62,53,,1035,0,303,0,3,3,,1,0,I1.000|4:44-I1.000|5:30-I1.000|5:38-I1.000|5:34-I1.000|5:51-I1.000|5:41-I1.000|5:48-I1.000|5:45-I1.000|6:10-I1.000|6:08-I1.000|5:32-I0.335|1:56,,Running,,,,"Polar M430",43,0,,0,168070,250480,30378,,,,,,,,,,,,,,,,,,,,,,,,,,,,,,,,,,,,,,,,,,,
6386266,dd972cfb-2f26-4dea-8816-6ccfa1929e17,1551204378,60,1551203291,,0,0,5.23,1480,1607,26,28,,,1,0,0.15,1.14,0.94,,343,145,163,,,,64,41.16,64.36,1,,,,,,,,,,,,,,31,81,12.76,12.84,12.98,2.1,,,,,,,,,,,,,,,,"0,6,5,15,39,33,3,0,0","1,14,83,1,0",,,,,,131,,,,,,,,,,,,,,,,,,,,,,,,,,,,,,,,,,,,32.3,18,12,9,34,,1032,0,282,1,5,3,,1,0,I4.817|23:02-I0.305|1:13-I0.109|0:31,,Running,,,,"Polar M430",43,0,,0,168070,250480,30378,,,,,,,,,,,,,,,,,,,,,,,,,,,,,,,,,,,,,,,,,,,
6397895,17cdce46-7eb7-4213-a404-8d54984c3f1e,1551285214,60,1551284284,,0,0,1.89,587,857,2,0,,,1,0,0.04,,,,119,135,148,,,,62.41,34.07,62.58,1,,,,,,,,,,,,,,9,80,11.64,11.74,11.79,-24.3,,,,,,,,,,,,,,,,"2,2,52,27,1,1,16,0,0","3,65,31,0,0",,,,,,121,,,,,,,,,,,,,,,,,,,,,,,,,,,,,,,,,,,,14,17,7,24,34,,1024,0,268,0,3,3,,1,0,I1.458|8:14-I0.434|1:38,,Running,,,,"Polar M430",43,0,,0,168070,250480,30378,,,,,,,,,,,,,,,,,,,,,,,,,,,,,,,,,,,,,,,,,,,
6412111,9a021485-fa95-4f2b-a93d-4462f937f273,1551377375,60,1551378126,,0,0,13.81,3553,3825,53,54,,,1,0,0.09,1.12,0.94,,885,151,181,,,,68.22,49,68.54,1,,,,,,,,,,,,,,93,84,14.04,14.33,14.41,14.4,,,,,,,,,,,,,,,,"0,0,2,17,24,23,31,3,1","1,27,33,39,0",,,,,,139,,,,,,,,,,,,,,,,,,,,,,,,,,,,,,,,,,,,89.1,15,21,260,47,,1019,,,1,2,1,,1,0,I10.015|40:31-I3.792|18:53,,Running,,,,"Polar M430",43,0,,0,168070,250480,30378,,,,,,,,,,,,,,,,,,,,,,,,,,,,,,,,,,,,,,,,,,,
6418127,77eee084-5025-41ee-9382-101dbc80e3a4,1551446254,60,1551446045,,0,0,9.53,2909,2942,28,28,,,1,0,0.13,1.1,0.89,,625,137,150,,,,62.63,39.07,62.85,1,,,,,,,,,,,,,,50,81,11.82,11.83,11.91,2.3,,,,,,,,,,,,,,,,"0,1,7,59,32,1,0,0,0","1,74,25,0,0",,,,,,121,,,,,,,,,,,,,,,,,,,,,,,,,,,,,,,,,,,,20.9,11,12,236,85,,1015,2,386,0,4,3,,1,0,I1.000|4:54-I1.000|5:05-I1.000|5:14-I1.000|5:08-I1.000|4:53-I1.000|5:04-I1.000|5:09-I1.000|5:07-I1.000|5:17-I0.533|2:42,,Running,,,,"Polar M430",43,0,,0,168070,250480,30378,,,,,,,,,,,,,,,,,,,,,,,,,,,,,,,,,,,,,,,,,,,
6435853,fcd1b9ae-6319-4319-be42-ad90d92c7088,1551596032,60,1551596283,,0,0,7.87,2589,3217,178,178,,,1,2.7,0.77,1.08,0.94,439,528,135,160,,,,58.13,35.31,59.76,1,,,,,,,,,,,,,,43,82,11.47,11.12,11.6,6.9,,,,,,,,,,,,,,,,"9,11,34,25,19,3,0,0,0","1,58,41,0,0",,,,,,111,,,,,,,,,,,,,,,,,,,,,,,,,,,,,,,,,,,,25.4,9,24,219,73,,1013,0,323,0,5,3,,1,0,I1.000|6:30-I1.000|5:08-I1.000|5:20-I1.000|5:53-I1.000|5:38-I1.000|5:05-I1.000|5:32-I0.869|4:09,,Running,,,,"Polar M430",43,0,,0,168070,250480,30378,,,,,,,,,,,,,,,,,,,,,,,,,,,,,,,,,,,,,,,,,,"5,5",
6498047,71e027f1-85a6-4c07-9639-b1f2b20e0fad,1551692242,60,1551971408,,0,0,10.78,3179,3210,38,41,,,1,0,0.06,1.08,0.9,,778,149,157,,,,58.67,41.04,58.91,1,,,,,,,,,,,,,,73,81,12.23,12.24,12.32,2.1,,,,,,,,,,,,,,,,"0,0,4,34,56,5,0,0,0","0,3,97,0,0",,,,,,126,,,,,,,,,,,,,,,,,,,,,,,,,,,,,,,,,,,,34,12,42,209,61,,1000,1,327,0,11,3,,1,0,I1.000|5:21-I1.000|4:47-I1.000|4:50-I1.000|4:50-I1.000|4:49-I1.000|4:50-I1.000|4:50-I1.000|4:54-I1.000|5:04-I1.000|4:54-I0.784|3:53,,Running,,,,"Polar M430",43,0,,0,168070,250480,30378,,,,,,,,,,,,,,,,,,,,,,,,,,,,,,,,,,,,,,,,,,,
6498049,d02e5986-4a85-41cc-8137-52927d45a075,1551885201,60,1551971411,,0,0,10.78,3238,3286,40,44,,,1,0,0.1,1.09,0.93,,799,150,159,,,,56.84,40.17,57.08,1,,,,,,,,,,,,,,75,80,12.02,12.01,12.08,3.7,,,,,,,,,,,,,,,,"0,1,2,51,44,2,0,0,0","0,3,97,0,0",,,,,,125,,,,,,,,,,,,,,,,,,,,,,,,,,,,,,,,,,,,33.4,16,14,203,54,,1003,1,351,0,4,3,,1,0,I1.000|4:59-I1.000|4:54-I1.000|4:53-I1.000|5:01-I1.000|5:00-I1.000|4:59-I1.000|5:04-I1.000|5:09-I1.000|5:07-I1.000|5:01-I0.785|3:59,,Running,,,,"Polar M430",43,0,,0,168070,250480,30378,,,,,,,,,,,,,,,,,,,,,,,,,,,,,,,,,,,,,,,,,,,
6498050,7a5c56a7-067a-49e8-84f1-73e2556172ce,1551809360,60,1551971411,,0,0,13.69,3275,3278,50,51,,,1,0,0.13,,0.95,,966,169,182,,,,63.48,53.28,63.76,1,,,,,,,,,,,,,,123,85,15.08,15.16,15.25,4.2,,,,,,,,,,,,,,,,"0,0,1,2,7,25,64,1,0","0,2,18,79,1",,,,,,148,,,,,,,,,,,,,,,,,,,,,,,,,,,,,,,,,,,,109.2,6,15,234,93,,1013,0,416,1,6,3,,1,0,I1.000|4:33-I1.000|4:24-I1.000|4:01-I1.000|4:00-I1.000|3:54-I1.000|3:55-I1.000|3:54-I1.000|3:53-I1.000|3:59-I1.000|3:52-I1.000|3:48-I1.000|3:43-I1.000|3:47-I0.695|2:55,,Running,,,,"Polar M430",43,0,,0,168070,250480,30378,,,,,,,,,,,,,,,,,,,,,,,,,,,,,,,,,,,,,,,,,,,
6498051,701096a4-64e2-417a-bd0d-a016c87f3ba4,1551968619,60,1551971412,,0,0,12.75,3685,3860,338,339,,,1,3.6,0.78,1.09,1.06,454,861,146,173,,,,61.79,42.55,63.82,1,,,,,,,,,,,,,,81,82,13.17,12.99,13.63,1,,,,,,,,,,,,,,,,"3,4,15,25,31,13,2,6,1","1,35,48,16,0",,,,,,127,,,,,,,,,,,,,,,,,,,,,,,,,,,,,,,,,,,,46.3,12,36,249,52,,1001,1,380,0,11,3,,1,0,I1.000|5:17-I1.000|4:59-I1.000|5:42-I1.000|5:01-I1.000|4:37-I1.000|4:48-I1.000|5:08-I1.000|5:23-I1.000|4:55-I1.000|4:54-I1.000|5:13-I1.000|3:13-I0.749|2:42,,Running,,,,"Polar M430",43,0,,0,168070,250480,30378,,,,,,,,,,,,,,,,,,,,,,,,,,,,,,,,,,,,,,,,,,"4,4",
6498062,31377eb8-3325-40bd-a176-74d83e041c3a,1551611075,60,1551971524,,0,0,11,3129,3210,101,298,,,1,1.7,0.63,,,224,267,80,110,,,,,,,1,,,,,,,,,,,,,,7,,,34.4,,,,,,,,,,,,,,,,,,"44,39,0,0,1,15","89,11,0,0,0",,,,,,,,,,,,,,,,,,,,,,,,,,,,,,,,,,,,,,,,,,2.4,10,31,212,74,,1013,2,327,0,11,3,,1,0,I1.000|12:23-I1.000|12:17-I1.000|12:19-I1.000|7:45-I1.000|1:08-I1.000|0:54-I1.000|0:52-I1.000|1:02-I1.000|1:48-I1.000|1:16-I1.000|1:41-I0.044|0:05,,Hiking,,,,"Polar M430",43,0,,0,168075,,30378,,,,,,,,,,,,,,,,,,,,,,,,,,,,,,,,,,,,,,,,,,5,
6506308,2f0d3e80-da3c-4729-a09b-74275f40993a,1552053862,60,1552052647,,0,0,5.62,1758,1931,153,153,,,1,2.9,0.93,1.13,1.14,435,388,141,164,,,,58.62,36.7,60.59,1,,,,,,,,,,,,,,34,82,12.2,11.71,12.66,-0.2,,,,,,,,,,,,,,,,"7,6,22,28,23,14,0,0,0","1,42,57,1,0",,,,,,117,,,,,,,,,,,,,,,,,,,,,,,,,,,,,,,,,,,,29.7,7,18,272,71,,1015,2,382,0,9,3,,1,0,I1.000|5:32-I1.000|5:25-I1.000|5:53-I1.000|5:17-I1.000|4:30-I0.622|2:51,,Running,,,,"Polar M430",43,0,,0,168070,250480,30378,,,,,,,,,,,,,,,,,,,,,,,,,,,,,,,,,,,,,,,,,,4,
6531902,f1f52209-5e67-4609-bb0f-3d0580c6e0aa,1552211996,60,1552216931,,0,0,21.38,4919,4920,99,94,,,1,0,0.15,1.15,0.97,,1517,174,182,,,,63.68,57.71,64.07,1,,,,,,,,,,,,,,204,86,15.73,15.7,15.85,5.8,,,,,,,,,,,,,,,,"0,0,0,0,0,17,78,5,0","0,2,4,93,2",,,,,,152,,,,,,,,,,,,,,,,,,,,,,,,,,,,,,,,,,,,113.1,12,33,221,88,,1008,1,318,0,6,3,,1,0,I5.037|18:49-I5.057|18:58-I5.048|19:21-I5.092|20:31-I1.151|4:23,,Running,,,,"Polar M430",43,0,,0,168070,250480,30378,,,,,,,,,,,,,,,,,,,,,,,,21.1,4919,,,0,Running,,,,,,,0,0,30378,6531902,,,,
6548686,71ddcbed-0d73-4a00-af3c-14231a799ad3,1552328418,60,1552332125,,0,0,8.42,2832,3231,26,24,,,1,0,0.09,1.1,0.91,,564,132,151,,,,58.11,34.55,58.35,1,,,,,,,,,,,,,,42,80,10.74,10.73,10.83,3.7,,,,,,,,,,,,,,,,"2,11,54,32,1,0,0,0,0","1,88,11,0,0",,,,,,111,,,,,,,,,,,,,,,,,,,,,,,,,,,,,,,,,,,,17.7,9,18,245,43,,1024,0,456,1,5,3,,1,0,I1.000|5:19-I1.000|5:22-I1.000|5:36-I1.000|5:43-I1.000|5:45-I1.000|5:47-I1.000|5:41-I1.000|5:43-I0.421|2:21,,Running,,,,"Polar M430",43,0,,0,168070,250480,30378,,,,,,,,,,,,,,,,,,,,,,,,,,,,,,,,,,,,,,,,,,,
6564905,b4ec5444-40bf-41d9-86da-293e54f35dbf,1552414142,60,1552414086,,0,0,11.88,3118,3121,40,41,,,1,0,0.1,1.09,0.92,,750,147,160,,,,69,47.35,69.28,1,,,,,,,,,,,,,,69,83,13.75,13.77,13.83,0.3,,,,,,,,,,,,,,,,"0,0,0,2,20,77,1,0,0","1,3,96,0,0",,,,,,138,,,,,,,,,,,,,,,,,,,,,,,,,,,,,,,,,,,,34,10,24,224,34,,1012,0,325,1,5,3,,1,0,I1.000|4:46-I1.000|4:25-I1.000|4:16-I1.000|4:19-I1.000|4:17-I1.000|4:20-I1.000|4:18-I1.000|4:22-I1.000|4:19-I1.000|4:19-I1.000|4:18-I0.886|4:01,,Running,,,,"Polar M430",43,0,,0,168070,250480,30378,,,,,,,,,,,,,,,,,,,,,,,,,,,,,,,,,,,,,,,,,,,
6609675,d3edcc8e-cf94-4e7a-9bed-a10970d7b844,1552586875,60,1552587965,,0,0,13.63,3606,3736,48,48,,,1,0,0.12,1.07,0.91,,902,152,170,,,,65.31,47.4,65.59,1,,,,,,,,,,,,,,90,83,13.65,13.73,13.81,1.3,,,,,,,,,,,,,,,,"0,0,1,8,29,54,8,0,0","0,12,76,12,0",,,,,,137,,,,,,,,,,,,,,,,,,,,,,,,,,,,,,,,,,,,48.7,8,42,192,79,,1004,0,390,1,6,3,,1,0,I1.000|4:34-I1.000|4:19-I1.000|4:31-I1.000|4:15-I1.000|4:18-I1.000|4:19-I1.000|4:11-I1.000|4:18-I1.000|4:20-I1.000|3:53-I1.000|4:23-I1.000|4:34-I1.000|4:58-I0.629|3:16,,Running,,,,"Polar M430",43,0,,0,168070,250480,30378,,,,,,,,,,,,,,,,,,,,,,,,,,,,,,,,,,,,,,,,,,,
6707468,cd6f6411-d19f-4234-9b3f-7ab4ef499f1f,1552935104,60,1553112366,,0,0,4.39,1335,1397,25,25,,,1,0,0.18,1.16,0.9,,261,131,145,,,,66.41,37.4,66.88,1,,,,,,,,,,,,,,19,81,11.89,11.87,12.07,0.8,,,,,,,,,,,,,,,,"1,1,8,47,41,1,0,0,0","2,90,7,0,0",,,,,,122,,,,,,,,,,,,,,,,,,,,,,,,,,,,,,,,,,,,13.8,10,11,240,49,,1023,0,362,1,3,3,,1,0,I1.000|5:13-I1.000|4:58-I1.000|5:00-I1.000|5:13-I0.387|1:58,,Running,,,,"Polar M430",43,0,,0,168070,250480,30378,,,,,,,,,,,,,,,,,,,,,,,,,,,,,,,,,,,,,,,,,,,
6707469,a3e1be48-d905-47f2-b4bb-05f91fef560d,1552663187,60,1553112366,,0,0,9.18,2801,2802,32,32,,,1,0,0.15,1.08,0.93,,609,138,147,,,,62.1,38.99,62.37,1,,,,,,,,,,,,,,49,82,11.85,11.85,11.94,2.1,,,,,,,,,,,,,,,,"2,2,7,49,39,1,0,0,0","1,59,40,0,0",,,,,,120,,,,,,,,,,,,,,,,,,,,,,,,,,,,,,,,,,,,22.1,14,30,246,70,,1011,1,338,0,6,3,,1,0,I1.000|5:10-I1.000|5:08-I1.000|5:06-I1.000|5:00-I1.000|5:09-I1.000|5:05-I1.000|4:55-I1.000|5:03-I1.000|5:12-I0.180|0:55,,Running,,,,"Polar M430",43,0,,0,168070,250480,30378,,,,,,,,,,,,,,,,,,,,,,,,,,,,,,,,,,,,,,,,,,,
6707471,fd083655-8449-4f2b-a1d2-746521c0b555,1553104151,60,1553112367,,0,0,12.27,3362,3392,41,41,,,1,0,0.13,1.15,1.02,,729,138,158,,,,70.94,45.15,71.24,1,,,,,,,,,,,,,,61,81,13.18,13.52,13.57,9.3,,,,,,,,,,,,,,,,"2,1,3,11,57,17,2,5,1","1,49,50,0,0",,,,,,135,,,,,,,,,,,,,,,,,,,,,,,,,,,,,,,,,,,,33.8,12,20,7,37,,1034,0,289,0,3,3,,1,0,I1.000|5:21-I1.000|4:56-I1.000|3:40-I1.000|4:43-I1.000|4:40-I1.000|4:38-I1.000|3:40-I1.000|4:30-I1.000|4:39-I1.000|4:35-I1.000|4:36-I1.000|4:47-I0.273|1:22,,Running,,,,"Polar M430",43,0,,0,168070,250480,30378,,,,,,,,,,,,,,,,,,,,,,,,,,,,,,,,,,,,,,,,,,,
6707472,0da84166-c9f7-44ab-b0eb-c8dc02bbb020,1552810481,60,1553112368,,0,0,5.82,1898,2097,154,154,,,1,2.8,0.76,1.16,1.15,400,409,138,160,,,,57.2,35,59.07,1,,,,,,,,,,,,,,34,82,11.69,11.28,12.27,-1.3,,,,,,,,,,,,,,,,"13,9,20,33,20,5,0,0,0","1,50,49,0,0",,,,,,112,,,,,,,,,,,,,,,,,,,,,,,,,,,,,,,,,,,,27.6,9,25,212,69,,1002,0,362,0,5,3,,1,0,I1.000|5:44-I1.000|5:20-I1.000|6:17-I1.000|5:56-I1.000|4:35-I0.823|4:06,,Running,,,,"Polar M430",43,0,,0,168070,250480,30378,,,,,,,,,,,,,,,,,,,,,,,,,,,,,,,,,,,,,,,,,,4,
6707509,cc6f9819-fb25-4d0f-9b7e-0f390d6d93c1,1553018878,60,1553112605,,0,0,10.22,2914,3113,53,53,,,1,0,0.14,1.12,0.93,,675,144,169,,,,63.98,42.53,64.39,1,,,,,,,,,,,,,,62,83,12.68,13,13.12,13.7,,,,,,,,,,,,,,,,"0,2,20,29,10,29,9,1,0","1,53,34,13,0",,,,,,127,,,,,,,,,,,,,,,,,,,,,,,,,,,,,,,,,,,,48.8,10,4,344,37,,1029,0,314,0,3,3,,1,0,I3.071|13:17-I7.151|35:21,,Running,,,,"Polar M430",43,0,,0,168070,250480,30378,,,,,,,,,,,,,,,,,,,,,,,,,,,,,,,,,,,,,,,,,,,
6722017,1b1d7497-f3b3-4747-a2ce-84b82074b27c,1553191565,60,1553193368,,0,0,15.41,3843,3867,40,40,,,1,0,0.08,,0.86,,1003,156,176,,,,67.78,51.23,68,1,,,,,,,,,,,,,,110,84,14.46,14.58,14.64,14.6,,,,,,,,,,,,,,,,"2,0,0,0,2,68,28,0,0","0,21,21,57,0",,,,,,143,,,,,,,,,,,,,,,,,,,,,,,,,,,,,,,,,,,,74.1,15,16,19,32,,1031,0,285,0,5,3,,1,0,I1.000|4:18-I1.000|4:09-I1.000|4:10-I1.000|4:04-I1.000|4:00-I1.000|4:05-I1.000|4:03-I1.000|4:02-I1.000|4:05-I1.000|4:07-I1.000|4:11-I1.000|4:08-I1.000|4:12-I1.000|4:02-I1.000|4:04-I0.410|2:28,,Running,,,,"Polar M430",43,0,,0,168070,250480,30378,,,,,,,,,,,,,,,,,,,,,,,,,,,,,,,,,,,,,,,,,,,
6722018,4b612c63-1a98-4e0c-b854-9f27c154c642,1553195465,60,1553193368,,0,0,2.01,500,507,19,20,,,1,0,0,,0.41,,91,125,160,,,,90.04,44.09,91.06,1,,,,,,,,,,,,,,6,83,14.47,15.6,15.6,19.1,,,,,,,,,,,,,,,,"12,1,1,4,15,14,18,35,1","0,93,7,0,0",,,,,,145,,,,,,,,,,,,,,,,,,,,,,,,,,,,,,,,,,,,9.3,14,15,20,34,,1031,0,289,1,5,3,,1,0,I0.010|0:12-I0.328|1:01-I0.205|0:57-I0.305|1:03-I0.221|0:58-I0.320|1:06-I0.202|0:58-I0.328|1:02-I0.089|1:13,,Running,,,,"Polar M430",43,0,,0,168070,250480,30378,,,,,,,,,,,,,,,,,,,,,,,,,,,,,,,,,,,,,,,,,,,
6785614,a6f13b1b-2e17-413e-888a-0f56b9fb509f,1553257068,60,1553530326,,0,0,11.2,3603,3757,45,44,,,1,0,0.11,1.09,0.87,,745,135,149,,,,59.76,37.18,60.06,1,,,,,,,,,,,,,,57,82,11.22,11.28,11.37,10.2,,,,,,,,,,,,,,,,"3,6,32,38,21,0,0,0,0","0,92,8,0,0",,,,,,114,,,,,,,,,,,,,,,,,,,,,,,,,,,,,,,,,,,,17.5,12,7,70,46,,1030,4,287,0,5,3,,1,0,I1.000|5:02-I1.000|5:02-I1.000|4:56-I1.000|5:10-I1.000|5:13-I1.000|5:25-I1.000|5:27-I1.000|5:30-I1.000|5:41-I1.000|5:35-I1.000|6:01-I0.200|1:07,,Running,,,,"Polar M430",43,0,,0,168070,250480,30378,,,,,,,,,,,,,,,,,,,,,,,,,,,,,,,,,,,,,,,,,,,
6785615,8f8e8bd9-03d6-4d49-9956-2342c0b964cc,1553515308,60,1553530327,,0,0,12.48,3402,4402,86,84,,,1,0,0.1,1.03,0.85,,819,148,183,,,,65.24,45.47,65.81,1,,,,,,,,,,,,,,82,84,13.25,13.83,13.89,5.3,,,,,,,,,,,,,,,,"1,2,14,31,14,7,25,7,0","1,52,17,28,2",,,,,,131,,,,,,,,,,,,,,,,,,,,,,,,,,,,,,,,,,,,93.9,9,18,281,52,,1023,2,420,0,5,3,,1,0,I4.070|20:43-I1.037|3:58-I0.414|1:23-I1.037|4:03-I0.413|1:24-I1.042|3:52-I0.407|1:25-I1.034|3:48-I3.021|16:15,,Running,,,,"Polar M430",43,0,,0,168070,250480,30378,,,,,,,,,,,,,,,,,,,,,,,,,,,,,,,,,,,,,,,,,,,
6785616,bf224d21-cae0-4511-a96e-49c66ce14f03,1553447886,60,1553530330,,0,0,7.37,1883,2327,35,36,,,1,0,0.08,1.05,0.94,,472,153,169,,,,67.58,47.37,67.97,1,,,,,,,,,,,,,,48,83,14.12,14.16,14.22,-4.7,,,,,,,,,,,,,,,,"0,0,0,2,15,70,13,0,0","1,11,64,24,0",,,,,,141,,,,,,,,,,,,,,,,,,,,,,,,,,,,,,,,,,,,47.5,14,10,346,57,,1023,0,346,0,5,3,,1,0,I1.000|4:37-I1.000|4:16-I1.000|4:13-I1.000|4:19-I1.000|4:08-I1.000|4:12-I1.000|4:04-I0.371|1:43,,Running,,,,"Polar M430",43,0,,0,168070,250480,30378,,,,,,,,,,,,,,,,,,,,,,,,,,,,,,,,,,,,,,,,,,,
6806040,6a579bd9-26f7-4766-adb3-0bb6b864478d,1553623577,60,1553627293,,0,0,16.77,4374,4824,85,85,,,1,0,0.2,1.05,0.87,,1175,157,186,,,,63.54,48.97,63.94,1,,,,,,,,,,,,,,131,85,13.87,14.6,14.7,10.7,,,,,,,,,,,,,,,,"9,2,5,16,13,7,36,11,0","0,16,48,19,16",,,,,,135,,,,,,,,,,,,,,,,,,,,,,,,,,,,,,,,,,,,115.5,9,7,355,50,,1030,0,330,0,4,3,,1,0,I2.883|13:20-I2.443|8:54-I0.298|2:02-I2.464|8:56-I0.214|2:13-I2.462|8:52-I0.210|2:17-I2.468|8:51-I3.323|20:23,,Running,,,,"Polar M430",43,0,,0,168070,250480,30378,,,,,,,,,,,,,,,,,,,,,,,,,,,,,,,,,,,,,,,,,,,
6815540,423db621-0f76-428d-8f58-94c7e10993a1,1553702869,60,1553704085,,0,0,14.56,3733,3778,62,62,,,1,0,0.14,1.07,0.9,,993,157,170,,,,64.91,49.4,65.25,1,,,,,,,,,,,,,,106,82,14.1,14.08,14.18,5.2,,,,,,,,,,,,,,,,"0,0,1,3,13,71,12,0,0","1,4,55,41,0",,,,,,143,,,,,,,,,,,,,,,,,,,,,,,,,,,,,,,,,,,,60.1,12,12,30,46,,1032,1,378,0,5,3,,1,0,I1.000|4:38-I1.000|4:17-I1.000|4:11-I1.000|4:14-I1.000|4:16-I1.000|4:16-I1.000|4:12-I1.000|4:23-I1.000|4:21-I1.000|4:12-I1.000|4:24-I1.000|4:19-I1.000|4:16-I1.000|4:04-I0.560|2:13,,Running,,,,"Polar M430",43,0,,0,168070,250480,30378,,,,,,,,,,,,,,,,,,,,,,,,,,,,,,,,,,,,,,,,,,,
6830411,8d2fe4bc-024a-4075-b1e4-dd9b94bbaebb,1553796428,60,1553794571,,0,0,4.41,1277,1277,30,31,,,1,0,0.14,1.11,0.84,,282,140,163,,,,65.07,39.64,65.6,1,,,,,,,,,,,,,,23,81,12.48,12.56,12.71,7.3,,,,,,,,,,,,,,,,"2,1,5,20,53,19,0,0,0","2,53,43,2,0",,,,,,128,,,,,,,,,,,,,,,,,,,,,,,,,,,,,,,,,,,,21.6,14,22,52,49,,1032,0,385,0,5,3,,1,0,I1.000|4:38-I1.000|4:34-I1.000|4:49-I1.000|5:09-I0.408|2:07,,Running,,,,"Polar M430",43,0,,0,168070,250480,30378,,,,,,,,,,,,,,,,,,,,,,,,,,,,,,,,,,,,,,,,,,,
6838453,59b035be-38f8-49de-a76b-0ba4d7d70f8f,1553861794,60,1553865246,,0,0,15.6,5653,6293,542,542,,,1,5.8,0.79,1.22,0.93,654,1380,147,183,,,,46.33,33.18,48.32,1,,,,,,,,,,,,,,134,80,10.93,10.71,12.41,16.2,,,,,,,,,,,,,,,,"32,15,17,13,14,9,0,0,0","0,42,29,27,1",,,,,,103,,,,,,,,,,,,,,,,,,,,,,,,,,,,,,,,,,,,70.2,13,15,102,60,,1031,3,364,0,5,3,,1,0,I6.612|33:25-I0.365|2:27-I0.383|4:01-I0.369|2:25-I0.396|4:45-I0.366|2:28-I0.383|5:21-I0.373|2:33-I0.376|5:36-I0.370|2:38-I5.602|33:20,,Running,,,,"Polar M430",43,0,,0,168070,250480,30378,,,,,,,,,,,,,,,,,,,,,,,,,,,,,,,,,,,,,,,,,,"4,4,4,4,4,4,4,4",
6857509,9047e815-369d-4d9c-b5e1-5c31b3ce5e71,1553974984,60,1553973483,,0,0,1.64,564,564,63,0,,,1,1.5,0.74,1.04,,403,107,129,141,,,,58.08,29.87,63.64,1,,,,,,,,,,,,,,7,81,12.02,10.61,12.16,8.2,,,,,,,,,,,,,,,,"9,24,34,32,1,0,0,0,0","0,99,1,0,0",,,,,,108,,,,,,,,,,,,,,,,,,,,,,,,,,,,,,,,,,,,10.4,18,9,229,33,,1021,0,362,1,5,3,,1,0,I1.000|5:32-I0.643|3:53,,Running,,,,"Polar M430",43,0,,0,168070,250480,30378,,,,,,,,,,,,,,,,,,,,,,,,,,,,,,,,,,,,,,,,,,5,
6857510,586bc97f-42c7-48d0-8317-04654f855ab7,1553975567,60,1553973484,,0,0,1.61,359,359,0,64,,,1,1.2,1,,1,,60,119,129,,,,,48.59,,1,,,,,,,,,,,,,,3,84,14.75,16.32,14.92,7.4,,,,,,,,,,,,,,,,"0,0,0,0,0,5,80,15,0","6,94,0,0,0",,,,,,160,,,,,,,,,,,,,,,,,,,,,,,,,,,,,,,,,,,,5,18,9,229,33,,1021,0,362,1,5,3,,1,0,I1.000|3:41-I0.611|2:19,,Running,,,,"Polar M430",43,0,,0,168070,250480,30378,,,,,,,,,,,,,,,,,,,,,,,,,,,,,,,,,,,,,,,,,,,
6864544,8deb04f5-144c-478e-835c-4e9c62b653bd,1554030060,120,1554029649,,0,0,19.08,5435,5591,453,452,,,1,4.4,0.79,1.06,1.06,486,1323,149,177,,,,61.24,44.68,63.04,1,,,,,,,,,,,,,,129,82,13.32,13.23,13.89,0.7,,,,,,,,,,,,,,,,"7,3,11,21,29,10,15,4,0","0,28,56,16,0",,,,,,128,,,,,,,,,,,,,,,,,,,,,,,,,,,,,,,,,,,,74.8,13,10,47,58,,1022,3,363,0,3,3,,1,0,I8.634|45:15-I3.625|16:50-I1.456|9:01-I5.333|19:50-I0.028|0:11,,Running,,,,"Polar M430",43,0,,0,168070,250480,30378,,,,,,,,,,,,,,,,,,,,,,,,,,,,,,,,,,,,,,,,,,"3,5,5",
6881296,676f7ddc-6e2f-4cc0-b2b8-83753b0e8ffb,1554140742,120,1554138489,,0,0,10.03,3242,3271,48,49,,,1,0,0.16,1.11,0.92,,635,130,146,,,,62.14,36.66,62.5,1,,,,,,,,,,,,,,45,81,11.2,11.18,11.3,1.8,,,,,,,,,,,,,,,,"1,2,38,51,8,0,0,0,0","1,98,2,0,0",,,,,,115,,,,,,,,,,,,,,,,,,,,,,,,,,,,,,,,,,,,13.4,19,28,31,41,,1016,1,362,0,11,3,,1,0,I1.000|4:56-I1.000|5:17-I1.000|5:22-I1.000|5:30-I1.000|5:34-I1.000|5:33-I1.000|5:28-I1.000|5:28-I1.000|5:20-I1.000|5:25-I0.036|0:12,,Running,,,,"Polar M430",43,0,,0,168070,250480,30378,,,,,,,,,,,,,,,,,,,,,,,,,,,,,,,,,,,,,,,,,,,
6894954,e7288d63-5c90-4fdf-ad1d-66cae8808fef,1554228461,120,1554227293,,0,0,16.78,4271,5099,31,33,,,1,0,0.06,,,,1045,150,179,,,,69.76,50.37,69.91,1,,,,,,,,,,,,,,104,84,14.17,14.53,14.58,0.9,,,,,,,,,,,,,,,,"2,2,4,6,25,32,13,16,0","0,17,66,17,0",,,,,,140,,,,,,,,,,,,,,,,,,,,,,,,,,,,,,,,,,,,60,21,8,264,29,,1006,0,357,0,5,3,,1,0,I6.789|30:46-I0.417|1:25-I0.203|0:53-I0.309|1:01-I0.213|0:54-I0.196|0:39-I0.211|0:52-I0.104|0:20-I0.204|0:51-I0.411|1:22-I0.206|0:52-I0.308|1:01-I0.205|0:53-I0.207|0:41-I0.198|0:54-I0.105|0:19-I0.210|0:55-I0.420|1:23-I0.204|0:56-I0.294|1:01-I0.213|0:58-I0.199|0:40-I0.219|1:00-I0.101|0:20-I0.211|1:02-I0.411|1:24-I0.202|1:00-I0.307|1:03-I0.199|1:03-I0.212|0:41-I0.202|1:00-I0.107|0:20-I0.214|1:02-I0.418|1:24-I0.201|0:58-I0.301|1:04-I0.218|0:56-I0.201|0:41-I0.207|0:56-I0.107|0:20-I0.906|5:26,,Running,,,,"Polar M430",43,0,,0,168070,250480,30378,,,,,,,,,,,,,,,,,,,,,,,,,,,,,,,,,,,,,,,,,,,
6935427,317d1195-68ab-4dad-bef3-bf301db02af5,1554316155,120,1554464644,,0,0,8.72,2526,2881,30,32,,,1,0,0.19,1.11,0.84,,547,139,157,,,,65.62,41.3,65.88,1,,,,,,,,,,,,,,45,81,12.46,12.48,12.57,3.2,,,,,,,,,,,,,,,,"1,1,4,18,63,13,0,0,0","1,50,49,0,0",,,,,,128,,,,,,,,,,,,,,,,,,,,,,,,,,,,,,,,,,,,21.7,8,16,233,79,,1001,0,371,0,6,3,,1,0,I1.000|4:59-I1.000|4:46-I1.000|4:31-I1.000|4:40-I1.000|4:44-I1.000|4:52-I1.000|5:03-I1.000|5:04-I0.723|3:34,,Running,,,,"Polar M430",43,0,,0,168070,250480,30378,,,,,,,,,,,,,,,,,,,,,,,,,,,,,,,,,,,,,,,,,,,
6935428,9d745e4a-26fb-4931-9891-8e40d09411ee,1554401207,120,1554464644,,0,0,13.18,3417,3554,48,48,,,1,0,0.13,1.17,0.93,,890,155,168,,,,65.18,48.4,65.48,1,,,,,,,,,,,,,,93,84,13.91,14.01,14.09,0.2,,,,,,,,,,,,,,,,"0,0,0,11,16,60,11,2,0","0,10,59,32,0",,,,,,138,,,,,,,,,,,,,,,,,,,,,,,,,,,,,,,,,,,,53.9,5,13,209,93,,1002,0,389,0,6,3,,1,0,I10.927|46:53-I0.198|0:40-I0.210|0:59-I0.206|0:40-I0.209|1:00-I0.198|0:38-I1.227|6:12,,Running,,,,"Polar M430",43,0,,0,168070,250480,30378,,,,,,,,,,,,,,,,,,,,,,,,,,,,,,,,,,,,,,,,,,,
6935429,70d26ae9-2456-4586-b816-fad02a664c85,1554466450,120,1554464645,,0,0,8.8,2751,2752,33,32,,,1,0,0.14,1.16,0.93,,446,116,152,,,,73.47,37.78,73.83,1,,,,,,,,,,,,,,26,82,11.57,11.55,11.66,5.2,,,,,,,,,,,,,,,,"0,2,13,66,18,0,0,0,0","14,83,3,0,0",,,,,,117,,,,,,,,,,,,,,,,,,,,,,,,,,,,,,,,,,,,10.6,6,6,317,86,,1006,3,361,0,4,3,,1,0,I1.000|5:08-I1.000|5:16-I1.000|4:59-I1.000|5:08-I1.000|5:10-I1.000|5:09-I1.000|5:23-I1.000|5:18-I0.809|4:21,,Running,,,,"Polar M430",43,0,,0,168070,250480,30378,,,,,,,,,,,,,,,,,,,,,,,,,,,,,,,,,,,,,,,,,,,
7021740,362a5662-b36e-4636-9f78-7b4382218896,1554724951,120,1554919088,,0,0,10.16,2786,2813,41,41,,,1,0,0.1,1.07,0.94,,703,152,164,,,,62.48,44.5,62.79,1,,,,,,,,,,,,,,69,82,13.18,13.21,13.3,9.1,,,,,,,,,,,,,,,,"0,0,1,15,53,25,4,2,1","0,11,88,1,0",,,,,,133,,,,,,,,,,,,,,,,,,,,,,,,,,,,,,,,,,,,41.8,12,13,251,78,,1011,3,373,0,4,3,,1,0,I1.000|4:09-I1.000|4:45-I1.000|4:24-I1.000|4:36-I1.000|4:36-I1.000|4:26-I1.000|4:38-I1.000|4:42-I1.000|4:46-I1.000|4:51-I0.161|0:49,,Running,,,,"Polar M430",43,0,,0,168070,250480,30378,,,,,,,,,,,,,,,,,,,,,,,,,,,,,,,,,,,,,,,,,,,
7021743,8cabe88f-36d1-46b7-9e55-8287f6df51ed,1554833256,120,1554919093,,0,0,13.6,3450,4212,92,93,,,1,0,0.06,,0.86,,863,152,180,,,,68.8,49.75,69.37,1,,,,,,,,,,,,,,90,84,14.2,14.73,14.78,-6.3,,,,,,,,,,,,,,,,"1,2,4,9,29,21,16,19,0","1,17,54,28,0",,,,,,141,,,,,,,,,,,,,,,,,,,,,,,,,,,,,,,,,,,,76.7,13,5,266,84,,1008,0,365,0,4,3,,1,0,I6.699|30:49-I1.039|3:28-I1.028|3:30-I1.025|3:47-I0.424|2:02-I1.034|3:50-I0.426|2:28-I1.068|3:29-I0.856|4:28,,Running,,,,"Polar M430",43,0,,0,168070,250480,30378,,,,,,,,,,,,,,,,,,,,,,,,,,,,,,,,,,,,,,,,,,,
7021773,7b0f0ed7-dc78-47d5-b96c-5c7b59d05198,1554916062,120,1554919210,,0,0,15.03,3965,4641,69,69,,,1,0,0.13,1.11,0.89,,925,147,167,,,,68.56,47.91,68.95,1,,,,,,,,,,,,,,88,82,13.67,13.74,13.83,-1.5,,,,,,,,,,,,,,,,"1,1,1,3,29,57,7,1,0","1,19,78,2,0",,,,,,139,,,,,,,,,,,,,,,,,,,,,,,,,,,,,,,,,,,,38.9,14,15,5,56,,1011,1,358,0,5,3,,1,0,I1.000|4:48-I1.000|4:22-I1.000|4:22-I1.000|4:18-I1.000|4:23-I1.000|4:32-I1.000|4:30-I1.000|4:32-I1.000|4:22-I1.000|4:23-I1.000|4:02-I1.000|4:10-I1.000|4:26-I1.000|4:27-I1.000|4:37-I0.036|0:09,,Running,,,,"Polar M430",43,0,,0,168070,250480,30378,,,,,,,,,,,,,,,,,,,,,,,,,,,,,,,,,,,,,,,,,,,
7021775,6a14d5da-31d1-4750-b9c9-9bde5b5bf693,1554559534,120,1554919211,,0,0,4.81,1250,1268,64,65,,,1,1.6,0.59,1.04,0.94,295,300,148,168,,,,69.22,45.26,70.35,1,,,,,,,,,,,,,,29,83,14.14,14.06,14.3,8.7,,,,,,,,,,,,,,,,"1,2,2,5,24,40,24,1,0","1,19,61,18,0",,,,,,139,,,,,,,,,,,,,,,,,,,,,,,,,,,,,,,,,,,,38.6,14,12,91,73,,1005,3,332,0,5,3,,1,0,I1.000|4:37-I1.000|4:24-I1.000|4:37-I1.000|3:57-I0.816|3:22,,Running,,,,"Polar M430",43,0,,0,168070,250480,30378,,,,,,,,,,,,,,,,,,,,,,,,,,,,,,,,,,,,,,,,,,5,
7021776,2f73363e-b872-4d8b-af93-99a8ddde4801,1554625165,120,1554919211,,0,0,16.71,4620,5312,372,372,,,1,4.1,0.6,1.09,0.96,637,1127,150,175,,,,62.97,45.76,64.71,1,,,,,,,,,,,,,,111,84,13.74,13.32,14.05,-0.6,,,,,,,,,,,,,,,,"5,3,4,13,28,36,11,1,0","1,10,73,17,0",,,,,,129,,,,,,,,,,,,,,,,,,,,,,,,,,,,,,,,,,,,53.2,7,9,85,97,,1005,0,346,0,5,3,,1,0,I1.000|5:46-I1.000|4:43-I1.000|4:23-I1.000|4:22-I1.000|4:42-I1.000|4:54-I1.000|4:22-I1.000|4:30-I1.000|4:31-I1.000|4:51-I1.000|4:45-I1.000|3:57-I1.000|4:30-I1.000|4:19-I1.000|4:57-I1.000|4:39-I0.714|3:01,,Running,,,,"Polar M430",43,0,,0,168070,250480,30378,,,,,,,,,,,,,,,,,,,,,,,,,,,,,,,,,,,,,,,,,,"4,4,4,5,5",
7037144,cc68e3f8-6bdc-44e1-9c4d-2de090027ac0,1555006075,120,1555004527,,0,0,16.01,4219,4288,52,53,,,1,0,0.04,1.07,0.89,,1096,155,172,,,,63.88,48.21,64.13,1,,,,,,,,,,,,,,114,83,13.69,13.78,13.84,2.7,,,,,,,,,,,,,,,,"0,1,2,5,24,59,6,2,0","0,7,77,15,0",,,,,,137,,,,,,,,,,,,,,,,,,,,,,,,,,,,,,,,,,,,50.2,13,17,44,34,,1018,1,366,0,3,3,,1,0,I14.177|1:02:22-I0.101|0:19-I0.104|0:32-I0.120|0:20-I0.109|0:31-I0.101|0:19-I0.107|0:31-I0.122|0:19-I0.111|0:30-I0.099|0:19-I0.099|0:31-I0.137|0:24-I0.622|3:30,,Running,,,,"Polar M430",43,0,,0,168070,250480,30378,,,,,,,,,,,,,,,,,,,,,,,,,,,,,,,,,,,,,,,,,,,
7058270,f41e9549-fe65-487f-86e0-142c9509f2ab,1555151387,120,1555147086,,0,0,8.07,2470,2557,175,175,,,1,2.6,0.75,1.03,1.02,469,571,145,168,,,,58.09,38.51,59.65,1,,,,,,,,,,,,,,52,83,12.34,12.01,12.48,3.7,,,,,,,,,,,,,,,,"7,8,15,26,29,14,1,0,0","1,32,62,5,0",,,,,,118,,,,,,,,,,,,,,,,,,,,,,,,,,,,,,,,,,,,40.4,3,10,15,69,,1023,2,443,0,5,3,,1,0,I1.000|6:08-I1.000|4:42-I1.000|4:57-I1.000|5:32-I1.000|5:06-I1.000|4:40-I1.000|5:17-I1.000|4:28-I0.073|0:24,,Running,,,,"Polar M430",43,0,,0,168070,250480,30378,,,,,,,,,,,,,,,,,,,,,,,,,,,,,,,,,,,,,,,,,,"5,5",
7102155,1531662a-6b34-4365-97c9-3d014bf58fd9,1555238529,120,1555317725,,0,0,19.06,5450,5693,469,468,,,1,4.4,0.76,1.09,1.04,482,1254,144,170,,,,63.75,44.48,65.7,1,,,,,,,,,,,,,,114,83,13.29,13.13,13.7,-10.8,,,,,,,,,,,,,,,,"5,6,11,23,26,12,15,3,0","0,31,63,6,0",,,,,,126,,,,,,,,,,,,,,,,,,,,,,,,,,,,,,,,,,,,42.2,5,23,43,65,,1023,2,450,0,3,3,,1,0,I8.599|44:24-I3.604|17:44-I1.455|8:25-I5.402|20:34,,Running,,,,"Polar M430",43,0,,0,168070,250480,30378,,,,,,,,,,,,,,,,,,,,,,,,,,,,,,,,,,,,,,,,,,"3,4,5",
7111906,6b02d7bd-8aa6-4e62-b331-b5f66d163a84,1555342244,120,1555343285,,0,0,14.54,4163,4180,72,73,,,1,0,0.14,1.1,0.91,,1033,150,165,,,,60.31,43.46,60.67,1,,,,,,,,,,,,,,99,81,12.62,12.67,12.77,1.2,,,,,,,,,,,,,,,,"0,2,5,21,52,17,3,0,0","0,7,91,2,0",,,,,,129,,,,,,,,,,,,,,,,,,,,,,,,,,,,,,,,,,,,42.4,18,21,82,39,,1019,3,384,0,5,3,,1,0,I0.586|3:15-I6.630|31:50-I7.325|34:24,,Running,,,,"Polar M430",43,0,,0,168070,250480,30378,,,,,,,,,,,,,,,,,,,,,,,,,,,,,,,,,,,,,,,,,,,
7136184,69ba8460-0bba-4564-87d6-5358e403a026,1555438198,120,1555438212,,0,0,17.36,4513,4582,48,50,,,1,0,0.05,,,,1194,157,172,,,,63.8,49.29,64.01,1,,,,,,,,,,,,,,130,83,13.87,14.2,14.26,8.4,,,,,,,,,,,,,,,,"5,0,2,2,10,58,22,2,0","0,14,25,60,0",,,,,,139,,,,,,,,,,,,,,,,,,,,,,,,,,,,,,,,,,,,64.2,17,9,350,45,,1018,1,358,0,9,3,,1,0,I15.737|1:08:51-I1.630|7:16,,Running,,,,"Polar M430",43,0,,0,168070,250480,30378,,,,,,,,,,,,,,,,,,,,,,,,,,,,,,,,,,,,,,,,,,,
7149546,6f018f29-f981-40de-9908-53eb63f68a82,1555527046,120,1555524244,,0,0,8.86,2393,2734,24,28,,,1,0,0.13,1.07,0.91,,568,147,184,,,,66.59,44.88,66.78,1,,,,,,,,,,,,,,60,83,13.37,14.35,14.42,17.4,,,,,,,,,,,,,,,,"11,18,7,5,8,6,34,10,1","1,56,10,23,10",,,,,,134,,,,,,,,,,,,,,,,,,,,,,,,,,,,,,,,,,,,105.9,21,17,45,44,,1021,0,358,0,5,3,,1,0,I1.980|10:07-I2.461|8:50-I2.481|8:59-I1.938|12:23,,Running,,,,"Polar M430",43,0,,0,168070,250480,30378,,,,,,,,,,,,,,,,,,,,,,,,,,,,,,,,,,,,,,,,,,,
7161942,1b1a24dc-8d5c-4ab4-a5b5-1b523a4affa9,1555599891,120,1555598769,,0,0,15.16,4505,4622,64,65,,,1,0,0.12,1.13,0.96,,1027,143,153,,,,61.34,41.76,61.65,1,,,,,,,,,,,,,,89,80,12.14,12.15,12.21,6.2,,,,,,,,,,,,,,,,"0,0,4,41,50,4,0,0,0","1,17,82,0,0",,,,,,126,,,,,,,,,,,,,,,,,,,,,,,,,,,,,,,,,,,,29.7,22,28,38,36,,1022,4,362,0,11,3,,1,0,I1.000|4:59-I1.000|4:47-I1.000|4:49-I1.000|4:49-I1.000|4:50-I1.000|4:54-I1.000|4:55-I1.000|4:48-I1.000|4:54-I1.000|5:12-I1.000|4:55-I1.000|5:07-I1.000|5:05-I1.000|5:13-I1.000|5:05-I0.165|0:49,,Running,,,,"Polar M430",43,0,,0,168070,250480,30378,,,,,,,,,,,,,,,,,,,,,,,,,,,,,,,,,,,,,,,,,,,
7182377,1284fea5-f2ea-4bf8-8750-f253f3b6bc12,1555692302,120,1555691044,,0,0,11.14,2816,3019,345,346,,,1,4.1,0.71,1.02,0.94,737,763,159,182,,,,64.88,49.24,67.36,1,,,,,,,,,,,,,,90,83,15.24,14.97,15.9,-2.5,,,,,,,,,,,,,,,,"4,6,3,12,18,22,12,23,1","1,19,13,65,2",,,,,,143,,,,,,,,,,,,,,,,,,,,,,,,,,,,,,,,,,,,99,22,19,88,28,,1029,3,343,0,3,3,,1,0,I2.056|11:14-I3.993|17:29-I5.092|18:44,,Running,,,,"Polar M430",43,0,,0,168070,250480,30378,,,,,,,,,,,,,,,,,,,,,,,,,,,,,,,,,,,,,,,,,,3,
7188232,6ca05e4b-d560-439c-b730-2781b22d6759,1555745000,120,1555749126,,0,0,16.5,4821,4830,358,358,,,1,3.6,0.59,1.06,1,475,1204,151,167,,,,58.29,42.88,59.85,1,,,,,,,,,,,,,,119,82,12.92,12.61,13.22,-2.2,,,,,,,,,,,,,,,,"5,6,11,20,33,15,9,1,0","0,7,85,8,0",,,,,,125,,,,,,,,,,,,,,,,,,,,,,,,,,,,,,,,,,,,43.7,8,4,83,81,,1030,0,347,0,3,3,,1,0,I1.000|5:12-I1.000|5:41-I1.000|5:06-I1.000|4:47-I1.000|4:58-I1.000|5:24-I1.000|5:07-I1.000|4:31-I1.000|4:54-I1.000|4:53-I1.000|5:21-I1.000|4:40-I1.000|3:55-I1.000|4:34-I1.000|4:26-I1.000|4:48-I0.499|2:13,,Running,,,,"Polar M430",43,0,,0,168070,250480,30378,,,,,,,,,,,,,,,,,,,,,,,,,,,,,,,,,,,,,,,,,,"4,4,5",
7216940,08440cf2-4e9a-4e2e-898e-06db952fb503,1555917602,120,1555928525,,0,0,10.08,3023,3421,223,222,,,1,2.8,0.58,1.07,0.95,539,704,146,166,,,,59.03,40.05,60.66,1,,,,,,,,,,,,,,65,82,12.58,12.31,12.85,-1,,,,,,,,,,,,,,,,"9,4,6,21,37,22,1,0,0","1,26,71,2,0",,,,,,122,,,,,,,,,,,,,,,,,,,,,,,,,,,,,,,,,,,,33.7,7,6,51,82,,1014,0,314,0,3,3,,1,0,I1.000|6:22-I1.000|5:14-I1.000|4:33-I1.000|4:28-I1.000|4:48-I1.000|4:36-I1.000|5:08-I1.000|4:37-I1.000|5:11-I1.000|5:07-I0.081|0:22,,Running,,,,"Polar M430",43,0,,0,168070,250480,30378,,,,,,,,,,,,,,,,,,,,,,,,,,,,,,,,,,,,,,,,,,"4,5",
7216941,75718f3e-124e-4c4e-a164-ba96ee93f6a5,1555855264,120,1555928526,,0,0,14.6,4260,4290,326,327,,,1,4,0.62,1,1.05,733,1097,154,179,,,,56.84,42.53,58.4,1,,,,,,,,,,,,,,116,82,13.09,13.08,13.58,-9.4,,,,,,,,,,,,,,,,"13,11,10,17,15,14,17,3,0","1,9,58,32,0",,,,,,125,,,,,,,,,,,,,,,,,,,,,,,,,,,,,,,,,,,,75.7,22,14,73,29,,1020,6,311,0,3,3,,1,0,I1.000|5:19-I1.000|6:00-I1.000|6:04-I1.000|6:22-I1.000|5:42-I1.000|4:35-I1.000|5:15-I1.000|4:49-I1.000|4:28-I1.000|4:18-I1.000|3:32-I1.000|3:43-I1.000|3:47-I1.000|3:54-I0.600|3:16,,Running,,,,"Polar M430",43,0,,0,168070,250480,30378,,,,,,,,,,,,,,,,,,,,,,,,,,,,,,,,,,,,,,,,,,3,
7242669,3dfdb048-1a41-47e1-bc4a-2724a0c6f44b,1556043341,120,1556041687,,0,0,12.54,3262,3643,60,60,,,1,0,0.16,1.08,0.91,,859,156,182,,,,64.33,48.03,64.71,1,,,,,,,,,,,,,,94,83,13.89,14.25,14.34,8,,,,,,,,,,,,,,,,"1,1,4,15,24,27,19,9,0","0,15,52,29,4",,,,,,139,,,,,,,,,,,,,,,,,,,,,,,,,,,,,,,,,,,,98.2,22,13,13,38,,996,1,357,0,4,3,,1,0,I4.036|17:40-I3.051|10:49-I0.888|4:31-I1.464|6:01-I3.102|15:29,,Running,,,,"Polar M430",43,0,,0,168070,250480,30378,,,,,,,,,,,,,,,,,,,,,,,,,,,,,,,,,,,,,,,,,,,
7261929,5527945c-0c06-4a7f-9f1f-ce8e429bace1,1556129331,120,1556131447,,0,0,14.94,4702,5471,77,77,,,1,0,0.18,1.06,0.91,,1035,141,163,,,,58.18,39.01,58.55,1,,,,,,,,,,,,,,91,82,11.5,11.92,12.04,10.9,,,,,,,,,,,,,,,,"22,11,6,12,31,18,1,1,0","1,38,60,1,0",,,,,,116,,,,,,,,,,,,,,,,,,,,,,,,,,,,,,,,,,,,35.7,17,40,218,58,,1003,1,365,0,11,3,,1,0,I1.000|6:19-I1.000|6:15-I1.000|5:01-I1.000|4:44-I1.000|4:42-I1.000|4:51-I1.000|4:40-I1.000|5:17-I1.000|7:08-I1.000|6:14-I1.000|4:15-I1.000|4:29-I1.000|4:29-I1.000|4:59-I0.946|5:10,,Running,,,,"Polar M430",43,0,,0,168070,250480,30378,,,,,,,,,,,,,,,,,,,,,,,,,,,,,,,,,,,,,,,,,,,
7277378,95c40d10-a14c-46d7-955d-25bbe7e273d9,1556213518,120,1556210044,,0,0,6.24,1740,2146,20,25,,,1,0,0.1,1.14,0.88,,404,145,181,,,,65.18,42.31,65.37,1,,,,,,,,,,,,,,38,83,12.93,13.78,13.86,12.5,,,,,,,,,,,,,,,,"10,9,9,18,16,10,17,12,0","1,43,39,16,0",,,,,,130,,,,,,,,,,,,,,,,,,,,,,,,,,,,,,,,,,,,64.6,23,19,217,48,,1005,2,370,0,5,3,,1,0,I2.120|10:23-I2.447|8:46-I1.677|9:57,,Running,,,,"Polar M430",43,0,,0,168070,250480,30378,,,,,,,,,,,,,,,,,,,,,,,,,,,,,,,,,,,,,,,,,,,
7290621,720c2ce0-d7c6-45e4-815e-6b096fc55529,1556301341,120,1556301844,,0,0,17.76,4827,5688,61,65,,,1,0,0.09,1.02,0.92,,1167,149,171,,,,64.9,46.9,65.15,1,,,,,,,,,,,,,,114,83,13.27,13.69,13.75,-0.3,,,,,,,,,,,,,,,,"2,8,13,13,11,29,20,5,0","0,27,58,14,0",,,,,,133,,,,,,,,,,,,,,,,,,,,,,,,,,,,,,,,,,,,49.6,14,21,209,65,,1016,1,377,0,3,3,,1,0,I3.010|16:18-I8.000|33:08-I0.285|1:00-I0.209|1:01-I0.297|1:01-I0.201|1:02-I0.303|1:01-I0.211|1:00-I0.295|1:02-I0.192|0:59-I0.288|1:03-I0.212|1:02-I0.269|1:01-I0.199|1:01-I0.294|1:01-I0.203|1:01-I0.308|1:03-I0.191|1:00-I0.259|1:00-I0.212|1:01-I0.287|1:00-I2.023|12:00,,Running,,,,"Polar M430",43,0,,0,168070,250480,30378,,,,,,,,,,,,,,,,,,,,,,,,,,,,,,,,,,,,,,,,,,,
7302575,e392a7ce-a5e3-40a0-a641-2238a604b7da,1556389570,120,1556385484,,0,0,8.03,2549,2605,181,180,,,1,2.7,0.83,1.03,0.99,460,569,141,158,,,,57.56,36.88,59.18,1,,,,,,,,,,,,,,49,81,11.91,11.55,12.04,6.9,,,,,,,,,,,,,,,,"9,9,15,30,31,5,0,0,0","1,36,63,0,0",,,,,,117,,,,,,,,,,,,,,,,,,,,,,,,,,,,,,,,,,,,29.8,12,7,254,68,,1013,1,375,0,6,3,,1,0,I1.000|6:32-I1.000|4:53-I1.000|5:06-I1.000|5:29-I1.000|5:11-I1.000|4:51-I1.000|5:30-I1.000|4:54-I0.037|0:10,,Running,,,,"Polar M430",43,0,,0,168070,250480,30378,,,,,,,,,,,,,,,,,,,,,,,,,,,,,,,,,,,,,,,,,,"5,5",
7309529,88ea5b04-8da2-4743-995c-0538f68760f2,1556450572,120,1556449932,,0,0,19.09,5565,5791,464,463,,,1,4.3,0.79,1.1,1.03,476,1188,137,159,,,,66.3,43.5,68.3,1,,,,,,,,,,,,,,97,83,13.03,12.95,13.56,-12.6,,,,,,,,,,,,,,,,"8,5,13,23,24,11,12,4,0","0,57,42,0,0",,,,,,124,,,,,,,,,,,,,,,,,,,,,,,,,,,,,,,,,,,,31.4,8,10,225,75,,1019,3,379,0,5,3,,1,0,I8.625|46:11-I3.588|16:53-I1.462|9:09-I5.342|20:13-I0.069|0:29,,Running,,,,"Polar M430",43,0,,0,168070,250480,30378,,,,,,,,,,,,,,,,,,,,,,,,,,,,,,,,,,,,,,,,,,"3,4,5",
7323459,9ad22601-1d7f-4dce-9ab4-da0392f4a962,1556532653,120,1556527564,,0,0,5.02,1663,1665,88,88,,,1,1.4,0.6,1,0.95,387,358,138,156,,,,56.1,34.06,57.32,1,,,,,,,,,,,,,,29,81,11.16,10.93,11.33,2.6,,,,,,,,,,,,,,,,"5,13,33,42,7,0,0,0,0","1,54,45,0,0",,,,,,112,,,,,,,,,,,,,,,,,,,,,,,,,,,,,,,,,,,,24,8,7,243,84,,1024,3,330,0,5,3,,1,0,I1.000|5:51-I1.000|5:39-I1.000|5:15-I1.000|5:33-I1.000|5:18-I0.021|0:09,,Running,,,,"Polar M430",43,0,,0,168070,250480,30378,,,,,,,,,,,,,,,,,,,,,,,,,,,,,,,,,,,,,,,,,,5,
7363274,cf2ca3cb-7c25-4ee1-aad4-5729be176240,1556622250,120,1556775484,,0,0,13.26,4079,4671,256,256,,,1,2.8,0.65,1.07,0.97,404,920,142,173,,,,59.3,39.69,60.72,1,,,,,,,,,,,,,,82,82,12.23,12.62,13.23,2.9,,,,,,,,,,,,,,,,"17,10,22,21,7,4,8,9,1","0,46,44,10,0",,,,,,119,,,,,,,,,,,,,,,,,,,,,,,,,,,,,,,,,,,,42.5,13,17,26,46,,1021,4,346,0,3,3,,1,0,I3.193|17:56-I1.040|6:11-I0.218|0:40-I0.108|0:56-I0.214|0:39-I0.142|0:58-I0.209|0:42-I0.028|0:28-I0.226|1:30-I1.004|3:33-I0.342|2:33-I1.001|3:40-I0.301|2:48-I1.001|3:21-I0.312|2:46-I0.204|0:38-I0.101|0:53-I0.205|0:41-I0.066|0:44-I0.200|0:35-I3.139|17:56,,Running,,,,"Polar M430",43,0,,0,168070,250480,30378,,,,,,,,,,,,,,,,,,,,,,,,,,,,,,,,,,,,,,,,,,4,
7363275,320857b7-1d55-4300-892c-b99316318f7a,1556735637,120,1556775485,,0,0,6.06,1680,1735,20,21,,,1,0,0.13,1.12,0.98,,390,144,153,,,,66.24,42.53,66.5,1,,,,,,,,,,,,,,34,81,13.03,13.04,13.12,1.6,,,,,,,,,,,,,,,,"0,1,1,8,57,32,0,0,0","1,12,87,0,0",,,,,,134,,,,,,,,,,,,,,,,,,,,,,,,,,,,,,,,,,,,27.3,20,5,41,38,,1014,1,365,0,3,3,,1,0,I1.886|8:52-I2.429|11:07-I1.742|8:06,,Running,,,,"Polar M430",43,0,,0,168070,250480,30378,,,,,,,,,,,,,,,,,,,,,,,,,,,,,,,,,,,,,,,,,,,
7369255,bca692f3-fbe3-4d48-bd1d-3c9f8b73d26e,1556820540,120,1556817963,,0,0,12.99,3611,3826,38,40,,,1,0,0.06,1.13,0.9,,857,147,170,,,,64.26,44.59,64.48,1,,,,,,,,,,,,,,79,82,12.98,13.08,13.14,2.3,,,,,,,,,,,,,,,,"0,1,4,12,54,24,2,2,0","0,13,84,3,0",,,,,,132,,,,,,,,,,,,,,,,,,,,,,,,,,,,,,,,,,,,36.6,15,25,184,66,,1008,1,376,0,11,3,,1,0,I11.206|52:19-I0.101|0:18-I0.103|0:31-I0.108|0:19-I0.102|0:30-I0.103|0:19-I0.096|0:28-I0.108|0:18-I0.104|0:30-I0.105|0:18-I0.100|0:34-I0.107|0:18-I0.644|3:39,,Running,,,,"Polar M430",43,0,,0,168070,250480,30378,,,,,,,,,,,,,,,,,,,,,,,,,,,,,,,,,,,,,,,,,,,
7451939,a8e5463d-c2cb-4e55-96c2-a907e7f44194,1556908070,120,1557297400,,0,0,1.31,420,420,4,2,,,1,0,0,,,,82,142,153,,,,56.35,31.56,56.67,1,55.47,1151,,,2,,,100,,,,,,8,80,11.24,11.26,11.33,3.3,,,,,,,,,,,,,,,,"0,8,18,66,8,0,0,0,0","0,35,65,0,0",,,,,,117,,,,,,,,,,,,,,,,,,,,,,,,,,,,,,,,,,,,16.4,16,6,305,46,,1011,1,374,0,5,3,,1,0,I1.000|5:24-I0.306|1:37,,,,,3113,"firmware 2.10",250,0,,0,168070,250480,30378,,,,,,,,,,,,,,,,,,,,,,,,,,,,,,,,,,,,,,,,,,,
7451940,17d022be-b1e7-43a4-abde-f04042056346,1556999147,120,1557297400,,0,0,6.03,1898,1917,28,28,,,1,0,0.1,,,,324,137,152,,,,60.3,36.59,60.64,1,55.4,1033,,,2.7,,98,99,,,,,,32,80,11.47,12.23,12.2,-12.2,,,,,,,,,,,,,,,,"2,7,41,32,6,6,3,2,1","1,70,29,0,0",,,,,,119,,,,,,,,,,,,,,,,,,,,,,,,,,,,,,,,,,,,20.3,7,8,208,73,,1013,0,431,0,6,3,,1,0,I1.000|5:26-I1.000|5:38-I1.000|5:32-I1.000|4:37-I1.000|4:38-I1.000|5:35-I0.032|0:12,,,,,3113,"firmware 2.40",250,0,,0,168070,250480,30378,,,,,,,,,,,,,,,,,,,,,,,,,,,,,,,,,,,,,,,,,,,
7451941,7696e3e1-26ce-4f49-b42a-3a866db6093d,1557252435,120,1557297400,,0,0,14.58,3823,4060,73,76,,,1,0,0.01,,,,668,146,176,,,,69.7,48.14,70.12,1,58.55,4320,,,3.9,,107,102,,,,,,83,82,13.72,14.24,14.24,-1.5,,,,,,,,,,,,,,,,"0,1,4,12,26,36,18,3,0","0,30,61,9,0",,,,,,140,,,,,,,,,,,,,,,,,,,,,,,,,,,,,,,,,,,,50.2,16,1,285,34,,1016,1,387,0,5,3,,1,0,I1.000|4:45-I1.000|4:35-I1.000|4:43-I1.000|4:23-I1.000|4:16-I1.000|4:38-I1.000|3:56-I1.000|4:14-I1.000|4:10-I1.000|4:03-I1.000|4:13-I0.728|3:45-I0.100|0:20-I0.111|0:27-I0.099|0:19-I0.105|0:27-I0.099|0:19-I0.112|0:27-I0.098|0:19-I0.103|0:26-I0.108|0:19-I0.118|0:30-I0.099|0:19-I0.105|0:27-I0.102|0:19-I0.114|0:27-I0.093|0:19-I0.110|0:29-I0.103|0:19-I0.102|0:28-I0.097|0:18-I0.011|0:02-I0.282|1:31-I0.577|3:09,,,,,3113,"firmware 2.40",250,0,,0,168070,250480,30378,,,,,,,,,,,,,,,,,,,,,,,,,,,,,,,,,,,,,,,,,,,
7451942,b4718f63-cf91-494d-8dc9-4c10273a7905,1557055192,120,1557297401,,0,0,1.94,715,715,11,9,,,1,0.3,0.36,,,,129,139,148,,,,48.75,28.04,49.15,1,56.22,3744,,,2.1,,,100,,,,,,12,83,9.77,10,10.04,-9,,,,,,,,,,,,,,,,"22,54,17,1,6,0,0,0,0","0,57,43,0,0",,,,,,98,,,,,,,,,,,,,,,,,,,,,,,,,,,,,,,,,,,,16.3,7,17,20,60,,1019,3,450,0,5,3,,1,0,I1.000|6:18-I0.936|5:38,,,,,3113,"firmware 2.40",250,0,,0,168070,250480,30378,,,,,,,,,,,,,,,,,,,,,,,,,,,,,,,,,,,,,,,,,,,
7451943,72759c0a-dc39-49a0-acc9-eaec9f5c12da,1556904899,120,1557297401,,0,0,7.58,2259,2558,30,30,,,1,0,0.17,,,,387,138,166,,,,63.93,39.58,64.24,1,55.47,1164,,,3,,104,104,,,,,,40,80,12.09,12.19,12.21,4.1,,,,,,,,,,,,,,,,"2,1,7,35,52,3,0,0,0","0,66,32,1,0",,,,,,126,,,,,,,,,,,,,,,,,,,,,,,,,,,,,,,,,,,,23.8,14,7,316,52,,1010,1,386,0,5,3,,1,0,I1.000|5:04-I1.000|4:57-I1.000|4:51-I1.000|5:00-I1.000|4:50-I1.000|5:01-I1.000|5:00-I0.388|1:57-I0.195|0:58,,,,,3113,"firmware 2.10",250,0,,0,168070,250480,30378,,,,,,,,,,,,,,,,,,,,,,,,,,,,,,,,,,,,,,,,,,,
7451944,02c23c6a-1567-4bf6-8c86-da1b10e90b4a,1557164989,120,1557297402,,0,0,13.65,4006,4550,35,33,,,1,0,0.04,,,,829,154,170,,,,56.43,42.02,56.62,1,56.23,4320,,,4.5,,,100,,,,,,106,80,12.28,12.43,12.45,5.5,,,,,,,,,,,,,,,,"2,2,6,22,51,16,0,0,0","0,9,76,15,0",,,,,,128,,,,,,,,,,,,,,,,,,,,,,,,,,,,,,,,,,,,50.9,13,3,31,44,,1021,1,405,0,5,3,,1,0,I1.000|5:00-I1.000|5:00-I1.000|5:17-I1.000|4:44-I1.000|4:39-I1.000|4:31-I1.000|4:35-I0.365|2:29-I1.000|4:32-I1.000|4:38-I1.000|4:59-I1.000|5:01-I1.000|5:04-I1.000|4:54-I0.288|1:23,,,,,3113,"firmware 2.40",250,0,,0,168070,250480,30378,,,,,,,,,,,,,,,,,,,,,,,,,,,,,,,,,,,,,,,,,,,
7451945,6f0768ee-5d55-4d5c-b171-efe399f2cbd2,1557049492,120,1557297402,,0,0,5.08,1569,2324,15,13,,,1,0,0.1,,,,297,147,172,,,,56.42,37.04,56.65,1,55.37,1298,,,3.1,,99,100,,,,,,34,82,11.63,12.54,12.6,-7.8,,,,,,,,,,,,,,,,"10,7,18,21,20,16,8,1,0","0,23,64,12,0",,,,,,118,,,,,,,,,,,,,,,,,,,,,,,,,,,,,,,,,,,,41.7,6,15,44,73,,1019,1,447,0,5,3,,1,0,I1.000|5:21-I1.000|5:28-I1.000|4:45-I1.000|4:25-I1.000|5:47-I0.075|0:24,,,,,3113,"firmware 2.40",250,0,,0,168070,250480,30378,,,,,,,,,,,,,,,,,,,,,,,,,,,,,,,,,,,,,,,,,,,
7451946,cd53a019-f2b6-437f-9de1-7f974ec42fd5,1557052202,120,1557297402,,0,0,8.87,1891,1891,26,25,,,1,0,0,,,,386,151,189,,,,86.2,59.24,86.52,1,56.22,3168,,,3.6,,106,99,,,,,,48,86,16.89,16.97,16.98,14.1,,,,,,,,,,,,,,,,"0,0,0,0,0,2,65,32,1","0,11,70,6,12",,,,,,164,,,,,,,,,,,,,,,,,,,,,,,,,,,,,,,,,,,,85.9,8,13,33,71,,1019,2,447,0,5,3,,1,0,I1.000|3:29-I1.000|3:29-I1.000|3:35-I1.000|3:25-I1.000|3:39-I1.000|3:38-I1.000|3:39-I1.000|3:39-I0.867|2:57,,,,,3113,"firmware 2.40",250,0,,0,168070,250480,30378,,,,,,,,,,,,,,,,,,,,,,,,8.88,1891,,,0,"Badische Meile",20,20,,,,,0,0,30378,7451946,,,,
7458296,8964bc18-5cd2-46df-8cd7-74ce4fb18374,1557338260,120,1557335341,,0,0,14.02,3872,4165,38,38,,,1,0,0.05,,,,719,144,157,,,,66.55,45.19,66.78,1,59.18,3456,,,3.6,,104,101,,,,,,80,80,13.03,13.1,13.1,1.9,,,,,,,,,,,,,,,,"0,0,1,8,55,35,1,0,0","0,15,85,0,0",,,,,,136,,,,,,,,,,,,,,,,,,,,,,,,,,,,,,,,,,,,30.8,14,9,233,89,,1001,1,387,0,6,3,,1,0,I1.000|4:43-I1.000|4:38-I1.000|4:38-I1.000|4:42-I1.000|4:24-I1.000|4:33-I1.000|4:28-I1.000|4:28-I1.000|4:31-I1.000|4:38-I1.000|4:34-I1.000|4:31-I1.000|4:44-I1.000|4:56-I0.020|0:05,,,,,3113,"firmware 2.40",250,0,,0,168070,250480,30378,,,,,,,,,,,,,,,,,,,,,,,,,,,,,,,,,,,,,,,,,,,
7478069,0f8c2649-9379-4991-b40a-0f2c3a5ce80b,1557425314,120,1557424019,,0,0,15.24,4125,5278,54,54,,,1,0,0.01,,,,866,159,185,,,,59.62,46.56,59.88,1,59.12,4355,,,5,,102,97,,,,,,124,82,13.3,13.61,13.63,-0.5,,,,,,,,,,,,,,,,"0,0,2,13,39,39,5,2,0","0,7,43,50,0",,,,,,135,,,,,,,,,,,,,,,,,,,,,,,,,,,,,,,,,,,,81.6,14,21,216,84,,1002,1,410,0,6,3,,1,0,I1.000|4:57-I1.000|4:23-I1.000|4:46-I1.000|4:39-I1.000|4:39-I1.000|4:19-I1.000|4:39-I1.000|4:33-I1.000|4:21-I1.000|4:15-I1.000|4:16-I0.485|2:01-I0.197|0:41-I0.206|1:00-I0.205|0:39-I0.216|1:01-I0.208|0:44-I0.205|0:59-I0.200|0:40-I1.000|4:53-I1.000|4:49-I0.313|1:34,,,,,3113,"firmware 2.40",250,0,,0,168070,250480,30378,,,,,,,,,,,,,,,,,,,,,,,,,,,,,,,,,,,,,,,,,,,
7495758,74007c38-96c5-4979-bcef-00e21c5c3ee1,1557513072,120,1557507352,,0,0,4.68,1379,1394,92,92,,,1,1.8,0.78,1.1,1.25,415,259,139,159,,,,64.25,38.98,65.82,1,59.14,2924,,,2.3,,101,100,,,,,,25,81,12.5,13.45,13.09,-7.2,,,,,,,,,,,,,,,,"3,9,34,23,11,6,3,12,0","0,44,56,0,0",,,,,,126,,,,,,,,,,,,,,,,,,,,,,,,,,,,,,,,,,,,26.1,18,17,245,36,,1011,1,378,0,5,3,,1,0,I1.000|5:35-I1.000|5:23-I1.000|5:35-I0.148|0:46-I1.000|3:16-I0.533|2:25,,,,,3113,"firmware 2.40",250,0,,0,168070,250480,30378,,,,,,,,,,,,,,,,,,,,,,,,,,,,,,,,,,,,,,,,,,5,
7504038,ab3b6c2c-8244-46f8-99e1-0c1c6c8fa36e,1557569524,120,1557566287,,0,0,12.8,3834,3834,258,258,,,1,3.1,0.79,1.09,0.99,447,946,171,190,,,,47.24,40.83,48.42,1,58.87,4479,,,5,,95,95,,,,,,151,80,12.37,12.22,12.5,1.3,,,,,,,,,,,,,,,,"5,4,8,30,38,15,0,0,0","0,1,12,78,9",,,,,,125,,,,,,,,,,,,,,,,,,,,,,,,,,,,,,,,,,,,116.1,8,19,41,99,,1008,2,383,0,6,3,,1,0,I1.000|6:05-I1.000|4:45-I1.000|4:54-I1.000|5:25-I1.000|5:06-I1.000|4:36-I1.000|4:34-I1.000|5:08-I1.000|5:03-I1.000|4:58-I1.000|4:30-I1.000|5:12-I0.801|3:38,,,,,3113,"firmware 2.40",250,0,,0,168070,250480,30378,,,,,,,,,,,,,,,,,,,,,,,,,,,,,,,,,,,,,,,,,,"5,5,5",
7514320,0d60811b-beba-4448-8bff-eac1f1831c48,1557646531,120,1557643567,,0,0,10.49,3679,3951,337,336,,,1,4.6,0.8,1.1,0.94,770,771,155,175,,,,44.89,33.41,46.68,1,58.72,4123,,,3.7,,97,95,,,,,,100,81,11.23,10.6,11.9,5.5,,,,,,,,,,,,,,,,"24,10,20,25,19,2,0,0,0","0,7,60,33,0",,,,,,106,,,,,,,,,,,,,,,,,,,,,,,,,,,,,,,,,,,,61.9,4,3,241,89,,1029,0,403,0,5,3,,1,0,I1.000|6:24-I1.000|4:53-I1.000|5:16-I1.000|5:57-I1.000|8:11-I1.000|6:53-I1.000|5:24-I1.000|5:20-I1.000|5:03-I1.000|5:35-I0.494|2:23,,,,,3113,"firmware 2.40",250,0,,0,168070,250480,30378,,,,,,,,,,,,,,,,,,,,,,,,,,,,,,,,,,,,,,,,,,"3,5",
7522303,bdcc46ee-9e34-4a1f-bfcf-f8d419471ca4,1557664222,120,1557674953,,0,0,12.11,10747,15635,284,280,,,1,3.5,0.77,,,167,375,71,96,,,,,,,1,58.72,3634,,,,,,100,,,,,,12,55,,4.42,,-38.2,,,,,,,,,,,,,,,,"86,14,0,0,0,0","100,0,0,0,0",,,,,,,,,,,,,,,,,,,,,,,,,,,,,,,,,,,,,,,,,,1.1,9,17,346,70,,1031,4,403,0,5,3,,1,0,I6.037|1:36:41-I6.069|1:22:26,,,,,3113,"firmware 2.40",250,0,,0,168075,,30378,,,,,,,,,,,,,,,,,,,,,,,,,,,,,,,,,,,,,,,,,,3,
7538048,13ff9801-1753-4c50-953b-b5052c4f04fe,1557763446,120,1557761210,,0,0,16.79,4259,4840,65,64,,,1,0,0.11,,,,853,151,169,,,,69.42,50.57,69.76,1,60,4320,,,3.7,,106,100,,,,,,105,82,14.21,14.32,14.34,0.9,,,,,,,,,,,,,,,,"0,0,0,1,9,75,14,0,0","0,20,63,17,0",,,,,,144,,,,,,,,,,,,,,,,,,,,,,,,,,,,,,,,,,,,59.8,17,29,41,31,,1034,4,376,0,11,3,,1,0,I1.000|4:33-I1.000|4:16-I1.000|4:09-I1.000|4:17-I1.000|4:15-I1.000|4:15-I1.000|4:23-I1.000|4:15-I1.000|4:09-I1.000|4:17-I1.000|4:13-I1.000|4:10-I1.000|4:05-I1.000|4:05-I1.000|4:06-I1.000|4:14-I0.791|3:16,,,,,3113,"firmware 2.40",250,0,,0,168070,250480,30378,,,,,,,,,,,,,,,,,,,,,,,,,,,,,,,,,,,,,,,,,,,
7554954,cee73a41-41c9-48e5-91a0-538e08dab368,1557857347,120,1557856373,,0,0,12.61,3617,4999,54,53,,,1,0,0.1,,,,603,140,162,,,,65.83,42.89,66.19,1,59.94,2753,,,2.9,,,98,,,,,,66,83,12.56,14.79,14.79,0.4,,,,,,,,,,,,,,,,"8,11,18,14,27,5,2,14,1","0,47,52,0,0",,,,,,126,,,,,,,,,,,,,,,,,,,,,,,,,,,,,,,,,,,,28.6,15,26,62,30,,1027,1,376,0,11,3,,1,0,I1.000|5:00-I1.000|4:39-I1.000|4:43-I1.000|4:47-I0.897|5:14-I0.795|2:38-I0.422|2:32-I0.815|2:41-I0.406|2:22-I0.401|1:17-I0.207|1:20-I0.398|1:15-I0.203|1:19-I0.403|1:16-I0.208|1:19-I0.196|0:36-I0.203|1:18-I0.204|0:37-I0.185|1:06-I0.201|0:37-I0.201|1:12-I0.201|0:35-I1.000|5:53-I1.000|5:35-I0.067|0:25,,,,,3113,"firmware 2.40",250,0,,0,168070,250480,30378,,,,,,,,,,,,,,,,,,,,,,,,,,,,,,,,,,,,,,,,,,,
7586469,1f3abf82-8c02-46ee-8d37-09d2097e4395,1558030192,120,1558028085,,0,0,13.85,3886,4156,42,45,,,1,0,0.03,,,,801,150,165,,,,61.83,44.32,62.05,1,59.97,1454,,,3.5,,99,100,,,,,,92,81,12.83,13.36,13.37,-6.5,,,,,,,,,,,,,,,,"0,1,2,28,38,25,3,2,1","0,8,88,4,0",,,,,,132,,,,,,,,,,,,,,,,,,,,,,,,,,,,,,,,,,,,44.7,17,18,348,46,,1012,1,377,0,3,3,,1,0,I1.000|5:05-I1.000|5:08-I1.000|4:47-I1.000|4:41-I1.000|4:48-I1.000|4:51-I1.000|4:56-I1.000|4:23-I1.000|4:21-I1.000|4:17-I1.000|4:28-I0.154|0:47-I0.200|0:40-I0.213|1:01-I0.198|0:39-I0.215|1:02-I0.194|0:38-I0.212|0:59-I0.203|0:36-I1.000|5:18-I0.262|1:22,,,,,3113,"firmware 2.40",250,0,,0,168070,250480,30378,,,,,,,,,,,,,,,,,,,,,,,,,,,,,,,,,,,,,,,,,,,
7599491,447f62b0-dafa-44d4-a5dc-35a876ae90db,1558096157,120,1558090892,,0,0,6.31,1849,1849,26,26,,,1,0,0.17,,,,362,140,155,,,,64.12,39.93,64.44,1,60.18,1048,,,2.6,,101,100,,,,,,35,80,12.29,12.7,12.76,9.9,,,,,,,,,,,,,,,,"1,1,6,33,48,7,2,1,1","1,26,74,0,0",,,,,,128,,,,,,,,,,,,,,,,,,,,,,,,,,,,,,,,,,,,28.2,17,11,5,60,,1006,6,365,0,3,3,,1,0,I1.000|4:54-I1.000|4:55-I1.000|4:51-I1.000|4:52-I1.000|4:16-I1.000|5:20-I0.312|1:41,,,,,3113,"firmware 2.40",250,0,,0,168070,250480,30378,,,,,,,,,,,,,,,,,,,,,,,,,,,,,,,,,,,,,,,,,,,
7613713,6f66d5b6-d159-4bb3-9452-acc4093e548d,1558194598,120,1558189501,,0,0,4.17,1189,1698,9,11,,,1,0,0.05,,,,249,147,168,,,,62.27,40.22,62.4,1,59.93,1083,,,2.6,,96,100,,,,,,26,79,12.61,12.8,12.81,-3.7,,,,,,,,,,,,,,,,"0,0,4,34,37,22,3,0,0","0,22,67,11,0",,,,,,133,,,,,,,,,,,,,,,,,,,,,,,,,,,,,,,,,,,,40.4,22,12,356,50,,1004,5,346,0,3,3,,1,0,I1.000|4:49-I1.000|5:11-I1.000|4:31-I1.000|4:31-I0.173|0:47,,,,,3113,"firmware 2.40",250,0,,0,168070,250480,30378,,,,,,,,,,,,,,,,,,,,,,,,,,,,,,,,,,,,,,,,,,,
7614328,4e6f97bb-f350-401a-8273-112cddb2ff88,1558197638,120,1558192991,,0,0,2.63,532,532,0,2,,,1,0,0,,,,88,127,145,,,,,57.29,,1,59.93,1052,,,,,,100,,,,,,7,89,17.75,17.9,17.88,-2.8,,,,,,,,,,,,,,,,"0,0,0,0,0,0,10,90,0","0,92,7,0,0",,,,,,167,,,,,,,,,,,,,,,,,,,,,,,,,,,,,,,,,,,,9.2,23,11,351,46,,1004,3,345,0,5,3,,1,0,I1.000|3:24-I1.000|3:18-I0.629|2:10,,,,,3113,"firmware 2.40",250,0,,0,168070,250480,30378,,,,,,,,,,,,,,,,,,,,,,,,,,,,,,,,,,,,,,,,,,,
7614330,f50e9fe4-7ff2-4f01-b187-cc8dbe8fcc4d,1558198948,120,1558193005,,0,0,2.23,875,875,0,0,,,1,0,0,,,,163,136,143,,,,46.35,26.36,46.35,1,59.01,1078,,,1.9,,93,93,,,,,,14,80,9.17,9.33,9.33,1.1,,,,,,,,,,,,,,,,"48,44,8,0,0,0,0,0,0","0,98,2,0,0",,,,,,96,,,,,,,,,,,,,,,,,,,,,,,,,,,,,,,,,,,,16.5,23,11,354,46,,1004,2,345,0,5,3,,1,0,I1.000|6:33-I1.000|6:14-I0.230|1:48,,,,,3113,"firmware 2.40",250,0,,0,168070,250480,30378,,,,,,,,,,,,,,,,,,,,,,,,,,,,,,,,,,,,,,,,,,,
7624583,9098b958-cbf9-4575-bb37-ae2943b3e423,1558261852,120,1558261049,,0,0,19.68,5460,6073,80,80,,,1,0,0.07,,,,906,141,177,,,,67.99,46.18,68.33,1,60.31,1338,,,3.3,,,95,,,,,,109,82,12.97,13.36,13.38,10.7,,,,,,,,,,,,,,,,"2,6,8,12,23,39,10,0,0","0,56,28,15,0",,,,,,132,,,,,,,,,,,,,,,,,,,,,,,,,,,,,,,,,,,,67,14,7,256,87,,1004,3,362,0,5,3,,1,0,I1.000|5:59-I1.000|5:16-I1.000|4:20-I1.000|4:26-I1.000|4:18-I1.000|4:18-I1.000|4:16-I1.000|4:09-I1.000|4:23-I1.000|4:13-I1.000|4:38-I1.000|3:51-I1.000|3:56-I1.000|4:14-I1.000|5:06-I1.000|4:36-I1.000|4:43-I1.000|4:46-I1.000|5:43-I0.679|3:50,,,,,3113,"firmware 2.40",250,0,,0,168070,250480,30378,,,,,,,,,,,,,,,,,,,,,,,,,,,,,,,,,,,,,,,,,,,
7647544,822830c1-647d-4991-b9f8-61a04d498823,1558375701,120,1558373303,,0,0,12.42,3982,4491,33,36,,,1,0,0.05,,,,584,131,157,,,,62.21,37.62,62.39,1,60.3,818,,,2.4,,103,99,,,,,,57,79,11.21,12.61,12.61,-0.3,,,,,,,,,,,,,,,,"3,16,25,44,7,1,1,1,2","0,96,4,0,0",,,,,,118,,,,,,,,,,,,,,,,,,,,,,,,,,,,,,,,,,,,16.9,16,9,140,85,,1005,1,335,0,6,3,,1,0,I1.000|5:32-I1.000|5:03-I1.000|5:17-I1.000|5:20-I1.000|5:18-I1.000|5:25-I1.000|5:32-I1.000|5:33-I1.000|5:33-I0.627|3:24-I0.204|0:38-I0.202|1:08-I0.210|0:37-I0.203|1:08-I0.206|0:36-I0.207|1:12-I0.200|0:34-I1.000|6:14-I0.357|2:19,,,,,3113,"firmware 2.40",250,0,,0,168070,250480,30378,,,,,,,,,,,,,,,,,,,,,,,,,,,,,,,,,,,,,,,,,,,
7662835,33a6f47e-7c6c-4fbf-9869-194321af00ac,1558464772,120,1558459968,,0,0,4.43,1412,1421,22,22,,,1,0.3,0.32,,,,236,128,148,,,,64.37,35.4,64.77,1,60.25,617,,,2,,98,99,,,,,,19,79,11.3,11.47,11.5,8.6,,,,,,,,,,,,,,,,"2,4,26,49,17,3,0,0,0","2,84,14,0,0",,,,,,119,,,,,,,,,,,,,,,,,,,,,,,,,,,,,,,,,,,,16.9,16,18,245,85,,1014,1,344,0,6,3,,1,0,I1.000|5:22-I1.000|5:23-I1.000|5:39-I1.000|4:55-I0.434|2:12,,,,,3113,"firmware 2.40",250,0,,0,168070,250480,30378,,,,,,,,,,,,,,,,,,,,,,,,,,,,,,,,,,,,,,,,,,,
7676973,8b4c7760-0d7a-4d4f-a99f-d5f02fe8f523,1558545525,120,1558544455,,0,0,13.79,4425,5191,32,34,,,1,0,0.09,,,,720,138,184,,,,58.35,37.9,58.51,1,60.61,1725,,,3.1,,103,101,,,,,,83,78,11.23,15.01,14.98,23,,,,,,,,,,,,,,,,"36,1,3,8,22,4,4,21,0","0,66,23,8,2",,,,,,120,,,,,,,,,,,,,,,,,,,,,,,,,,,,,,,,,,,,65.7,19,11,343,48,,1019,2,356,0,5,3,,1,0,I1.000|4:51-I1.000|4:46-I1.000|4:34-I1.000|4:47-I0.892|4:33-I0.616|2:05-I0.207|1:54-I0.615|2:03-I0.206|1:57-I0.607|2:03-I0.210|2:01-I0.612|2:01-I0.375|5:02-I0.608|2:03-I0.207|2:09-I0.607|1:59-I0.207|2:02-I0.607|2:00-I0.208|2:09-I0.611|2:01-I0.202|2:03-I0.606|1:57-I0.205|2:15-I0.609|1:58-I0.230|3:17-I0.542|5:17,,,,,3113,"firmware 2.40",250,0,,0,168070,250480,30378,,,,,,,,,,,,,,,,,,,,,,,,,,,,,,,,,,,,,,,,,,,
7685054,a6c3c119-0509-48f1-a792-709260131643,1558613863,120,1558609987,,0,0,6.27,1681,1699,35,36,,,1,0,0.1,,,,387,157,171,,,,61.42,44.33,61.83,1,60.23,1624,,,3.2,,100,98,,,,,,48,80,13.4,13.47,13.47,3.6,,,,,,,,,,,,,,,,"0,0,0,4,44,49,3,0,0","1,8,48,43,0",,,,,,140,,,,,,,,,,,,,,,,,,,,,,,,,,,,,,,,,,,,59.7,17,9,24,54,,1020,7,339,0,3,3,,1,0,I1.000|4:36-I1.000|4:44-I1.000|4:28-I1.000|4:25-I1.000|4:20-I1.000|4:19-I0.266|1:10,,,,,3113,"firmware 2.40",250,0,,0,168070,250480,30378,,,,,,,,,,,,,,,,,,,,,,,,,,,,,,,,,,,,,,,,,,,
7685055,d18b8eb4-11cb-49f1-a973-49a6c957cabe,1558615897,120,1558609995,,0,0,1.99,664,664,0,3,,,1,0,0.07,,,,140,150,178,,,,49.93,31.55,49.84,1,60.23,2016,,,2.2,,,100,,,,,,16,76,10.74,16.82,16.6,12.3,,,,,,,,,,,,,,,,"53,4,5,5,5,4,4,4,16","0,13,69,18,0",,,,,,118,,,,,,,,,,,,,,,,,,,,,,,,,,,,,,,,,,,,34.1,18,9,23,52,,1019,8,339,0,3,3,,1,0,I0.094|0:29-I0.206|0:34-I0.217|1:42-I0.197|0:34-I0.204|1:45-I0.205|0:33-I0.203|1:51-I0.211|0:34-I0.206|1:56-I0.204|0:34-I0.039|0:33,,,,,3113,"firmware 2.40",250,0,,0,168070,250480,30378,,,,,,,,,,,,,,,,,,,,,,,,,,,,,,,,,,,,,,,,,,,
7685057,fffeaf7d-5df9-4a75-bf60-3af387d02fd5,1558616797,120,1558609999,,0,0,0.5,212,212,0,1,,,1,0,0,,,,37,137,145,,,,41.74,20.56,41.64,1,60.23,2009,,,,,,100,,,,,,3,79,8.4,8.48,8.45,1,,,,,,,,,,,,,,,,"100,0,0,0,0,0,0,0,0","0,85,15,0,0",,,,,,90,,,,,,,,,,,,,,,,,,,,,,,,,,,,,,,,,,,,7.6,18,9,23,52,,1019,8,339,0,3,3,,1,0,,,,,,3113,"firmware 2.40",250,0,,0,168070,250480,30378,,,,,,,,,,,,,,,,,,,,,,,,,,,,,,,,,,,,,,,,,,,
7697577,bc8962ff-4262-41b2-a895-89bcb6053fd0,1558709415,120,1558705130,,0,0,7.89,2713,2806,172,172,,,1,2.7,0.76,1.02,1.05,429,483,139,158,,,,53.1,33.51,54.53,1,59.05,1692,,,2.7,,95,99,,,,,,49,78,10.81,10.68,11.01,0.3,,,,,,,,,,,,,,,,"15,18,25,39,4,0,0,0,0","0,57,43,0,0",,,,,,112,,,,,,,,,,,,,,,,,,,,,,,,,,,,,,,,,,,,27.5,23,5,159,40,,1014,6,328,0,5,3,,1,0,I1.000|6:52-I1.000|5:22-I1.000|5:32-I1.000|5:46-I1.000|5:38-I1.000|5:17-I1.000|6:01-I0.893|4:45,,,,,3113,"firmware 2.40",250,0,,0,168070,250480,30378,,,,,,,,,,,,,,,,,,,,,,,,,,,,,,,,,,,,,,,,,,"5,5",
7710441,05f8dc17-de32-4ca5-9a47-ce1f5d696914,1558803679,120,1558801996,,0,0,6.11,1870,1995,145,113,,,1,2.4,0.76,0.99,1.05,481,361,144,161,,,,58.62,37.85,60.72,1,59.16,1106,,,2.7,,98,101,,,,,,39,79,12.34,12.01,12.48,-2.7,,,,,,,,,,,,,,,,"12,3,10,24,39,12,0,0,0","1,32,64,4,0",,,,,,124,,,,,,,,,,,,,,,,,,,,,,,,,,,,,,,,,,,,32.7,24,15,330,37,,1016,3,345,0,5,3,,1,0,I1.000|6:19-I1.000|4:42-I1.000|4:56-I1.000|5:16-I1.000|4:55-I1.000|4:31-I0.109|0:32,,,,,3113,"firmware 2.40",250,0,,0,168070,250480,30378,,,,,,,,,,,,,,,,,,,,,,,,,,,,,,,,,,,,,,,,,,"5,5",
7710445,78a6259e-4eb5-4c53-b1e9-8f21ff794974,1558805854,120,1558802015,,0,0,7.41,2517,2517,72,73,,,1,1,0.5,1.62,2.14,,485,152,181,,,,47.97,33.85,48.54,1,60.06,2796,,,3.3,,105,105,,,,,,70,81,10.72,14.9,14.84,18.8,,,,,,,,,,,,,,,,"50,1,1,2,1,2,19,23,1","0,34,13,53,0",,,,,,109,,,,,,,,,,,,,,,,,,,,,,,,,,,,,,,,,,,,72.3,24,15,332,38,,1016,2,346,0,5,3,,1,0,I0.603|1:59-I0.192|2:00-I0.613|2:13-I0.162|2:02-I0.600|1:54-I0.123|1:57-I0.601|2:11-I0.144|1:58-I0.601|1:55-I0.120|1:59-I0.602|2:13-I0.134|2:00-I0.603|1:54-I0.125|2:02-I0.600|2:13-I0.110|2:01-I0.603|1:53-I0.102|2:04-I0.595|2:12-I0.178|3:17,,,,,3113,"firmware 2.40",250,0,,0,168070,250480,30378,,,,,,,,,,,,,,,,,,,,,,,,,,,,,,,,,,,,,,,,,,,
7710449,e1773b4e-3149-4616-b746-aebf59eb3c41,1558808435,120,1558802025,,0,0,1.62,620,626,32,61,,,1,1.4,0.87,1.05,1.02,,108,130,147,,,,50.45,26.36,50.56,1,59.84,2785,,,1.2,,96,96,,,,,,8,81,9.48,9.54,9.56,3.5,,,,,,,,,,,,,,,,"47,38,12,2,1,0,0,0,0","0,80,20,0,0",,,,,,97,,,,,,,,,,,,,,,,,,,,,,,,,,,,,,,,,,,,12,24,14,335,40,,1016,1,348,0,5,3,,1,0,I1.000|6:39-I0.616|3:40,,,,,3113,"firmware 2.40",250,0,,0,168070,250480,30378,,,,,,,,,,,,,,,,,,,,,,,,,,,,,,,,,,,,,,,,,,,
7723271,a772676e-1977-45ee-8861-fc5d83043d12,1558889725,120,1558886978,,0,0,7.78,2729,2851,333,42,,,1,4,0.85,1.07,1.06,436,545,145,159,,,,49.1,32.69,54,1,59.3,2122,,,3.1,,96,98,,,,,,58,80,11.82,10.35,12.09,4.1,,,,,,,,,,,,,,,,"16,21,38,19,6,0,0,0,0","1,20,80,0,0",,,,,,107,,,,,,,,,,,,,,,,,,,,,,,,,,,,,,,,,,,,33.6,23,18,240,40,,1013,4,321,0,3,3,,1,0,I1.000|6:36-I1.000|5:33-I1.000|5:19-I1.000|5:54-I1.000|5:48-I1.000|5:53-I1.000|6:11-I0.779|4:14,,,,,3113,"firmware 2.40",250,0,,0,168070,250480,30378,,,,,,,,,,,,,,,,,,,,,,,,,,,,,,,,,,,,,,,,,,3,
7723274,f33d174a-3b86-4b80-b82a-099d5e6a1c8d,1558892829,120,1558886988,,0,0,5.01,1045,1058,0,283,,,1,1.1,0.84,,1.03,,237,159,172,,,,82.37,58.66,76.61,1,60.14,3168,,,2.8,,102,102,,,,,,31,84,15.66,17.57,15.91,-3,,,,,,,,,,,,,,,,"0,0,0,0,1,7,41,46,4","0,4,43,53,0",,,,,,171,,,,,,,,,,,,,,,,,,,,,,,,,,,,,,,,,,,,52.2,19,17,232,49,,1013,2,319,0,3,3,,1,0,I1.000|3:38-I1.000|3:38-I1.000|3:28-I1.000|3:22-I1.000|3:19-I0.006|0:01,,,,,3113,"firmware 2.40",250,0,,0,168070,250480,30378,,,,,,,,,,,,,,,,,,,,,,,,,,,,,,,,,,,,,,,,,,,
7735162,4f26cdb7-df74-45bb-8c2d-93a091e6412b,1558982783,120,1558979225,,0,0,6.25,1958,3495,23,23,,,1,0,0.1,,,,340,132,151,,,,63.44,36.87,63.73,1,60.26,1540,,,2.1,,97,100,,,,,,29,78,11.48,11.53,11.55,-6.4,,,,,,,,,,,,,,,,"1,3,23,45,26,1,0,0,0","2,92,6,0,0",,,,,,123,,,,,,,,,,,,,,,,,,,,,,,,,,,,,,,,,,,,15.9,18,15,230,77,,1009,,,0,8,1,,1,0,I1.000|5:33-I1.000|5:26-I1.000|5:07-I1.000|5:09-I1.000|5:13-I1.000|4:55-I0.245|1:15,,,,,3113,"firmware 2.40",250,0,,0,168070,250480,30378,,,,,,,,,,,,,,,,,,,,,,,,,,,,,,,,,,,,,,,,,,,
7748988,8b70107e-5bbb-4ed2-b642-7d72c6223da8,1559066907,120,1559062236,,0,0,3.97,1088,1097,25,25,,,1,0,0.21,,,,209,136,153,,,,72.22,42,72.78,1,60.33,758,,,2.1,,100,100,,,,,,18,80,13.14,13.23,13.25,13.7,,,,,,,,,,,,,,,,"0,2,0,8,44,45,1,0,0","1,68,31,0,0",,,,,,137,,,,,,,,,,,,,,,,,,,,,,,,,,,,,,,,,,,,22.4,20,17,268,44,,1010,2,357,0,5,3,,1,0,,,,,,3113,"firmware 2.40",250,0,,0,168070,250480,30378,,,,,,,,,,,,,,,,,,,,,,,,,,,,,,,,,,,,,,,,,,,
7749043,77f99ffb-408b-47ad-b5a8-d0584f855b70,1559068232,120,1559062250,,0,0,4.38,1037,1037,0,0,,,1,0,0.01,,,,226,151,181,,,,75.63,50.15,75.63,1,60.61,1702,,,2.6,,108,92,,,,,,26,83,15.22,15.77,15.77,22,,,,,,,,,,,,,,,,"6,0,0,0,0,15,75,3,0","0,39,33,27,2",,,,,,153,,,,,,,,,,,,,,,,,,,,,,,,,,,,,,,,,,,,64,20,14,270,44,,1010,1,357,0,5,3,,1,0,I1.007|3:47-I1.019|3:41-I1.008|4:00-I1.014|3:47-I0.280|1:10-I0.055|0:52,,,,,3113,"firmware 2.40",250,0,,0,168070,250480,30378,,,,,,,,,,,,,,,,,,,,,,,,,,,,,,,,,,,,,,,,,,,
7795693,c0f76de8-5422-4033-a123-d85f57895880,1559302077,120,1559306576,,0,0,18.86,5620,5873,458,458,,,1,4.3,0.79,1.02,1.08,467,1140,154,169,,,,55.38,42.36,57.04,1,59.62,2939,,,4.1,,96,98,,,,,,149,81,12.62,12.74,12.92,-2.2,,,,,,,,,,,,,,,,"7,5,18,27,23,10,9,1,0","0,12,49,38,0",,,,,,124,,,,,,,,,,,,,,,,,,,,,,,,,,,,,,,,,,,,55.6,20,12,244,58,,1025,5,333,0,5,3,,1,0,I13.502|1:11:21-I5.356|22:19,,,,,3113,"firmware 2.40",250,0,,0,168070,250480,30378,,,,,,,,,,,,,,,,,,,,,,,,,,,,,,,,,,,,,,,,,,"3,5,5",
7811710,eb89f903-8d9d-4cf6-83c2-ec44130f8d3a,1559415823,120,1559411157,,0,0,7.14,2162,2427,180,179,,,1,2.5,0.82,0.97,1.05,488,415,143,160,,,,59.93,38.7,61.81,1,59.52,1338,,,2.8,,98,103,,,,,,44,79,12.53,12.3,12.6,-2.4,,,,,,,,,,,,,,,,"11,5,12,19,30,21,2,0,0","1,37,62,0,0",,,,,,125,,,,,,,,,,,,,,,,,,,,,,,,,,,,,,,,,,,,29.8,29,6,173,40,,1020,1,332,0,3,3,,1,0,I1.000|6:18-I1.000|4:34-I1.000|4:50-I1.000|5:10-I1.000|4:57-I1.000|5:00-I1.000|4:38-I0.136|0:36,,,,,3113,"firmware 2.40",250,0,,0,168070,250480,30378,,,,,,,,,,,,,,,,,,,,,,,,,,,,,,,,,,,,,,,,,,"5,5",
7818461,973cc2c8-bcba-4249-b95b-66353a6e1b00,1559472581,120,1559471736,,0,0,18.75,5776,6200,463,463,,,1,4.3,0.79,1.06,1.11,456,1143,154,168,,,,53.15,40.73,54.78,1,58.62,2905,,,4.1,,95,99,,,,,,152,81,12.21,12.23,12.41,0.7,,,,,,,,,,,,,,,,"9,9,19,21,24,15,3,0,0","0,8,62,30,0",,,,,,120,,,,,,,,,,,,,,,,,,,,,,,,,,,,,,,,,,,,55.5,23,8,161,57,,1017,5,332,0,3,3,,1,0,I1.000|6:30-I1.000|4:57-I1.000|5:05-I1.000|5:21-I1.000|5:01-I1.000|4:35-I1.000|5:14-I1.000|5:27-I1.000|5:20-I1.000|5:50-I1.000|5:58-I1.000|5:50-I1.000|5:54-I1.000|4:47-I1.000|4:34-I1.000|4:19-I1.000|4:09-I1.000|4:10-I0.751|3:17,,,,,3113,"firmware 2.40",250,0,,0,168070,250480,30378,,,,,,,,,,,,,,,,,,,,,,,,,,,,,,,,,,,,,,,,,,"3,5,5",
7830439,49e70cdf-712b-4155-99e5-ebcfffe48b62,1559548896,120,1559544760,,0,0,10.01,2859,2885,32,31,,,1,0,0.06,,,,537,143,162,,,,64.42,42.38,64.68,1,59.59,1728,,,3,,100,103,,,,,,56,81,12.61,12.68,12.69,5.9,,,,,,,,,,,,,,,,"1,2,4,13,64,16,0,0,0","0,25,74,0,0",,,,,,130,,,,,,,,,,,,,,,,,,,,,,,,,,,,,,,,,,,,28.6,20,6,190,66,,1014,1,339,0,3,3,,1,0,I1.000|4:50-I1.000|4:48-I1.000|4:37-I1.000|4:40-I1.000|4:30-I1.000|4:37-I1.000|4:40-I1.000|4:39-I1.000|4:47-I1.000|5:30-I0.006|0:02,,,,,3113,"firmware 2.40",250,0,,0,168070,250480,30378,,,,,,,,,,,,,,,,,,,,,,,,,,,,,,,,,,,,,,,,,,,
7859081,1e44ad87-637b-4787-87b0-240d98138425,1559671812,120,1559669884,,0,0,14.75,3746,4311,33,34,,,1,0,0.08,,,,862,165,179,,,,61.11,50,61.28,1,59.17,3168,,,4.6,,100,97,,,,,,129,82,14.18,14.41,14.41,9.8,,,,,,,,,,,,,,,,"0,0,1,3,21,50,24,1,0","0,2,20,77,0",,,,,,144,,,,,,,,,,,,,,,,,,,,,,,,,,,,,,,,,,,,92.4,33,3,20,39,,1007,1,333,0,3,3,,1,0,I1.000|4:23-I1.000|4:09-I1.000|4:09-I1.000|3:58-I1.000|3:53-I1.000|4:08-I1.000|4:03-I1.000|3:59-I1.000|4:14-I1.000|4:12-I1.000|4:24-I1.000|4:49-I1.000|4:43-I0.597|2:41-I0.099|0:18-I0.106|0:31-I0.098|0:20-I0.110|0:33-I0.094|0:19-I0.104|0:32-I0.097|0:19-I0.107|0:32-I0.092|0:19-I0.208|0:50-I0.033|0:09,,,,,3113,"firmware 2.40",250,0,,0,168070,250480,30378,,,,,,,,,,,,,,,,,,,,,,,,,,,,,,,,,,,,,,,,,,,
7865506,b035fd95-1f80-47d0-a886-f9a6ef8fd8d4,1559721445,120,1559715905,,0,0,10.56,1510,1510,28,37,,,1,0,0.13,,,,242,128,147,,,,,,,1,59.17,2388,,,2,,,100,,,,,,20,,,25.98,,4.5,-87.3,169,150,,1,326,319,,,,,,,,,"6,5,18,66,5,0,0","6,81,13,0,0","69,23,1,1,5",,,,,,,,,,,,,,,,,,,,,,,,,,,,,,,,,,,,,,,,,15.4,22,11,254,62,,1008,1,333,0,5,3,,1,0,I5.000|11:54-I5.000|11:53-I0.558|1:23,,,,,3113,"firmware 2.40",250,0,,0,168072,,30378,,,,,,,,,,,,,,,,,,,,,,,,,,,,,,,,,,,,,,,,,,,
7870800,3bed3335-1ebe-4f9b-b8e7-0abb9b897ab2,1559752727,120,1559749027,,0,0,10.49,3073,3288,60,59,,,1,0,0.06,,,,646,153,177,,,,57.07,41.28,57.48,1,58.97,4380,,,3.4,,97,100,,,,,,79,79,12.32,12.89,12.87,5.1,,,,,,,,,,,,,,,,"2,4,7,28,46,9,2,3,0","0,6,81,13,0",,,,,,130,,,,,,,,,,,,,,,,,,,,,,,,,,,,,,,,,,,,58.3,29,12,16,34,,1004,3,335,0,5,3,,1,0,I1.000|5:11-I1.000|4:43-I1.000|4:45-I1.000|4:44-I1.000|4:55-I1.000|4:52-I1.000|4:50-I1.000|4:47-I0.285|1:37-I0.140|0:41-I0.031|0:13-I0.141|0:27-I0.028|0:09-I0.144|0:46-I0.022|0:09-I0.139|0:25-I0.027|0:11-I0.141|0:44-I0.016|0:07-I0.128|0:25-I0.027|0:08-I0.128|0:46-I0.019|0:07-I0.122|0:26-I0.031|0:11-I0.130|0:47-I0.023|0:08-I0.128|0:24-I0.031|0:09-I0.130|0:50-I0.025|0:10-I0.122|0:25-I0.335|2:00,,,,,3113,"firmware 2.40",250,0,,0,168070,250480,30378,,,,,,,,,,,,,,,,,,,,,,,,,,,,,,,,,,,,,,,,,,,
7871303,3ca1d574-b33d-417f-8ae1-3d7377869bc6,1559757553,120,1559752083,,0,0,10.67,1636,1636,44,34,,,1,0,0.08,,,,263,129,148,,,,,,,1,58.97,4328,,,2.1,,,100,,,,,,22,,,24.06,,-1.8,-22.1,113,102,,1,263,256,,,,,,,,,"5,8,37,51,0,0,0","0,90,10,0,0","88,6,1,1,4",,,,,,,,,,,,,,,,,,,,,,,,,,,,,,,,,,,,,,,,,17.4,30,8,21,37,,1003,2,334,0,5,3,,1,0,I5.000|13:21-I5.000|11:47-I0.672|2:08,,,,,3113,"firmware 2.40",250,0,,0,168072,,30378,,,,,,,,,,,,,,,,,,,,,,,,,,,,,,,,,,,,,,,,,,,
7896055,e619aad7-3ab0-4f7f-afff-0885fea926ea,1559924945,120,1559923748,,0,0,13.13,3933,4495,340,340,,,1,4,0.86,1.05,1.2,450,736,148,166,,,,58.07,40.91,59.93,1,58.46,2282,,,3.5,,95,100,,,,,,91,80,12.73,12.85,12.99,-12.4,,,,,,,,,,,,,,,,"9,6,24,23,9,15,11,2,0","0,24,70,5,0",,,,,,125,,,,,,,,,,,,,,,,,,,,,,,,,,,,,,,,,,,,46.1,27,19,95,48,,1008,4,340,0,3,3,,1,0,I1.000|6:18-I1.000|5:23-I1.000|5:12-I1.000|5:42-I1.000|5:42-I1.000|5:42-I1.000|5:46-I1.000|5:02-I1.000|4:07-I1.000|4:06-I1.000|4:04-I1.000|3:55-I1.000|4:06-I0.125|0:30,,,,,3113,"firmware 2.40",250,0,,0,168070,250480,30378,,,,,,,,,,,,,,,,,,,,,,,,,,,,,,,,,,,,,,,,,,3,
7911528,8bf622ee-5a25-4924-a28b-89800bde2b60,1560023303,120,1560017463,,0,0,4.83,1248,1248,71,71,,,1,1.5,0.57,0.92,1.02,282,268,152,172,,,,67.25,45.58,68.47,1,59.75,1222,,,2.9,,102,104,,,,,,32,81,14.2,14.83,14.57,-6.8,,,,,,,,,,,,,,,,"2,2,2,13,36,12,22,12,0","1,8,75,16,0",,,,,,143,,,,,,,,,,,,,,,,,,,,,,,,,,,,,,,,,,,,47.3,14,21,227,68,,1022,0,378,0,3,3,,1,0,I1.000|4:44-I1.000|4:44-I1.000|4:46-I1.000|3:36-I0.834|2:58,,,,,3113,"firmware 2.50",250,0,,0,168070,250480,30378,,,,,,,,,,,,,,,,,,,,,,,,,,,,,,,,,,,,,,,,,,5,
7916941,e8025505-7e9f-464d-bd55-8d2ab5a28883,1560064379,120,1560066844,,0,0,30.02,8194,9461,706,706,,,1,4.3,0.67,1.02,0.98,492,1585,152,169,,,,62.84,48.6,64.67,1,60.22,2736,,,4.2,,98,101,,,,,,207,82,13.39,13.38,13.54,1.2,,,,,,,,,,,,,,,,"3,1,3,14,22,53,5,0,0","0,10,76,14,0",,,,,,134,,,,,,,,,,,,,,,,,,,,,,,,,,,,,,,,,,,,52.9,11,10,169,84,,1025,0,355,0,5,3,,1,0,I1.000|5:41-I1.000|5:00-I1.000|4:41-I1.000|5:11-I1.000|4:47-I1.000|4:42-I1.000|5:00-I1.000|4:16-I1.000|4:26-I1.000|4:22-I1.000|4:22-I1.000|4:25-I1.000|4:20-I1.000|4:15-I1.000|4:30-I1.000|4:17-I1.000|4:18-I1.000|4:14-I1.000|4:17-I1.000|4:23-I1.000|4:16-I1.000|4:16-I1.000|4:48-I1.000|4:07-I1.000|4:44-I1.000|4:17-I1.000|4:06-I1.000|5:47-I1.000|4:26-I1.000|4:16-I0.022|0:06,,,,,3113,"firmware 2.50",250,0,,0,168070,250480,30378,,,,,,,,,,,,,,,,,,,,,,,,,,,,,,,,,,,,,,,,,,"4,4,4,5,5,5,5,5,5,5",
7942583,df6b0e66-cd8e-46a8-ad07-933299145d92,1560192349,120,1560187262,,0,0,5.98,1882,2035,17,16,,,1,0,0.06,,,,351,139,151,,,,59.23,36.58,59.45,1,60.13,1207,,,2.5,,,101,,,,,,34,77,11.55,11.58,11.58,4.3,,,,,,,,,,,,,,,,"6,1,7,38,49,0,0,0,0","1,32,67,0,0",,,,,,124,,,,,,,,,,,,,,,,,,,,,,,,,,,,,,,,,,,,22,19,13,189,85,,1011,1,319,0,6,3,,1,0,I1.000|5:03-I1.000|5:01-I1.000|5:05-I1.000|4:57-I1.000|5:13-I0.980|6:03,,,,,3113,"firmware 2.50",250,0,,0,168070,250480,30378,,,,,,,,,,,,,,,,,,,,,,,,,,,,,,,,,,,,,,,,,,,
7953122,74e701af-e35d-43d7-8e06-bc97979aeaff,1560276647,120,1560274384,,0,0,16.91,4366,4414,59,60,,,1,0,0.06,,,,926,159,180,,,,63.2,49.58,63.47,1,60.17,2945,,,4.5,,100,100,,,,,,134,83,13.94,14.84,14.9,11.8,,,,,,,,,,,,,,,,"5,2,6,2,12,32,33,7,0","0,19,18,63,0",,,,,,140,,,,,,,,,,,,,,,,,,,,,,,,,,,,,,,,,,,,85.1,22,6,359,60,,1010,2,333,0,6,3,,1,0,I1.000|4:31-I1.000|4:33-I1.000|4:05-I1.000|3:50-I1.000|4:08-I1.000|3:47-I1.000|4:03-I1.000|3:46-I1.000|4:10-I1.000|3:41-I1.000|4:23-I1.000|3:42-I0.604|4:16-I1.000|3:33-I1.000|4:23-I1.000|3:38-I1.000|6:26-I0.302|1:50,,,,,3113,"firmware 2.50",250,0,,0,168070,250480,30378,,,,,,,,,,,,,,,,,,,,,,,,,,,,,,,,,,,,,,,,,,,
7967563,285f740e-01ae-4465-8f23-9a66b89aae58,1560357205,120,1560352814,,0,0,7.87,2277,2550,36,36,,,1,0,0.16,,,,445,142,150,,,,63.97,41.08,64.33,1,60.65,1454,,,2.7,,101,102,,,,,,43,79,12.48,12.5,12.53,0.5,,,,,,,,,,,,,,,,"0,0,1,24,65,10,0,0,0","0,29,70,0,0",,,,,,131,,,,,,,,,,,,,,,,,,,,,,,,,,,,,,,,,,,,26.6,20,12,231,55,,1012,3,347,0,5,3,,1,0,I1.000|5:07-I1.000|4:51-I1.000|4:45-I1.000|4:40-I1.000|4:51-I1.000|4:52-I1.000|4:46-I0.874|4:05,,,,,3113,"firmware 2.50",250,0,,0,168070,250480,30378,,,,,,,,,,,,,,,,,,,,,,,,,,,,,,,,,,,,,,,,,,,
7978871,c69eac88-bcd8-4036-aebf-6b621b10bb4b,1560449426,120,1560446105,,0,0,11.55,2987,2987,66,68,,,1,0,0.13,,,,638,151,173,,,,67.78,48.07,68.25,1,60.17,1914,,,3.7,,101,99,,,,,,78,82,13.93,14.04,14.06,15.3,,,,,,,,,,,,,,,,"0,0,1,2,20,62,15,0,0","0,35,7,58,0",,,,,,141,,,,,,,,,,,,,,,,,,,,,,,,,,,,,,,,,,,,66.6,26,9,215,37,,1015,2,348,0,3,3,,1,0,I1.000|4:38-I1.000|4:26-I1.000|4:19-I1.000|4:13-I1.000|4:26-I1.000|4:02-I1.000|3:59-I1.000|4:18-I1.000|4:16-I1.000|4:23-I1.000|4:25-I0.547|2:21,,,,,3113,"firmware 2.50",250,0,,0,168070,250480,30378,,,,,,,,,,,,,,,,,,,,,,,,,,,,,,,,,,,,,,,,,,,
7990103,ef5b66e1-dd20-49bf-9586-b48fc8223a10,1560524706,120,1560522304,,0,0,15.02,3998,4651,46,45,,,1,0,0.01,,,,911,161,179,,,,59.78,47.42,60.01,1,59.4,3707,,,4.4,,100,96,,,,,,126,79,13.52,13.57,13.58,4.4,,,,,,,,,,,,,,,,"0,0,1,3,33,59,4,0,0","0,12,18,70,0",,,,,,143,,,,,,,,,,,,,,,,,,,,,,,,,,,,,,,,,,,,75.3,20,9,260,72,,1014,4,306,0,4,3,,1,0,I1.000|4:48-I1.000|4:32-I1.000|4:38-I1.000|4:28-I1.000|4:21-I1.000|4:25-I1.000|4:21-I1.000|4:24-I1.000|4:18-I1.000|4:31-I1.000|4:16-I1.000|4:20-I1.000|4:29-I1.000|4:19-I1.000|4:25-I0.016|0:04,,,,,3113,"firmware 2.50",250,0,,0,168070,250480,30378,,,,,,,,,,,,,,,,,,,,,,,,,,,,,,,,,,,,,,,,,,,
7999694,07ad9bb4-4078-4e6c-95f2-578049753c12,1560615711,120,1560609088,,0,0,1.28,403,403,4,2,,,1,0,0.02,,,,84,145,151,,,,56.1,32.13,56.42,1,59.32,1930,,,1.6,,97,97,,,,,,8,80,11.54,11.49,11.58,2.5,,,,,,,,,,,,,,,,"0,0,19,70,11,0,0,0,0","0,12,88,0,0",,,,,,119,,,,,,,,,,,,,,,,,,,,,,,,,,,,,,,,,,,,18.7,23,12,321,56,,1015,4,327,0,5,3,,1,0,I1.000|5:16-I0.282|1:27,,,,,3113,"firmware 2.50",250,0,,0,168070,250480,30378,,,,,,,,,,,,,,,,,,,,,,,,,,,,,,,,,,,,,,,,,,,
7999701,b019769e-6004-4bb4-96b6-7a62f225ef6d,1560614636,120,1560609093,,0,0,1.12,496,514,0,1,,,1,0,0.09,,,,86,136,170,,,,39.91,21.34,39.87,1,59.49,1945,,,1.3,,,100,,,,,,9,67,8,16,16.09,51.4,,,,,,,,,,,,,,,,"71,0,0,1,1,0,2,14,10","0,58,26,16,0",,,,,,101,,,,,,,,,,,,,,,,,,,,,,,,,,,,,,,,,,,,16.7,23,12,321,56,,1015,4,327,0,5,3,,1,0,I0.508|1:32-I0.346|4:35-I0.210|0:39-I0.058|1:30,,,,,3113,"firmware 2.50",250,0,,0,168070,250480,30378,,,,,,,,,,,,,,,,,,,,,,,,,,,,,,,,,,,,,,,,,,,
7999704,a97efc5d-b6ba-4cf9-8059-622b03f1334f,1560612175,120,1560609094,,0,0,4.43,1256,1265,32,33,,,1,0,0.19,,,,269,148,160,,,,62.15,40.65,62.69,1,59.49,1957,,,2.7,,101,101,,,,,,28,80,12.66,12.7,12.72,1.4,,,,,,,,,,,,,,,,"0,0,3,13,63,21,0,0,0","0,4,96,0,0",,,,,,132,,,,,,,,,,,,,,,,,,,,,,,,,,,,,,,,,,,,32.7,23,14,204,59,,1015,6,328,0,5,3,,1,0,I1.000|4:55-I1.000|4:39-I1.000|4:43-I1.000|4:38-I0.425|2:00,,,,,3113,"firmware 2.50",250,0,,0,168070,250480,30378,,,,,,,,,,,,,,,,,,,,,,,,,,,,,,,,,,,,,,,,,,,
8012820,ec75e9a5-d371-438d-ae3c-97c8614af7dc,1560689491,120,1560686488,,0,0,15.01,3804,3863,37,42,,,1,0,0.03,,,,887,163,178,,,,62.38,50.19,62.55,1,59.76,4320,,,4.6,,102,99,,,,,,126,82,14.2,14.29,14.28,5.3,,,,,,,,,,,,,,,,"0,0,0,1,15,65,19,0,0","1,3,27,70,0",,,,,,144,,,,,,,,,,,,,,,,,,,,,,,,,,,,,,,,,,,,85.6,19,9,209,69,,1022,6,334,0,5,3,,1,0,I1.000|4:37-I1.000|4:24-I1.000|4:21-I1.000|4:28-I1.000|4:07-I1.000|4:11-I1.000|4:07-I1.000|4:08-I1.000|4:08-I1.000|4:11-I1.000|4:09-I1.000|4:08-I1.000|4:08-I1.000|4:16-I1.000|3:58-I0.007|0:01,,,,,3113,"firmware 2.50",250,0,,0,168070,250480,30378,,,,,,,,,,,,,,,,,,,,,,,,,,,,,,,,,,,,,,,,,,,
8029201,b050e51b-fec9-4d93-afd0-056c254412a8,1560792568,120,1560791105,,0,0,12.34,3938,5647,48,41,,,1,0,0.1,,,,677,139,179,,,,58.22,37.81,58.54,1,59.9,2016,,,2.8,,105,99,,,,,,72,80,11.31,11.67,11.74,11.8,,,,,,,,,,,,,,,,"8,8,19,36,19,7,2,0,0","0,63,34,3,0",,,,,,118,,,,,,,,,,,,,,,,,,,,,,,,,,,,,,,,,,,,33.6,26,12,63,50,,1017,3,331,0,3,3,,1,0,I1.000|4:39-I1.000|4:35-I1.000|5:22-I1.000|5:17-I1.000|5:05-I1.000|4:58-I0.485|2:35-I1.000|5:18-I1.000|6:34-I1.000|5:38-I1.000|5:54-I1.000|5:00-I0.856|4:44,,,,,3113,"firmware 2.50",250,0,,0,168070,250480,30378,,,,,,,,,,,,,,,,,,,,,,,,,,,,,,,,,,,,,,,,,,,
8060613,70deea36-dd6b-442f-8ba8-f62b0de6010e,1560944544,120,1560957009,,0,0,7.88,2464,2522,184,183,,,1,2.7,0.95,0.99,1.01,471,477,145,162,,,,56.57,37.49,58.22,1,59.46,1443,,,2.9,,97,98,,,,,,51,80,11.93,11.74,12.07,3.1,,,,,,,,,,,,,,,,"7,6,22,24,38,4,0,0,0","0,36,62,1,0",,,,,,120,,,,,,,,,,,,,,,,,,,,,,,,,,,,,,,,,,,,33.9,26,15,207,46,,1010,7,316,0,3,3,,1,0,I1.000|5:56-I1.000|4:46-I1.000|5:00-I1.000|5:31-I1.000|5:09-I1.000|4:47-I1.000|5:42-I0.876|4:13,,,,,3113,"firmware 2.50",250,0,,0,168070,250480,30378,,,,,,,,,,,,,,,,,,,,,,,,,,,,,,,,,,,,,,,,,,"5,5",
8081553,0dcae02f-1894-464d-a94d-ae4f4a0c7444,1561052054,120,1561047303,,0,0,8.07,2267,2284,181,179,,,1,2.7,0.79,0.99,1.06,504,447,146,164,,,,64,42.6,65.8,1,59.83,1164,,,3,,100,102,,,,,,50,81,13.3,13.27,13.53,1.8,,,,,,,,,,,,,,,,"7,1,4,17,31,27,12,0,0","1,32,58,9,0",,,,,,132,,,,,,,,,,,,,,,,,,,,,,,,,,,,,,,,,,,,41.5,21,22,237,65,,1013,2,338,0,6,3,,1,0,I1.000|5:55-I1.000|4:25-I1.000|4:18-I1.000|4:53-I1.000|4:35-I1.000|4:13-I1.000|4:50-I1.000|4:20-I0.069|0:19,,,,,3113,"firmware 2.50",250,0,,0,168070,250480,30378,,,,,,,,,,,,,,,,,,,,,,,,,,,,,,,,,,,,,,,,,,"5,5",
8094847,749a3cee-57c7-41eb-9c78-555f4ef8ff9c,1561125971,120,1561122724,,0,0,13.25,3701,3834,349,349,,,1,4,0.8,1.02,1.13,474,756,151,168,,,,61.62,44.4,63.63,1,59.85,1454,,,3.5,,99,100,,,,,,92,82,13.66,14.07,13.99,-7.8,,,,,,,,,,,,,,,,"5,5,18,22,16,7,18,9,0","0,9,84,7,0",,,,,,131,,,,,,,,,,,,,,,,,,,,,,,,,,,,,,,,,,,,45.4,21,10,288,45,,1019,6,335,0,5,3,,1,0,I1.000|5:56-I1.000|5:01-I1.000|4:47-I1.000|5:17-I1.000|5:34-I1.000|5:16-I1.000|5:38-I0.873|4:13-I1.000|3:43-I1.000|3:43-I1.000|3:40-I1.000|3:35-I1.000|3:32-I0.378|1:45,,,,,3113,"firmware 2.50",250,0,,0,168070,250480,30378,,,,,,,,,,,,,,,,,,,,,,,,,,,,,,,,,,,,,,,,,,3,
8112376,b18cb84e-9409-4b13-9a84-a115823e5d05,1561222492,120,1561220284,,0,0,14.77,4579,4819,223,223,,,1,2.3,0.53,1,1.16,475,888,152,182,,,,53.69,39.67,54.7,1,59.61,2079,,,3.7,,97,100,,,,,,118,81,11.9,13.11,13.25,14.8,,,,,,,,,,,,,,,,"21,6,11,15,19,8,11,8,0","0,27,41,31,0",,,,,,119,,,,,,,,,,,,,,,,,,,,,,,,,,,,,,,,,,,,69.1,25,19,43,48,,1017,3,331,0,5,3,,1,0,I1.000|6:19-I1.000|4:38-I1.000|4:47-I1.000|5:18-I1.000|5:00-I1.000|4:39-I0.348|1:57-I0.407|1:22-I0.204|1:06-I0.399|1:28-I0.148|1:01-I0.403|1:25-I0.170|1:08-I0.396|1:29-I0.266|2:15-I0.400|1:22-I0.149|1:10-I0.396|1:28-I0.078|0:47-I0.401|1:21-I0.093|1:01-I0.401|1:30-I0.166|1:53-I0.399|1:22-I0.105|1:01-I0.399|1:28-I0.062|1:00-I0.398|1:22-I0.096|1:35-I0.399|1:22-I1.000|7:12-I1.000|5:06-I0.084|0:26,,,,,3113,"firmware 2.50",250,0,,0,168070,250480,30378,,,,,,,,,,,,,,,,,,,,,,,,,,,,,,,,,,,,,,,,,,"5,5",
8127952,ffd1349a-a5dc-4083-a232-f989f2aea1f4,1561319421,120,1561316284,,0,0,13.16,3614,3911,344,344,,,1,3.8,0.73,0.98,1.12,470,757,153,176,,,,61.81,45.26,63.81,1,59.15,1923,,,3.5,,98,100,,,,,,92,82,13.96,15.33,14.86,-13.8,,,,,,,,,,,,,,,,"7,5,19,23,15,4,6,19,3","0,12,71,16,0",,,,,,133,,,,,,,,,,,,,,,,,,,,,,,,,,,,,,,,,,,,59.9,25,16,84,55,,1018,0,330,0,3,3,,1,0,I1.000|6:09-I1.000|5:00-I1.000|4:53-I1.000|5:42-I1.000|5:42-I1.000|5:16-I1.000|5:24-I0.774|3:49-I1.000|3:12-I1.000|3:11-I1.000|3:16-I1.000|3:16-I1.000|3:26-I0.385|1:58,,,,,3113,"firmware 2.50",250,0,,0,168070,250480,30378,,,,,,,,,,,,,,,,,,,,,,,,,,,,,,,,,,,,,,,,,,3,
8140564,67729a36-f8a3-4886-81b1-32cfc711577c,1561392565,120,1561388652,,0,0,9.78,3004,3077,245,245,,,1,3.1,0.79,1.02,0.99,499,605,148,170,,,,56.3,38.86,58.04,1,58.48,1703,,,3.4,,100,99,,,,,,71,80,12.2,12.02,12.33,7,,,,,,,,,,,,,,,,"10,3,16,29,30,12,1,0,0","1,22,54,23,0",,,,,,122,,,,,,,,,,,,,,,,,,,,,,,,,,,,,,,,,,,,51.3,29,20,109,44,,1019,5,321,0,5,3,,1,0,I1.000|6:09-I1.000|4:41-I1.000|5:08-I1.000|5:24-I1.000|5:01-I1.000|4:35-I1.000|5:13-I1.000|5:30-I1.000|4:42-I0.780|3:40,,,,,3113,"firmware 2.50",250,0,,0,168070,250480,30378,,,,,,,,,,,,,,,,,,,,,,,,,,,,,,,,,,,,,,,,,,"4,4,5",
8154260,389c8df2-a810-4a3f-87fa-bc0bd6f68bcc,1561465742,120,1561463585,,0,0,11.96,3474,4871,224,223,,,1,2.4,0.52,0.94,0.98,807,713,155,176,,,,56.64,42.1,57.96,1,58.87,1728,,,3.5,,105,96,,,,,,96,81,12.73,12.79,12.98,10.2,,,,,,,,,,,,,,,,"6,5,10,19,34,16,10,1,0","0,9,47,44,0",,,,,,128,,,,,,,,,,,,,,,,,,,,,,,,,,,,,,,,,,,,63.8,28,12,137,51,,1020,8,313,0,3,3,,1,0,I1.000|3:59-I1.000|3:52-I1.000|4:39-I1.000|4:38-I1.000|5:34-I1.000|6:11-I1.000|5:00-I1.000|5:16-I1.000|4:50-I1.000|4:34-I1.000|4:53-I0.959|4:29,,,,,3113,"firmware 2.50",250,0,,0,168070,250480,30378,,,,,,,,,,,,,,,,,,,,,,,,,,,,,,,,,,,,,,,,,,4,
8186344,734b2b68-223e-4f8c-9bb0-90929a76eb05,1561569255,120,1561566543,,0,0,14.32,3838,4029,79,78,,,1,0,0.13,,,,899,166,178,,,,56.67,46.86,57.06,1,58.42,3744,,,4.7,,103,97,,,,,,134,80,13.42,13.53,13.56,11.5,,,,,,,,,,,,,,,,"0,0,0,5,39,51,4,0,0","0,1,20,79,0",,,,,,140,,,,,,,,,,,,,,,,,,,,,,,,,,,,,,,,,,,,91.9,34,8,15,38,,1021,4,310,0,3,3,,1,0,I1.000|4:26-I1.000|4:24-I1.000|4:13-I1.000|4:19-I1.000|4:18-I1.000|4:25-I1.000|4:24-I1.000|4:39-I1.000|4:28-I1.000|4:18-I1.000|4:34-I1.000|4:39-I1.000|4:41-I1.000|4:37-I0.320|1:33,,,,,3113,"firmware 2.50",250,0,,0,168070,250480,30378,,,,,,,,,,,,,,,,,,,,,,,,,,,,,,,,,,,,,,,,,,,
8205896,ab40171d-ef51-415d-9809-0efee855818b,1561658929,120,1561656485,,0,0,13.65,3425,3968,59,61,,,1,0,0.1,,,,747,159,181,,,,65.47,50.4,65.81,1,59.31,4032,,,4,,103,103,,,,,,103,83,14.35,14.79,14.8,2.8,,,,,,,,,,,,,,,,"0,0,0,4,17,53,22,3,0","0,10,33,57,0",,,,,,144,,,,,,,,,,,,,,,,,,,,,,,,,,,,,,,,,,,,73.8,31,21,11,34,,1022,2,303,0,3,3,,1,0,I1.000|4:26-I1.000|4:34-I1.000|4:29-I1.000|4:11-I1.000|4:06-I1.000|4:04-I1.000|3:55-I1.000|4:13-I1.000|4:06-I1.000|4:06-I1.000|4:06-I0.853|3:46-I0.192|0:37-I0.199|0:59-I0.191|0:36-I0.206|0:57-I0.192|0:35-I0.209|0:56-I0.194|0:37-I0.202|1:03-I0.199|0:39-I0.015|0:03,,,,,3113,"firmware 2.50",250,0,,0,168070,250480,30378,,,,,,,,,,,,,,,,,,,,,,,,,,,,,,,,,,,,,,,,,,,
8235047,5549c2f5-ce3f-446a-b913-4dab6fcc6a62,1561750366,120,1561747023,,0,0,10.24,2924,3376,38,37,,,1,0,0.05,,,,584,146,158,,,,62.72,42.46,63.02,1,59.41,2519,,,3.1,,100,100,,,,,,63,79,12.61,12.69,12.69,6.3,,,,,,,,,,,,,,,,"0,1,2,14,73,11,0,0,0","0,14,85,0,0",,,,,,133,,,,,,,,,,,,,,,,,,,,,,,,,,,,,,,,,,,,32.2,27,13,7,45,,1021,1,312,0,3,3,,1,0,I1.000|4:43-I1.000|4:39-I1.000|4:40-I1.000|4:40-I1.000|4:50-I1.000|4:44-I1.000|4:45-I1.000|4:49-I1.000|4:56-I1.000|4:47-I0.238|1:13,,,,,3113,"firmware 2.50",250,0,,0,168070,250480,30378,,,,,,,,,,,,,,,,,,,,,,,,,,,,,,,,,,,,,,,,,,,
8259290,e27c2a4b-2daf-4abe-ac04-b8b7476ea80c,1561875671,120,1561872910,,0,0,16,4099,4304,14,15,,,1,0,0,,,,889,158,192,,,,64.39,49.81,64.45,1,60.37,2592,,,4.1,,102,100,,,,,,120,82,14.06,14.17,14.18,6.4,,,,,,,,,,,,,,,,"0,0,1,6,9,73,12,0,0","0,3,52,42,2",,,,,,143,,,,,,,,,,,,,,,,,,,,,,,,,,,,,,,,,,,,82.9,19,7,173,64,,1010,0,306,0,5,3,,1,0,I1.000|4:20-I1.000|4:24-I1.000|4:21-I1.000|4:15-I1.000|4:07-I1.000|4:07-I0.557|2:14-I0.465|1:55-I1.000|4:06-I1.000|4:04-I1.000|4:09-I1.000|4:14-I1.000|4:13-I1.000|4:18-I1.000|4:16-I1.000|4:15-I0.977|5:01,,,,,3113,"firmware 2.50",250,0,,0,168070,250480,30378,,,,,,,,,,,,,,,,,,,,,,,,,,,,,,,,,,,,,,,,,,,
8288109,bc60000b-25d3-4b4d-82bd-79072a8a842d,1562005255,120,1562003352,,0,0,12.04,3528,4096,31,30,,,1,0,0.1,,,,692,147,166,,,,60.21,41.69,60.4,1,60.26,1607,,,3.1,,102,97,,,,,,78,80,12.3,12.51,12.53,6.5,,,,,,,,,,,,,,,,"0,0,5,46,34,13,3,0,0","0,7,85,8,0",,,,,,128,,,,,,,,,,,,,,,,,,,,,,,,,,,,,,,,,,,,41.6,28,7,206,31,,1017,1,311,0,5,3,,1,0,I1.000|4:05-I1.000|4:05-I1.000|4:57-I1.000|4:57-I1.000|4:58-I1.000|5:01-I1.000|5:08-I1.000|5:08-I1.000|5:05-I1.000|5:09-I1.000|5:03-I1.000|5:01-I0.035|0:11,,,,,3113,"firmware 2.50",250,0,,0,168070,250480,30378,,,,,,,,,,,,,,,,,,,,,,,,,,,,,,,,,,,,,,,,,,,
8301404,6740be52-b168-48dd-b389-2e64e938923c,1562087519,120,1562082487,,0,0,6.05,1773,2025,29,27,,,1,0,0.11,,,,300,132,151,,,,68.9,39.83,69.34,1,60.24,804,,,2.1,,100,99,,,,,,26,79,12.29,12.38,12.41,-0.1,,,,,,,,,,,,,,,,"0,0,8,29,51,11,0,0,0","1,94,5,0,0",,,,,,130,,,,,,,,,,,,,,,,,,,,,,,,,,,,,,,,,,,,15.8,26,20,2,33,,1019,4,324,0,3,3,,1,0,I1.000|5:06-I1.000|5:00-I1.000|4:42-I1.000|4:31-I1.000|4:54-I1.000|5:03-I0.053|0:16,,,,,3113,"firmware 2.50",250,0,,0,168070,250480,30378,,,,,,,,,,,,,,,,,,,,,,,,,,,,,,,,,,,,,,,,,,,
8308488,403621a5-80e5-4db9-a01e-cc2fc4941c27,1562137260,120,1562133068,,0,0,9.31,2861,2890,22,21,,,1,0,0.04,,,,561,144,169,,,,58.32,38.7,58.5,1,60.17,1300,,,3.1,,99,97,,,,,,59,81,11.73,11.76,11.79,8.4,,,,,,,,,,,,,,,,"1,1,8,62,26,1,0,0,0","1,34,62,3,0",,,,,,121,,,,,,,,,,,,,,,,,,,,,,,,,,,,,,,,,,,,38.6,16,21,38,65,,1021,0,321,0,3,3,,1,0,I1.000|5:16-I1.000|4:56-I1.000|5:08-I1.000|5:07-I1.000|5:00-I1.000|5:22-I1.000|5:05-I1.000|5:06-I1.000|5:03-I0.312|1:38,,,,,3113,"firmware 2.50",250,0,,0,168070,250480,30378,,,,,,,,,,,,,,,,,,,,,,,,,,,,,,,,,,,,,,,,,,,
8327785,28a32d00-6a76-4a01-be33-572d81d1530a,1562236741,120,1562234647,,0,0,14.92,4295,4774,63,61,,,1,0,0.05,,,,854,150,164,,,,59.9,43.28,60.23,1,60.29,1474,,,3.4,,100,100,,,,,,100,81,12.53,12.7,12.76,-4.9,,,,,,,,,,,,,,,,"5,3,5,18,41,26,4,0,0","0,8,92,1,0",,,,,,129,,,,,,,,,,,,,,,,,,,,,,,,,,,,,,,,,,,,37.2,21,22,30,44,,1023,5,329,0,3,3,,1,0,I1.000|4:38-I1.000|4:35-I1.000|5:20-I1.000|5:19-I1.000|4:56-I1.000|5:03-I0.620|2:47-I0.432|1:53-I1.000|4:40-I1.000|4:45-I1.000|4:45-I1.000|4:31-I1.000|4:53-I1.000|4:58-I1.000|4:39-I0.865|3:53,,,,,3113,"firmware 2.50",250,0,,0,168070,250480,30378,,,,,,,,,,,,,,,,,,,,,,,,,,,,,,,,,,,,,,,,,,,
8344444,86e02d65-fbb1-4cde-b74f-172f0d03b996,1562307847,120,1562302273,,0,0,5.04,1474,1474,26,26,,,1,0,0.2,,,,279,137,151,,,,66.03,39.5,66.45,1,60.44,874,,,2.3,,100,102,,,,,,25,80,12.33,12.44,12.47,-4.1,,,,,,,,,,,,,,,,"0,4,9,28,37,20,0,0,0","0,60,40,0,0",,,,,,128,,,,,,,,,,,,,,,,,,,,,,,,,,,,,,,,,,,,21.8,17,16,316,61,,1015,0,350,0,4,3,,1,0,I1.000|5:09-I1.000|5:15-I1.000|4:50-I1.000|4:32-I1.000|4:35-I0.041|0:13,,,,,3113,"firmware 2.50",250,0,,0,168070,250480,30378,,,,,,,,,,,,,,,,,,,,,,,,,,,,,,,,,,,,,,,,,,,
8396905,7d64fc5e-e11e-4577-9bb1-025bbb3f6b5d,1562606718,120,1562604124,,0,0,15.15,3777,4121,51,51,,,1,0,0.03,,,,839,161,179,,,,64.82,51.19,65.09,1,60.3,2662,,,4.2,,101,100,,,,,,119,82,14.44,14.68,14.69,6,,,,,,,,,,,,,,,,"0,0,3,7,5,43,41,0,0","0,9,19,71,0",,,,,,147,,,,,,,,,,,,,,,,,,,,,,,,,,,,,,,,,,,,92.7,21,6,352,42,,1017,2,347,0,5,3,,1,0,I1.000|4:30-I1.000|4:15-I1.000|4:07-I1.000|4:05-I1.000|4:04-I1.000|4:01-I1.000|4:00-I1.000|3:59-I1.000|3:58-I1.000|4:03-I1.000|4:03-I1.000|3:53-I1.000|3:54-I1.000|3:53-I1.000|5:22-I0.153|0:50,,,,,3113,"firmware 2.50",250,0,,0,168070,250480,30378,,,,,,,,,,,,,,,,,,,,,,,,,,,,,,,,,,,,,,,,,,,
8415360,dc1c5dae-bb17-4fe9-98b1-c92c852dc76d,1562694320,120,1562693228,,0,0,16.33,4591,5898,46,48,,,1,0,0.01,,,,859,148,169,,,,62.8,44.8,63.01,1,60.33,2375,,,3.7,,100,100,,,,,,106,83,12.78,13.16,13.17,9.7,,,,,,,,,,,,,,,,"1,8,10,9,32,34,7,0,0","1,23,64,13,0",,,,,,129,,,,,,,,,,,,,,,,,,,,,,,,,,,,,,,,,,,,60.8,21,22,26,38,,1018,2,350,0,5,3,,1,0,I1.000|4:35-I1.000|4:33-I1.000|4:32-I1.000|4:33-I1.000|4:23-I1.000|4:28-I1.000|4:26-I1.000|4:09-I1.000|4:00-I1.000|4:01-I1.000|4:27-I1.000|4:51-I1.000|4:58-I1.000|4:58-I1.000|5:38-I1.000|6:05-I0.326|1:53,,,,,3113,"firmware 2.50",250,0,,0,168070,250480,30378,,,,,,,,,,,,,,,,,,,,,,,,,,,,,,,,,,,,,,,,,,,
8455300,c67c8d43-2cdc-4b4e-836a-846f67216fc2,1562867407,120,1562864645,,0,0,12.25,3812,4343,47,47,,,1,0,0.11,,,,628,136,151,,,,61.71,38.92,62,1,59.85,1299,,,2.6,,100,97,,,,,,63,84,11.58,11.81,11.9,-0.2,,,,,,,,,,,,,,,,"1,3,18,56,19,2,0,0,0","0,81,18,0,0",,,,,,115,,,,,,,,,,,,,,,,,,,,,,,,,,,,,,,,,,,,19.9,19,7,245,74,,1015,2,353,0,6,3,,1,0,I1.000|4:50-I1.000|5:03-I1.000|5:32-I1.000|5:18-I1.000|5:24-I1.000|5:10-I1.000|5:17-I1.000|5:10-I1.000|5:16-I1.000|5:15-I1.000|5:20-I1.000|4:45-I0.248|1:11,,,,,3113,"firmware 2.50",250,0,,0,168070,250480,30378,,,,,,,,,,,,,,,,,,,,,,,,,,,,,,,,,,,,,,,,,,,
8467897,84f2aa97-468f-4cf3-9efa-070297a27054,1562945515,120,1562942006,,0,0,10,2976,3352,47,47,,,1,0,0.11,,,,604,148,158,,,,58.54,40.39,58.88,1,59.39,1671,,,3.2,,97,98,,,,,,66,81,12.11,12.19,12.19,-1,,,,,,,,,,,,,,,,"2,3,7,30,50,9,0,0,0","1,6,93,0,0",,,,,,124,,,,,,,,,,,,,,,,,,,,,,,,,,,,,,,,,,,,33.7,23,10,208,65,,1012,5,362,0,6,3,,1,0,I1.000|5:00-I1.000|5:01-I1.000|4:59-I1.000|4:54-I1.000|4:59-I1.000|4:39-I1.000|4:51-I1.000|4:51-I1.000|5:06-I1.000|5:14-I0.003|0:01,,,,,3113,"firmware 2.50",250,0,,0,168070,250480,30378,,,,,,,,,,,,,,,,,,,,,,,,,,,,,,,,,,,,,,,,,,,
8483591,03b4ab4e-e21b-49ae-b6bd-8296c726ff0f,1563039876,120,1563036544,,0,0,13.23,3639,3765,351,351,,,1,3.8,0.78,1.03,1.09,502,730,154,167,,,,61.13,45.2,63.14,1,59.22,2007,,,3.7,,101,99,,,,,,96,82,13.79,13.66,13.95,-5.8,,,,,,,,,,,,,,,,"2,3,6,26,20,20,21,1,0","0,8,58,34,0",,,,,,133,,,,,,,,,,,,,,,,,,,,,,,,,,,,,,,,,,,,58,17,12,258,95,,1016,2,350,0,5,3,,1,0,I1.000|5:27-I1.000|4:40-I1.000|4:37-I1.000|5:16-I1.000|5:18-I1.000|5:10-I1.000|5:06-I1.000|4:25-I1.000|4:01-I1.000|3:58-I1.000|3:52-I1.000|3:54-I1.000|3:52-I0.225|1:01,,,,,3113,"firmware 2.50",250,0,,0,168070,250480,30378,,,,,,,,,,,,,,,,,,,,,,,,,,,,,,,,,,,,,,,,,,3,
8544044,4d968592-f969-4e6f-96d3-a30f6151475e,1563138791,120,1563298024,,0,0,12.94,3497,3816,113,112,,,1,0.5,0.34,1.06,,,707,151,167,,,,64.19,46.06,64.89,1,60.01,1584,,,3.5,,103,102,,,,,,87,82,13.35,13.51,13.55,5.1,,,,,,,,,,,,,,,,"0,1,4,11,30,46,8,0,0","0,14,68,18,0",,,,,,135,,,,,,,,,,,,,,,,,,,,,,,,,,,,,,,,,,,,53.6,27,9,135,66,,1011,0,310,1,5,3,,1,0,I1.000|4:39-I1.000|4:22-I1.000|4:10-I1.000|4:05-I1.000|4:08-I1.000|4:24-I1.000|4:46-I1.000|4:23-I1.000|4:22-I1.000|4:31-I1.000|4:49-I1.000|5:02-I0.940|4:36,,,,,3113,"firmware 2.50",250,0,,0,168070,250480,30378,,,,,,,,,,,,,,,,,,,,,,,,,,,,,,,,,,,,,,,,,,,
8544047,ec34c353-b6ab-47a6-beb6-3f05643972bc,1563225660,120,1563298027,,0,0,9.95,2787,2994,47,46,,,1,0,0,,,,601,152,170,,,,60.86,43.34,61.22,1,59.79,1730,,,3.5,,101,99,,,,,,70,81,12.88,13.22,13.23,3,,,,,,,,,,,,,,,,"5,3,4,8,30,46,4,1,0","0,11,67,22,0",,,,,,132,,,,,,,,,,,,,,,,,,,,,,,,,,,,,,,,,,,,51.1,27,10,94,73,,1012,0,310,1,5,3,,1,0,I1.000|5:07-I1.000|4:50-I1.000|4:36-I1.000|4:38-I1.000|4:23-I1.000|4:35-I1.000|4:46-I1.000|4:09-I1.000|4:23-I0.950|5:00,,,,,3113,"firmware 2.50",250,0,,0,168070,250480,30378,,,,,,,,,,,,,,,,,,,,,,,,,,,,,,,,,,,,,,,,,,,
8544063,30ffcada-09b1-49b9-9333-bc5cd2683e45,1563298076,120,1563298088,,0,0,13.02,3440,4133,56,55,,,1,0,0.16,,,,742,154,181,,,,64.25,47.31,64.6,1,59.54,2466,,,4,,104,95,,,,,,94,82,13.62,13.71,13.73,13.5,,,,,,,,,,,,,,,,"0,0,1,1,29,65,3,0,0","0,20,27,52,0",,,,,,138,,,,,,,,,,,,,,,,,,,,,,,,,,,,,,,,,,,,68.9,29,25,123,52,,1014,5,300,0,5,3,,1,0,I1.000|4:21-I1.000|4:19-I1.000|4:29-I1.000|4:21-I1.000|4:12-I1.000|4:14-I1.000|4:29-I1.000|4:15-I1.000|4:29-I1.000|4:35-I1.000|4:30-I1.000|4:26-I1.000|4:28-I0.015|0:11,,,,,3113,"firmware 2.50",250,0,,0,168070,250480,30378,,,,,,,,,,,,,,,,,,,,,,,,,,,,,,,,,,,,,,,,,,,
8564743,7ab4f833-abe0-4a04-b006-003df7ccfcab,1563395131,120,1563392104,,0,0,11.01,3067,3956,138,139,,,1,0.7,0.36,1.07,0.79,,608,154,180,,,,60.18,43.94,61.11,1,59.62,1872,,,3.5,,101,103,,,,,,83,82,12.96,13.92,14.06,2.4,,,,,,,,,,,,,,,,"3,3,10,30,19,12,16,7,0","0,18,46,36,0",,,,,,131,,,,,,,,,,,,,,,,,,,,,,,,,,,,,,,,,,,,75.3,27,11,81,65,,1013,0,333,0,5,3,,1,0,I1.000|4:53-I1.000|4:53-I1.000|3:31-I1.000|4:33-I1.000|3:42-I1.000|5:46-I1.000|3:51-I1.000|5:35-I1.000|3:44-I1.000|5:23-I1.000|5:14-I0.005|0:02,,,,,3113,"firmware 2.50",250,0,,0,168070,250480,30378,,,,,,,,,,,,,,,,,,,,,,,,,,,,,,,,,,,,,,,,,,,
8578160,27ff60ac-c004-4595-aee1-3488214e4fec,1563484222,120,1563477611,,0,0,1.16,469,478,4,4,,,1,0,0,,,,86,134,149,,,,45.48,23.84,45.67,1,59.62,445,,,1.2,,,100,,,,,,7,79,8.84,10.26,10.41,20.4,,,,,,,,,,,,,,,,"41,12,18,20,1,5,2,0,0","1,69,30,0,0",,,,,,94,,,,,,,,,,,,,,,,,,,,,,,,,,,,,,,,,,,,12.7,27,11,69,60,,1014,0,319,0,5,3,,1,0,I1.000|5:53-I0.158|1:57,,,,,3113,"firmware 2.50",250,0,,0,168070,250480,30378,,,,,,,,,,,,,,,,,,,,,,,,,,,,,,,,,,,,,,,,,,,
8580839,5545c599-4af7-4591-a5d6-86bfceb7e2c2,1563522891,120,1563519305,,0,0,11.21,3338,3440,114,115,,,1,0.6,0.34,,,,677,148,173,,,,58.5,40.7,59.23,1,59.38,1659,,,3.4,,99,98,,,,,,75,81,12.09,12.37,12.44,3.9,,,,,,,,,,,,,,,,"1,3,7,44,36,3,5,0,0","0,23,65,12,0",,,,,,124,,,,,,,,,,,,,,,,,,,,,,,,,,,,,,,,,,,,55.1,23,6,340,67,,1016,0,318,0,5,3,,1,0,I1.000|5:17-I1.000|4:52-I1.000|5:03-I1.000|5:05-I1.000|5:15-I0.885|4:20-I0.280|1:01-I0.189|1:01-I0.259|1:00-I0.188|1:00-I0.264|1:01-I0.210|1:03-I0.273|1:08-I1.000|5:11-I1.000|5:12-I1.000|4:57-I0.660|3:13,,,,,3113,"firmware 2.50",250,0,,0,168070,250480,30378,,,,,,,,,,,,,,,,,,,,,,,,,,,,,,,,,,,,,,,,,,,
8594932,2c09f5b0-3928-4ba8-b27b-c8750b8fc01f,1563627149,120,1563623653,,0,0,10.66,2913,3160,301,300,,,1,4,0.68,1.02,1.08,654,607,152,170,,,,62.75,44.83,64.95,1,59.79,1454,,,3.4,,103,101,,,,,,73,80,13.9,13.88,14.26,-7.4,,,,,,,,,,,,,,,,"2,7,11,12,26,15,22,5,0","0,6,79,15,0",,,,,,137,,,,,,,,,,,,,,,,,,,,,,,,,,,,,,,,,,,,45.5,27,19,218,46,,1012,4,344,0,6,3,,1,0,I1.000|4:51-I1.000|5:03-I1.000|5:50-I1.000|5:01-I1.000|4:49-I1.000|5:11-I1.000|3:39-I1.000|4:01-I1.000|3:48-I1.000|3:56-I0.662|2:25,,,,,3113,"firmware 2.50",250,0,,0,168070,250480,30378,,,,,,,,,,,,,,,,,,,,,,,,,,,,,,,,,,,,,,,,,,3,
8607341,7fdcf874-3586-4605-bf52-c36824945884,1563702427,120,1563701826,,0,0,21.16,5866,6180,370,370,,,1,3.2,0.55,0.97,1,422,1128,152,170,,,,61.64,46.49,62.98,1,59.9,2356,,,4,,101,98,,,,,,149,82,13.28,13.34,13.54,2.5,,,,,,,,,,,,,,,,"1,4,7,14,32,33,8,1,0","0,14,66,20,0",,,,,,132,,,,,,,,,,,,,,,,,,,,,,,,,,,,,,,,,,,,49.1,16,11,247,95,,1019,2,359,0,4,3,,1,0,I1.000|4:49-I1.000|4:11-I1.000|4:28-I1.000|4:21-I1.000|4:39-I1.000|4:37-I1.000|4:45-I1.000|4:27-I1.000|4:43-I1.000|4:26-I1.000|4:13-I1.000|4:46-I1.000|5:15-I1.000|5:22-I1.000|4:32-I1.000|4:49-I1.000|4:46-I1.000|5:00-I1.000|5:14-I1.000|3:43-I1.000|3:57-I0.155|0:43,,,,,3113,"firmware 2.50",250,0,,0,168070,250480,30378,,,,,,,,,,,,,,,,,,,,,,,,,,,,,,,,,,,,,,,,,,"4,4,5",
8628497,a4ad1ba0-e097-4af9-b06b-2f082aaec6e5,1563809221,120,1563806043,,0,0,12.88,3593,3723,208,242,,,1,2.4,0.5,1.01,1,735,796,157,172,,,,58.48,44.37,59.46,1,59.56,2338,,,3.9,,104,97,,,,,,102,83,13.1,13.1,13.4,4.1,,,,,,,,,,,,,,,,"3,3,4,15,34,37,6,0,0","0,10,42,48,0",,,,,,130,,,,,,,,,,,,,,,,,,,,,,,,,,,,,,,,,,,,61.4,27,15,258,45,,1024,4,306,0,5,3,,1,0,I1.000|4:46-I1.000|4:19-I1.000|4:44-I1.000|4:23-I1.000|4:29-I1.000|4:24-I1.000|4:34-I1.000|4:25-I1.000|5:04-I1.000|4:25-I1.000|4:35-I1.000|5:17-I0.879|4:27,,,,,3113,"firmware 2.50",250,0,,0,168070,250480,30378,,,,,,,,,,,,,,,,,,,,,,,,,,,,,,,,,,,,,,,,,,4,
8647417,4bec56e5-e057-47b6-abd2-9a9efd28d6ac,1563903673,120,1563903551,,0,0,6.67,1759,3018,31,35,,,1,0,0.22,,,,371,148,171,,,,67.97,45.37,68.31,1,60.14,1280,,,3,,103,104,,,,,,41,82,13.61,13.77,13.74,1.7,,,,,,,,,,,,,,,,"0,0,2,10,29,45,15,0,0","1,26,57,16,0",,,,,,139,,,,,,,,,,,,,,,,,,,,,,,,,,,,,,,,,,,,46.2,33,16,5,32,,1018,2,300,0,5,3,,1,0,I1.000|4:57-I1.000|4:36-I1.000|4:15-I1.000|4:24-I1.000|4:07-I1.000|4:14-I0.669|2:46,,,,,3113,"firmware 2.50",250,0,,0,168070,250480,30378,,,,,,,,,,,,,,,,,,,,,,,,,,,,,,,,,,,,,,,,,,,
8647428,727b1931-0376-4fae-9ad3-5eac5661fcb0,1563907198,120,1563903560,,0,0,1.51,290,290,1,0,,,1,0,0,,,,58,141,155,,,,,57.04,,1,60.14,1268,,,1.1,,,100,,,,,,5,92,18.81,18.81,18.85,5,,,,,,,,,,,,,,,,"0,0,0,0,0,0,0,99,1","0,53,47,0,0",,,,,,170,,,,,,,,,,,,,,,,,,,,,,,,,,,,,,,,,,,,12.1,34,14,359,29,,1017,1,299,0,5,3,,1,0,I1.000|3:14-I0.512|1:37,,,,,3113,"firmware 2.50",250,0,,0,168070,250480,30378,,,,,,,,,,,,,,,,,,,,,,,,,,,,,,,,,,,,,,,,,,,
8647431,b876def3-9170-41a3-a0d6-a9694872b358,1563908428,120,1563903560,,0,0,1.32,514,514,1,0,,,1,0,0.07,,,,96,145,177,,,,43.16,25.27,43.24,1,60.14,1245,,,2,,,100,,,,,,11,70,9.32,14.85,14.8,42.3,,,,,,,,,,,,,,,,"59,3,3,3,2,2,9,20,0","0,39,35,26,0",,,,,,110,,,,,,,,,,,,,,,,,,,,,,,,,,,,,,,,,,,,30.2,34,14,359,29,,1017,1,299,0,5,3,,1,0,I0.403|1:19-I0.209|1:19-I0.408|1:28-I0.295|4:29,,,,,3113,"firmware 2.50",250,0,,0,168070,250480,30378,,,,,,,,,,,,,,,,,,,,,,,,,,,,,,,,,,,,,,,,,,,
8647432,e74024d6-d0f0-4992-8652-d326e24998ef,1563910148,120,1563903565,,0,0,1.26,420,420,5,4,,,1,0,0.18,,,,85,140,145,,,,54.68,30.06,55,1,59.83,1216,,,1.4,,97,97,,,,,,7,80,10.81,10.79,10.84,0.6,,,,,,,,,,,,,,,,"0,4,70,26,0,0,0,0,0","0,71,29,0,0",,,,,,113,,,,,,,,,,,,,,,,,,,,,,,,,,,,,,,,,,,,13.7,33,13,357,32,,1017,1,300,0,5,3,,1,0,I1.000|5:35-I0.256|1:25,,,,,3113,"firmware 2.50",250,0,,0,168070,250480,30378,,,,,,,,,,,,,,,,,,,,,,,,,,,,,,,,,,,,,,,,,,,
8660432,a2bd33f3-f6a6-4a04-b9d1-34bf147aaf26,1563989108,120,1563986826,,0,0,12.31,3627,4717,67,66,,,1,0,0.11,,,,710,146,159,,,,60.34,41.49,60.75,1,59.68,1280,,,3.2,,99,100,,,,,,77,80,12.23,12.26,12.28,3.2,,,,,,,,,,,,,,,,"0,0,1,43,52,5,0,0,0","0,10,90,0,0",,,,,,127,,,,,,,,,,,,,,,,,,,,,,,,,,,,,,,,,,,,32.2,38,8,224,21,,1014,3,307,0,3,3,,1,0,I1.000|4:52-I1.000|4:44-I1.000|4:43-I1.000|4:44-I1.000|4:45-I1.000|4:45-I1.000|4:59-I1.000|4:58-I1.000|5:00-I1.000|5:08-I1.000|5:08-I1.000|5:06-I0.309|1:34,,,,,3113,"firmware 2.50",250,0,,0,168070,250480,30378,,,,,,,,,,,,,,,,,,,,,,,,,,,,,,,,,,,,,,,,,,,
8671959,efdcf0d1-b4cc-4b5e-b447-9fda03c07ff8,1564078031,120,1564074786,,0,0,11.6,2893,3206,50,50,,,1,0,0.11,,,,701,168,184,,,,60.84,50.17,61.16,1,58.33,3438,,,4.4,,103,99,,,,,,107,83,14.45,14.49,14.53,9.8,,,,,,,,,,,,,,,,"0,0,0,0,10,66,24,0,0","0,6,18,65,11",,,,,,145,,,,,,,,,,,,,,,,,,,,,,,,,,,,,,,,,,,,115.2,39,17,21,23,,1012,2,300,0,5,3,,1,0,I1.000|4:08-I1.000|4:17-I1.000|4:12-I1.000|4:07-I1.000|4:11-I1.000|4:01-I1.000|4:04-I1.000|4:10-I1.000|4:02-I1.000|4:07-I1.000|4:17-I0.602|2:37,,,,,3113,"firmware 2.50",250,0,,0,168070,250480,30378,,,,,,,,,,,,,,,,,,,,,,,,,,,,,,,,,,,,,,,,,,,
8684731,9af65731-cf6a-4619-86e5-e66e19efc0da,1564167830,120,1564164907,,0,0,6.52,1994,4138,33,33,,,1,0,0.13,,,,399,146,160,,,,57.63,38.04,57.99,1,57.99,1928,,,2.7,,100,101,,,,,,43,79,11.79,11.84,11.84,6.8,,,,,,,,,,,,,,,,"0,1,6,66,27,1,0,0,0","1,12,87,0,0",,,,,,124,,,,,,,,,,,,,,,,,,,,,,,,,,,,,,,,,,,,35.2,32,6,246,36,,1006,1,301,0,5,3,,1,0,I1.000|4:54-I1.000|5:14-I1.000|4:58-I1.000|5:12-I1.000|5:11-I1.000|5:12-I0.523|2:34,,,,,3113,"firmware 2.50",250,0,,0,168070,250480,30378,,,,,,,,,,,,,,,,,,,,,,,,,,,,,,,,,,,,,,,,,,,
8691646,2d99fd8f-191e-42f1-b5a1-fa8211a312e8,1564229017,120,1564224604,,0,0,4.94,1305,1305,90,43,,,1,1.2,0.27,1.09,0.98,910,314,170,185,,,,55.66,44.47,57.57,1,57.89,2007,,,3.5,,97,98,,,,,,52,84,14.12,13.73,14.99,1.6,,,,,,,,,,,,,,,,"0,0,0,3,34,53,9,0,0","0,15,6,53,27",,,,,,135,,,,,,,,,,,,,,,,,,,,,,,,,,,,,,,,,,,,116.2,28,15,40,41,,1003,5,311,0,5,3,,1,0,I1.000|4:34-I1.000|4:28-I1.000|4:19-I1.000|4:18-I0.943|4:06,,,,,3113,"firmware 2.50",250,0,,0,168070,250480,30378,,,,,,,,,,,,,,,,,,,,,,,,,,,,,,,,,,,,,,,,,,4,
8691648,c0f22bef-fee2-4a35-8ee8-3de5191831d4,1564230568,120,1564224605,,0,0,4.86,1171,1171,39,278,,,1,1.1,0.81,,1.04,,259,157,177,,,,70.1,49.48,66.54,1,58.62,3168,,,3,,101,100,,,,,,33,82,13.67,15.32,14.03,-2.6,,,,,,,,,,,,,,,,"0,0,0,3,8,40,44,5,0","0,0,64,36,0",,,,,,152,,,,,,,,,,,,,,,,,,,,,,,,,,,,,,,,,,,,62.5,28,15,40,41,,1003,5,311,0,5,3,,1,0,I1.000|4:17-I1.000|4:05-I1.000|4:07-I1.000|3:34-I0.864|3:28,,,,,3113,"firmware 2.50",250,0,,0,168070,250480,30378,,,,,,,,,,,,,,,,,,,,,,,,,,,,,,,,,,,,,,,,,,,
8700536,d542eaf9-ea32-4cf0-86b8-e1a9d5cceaff,1564306898,120,1564305853,,0,0,21.13,6028,6028,383,383,,,1,2.8,0.55,0.96,1.03,413,1149,152,178,,,,59.5,44.97,60.83,1,58.73,3612,,,4,,100,98,,,,,,151,82,12.9,13.25,13.28,-1.4,,,,,,,,,,,,,,,,"1,4,8,23,42,14,5,4,0","0,12,69,19,0",,,,,,128,,,,,,,,,,,,,,,,,,,,,,,,,,,,,,,,,,,,68.7,19,5,316,88,,1001,2,304,0,6,3,,1,0,I1.000|5:02-I1.000|4:40-I1.000|4:44-I1.000|4:45-I1.000|5:01-I1.000|5:02-I1.000|5:04-I1.000|4:50-I1.000|5:00-I1.000|4:35-I1.000|4:16-I1.000|4:50-I1.000|5:10-I1.000|5:28-I1.000|4:28-I1.000|4:48-I1.000|4:52-I1.000|5:04-I1.000|5:12-I1.000|3:33-I1.000|3:30-I0.128|0:31,,,,,3113,"firmware 2.50",250,0,,0,168070,250480,30378,,,,,,,,,,,,,,,,,,,,,,,,,,,,,,,,,,,,,,,,,,"4,4,5",
8723809,1875b380-7620-4f4b-927d-4e6407a283b3,1564421734,120,1564418588,,0,0,10.94,3236,3826,47,44,,,1,0,0.13,,,,569,139,151,,,,63.95,40.94,64.31,1,59.31,1584,,,2.7,,101,101,,,,,,58,81,12.19,12.26,12.3,3.2,,,,,,,,,,,,,,,,"0,1,5,32,57,4,0,0,0","0,49,51,0,0",,,,,,125,,,,,,,,,,,,,,,,,,,,,,,,,,,,,,,,,,,,23.2,28,3,303,40,,1011,3,303,0,3,3,,1,0,I1.000|4:45-I1.000|4:58-I1.000|4:55-I1.000|4:54-I1.000|4:47-I1.000|4:54-I1.000|4:57-I1.000|4:51-I1.000|5:02-I1.000|5:10-I0.938|4:44,,,,,3113,"firmware 2.50",250,0,,0,168070,250480,30378,,,,,,,,,,,,,,,,,,,,,,,,,,,,,,,,,,,,,,,,,,,
8737852,e3850ef2-f98a-4e59-9238-a31e8bfa3e38,1564509993,120,1564508405,,0,0,12.89,3392,3635,59,61,,,1,0,0.1,,,,688,151,181,99,,,66.34,47.49,66.7,1,60.76,1856,,,3.5,,104,103,,,,,,87,83,13.67,15.07,15.08,7,,,,,,,,,,,,,,,,"6,2,5,13,19,18,27,10,0","0,24,39,37,0",,,,,,137,,,,,,,,,,,,,,,,,,,,,,,,,,,,,,,,,,,,69.2,27,20,223,41,,1013,2,303,0,5,3,,1,0,I1.000|4:25-I1.000|4:15-I1.000|4:33-I1.000|4:39-I1.050|5:47-I1.007|3:40-I0.415|2:05-I1.009|3:35-I0.413|2:17-I1.015|3:36-I0.415|2:25-I1.011|3:44-I0.418|2:21-I1.006|3:55-I0.115|1:53-I1.002|3:22-I0.015|0:02,,,,,3113,"firmware 2.50",250,0,,0,168070,250480,30378,,,,,,,,,,,,,,,,,,,,,,,,,,,,,,,,,,,,,,,,,,,
8737860,d44ef582-1e12-4d2b-8396-4bd2d589e1d7,1564514364,120,1564508409,,0,0,2.13,770,770,9,9,,,1,0,0,,,,142,133,138,103,,,52.68,28.92,52.96,1,60.51,1830,,,1.5,,95,97,,,,,,11,82,9.93,10.06,10.07,-9.9,,,,,,,,,,,,,,,,"15,46,30,10,0,0,0,0,0","0,100,0,0,0",,,,,,101,,,,,,,,,,,,,,,,,,,,,,,,,,,,,,,,,,,,13.4,26,19,284,42,,1013,0,305,0,5,3,,1,0,,,,,,3113,"firmware 2.50",250,0,,0,168070,250480,30378,,,,,,,,,,,,,,,,,,,,,,,,,,,,,,,,,,,,,,,,,,,
8744802,8f747bcd-21c0-4846-a9aa-d10a2b23a63e,1564556872,120,1564552867,,0,0,8.95,3012,3016,18,17,,,1,0,0.14,,,,473,130,149,,,,59.12,34.67,59.27,1,60.76,1106,,,2.2,,,100,,,,,,42,81,10.7,10.73,10.74,1.5,,,,,,,,,,,,,,,,"5,8,49,36,2,0,0,0,0","1,97,2,0,0",,,,,,110,,,,,,,,,,,,,,,,,,,,,,,,,,,,,,,,,,,,15.1,18,13,213,84,,1017,0,326,0,5,3,,1,0,,,,,,3113,"firmware 2.50",250,0,,0,168070,250480,30378,,,,,,,,,,,,,,,,,,,,,,,,,,,,,,,,,,,,,,,,,,,
8781230,07472480-faa5-45c4-8b5c-babd6bf5621e,1564682803,120,1564726325,,0,0,16.08,3920,4222,68,68,,,1,0,0.09,,,,847,153,187,,,,71.63,52.77,72,1,60.38,1958,,,3.7,,104,94,,,,,,102,84,14.78,15.06,15.09,6.8,,,,,,,,,,,,,,,,"0,0,0,1,20,26,52,2,0","0,8,72,16,4",,,,,,147,,,,,,,,,,,,,,,,,,,,,,,,,,,,,,,,,,,,70.9,26,7,10,32,,1016,2,315,0,5,3,,1,0,I13.009|51:02-I3.073|14:18,,,,,3113,"firmware 2.50",250,0,,0,168070,250480,30378,,,,,,,,,,,,,,,,,,,,,,,,,,,,,,,,,,,,,,,,,,,
8784162,8d3698d7-f911-42dd-b497-d9d06655a9aa,1564752014,120,1564748168,,0,0,10.41,3046,3074,46,45,,,1,0,0.11,,,,636,148,162,,,,59.77,41.32,60.11,1,60.09,1685,,,3.2,,98,99,,,,,,68,80,12.31,12.34,12.35,1.9,,,,,,,,,,,,,,,,"0,1,5,27,61,5,0,0,0","0,5,95,0,0",,,,,,128,,,,,,,,,,,,,,,,,,,,,,,,,,,,,,,,,,,,34.2,27,9,306,39,,1015,5,320,0,5,3,,1,0,I1.000|4:56-I1.000|4:57-I1.000|4:56-I1.000|4:51-I1.000|5:00-I1.000|4:46-I1.000|4:45-I1.000|4:48-I1.000|4:59-I1.000|4:53-I0.407|1:55,,,,,3113,"firmware 2.50",250,0,,0,168070,250480,30378,,,,,,,,,,,,,,,,,,,,,,,,,,,,,,,,,,,,,,,,,,,
8798448,b83bc3ec-0704-4446-94af-ec533ea38262,1564843489,120,1564840628,,0,0,13.18,3831,4158,348,348,,,1,3.9,0.81,1.02,1.1,466,722,146,168,,,,61.36,42.38,63.37,1,59.54,1806,,,3.3,,98,98,,,,,,83,82,13.06,13.16,13.24,-7.4,,,,,,,,,,,,,,,,"6,4,19,27,10,16,18,0,0","0,22,76,3,0",,,,,,126,,,,,,,,,,,,,,,,,,,,,,,,,,,,,,,,,,,,44.5,22,12,350,54,,1016,5,325,0,5,3,,1,0,I1.000|6:15-I1.000|5:18-I1.000|5:07-I1.000|5:45-I1.000|5:33-I1.000|5:19-I1.000|5:13-I1.000|4:38-I1.000|4:12-I1.000|3:54-I1.000|3:53-I1.000|3:55-I1.000|4:00-I0.177|0:49,,,,,3113,"firmware 2.50",250,0,,0,168070,250480,30378,,,,,,,,,,,,,,,,,,,,,,,,,,,,,,,,,,,,,,,,,,3,
8823599,aedf41e6-6881-4116-961d-f5208c15dc1e,1565013530,120,1565010904,,0,0,13.11,3918,4369,348,347,,,1,3.9,0.78,1.05,1.12,462,693,144,165,,,,60.36,41.01,62.36,1,59.07,1606,,,3.2,,101,97,,,,,,82,81,12.7,12.59,12.87,-6.9,,,,,,,,,,,,,,,,"7,5,21,26,10,25,7,0,0","0,38,61,1,0",,,,,,124,,,,,,,,,,,,,,,,,,,,,,,,,,,,,,,,,,,,44.5,23,15,182,64,,1011,7,301,0,5,3,,1,0,I1.000|6:19-I1.000|5:31-I1.000|5:11-I1.000|5:34-I1.000|5:27-I1.000|5:23-I1.000|5:39-I1.000|4:46-I1.000|4:13-I1.000|4:10-I1.000|4:09-I1.000|4:09-I1.000|4:17-I0.109|0:31,,,,,3113,"firmware 2.50",250,0,,0,168070,250480,30378,,,,,,,,,,,,,,,,,,,,,,,,,,,,,,,,,,,,,,,,,,3,
8849509,02dc8ab2-3cb5-46cb-8d91-1565306d15e4,1565114812,120,1565113804,,0,0,14.08,3787,4397,55,56,,,1,0,0.04,,,,818,161,185,129,,,59.02,46.61,59.3,1,59.71,2304,,,4.1,,104,98,,,,,,122,82,13.38,14.66,14.67,18.8,,,,,,,,,,,,,,,,"12,3,5,4,12,39,17,8,0","0,13,24,59,4",,,,,,136,,,,,,,,,,,,,,,,,,,,,,,,,,,,,,,,,,,,93.9,28,23,200,45,,1010,1,322,0,4,3,,1,0,I1.000|4:27-I1.000|4:26-I1.000|4:19-I1.000|4:12-I1.000|4:12-I0.408|1:54-I0.401|1:19-I0.206|0:58-I0.303|0:59-I0.212|0:55-I0.205|0:41-I0.206|0:52-I0.101|0:20-I0.205|0:53-I0.403|1:21-I0.207|0:54-I0.300|1:04-I0.206|0:57-I0.201|0:43-I0.211|1:00-I0.102|0:20-I0.207|1:07-I0.411|1:25-I0.207|1:17-I0.302|1:04-I0.207|1:19-I0.201|0:42-I0.210|1:25-I0.100|0:22-I0.206|1:12-I0.400|1:28-I0.212|1:31-I0.300|1:08-I0.089|0:48-I0.201|0:43-I0.109|0:47-I0.098|0:22-I0.046|0:34-I0.153|1:37-I0.404|1:31-I0.103|1:06-I0.306|1:08-I0.205|1:11-I0.202|0:45-I0.204|1:28-I0.102|0:23-I0.013|0:01,,,,,3113,"firmware 2.50",250,0,,0,168070,250480,30378,,,,,,,,,,,,,,,,,,,,,,,,,,,,,,,,,,,,,,,,,,,
8849521,cdd87b91-aee3-471a-b049-e05efc0adedc,1565119909,120,1565113813,,0,0,0.33,139,139,1,0,,,1,0.3,0.39,,,,22,128,134,104,,,45.63,19.98,45.97,1,59.71,2290,,,,,,100,,,,,,1,81,8.51,8.47,8.55,3.3,,,,,,,,,,,,,,,,"100,0,0,0,0,0,0,0,0","0,100,0,0,0",,,,,,88,,,,,,,,,,,,,,,,,,,,,,,,,,,,,,,,,,,,3.7,29,11,281,45,,1010,0,320,0,6,3,,1,0,,,,,,3113,"firmware 2.50",250,0,,0,168070,250480,30378,,,,,,,,,,,,,,,,,,,,,,,,,,,,,,,,,,,,,,,,,,,
8868433,aba74de7-c685-40f9-8adf-dbef91270cfb,1565193292,120,1565188623,,0,0,8.72,2319,2401,196,199,,,1,3,0.55,1.15,0.96,553,504,150,163,,,,66.07,45.66,67.89,1,60.58,1584,,,3.2,,101,101,,,,,,55,82,13.78,13.67,14.14,0.4,,,,,,,,,,,,,,,,"0,0,0,6,35,49,9,0,0","0,12,83,5,0",,,,,,138,,,,,,,,,,,,,,,,,,,,,,,,,,,,,,,,,,,,43.4,15,8,228,100,,1012,3,333,0,6,3,,1,0,I1.000|4:56-I1.000|4:40-I1.000|4:28-I1.000|4:12-I1.000|4:18-I1.000|4:15-I1.000|4:26-I1.000|4:10-I0.721|3:15,,,,,3113,"firmware 2.50",250,0,,0,168070,250480,30378,,,,,,,,,,,,,,,,,,,,,,,,,,,,,,,,,,,,,,,,,,"4,5,5",
8881111,c9b023a7-3370-426d-ac2d-dea0ce0466ef,1565256380,120,1565255766,,0,0,20.01,5746,6284,59,51,,,1,0,0.05,,,577,1070,156,185,119,,,56.94,44.43,57.17,1,60.41,3882,,,4.7,,100,98,,,,,,166,83,12.57,12.74,12.87,-17.5,,,,,,,,,,,,,,,,"3,5,3,15,46,28,1,0,0","0,20,39,40,1",,,,,,126,,,,,,,,,,,,,,,,,,,,,,,,,,,,,,,,,,,,107.4,17,3,210,82,,1014,2,332,0,4,3,,1,0,I1.000|4:54-I1.000|4:52-I0.906|4:35-I0.223|1:00-I0.167|1:00-I0.444|2:00-I0.160|1:00-I0.625|3:00-I0.182|1:01-I0.879|4:00-I0.198|1:01-I1.113|5:00-I0.192|1:00-I0.890|4:01-I0.185|1:00-I0.619|3:00-I0.168|1:00-I0.457|2:03-I0.203|1:00-I0.238|1:01-I0.293|1:53-I0.497|2:06-I1.000|5:08-I1.000|4:33-I1.000|4:34-I1.000|4:53-I1.000|4:26-I1.000|4:32-I1.000|4:37-I1.000|4:32-I1.000|4:39-I0.372|2:21-I0.002|0:01,,,,,3113,"firmware 2.50",250,0,,0,168070,250480,30378,,,,,,,,,,,,,,,,,,,,,,,,,,,,,,,,,,,,,,,,,,4,
8886436,3101dd01-02dc-426c-813d-f9869722185e,1565287585,120,1565282828,,0,0,8.84,2318,2318,191,189,,,1,2.5,0.45,1.14,0.92,765,539,158,171,,,,62.56,46.46,64.26,1,60.68,4320,,,3.5,,102,100,,,,,,68,82,13.91,13.83,14.39,4.8,,,,,,,,,,,,,,,,"0,0,0,4,29,59,8,0,0","1,5,39,55,0",,,,,,140,,,,,,,,,,,,,,,,,,,,,,,,,,,,,,,,,,,,64.9,23,5,257,53,,1013,2,324,0,5,3,,1,0,I1.000|4:42-I1.000|4:26-I1.000|4:20-I1.000|4:05-I1.000|4:14-I1.000|4:10-I1.000|4:21-I1.000|4:21-I0.839|3:59,,,,,3113,"firmware 2.50",250,0,,0,168070,250480,30378,,,,,,,,,,,,,,,,,,,,,,,,,,,,,,,,,,,,,,,,,,"4,5",
8899353,ecf9e366-afac-4830-9905-858b4e169048,1565343189,120,1565343246,,0,0,20.01,6331,6908,680,680,,,1,5.9,0.58,0.91,0.93,717,1240,156,189,,,,50.52,39.69,52.64,1,59.84,4320,,,4.4,,104,96,,,,,,179,81,12.45,12.25,13.04,-2.2,,,,,,,,,,,,,,,,"19,8,8,11,21,28,6,0,0","0,7,54,37,1",,,,,,117,,,,,,,,,,,,,,,,,,,,,,,,,,,,,,,,,,,,89.6,21,8,181,62,,1012,2,305,0,5,3,,1,0,I1.000|4:36-I1.000|4:24-I1.000|4:22-I1.000|9:40-I1.000|8:18-I1.000|4:29-I1.000|4:36-I1.000|4:44-I1.000|7:12-I1.000|5:40-I1.000|4:53-I1.000|4:23-I1.000|4:21-I1.000|4:28-I1.000|4:22-I1.000|4:20-I1.000|4:35-I1.000|4:24-I1.000|5:37-I1.000|6:04-I0.009|0:03,,,,,3113,"firmware 2.50",250,0,,0,168070,250480,30378,,,,,,,,,,,,,,,,,,,,,,,,,,,,,,,,,,,,,,,,,,"2,4,4,5",
8905438,951390fd-937e-4a24-b9d5-66d80b03174a,1565373850,120,1565369709,,0,0,8.85,2885,2889,196,193,,,1,2.7,0.51,1.15,0.93,652,570,143,162,,,,54.71,35.98,56.24,1,60.28,4435,,,2.9,,97,98,,,,,,57,80,11.22,11.08,11.61,0.7,,,,,,,,,,,,,,,,"2,5,36,53,5,0,0,0,0","0,22,77,0,0",,,,,,115,,,,,,,,,,,,,,,,,,,,,,,,,,,,,,,,,,,,30.2,27,12,210,48,,1009,2,297,0,5,3,,1,0,I1.000|5:50-I1.000|5:34-I1.000|5:30-I1.000|5:10-I1.000|5:29-I1.000|5:22-I1.000|5:28-I1.000|5:08-I0.853|4:34,,,,,3113,"firmware 2.50",250,0,,0,168070,250480,30378,,,,,,,,,,,,,,,,,,,,,,,,,,,,,,,,,,,,,,,,,,"4,4",
8914850,6c2e3d21-0e1e-46ff-9397-09daf9bf907d,1565428416,120,1565427425,,0,0,15.04,5267,5965,532,531,,,1,4.9,0.72,1.25,0.95,661,839,142,180,,,,50.54,34.44,52.76,1,59.6,3475,,,3.3,,100,96,,,,,,106,80,10.87,11.47,12.71,24.5,,,,,,,,,,,,,,,,"28,9,17,19,10,13,5,0,0","0,44,47,9,0",,,,,,107,,,,,,,,,,,,,,,,,,,,,,,,,,,,,,,,,,,,74.1,16,12,234,78,,1018,2,295,0,5,3,,1,0,I1.000|5:38-I1.000|4:56-I1.000|5:40-I1.000|5:49-I1.000|4:43-I1.000|5:11-I0.727|3:54-I1.000|5:28-I1.000|4:42-I1.000|4:33-I1.000|4:39-I0.190|0:51-I0.077|0:16-I0.111|1:22-I0.108|0:24-I0.133|1:43-I0.109|0:24-I0.135|1:43-I0.104|0:24-I0.136|1:37-I0.099|0:23-I0.130|1:47-I0.104|0:24-I0.127|1:59-I0.107|0:27-I0.120|1:58-I0.108|0:25-I0.125|1:43-I0.100|0:24-I0.139|2:06-I0.110|0:25-I1.000|6:15-I0.937|5:34,,,,,3113,"firmware 2.50",250,0,,0,168070,250480,30378,,,,,,,,,,,,,,,,,,,,,,,,,,,,,,,,,,,,,,,,,,2,
8923052,77f627c5-5684-4a4e-ac8e-9ca5cae08670,1565458989,120,1565454245,,0,0,8.79,2242,2242,188,187,,,1,2.7,0.5,1.15,0.92,634,521,159,170,,,,64.16,47.97,65.87,1,60.63,4320,,,3.5,,104,101,,,,,,66,83,14.32,14.22,14.78,2.7,,,,,,,,,,,,,,,,"0,0,0,0,22,57,20,0,0","1,2,41,56,0",,,,,,142,,,,,,,,,,,,,,,,,,,,,,,,,,,,,,,,,,,,62.1,22,14,253,46,,1019,2,305,0,5,3,,1,0,I1.000|4:35-I1.000|4:18-I1.000|4:18-I1.000|4:13-I1.000|4:14-I1.000|4:04-I1.000|4:16-I1.000|3:58-I0.790|3:26,,,,,3113,"firmware 2.50",250,0,,0,168070,250480,30378,,,,,,,,,,,,,,,,,,,,,,,,,,,,,,,,,,,,,,,,,,"4,4,5",
8932210,25de4e89-e7d2-4642-bf55-0e5c579bc9ab,1565514005,120,1565516769,,0,0,25.01,7646,8268,799,800,,,1,6.1,0.74,1,0.95,619,1381,149,169,,,,56.12,42.02,58.34,1,58.39,4437,,,4.1,,100,97,,,,,,181,83,12.5,12.12,13.04,7.7,,,,,,,,,,,,,,,,"11,9,13,20,26,18,3,0,0","0,25,57,18,0",,,,,,118,,,,,,,,,,,,,,,,,,,,,,,,,,,,,,,,,,,,55.2,17,2,58,68,,1020,2,297,0,5,3,,1,0,I1.000|4:46-I1.000|4:43-I1.000|5:24-I1.000|5:59-I1.000|5:32-I1.000|5:17-I1.000|5:04-I1.000|5:32-I1.000|5:17-I1.000|4:24-I1.000|4:16-I1.000|4:18-I1.000|4:06-I1.000|4:19-I1.000|4:59-I1.000|4:21-I1.000|4:27-I1.000|6:04-I1.000|5:12-I1.000|6:14-I1.000|6:35-I1.000|5:11-I1.000|5:07-I1.000|5:09-I1.000|5:08-I0.005|0:02,,,,,3113,"firmware 2.50",250,0,,0,168070,250480,30378,,,,,,,,,,,,,,,,,,,,,,,,,,,,,,,,,,,,,,,,,,"3,3,4,4,5",
8956048,bea029d1-ae6f-4408-ac0a-9ec4c2756117,1565640332,120,1565634976,,0,0,2.74,823,1196,8,8,,,1,0,0,,,,159,138,148,,,,63.32,36.69,63.54,1,59.99,2449,,,2,,99,100,,,,,,14,80,11.98,12.08,12.08,-2.5,,,,,,,,,,,,,,,,"1,6,9,29,50,6,0,0,0","3,43,54,0,0",,,,,,125,,,,,,,,,,,,,,,,,,,,,,,,,,,,,,,,,,,,19.4,19,11,225,68,,1018,0,335,0,5,3,,1,0,I1.000|5:12-I1.000|5:01-I0.738|3:30,,,,,3113,"firmware 2.50",250,0,,0,168070,250480,30378,,,,,,,,,,,,,,,,,,,,,,,,,,,,,,,,,,,,,,,,,,,
8972531,4b24084e-d7eb-4c0a-952f-dfd758e76a07,1565719687,120,1565716984,,0,0,12.02,3007,3007,34,33,,,1,0,0.07,,,,680,154,173,,,,68.74,50.11,68.99,1,61.22,2160,,,3.7,,104,100,,,,,,78,83,14.38,14.45,14.46,2.9,,,,,,,,,,,,,,,,"0,0,1,0,6,67,26,0,0","0,8,71,21,0",,,,,,144,,,,,,,,,,,,,,,,,,,,,,,,,,,,,,,,,,,,63.4,20,11,238,46,,1019,1,329,0,4,3,,1,0,I1.000|4:25-I1.000|4:16-I1.000|4:21-I1.000|4:14-I1.000|4:12-I1.000|4:19-I1.000|4:05-I1.000|4:05-I1.000|4:07-I1.000|4:04-I0.489|2:00-I1.000|3:55-I0.526|2:04,,,,,3113,"firmware 2.50",250,0,,0,168070,250480,30378,,,,,,,,,,,,,,,,,,,,,,,,,,,,,,,,,,,,,,,,,,,
9000047,b37962a9-7388-4161-bbe8-db3b6ad7134f,1565809071,120,1565805425,,0,0,10.85,2887,3372,38,38,,,1,0,0.08,,,,609,150,171,105,,,66.03,46.3,66.31,1,61.56,1454,,,3.3,,102,101,,,,,,69,81,13.53,13.64,13.65,-1.1,,,,,,,,,,,,,,,,"0,0,1,4,35,52,7,0,0","0,20,67,12,0",,,,,,139,,,,,,,,,,,,,,,,,,,,,,,,,,,,,,,,,,,,52.2,23,8,262,48,,1018,1,321,0,5,3,,1,0,I1.000|4:40-I1.000|4:31-I1.000|4:28-I1.000|4:15-I1.000|4:11-I1.000|4:25-I1.000|4:21-I1.000|4:28-I1.000|4:36-I1.000|4:21-I0.847|3:50,,,,,3113,"firmware 2.50",250,0,,0,168070,250480,30378,,,,,,,,,,,,,,,,,,,,,,,,,,,,,,,,,,,,,,,,,,,
9021414,81236ec9-4c65-4485-8d75-0d84f3217315,1565892327,120,1565889308,,0,0,12.18,3248,3268,51,52,,,1,0,0.05,,,,643,147,175,88,,,67.65,46.57,67.99,1,62.1,1396,,,3.3,,104,99,,,,,,73,83,13.5,14.63,14.63,8.9,,,,,,,,,,,,,,,,"2,2,7,22,13,28,18,9,0","0,27,63,9,0",,,,,,136,,,,,,,,,,,,,,,,,,,,,,,,,,,,,,,,,,,,47.4,21,13,220,65,,1016,2,326,0,5,3,,1,0,I1.000|4:23-I1.000|4:21-I1.000|4:10-I1.000|4:02-I1.000|4:20-I0.578|2:38-I1.000|3:25-I0.495|2:11-I1.000|3:39-I1.000|5:16-I1.000|5:26-I1.000|5:32-I0.048|0:15-I1.000|3:26-I0.022|0:05-I0.039|0:57,,,,,3113,"firmware 2.70",250,0,,0,168070,250480,30378,,,,,,,,,,,,,,,,,,,,,,,,,,,,,,,,,,,,,,,,,,,
9045909,2e009f1b-7eb2-43f8-afeb-87fe40cee9c9,1565985663,120,1565996463,,0,0,10.69,3137,3408,31,32,,,1,0,0.08,,,,638,144,163,,,,61.74,41.26,61.96,1,61.48,1504,,,3,,99,98,,,,,,63,79,12.27,12.34,12.37,-1.7,,,,,,,,,,,,,,,,"0,1,4,32,54,9,0,0,0","0,18,81,0,0",,,,,,129,,,,,,,,,,,,,,,,,,,,,,,,,,,,,,,,,,,,27.1,23,4,179,59,,1016,0,302,0,5,3,,1,0,I1.000|4:57-I1.000|5:06-I1.000|5:05-I1.000|5:05-I1.000|4:46-I1.000|4:41-I1.000|5:03-I1.000|4:56-I1.000|4:50-I1.000|4:47-I0.691|3:01,,,,,3113,"firmware 2.70",250,0,,0,168070,250480,30378,,,,,,,,,,,,,,,,,,,,,,,,,,,,,,,,,,,,,,,,,,,
9050048,ce3323d7-9fbd-425e-aaa6-af2d9c745713,1566034624,120,1566032892,,0,0,4.88,1617,2106,7,13,,,1,0,0.04,,,,326,142,162,,,,54.11,33.99,54.12,1,60.8,1546,,,2.5,,94,95,,,,,,32,80,10.85,11.07,11.03,0.8,,,,,,,,,,,,,,,,"4,8,35,48,3,1,0,0,0","1,24,74,1,0",,,,,,113,,,,,,,,,,,,,,,,,,,,,,,,,,,,,,,,,,,,27,19,8,205,79,,1013,2,297,0,5,3,,1,0,I1.000|5:20-I1.000|5:27-I1.000|5:27-I1.000|5:29-I0.876|5:14,,,,,3113,"firmware 2.70",250,0,,0,168070,250480,30378,,,,,,,,,,,,,,,,,,,,,,,,,,,,,,,,,,,,,,,,,,,
9050058,40d070ff-012e-4ea4-b86f-22964c632a29,1566036810,120,1566032944,,0,0,5.99,2007,2007,0,0,,,1,0,0,,,,425,158,186,,,,46.23,33.95,46.23,1,61.09,4198,,,3.2,,101,105,,,,,,61,82,10.75,14.91,14.91,6.9,,,,,,,,,,,,,,,,"50,4,3,4,3,3,5,27,1","0,20,27,45,8",,,,,,109,,,,,,,,,,,,,,,,,,,,,,,,,,,,,,,,,,,,72.3,20,12,198,76,,1013,3,297,0,5,3,,1,0,I0.452|1:41-I0.181|1:33-I0.305|0:58-I0.191|1:33-I0.497|1:40-I0.183|1:35-I0.300|0:58-I0.222|3:00-I0.501|1:37-I0.140|1:30-I0.301|0:57-I0.175|1:36-I0.507|1:39-I0.112|1:26-I0.302|1:01-I0.195|3:13-I0.302|1:00-I0.112|1:14-I0.200|0:36-I0.089|1:27-I0.297|0:57-I0.199|1:35-I0.195|0:35-I0.026|0:06,,,,,3113,"firmware 2.70",250,0,,0,168070,250480,30378,,,,,,,,,,,,,,,,,,,,,,,,,,,,,,,,,,,,,,,,,,,
9050060,14daa22d-d534-4053-9b0d-8ed4d95b1821,1566038985,120,1566032945,,0,0,2.53,898,1020,15,13,,,1,0,0.17,1.09,,,186,143,157,,,,49.26,29.99,49.67,1,60.66,4577,,,2.2,,94,95,,,,,,17,81,10.14,10.25,10.29,-6.5,,,,,,,,,,,,,,,,"12,32,43,12,2,0,0,0,0","0,23,77,0,0",,,,,,104,,,,,,,,,,,,,,,,,,,,,,,,,,,,,,,,,,,,23.6,21,15,206,72,,1013,3,296,0,5,3,,1,0,I1.000|6:17-I1.000|5:48-I0.527|2:54,,,,,3113,"firmware 2.70",250,0,,0,168070,250480,30378,,,,,,,,,,,,,,,,,,,,,,,,,,,,,,,,,,,,,,,,,,,
9077509,f1cec5ee-a671-4299-a769-87010ddec4e7,1566132268,120,1566130830,,0,0,14.1,4454,4808,67,64,,,1,0,0.12,,,,922,148,163,,,,54.38,38.67,54.72,1,60.62,3136,,,3.4,,96,95,,,,,,100,80,11.41,11.46,11.51,1.4,,,,,,,,,,,,,,,,"2,3,17,60,15,2,0,0,0","0,4,95,0,0",,,,,,119,,,,,,,,,,,,,,,,,,,,,,,,,,,,,,,,,,,,35.4,29,22,216,51,,1009,6,295,0,5,3,,1,0,I1.000|5:37-I1.000|5:17-I1.000|5:15-I1.000|5:02-I1.000|5:25-I1.000|4:57-I1.000|5:07-I1.000|5:25-I1.000|5:19-I1.000|5:21-I1.000|5:14-I1.000|5:11-I1.000|5:22-I1.000|5:11-I0.102|0:31,,,,,3113,"firmware 2.70",250,0,,0,168070,250480,30378,,,,,,,,,,,,,,,,,,,,,,,,,,,,,,,,,,,,,,,,,,,
9104237,839bbb75-804f-4a4c-a91a-5888234fbc05,1566246500,120,1566241812,,0,0,6.36,1707,1755,20,23,,,1,0,0.06,,,,380,151,164,113,,,64.74,44.31,64.95,1,61.22,1454,,,3,,102,101,,,,,,41,81,13.4,13.48,13.47,0.2,,,,,,,,,,,,,,,,"0,0,1,9,38,48,4,0,0","0,7,83,10,0",,,,,,138,,,,,,,,,,,,,,,,,,,,,,,,,,,,,,,,,,,,43.5,22,4,235,52,,1019,0,314,1,5,3,,1,0,I1.000|4:38-I1.000|4:48-I1.000|4:24-I1.000|4:08-I1.000|4:27-I1.000|4:25-I0.361|1:37,,,,,3113,"firmware 2.70",250,0,,0,168070,250480,30378,,,,,,,,,,,,,,,,,,,,,,,,,,,,,,,,,,,,,,,,,,,
9122715,f8ec0721-eff5-46e2-86c7-89851b1bce57,1566324492,120,1566322028,,0,0,11.8,3756,3756,49,50,,,1,0,0.07,,,,649,136,151,,,,60,37.79,60.31,1,60.45,1467,,,2.5,,98,97,,,,,,61,81,11.31,11.35,11.36,2.7,,,,,,,,,,,,,,,,"1,2,19,71,8,0,0,0,0","0,93,7,0,0",,,,,,116,,,,,,,,,,,,,,,,,,,,,,,,,,,,,,,,,,,,19.5,17,7,146,86,,1025,1,301,0,4,3,,1,0,I1.000|5:24-I1.000|5:21-I1.000|5:17-I1.000|5:12-I1.000|5:16-I1.000|5:18-I1.000|5:09-I1.000|5:10-I1.000|5:14-I1.000|5:27-I1.000|5:19-I0.802|4:29,,,,,3113,"firmware 2.70",250,0,,0,168070,250480,30378,,,,,,,,,,,,,,,,,,,,,,,,,,,,,,,,,,,,,,,,,,,
9146283,4f77089d-a43b-44d1-9e0d-197dd2d019c0,1566412071,120,1566408848,,0,0,12.41,3173,3421,42,43,,,1,0,0.07,,,,703,153,166,,,,67.52,48.97,67.79,1,61.26,1584,,,3.5,,105,102,,,,,,81,84,14.08,14.16,14.15,2.4,,,,,,,,,,,,,,,,"0,0,0,2,11,76,10,0,0","0,5,89,6,0",,,,,,140,,,,,,,,,,,,,,,,,,,,,,,,,,,,,,,,,,,,46,23,13,89,42,,1026,1,317,0,3,3,,1,0,I1.000|4:39-I1.000|4:26-I1.000|4:11-I1.000|4:15-I1.000|4:12-I1.000|4:09-I1.000|4:05-I1.000|4:06-I1.000|4:11-I1.000|4:20-I1.000|4:17-I1.000|4:12-I0.410|1:50,,,,,3113,"firmware 2.70",250,0,,0,168070,250480,30378,,,,,,,,,,,,,,,,,,,,,,,,,,,,,,,,,,,,,,,,,,,
9167103,ef197627-e768-46c9-a6de-0d3cd1a48be0,1566497203,120,1566494883,,0,0,4.51,1461,1461,22,23,,,1,0,0.24,,,,293,140,158,,,,56.65,34.76,56.97,1,61.09,932,,,2.5,,96,102,,,,,,27,81,11.1,12,12.02,0.6,,,,,,,,,,,,,,,,"10,1,23,26,15,25,0,0,0","1,39,60,0,0",,,,,,114,,,,,,,,,,,,,,,,,,,,,,,,,,,,,,,,,,,,29,26,17,39,43,,1024,1,307,0,3,3,,1,0,I1.000|5:31-I1.000|5:32-I1.000|4:38-I1.000|4:25-I0.505|4:14,,,,,3113,"firmware 2.70",250,0,,0,168070,250480,30378,,,,,,,,,,,,,,,,,,,,,,,,,,,,,,,,,,,,,,,,,,,
9167113,dd84042a-bd8c-4466-9eb2-7030792b1887,1566498833,120,1566494893,,0,0,6.39,1886,1886,0,0,,,1,0,0,,,,405,157,185,,,,54.55,39.62,54.55,1,61.49,3637,,,3.1,,102,106,,,,,,56,82,12.19,15.75,15.76,8.8,,,,,,,,,,,,,,,,"40,4,5,5,3,4,4,29,5","0,16,32,50,2",,,,,,124,,,,,,,,,,,,,,,,,,,,,,,,,,,,,,,,,,,,64.4,25,16,40,45,,1024,1,306,0,3,3,,1,0,I0.502|1:40-I0.206|1:23-I0.306|0:58-I0.198|1:13-I0.519|1:39-I0.184|1:14-I0.308|0:59-I0.240|3:05-I0.511|1:36-I0.194|1:27-I0.296|0:57-I0.199|1:24-I0.510|1:36-I0.176|1:23-I0.298|0:56-I0.223|2:54-I0.299|0:55-I0.182|1:21-I0.200|0:37-I0.129|1:07-I0.305|0:54-I0.178|1:30-I0.201|0:35-I0.019|0:05,,,,,3113,"firmware 2.70",250,0,,0,168070,250480,30378,,,,,,,,,,,,,,,,,,,,,,,,,,,,,,,,,,,,,,,,,,,
9176409,84c730cb-0e67-4683-9f15-193eef87c2db,1566542901,120,1566540365,,0,0,13.54,3745,4309,37,40,,,1,0,0.08,,,,883,158,180,,,,58.57,44.99,58.75,1,61.07,4604,,,4.2,,96,96,,,,,,109,82,13.01,13.06,13.07,1.2,,,,,,,,,,,,,,,,"0,0,3,15,41,40,1,0,0","0,4,49,47,0",,,,,,132,,,,,,,,,,,,,,,,,,,,,,,,,,,,,,,,,,,,67.8,12,6,24,100,,1025,0,304,0,3,3,,1,0,I1.000|5:09-I1.000|4:46-I1.000|4:47-I1.000|4:48-I1.000|4:47-I1.000|4:35-I1.000|4:26-I1.000|4:35-I1.000|4:27-I1.000|4:24-I1.000|4:17-I1.000|4:27-I1.000|4:28-I0.537|2:29,,,,,3113,"firmware 2.70",250,0,,0,168070,250480,30378,,,,,,,,,,,,,,,,,,,,,,,,,,,,,,,,,,,,,,,,,,,
9201539,fd03686c-0f8f-4b12-a2a7-9698e852d49c,1566659578,120,1566658744,,0,0,17.28,4958,5501,698,645,,,2,5.3,0.6,1.1,0.97,654,1074,154,174,,,,58.03,43.95,61.16,1,60.95,2842,,,3.9,,100,98,,,,,,131,83,13.29,12.87,13.97,1.1,,,,,,,,,,,,,,,,"7,5,10,14,23,27,12,0,0","0,11,58,30,0",,,,,,126,,,,,,,,,,,,,,,,,,,,,,,,,,,,,,,,,,,,64.1,15,3,5,63,,1014,0,302,0,3,3,,1,0,I1.000|5:10-I1.000|4:30-I1.000|5:15-I1.000|5:14-I1.000|5:08-I1.000|5:47-I1.000|5:30-I1.000|5:12-I1.000|4:22-I1.000|4:55-I1.000|4:32-I1.000|4:29-I1.000|4:37-I1.000|4:35-I1.000|4:10-I1.000|3:51-I1.000|3:55-I0.284|1:25,,,,,3113,"firmware 2.70",250,0,,0,168070,250480,30378,,,,,,,,,,,,,,,,,,,,,,,,,,,,,,,,,,,,,,,,,,"3,4,4,5,5,5,5,5",
9217363,bd9f7caf-3978-41db-aab7-48b49afe453a,1566746203,120,1566744724,,0,0,14.12,4577,5542,491,506,,,2,4.5,0.68,1.2,1.03,459,894,147,170,,,,53.15,37.52,55.37,1,60.35,2573,,,3.4,,96,97,,,,,,101,82,11.67,11.31,12.33,2.4,,,,,,,,,,,,,,,,"17,10,16,22,28,7,1,0,0","0,21,73,6,0",,,,,,113,,,,,,,,,,,,,,,,,,,,,,,,,,,,,,,,,,,,42.4,14,3,312,85,,1020,0,294,0,5,3,,1,0,I1.000|5:39-I1.000|5:27-I1.000|6:15-I1.000|5:53-I1.000|5:56-I1.000|5:59-I1.000|5:45-I1.000|5:44-I1.000|4:46-I1.000|5:16-I1.000|4:48-I1.000|4:44-I1.000|4:43-I1.000|4:41-I0.124|0:42,,,,,3113,"firmware 2.70",250,0,,0,168070,250480,30378,,,,,,,,,,,,,,,,,,,,,,,,,,,,,,,,,,,,,,,,,,2,
9232849,2cfef75b-1715-4e72-88ff-82c94b8e59e2,1566831908,120,1566829748,,0,0,16.25,4556,4841,581,581,,,2,4.8,0.71,1.05,1.04,579,952,151,172,,,,61.34,44.93,64.06,1,60.23,2279,,,3.6,,100,99,,,,,,111,83,13.5,13.66,13.93,-8.1,,,,,,,,,,,,,,,,"5,5,13,22,15,16,18,5,0","0,7,86,6,0",,,,,,129,,,,,,,,,,,,,,,,,,,,,,,,,,,,,,,,,,,,41.8,13,5,332,83,,1021,0,290,0,3,3,,1,0,I1.000|5:02-I1.000|5:05-I1.000|5:37-I1.000|5:46-I1.000|5:32-I1.000|5:06-I1.000|5:18-I1.000|5:12-I1.000|4:06-I1.000|3:40-I1.000|3:50-I1.000|3:47-I1.000|4:08-I1.000|3:57-I1.000|4:22-I1.000|4:26-I0.252|1:01,,,,,3113,"firmware 2.70",250,0,,0,168070,250480,30378,,,,,,,,,,,,,,,,,,,,,,,,,,,,,,,,,,,,,,,,,,"4,4,5,5",
9252765,e186bfc8-c670-47a0-baa6-5d47cadabf03,1566919009,120,1566915006,,0,0,9.75,2627,2942,248,279,,,2,2.7,0.51,1.03,0.93,500,550,146,163,,,,67.4,45.29,69.26,1,61.03,1338,,,3,,101,103,,,,,,57,82,13.31,13.62,13.58,-6.8,,,,,,,,,,,,,,,,"2,1,2,6,38,40,10,1,0","1,12,86,1,0",,,,,,136,,,,,,,,,,,,,,,,,,,,,,,,,,,,,,,,,,,,37,17,9,13,60,,1014,0,290,0,3,3,,1,0,I1.000|4:52-I1.000|4:47-I1.000|4:34-I1.000|4:41-I1.000|4:35-I1.000|4:31-I1.000|4:34-I1.000|4:18-I1.000|3:42-I0.748|3:15,,,,,3113,"firmware 2.70",250,0,,0,168070,250480,30378,,,,,,,,,,,,,,,,,,,,,,,,,,,,,,,,,,,,,,,,,,"4,4,5",
9275916,17f72ef3-cfc9-4093-802c-4bd5a685b3dd,1567006164,120,1567003984,,0,0,13.71,4559,4778,536,542,,,2,5.1,0.63,1.11,1.03,464,936,152,179,,,,49.25,36.33,51.61,1,60.07,2334,,,3.7,,97,95,,,,,,115,81,11.23,11.21,11.73,-2.2,,,,,,,,,,,,,,,,"20,15,18,19,21,5,1,0,0","0,12,69,19,0",,,,,,111,,,,,,,,,,,,,,,,,,,,,,,,,,,,,,,,,,,,53.6,17,3,35,72,,1009,0,292,0,3,3,,1,0,I1.000|5:30-I1.000|5:27-I1.000|5:37-I1.000|5:49-I1.000|6:02-I1.000|6:19-I1.000|6:40-I1.000|6:33-I1.000|4:43-I1.000|4:44-I1.000|5:09-I1.000|4:56-I1.000|4:54-I0.707|3:36,,,,,3113,"firmware 2.70",250,0,,0,168070,250480,30378,,,,,,,,,,,,,,,,,,,,,,,,,,,,,,,,,,,,,,,,,,"3,4,4,4",
9297451,e32eb5bd-92fd-4c50-ac63-89ace5823107,1567092784,120,1567090369,,0,0,13.83,3755,3852,167,167,,,2,1.4,0.31,1.07,0.96,828,849,156,186,,,,61.01,46.04,61.93,1,59.8,2768,,,4,,102,100,,,,,,106,82,13.29,13.71,13.8,1.5,,,,,,,,,,,,,,,,"2,1,2,11,41,28,15,1,0","0,3,62,32,3",,,,,,135,,,,,,,,,,,,,,,,,,,,,,,,,,,,,,,,,,,,83.5,19,3,240,84,,1014,0,297,0,4,3,,1,0,I1.000|4:56-I1.000|4:35-I1.000|4:38-I1.000|4:49-I1.000|4:35-I1.000|4:43-I1.000|4:31-I1.000|4:28-I1.000|4:20-I1.000|4:19-I0.963|4:10-I0.680|2:34-I0.066|1:07-I0.689|2:31-I1.000|4:25-I0.436|1:53,,,,,3113,"firmware 2.70",250,0,,0,168070,250480,30378,,,,,,,,,,,,,,,,,,,,,,,,,,,,,,,,,,,,,,,,,,4,
9320806,6cb7ec8c-0f05-4ed0-bb2a-880df313b5fb,1567183855,120,1567182126,,0,0,13.21,4198,4501,488,484,,,2,4.2,0.68,1.01,0.88,495,967,161,191,,,,48.04,38.2,50.26,1,59.45,4538,,,4.4,,99,95,,,,,,132,82,11.85,11.95,12.5,11.2,,,,,,,,,,,,,,,,"21,8,15,18,14,18,4,2,0","0,3,47,45,5",,,,,,115,,,,,,,,,,,,,,,,,,,,,,,,,,,,,,,,,,,,101.7,19,5,151,75,,1018,0,290,0,4,3,,1,0,I1.000|4:49-I1.000|5:22-I1.000|5:45-I1.000|5:34-I1.000|5:57-I1.000|6:02-I1.000|6:24-I1.000|5:13-I1.000|4:13-I1.000|4:32-I1.000|6:03-I1.000|4:30-I1.000|4:51-I0.214|0:43,,,,,3113,"firmware 2.70",250,0,,0,168070,250480,30378,,,,,,,,,,,,,,,,,,,,,,,,,,,,,,,,,,,,,,,,,,"4,4,5",
9375359,8855f324-d5da-4ac0-afb4-e6bb350b3cf6,1567369388,120,1567445825,,0,0,7.97,2237,2261,173,175,,,1,2.7,0.85,1,0.99,511,463,146,167,,,,64.07,42.61,65.78,1,60.17,1338,,,3,,104,100,,,,,,49,81,13.3,13.15,13.37,4.6,,,,,,,,,,,,,,,,"4,4,3,20,27,34,8,0,0","0,17,81,1,0",,,,,,132,,,,,,,,,,,,,,,,,,,,,,,,,,,,,,,,,,,,35.3,17,14,331,63,,1018,0,280,1,5,3,,1,0,I1.000|5:44-I1.000|4:11-I1.000|4:26-I1.000|5:02-I1.000|4:33-I1.000|4:23-I1.000|4:47-I0.968|4:09,,,,,3113,"firmware 2.70",250,0,,0,168070,250480,30378,,,,,,,,,,,,,,,,,,,,,,,,,,,,,,,,,,,,,,,,,,"5,5",
9375361,1a994040-b836-4613-b822-b424611a1bb0,1567447892,120,1567445827,,0,0,11.48,3462,4769,53,51,,,1,0,0.11,,,,612,137,158,,,,63.57,40.17,63.95,1,60.04,1190,,,2.6,,104,97,,,,,,59,81,11.96,12.11,12.17,1.5,,,,,,,,,,,,,,,,"1,1,14,46,26,10,2,0,0","1,65,35,0,0",,,,,,123,,,,,,,,,,,,,,,,,,,,,,,,,,,,,,,,,,,,23.9,22,11,11,36,,1023,1,294,0,3,3,,1,0,I1.000|4:20-I1.000|4:28-I1.000|5:19-I1.000|5:09-I1.000|5:19-I1.000|5:10-I1.000|5:18-I1.000|5:17-I1.000|5:05-I1.000|5:12-I1.000|4:43-I0.478|2:22,,,,,3113,"firmware 2.70",250,0,,0,168070,250480,30378,,,,,,,,,,,,,,,,,,,,,,,,,,,,,,,,,,,,,,,,,,,
9420860,26cfabc4-f610-4913-af81-9b24e2e9dde2,1567619340,120,1567616408,,0,0,2.35,985,992,0,2,,,1,0,0,,,,187,141,167,,,,40.85,24.45,40.8,1,61.68,1728,,,2.3,,,100,,,,,,19,67,8.51,12.6,12.67,32,,,,,,,,,,,,,,,,"65,3,3,3,4,3,5,9,5","0,37,56,7,0",,,,,,107,,,,,,,,,,,,,,,,,,,,,,,,,,,,,,,,,,,,31.8,26,17,207,37,,1015,1,275,0,3,3,,1,0,I0.127|0:22-I0.080|0:54-I0.136|0:24-I0.068|0:47-I0.128|0:22-I0.074|0:47-I0.125|0:24-I0.075|0:49-I0.127|0:23-I0.090|0:53-I0.128|0:24-I0.068|0:45-I0.132|0:21-I0.076|0:48-I0.131|0:24-I0.067|0:50-I0.129|0:23-I0.083|0:55-I0.138|0:24-I0.362|5:06,,,,,3113,"firmware 2.70",250,0,,0,168070,250480,30378,,,,,,,,,,,,,,,,,,,,,,,,,,,,,,,,,,,,,,,,,,,
9420862,bde8202e-56ec-488c-8a00-49fd8dedb976,1567617063,120,1567616409,,0,0,8.01,2048,2051,33,33,,,1,0,0.16,,,,483,155,168,,,,66.31,47.56,66.65,1,61.68,1396,,,3.3,,102,100,,,,,,55,82,14.09,14.13,14.16,3.6,,,,,,,,,,,,,,,,"0,0,0,0,9,84,7,0,0","1,2,80,18,0",,,,,,143,,,,,,,,,,,,,,,,,,,,,,,,,,,,,,,,,,,,50.3,27,18,200,36,,1015,2,275,0,3,3,,1,0,,,,,,3113,"firmware 2.70",250,0,,0,168070,250480,30378,,,,,,,,,,,,,,,,,,,,,,,,,,,,,,,,,,,,,,,,,,,
9420866,0faa25af-821a-469e-ad4a-e97444ee2b17,1567621495,120,1567616412,,0,0,10.04,2005,2005,30,25,,,1,0,0.06,,,,214,107,128,,,,,,,1,61.68,1675,,,,,,100,,,,,,13,,,18.4,,-11.6,,90,83,,1,166,162,,,,,,,,,"6,73,21,0,0,0,0","14,86,0,0,0","91,2,1,1,5",,,,,,,,,,,,,,,,,,,,,,,,,,,,,,,,,,,,,,,,,4.6,26,16,208,38,,1014,1,274,0,3,3,,1,0,I5.000|17:40-I5.000|15:36-I0.038|0:08,,,,,3113,"firmware 2.70",250,0,,0,168072,,30378,,,,,,,,,,,,,,,,,,,,,,,,,,,,,,,,,,,,,,,,,,,
9420936,f30220d3-2f64-4430-aeaa-264be08ab3ca,1567534013,120,1567616765,,0,0,16.49,4256,4929,63,64,,,1,0,0.15,,,,890,152,184,,,,67.34,49.5,67.65,1,61.32,1626,,,3.5,,104,104,,,,,,107,85,13.95,15,15.04,12.9,,,,,,,,,,,,,,,,"7,0,1,7,18,25,34,8,0","0,9,76,14,0",,,,,,137,,,,,,,,,,,,,,,,,,,,,,,,,,,,,,,,,,,,56.1,24,14,184,31,,1023,1,275,0,3,3,,1,0,I1.000|4:22-I1.000|4:26-I1.000|4:22-I0.603|2:39-I2.433|8:52-I0.480|2:30-I2.438|9:01-I0.349|2:28-I2.445|8:30-I0.197|3:22-I2.455|10:48-I2.090|9:37,,,,,3113,"firmware 2.70",250,0,,0,168070,250480,30378,,,,,,,,,,,,,,,,,,,,,,,,,,,,,,,,,,,,,,,,,,,
9445916,d5346633-76aa-4355-8dd2-24b2bbb2ac72,1567706756,120,1567714991,,0,0,15.81,4096,4368,50,51,,,1,0,0.03,,,,863,150,179,,,,68.24,49.12,68.51,1,62.48,1584,,,3.5,,101,102,,,,,,98,83,13.89,14.59,14.59,8.6,,,,,,,,,,,,,,,,"3,1,3,7,10,61,11,4,1","0,10,76,13,0",,,,,,140,,,,,,,,,,,,,,,,,,,,,,,,,,,,,,,,,,,,50.2,20,6,336,44,,1021,1,312,0,4,3,,1,0,I1.000|4:18-I1.000|4:26-I1.000|4:10-I1.000|4:08-I1.000|4:04-I1.000|4:13-I1.000|4:31-I1.000|4:19-I1.000|4:14-I1.000|4:09-I1.000|4:08-I0.716|2:57-I0.173|0:52-I0.195|0:38-I0.211|1:02-I0.198|0:38-I0.209|1:01-I0.203|0:39-I0.209|1:01-I0.208|0:38-I0.209|1:03-I0.201|0:37-I0.207|1:02-I0.206|0:38-I0.208|1:04-I0.201|0:36-I0.208|1:00-I0.206|0:36-I0.842|5:35,,,,,3113,"firmware 2.70",250,0,,0,168070,250480,30378,,,,,,,,,,,,,,,,,,,,,,,,,,,,,,,,,,,,,,,,,,,
9459192,d7897adb-3de5-454b-953f-f690f0b35b7f,1567782284,120,1567779544,,0,0,4.46,1167,1193,21,26,,,1,0,0.24,,,,270,150,162,99,,,67.41,44.68,67.71,1,62.88,1106,,,2.7,,101,100,,,,,,27,83,13.7,13.72,13.67,1.9,,,,,,,,,,,,,,,,"0,0,0,2,17,81,0,0,0","1,6,91,2,0",,,,,,138,,,,,,,,,,,,,,,,,,,,,,,,,,,,,,,,,,,,35.3,20,11,6,47,,1022,3,309,0,4,3,,1,0,I1.000|4:31-I1.000|4:23-I1.000|4:14-I1.000|4:18-I0.458|2:01,,,,,3113,"firmware 2.70",250,0,,0,168070,250480,30378,,,,,,,,,,,,,,,,,,,,,,,,,,,,,,,,,,,,,,,,,,,
9459196,b101e7a2-b0d5-4f0d-a4e5-ff4d1489ca2a,1567786279,120,1567779569,,0,0,1.3,361,361,0,0,,,1,0,0.21,,,,87,155,164,,,,59.88,37.08,59.88,1,63.26,3048,,,1.8,,97,97,,,,,,9,84,12.94,13.05,13.08,1.3,,,,,,,,,,,,,,,,"0,1,3,14,50,30,2,0,0","0,5,73,22,0",,,,,,129,,,,,,,,,,,,,,,,,,,,,,,,,,,,,,,,,,,,27.9,20,10,2,43,,1022,3,307,0,5,3,,1,0,I1.000|4:39-I0.298|1:23,,,,,3113,"firmware 2.70",250,0,,0,168070,250480,30378,,,,,,,,,,,,,,,,,,,,,,,,,,,,,,,,,,,,,,,,,,,
9459199,87aff40d-bfcb-4cf5-893a-cd0cd5f17d70,1567783942,120,1567779573,,0,0,6.27,2305,2305,1,0,,,1,0,0,,,,448,149,181,,,,44.7,30.47,44.72,1,63.46,3054,,,3.1,,104,108,,,,,,58,78,9.8,15.37,15.39,32.4,,,,,,,,,,,,,,,,"53,1,3,5,2,3,5,26,1","0,33,26,40,0",,,,,,105,,,,,,,,,,,,,,,,,,,,,,,,,,,,,,,,,,,,56.1,20,10,2,43,,1022,3,307,0,5,3,,1,0,I0.300|1:37-I0.499|1:38-I0.148|1:14-I0.312|0:58-I0.154|1:14-I0.511|1:38-I0.126|1:04-I0.312|0:58-I0.246|3:07-I0.506|1:37-I0.120|1:15-I0.304|0:58-I0.175|1:43-I0.507|1:39-I0.117|1:28-I0.302|0:59-I0.223|3:23-I0.303|0:58-I0.103|1:13-I0.203|0:37-I0.104|1:10-I0.302|0:57-I0.107|1:07-I0.197|0:37-I0.092|5:19,,,,,3113,"firmware 2.70",250,0,,0,168070,250480,30378,,,,,,,,,,,,,,,,,,,,,,,,,,,,,,,,,,,,,,,,,,,
9480221,ab43a31d-a29f-49f1-906f-556ac2bd019f,1567889800,120,1567883644,,0,0,3.09,904,904,58,58,,,1,1.6,0.8,,,446,192,142,161,,,,63.1,38.2,64.57,1,63.31,1314,,,2.1,,99,99,,,,,,17,81,12.57,12.42,12.68,-0.8,,,,,,,,,,,,,,,,"0,5,5,34,35,21,0,0,0","0,46,51,3,0",,,,,,127,,,,,,,,,,,,,,,,,,,,,,,,,,,,,,,,,,,,22.9,12,1,107,95,,1020,0,329,1,4,3,,1,0,I1.000|5:10-I1.000|5:02-I1.000|4:28-I0.089|0:25,,,,,3113,"firmware 2.80",250,0,,0,168070,250480,30378,,,,,,,,,,,,,,,,,,,,,,,,,,,,,,,,,,,,,,,,,,5,
9485552,71642204-0acb-44b2-be0e-e279d82629ca,1567937079,120,1567938249,,0,0,13.22,3847,4083,345,343,,,1,3.8,0.76,1.1,1.08,457,977,164,188,,,,52.13,42.33,53.82,1,61.87,3745,,,4.4,,96,94,,,,,,130,83,13.11,13.17,13.34,0.4,,,,,,,,,,,,,,,,"8,4,20,28,8,13,20,1,0","0,2,30,66,2",,,,,,124,,,,,,,,,,,,,,,,,,,,,,,,,,,,,,,,,,,,92.1,12,12,26,91,,1019,2,332,0,6,3,,1,0,I1.000|6:05-I1.000|5:10-I1.000|5:00-I1.000|5:41-I1.000|5:33-I1.000|5:27-I1.000|5:52-I1.000|4:54-I1.000|4:06-I1.000|3:57-I1.000|3:54-I1.000|3:48-I1.000|3:45-I0.220|0:55,,,,,3113,"firmware 2.80",250,0,,0,168070,250480,30378,,,,,,,,,,,,,,,,,,,,,,,,,,,,,,,,,,,,,,,,,,3,
9514410,a2472500-f18f-47d6-9f59-22d90d8d4f6f,1568051752,120,1568049039,,0,0,15.02,3576,3765,38,38,,,1,0,0.04,,,,862,160,178,,,,69.25,53.95,69.46,1,61.95,3744,,,4,,103,100,,,,,,108,85,15.12,15.19,15.2,5.3,,,,,,,,,,,,,,,,"0,0,0,0,2,40,58,1,0","0,2,43,55,0",,,,,,148,,,,,,,,,,,,,,,,,,,,,,,,,,,,,,,,,,,,71.4,16,12,195,64,,1015,1,317,0,5,3,,1,0,I1.000|4:05-I1.000|4:09-I1.000|4:00-I1.000|4:00-I1.000|3:59-I1.000|4:03-I1.000|3:49-I1.000|3:55-I1.000|3:56-I1.000|3:56-I1.000|4:02-I1.000|3:51-I1.000|3:56-I1.000|3:56-I1.000|3:55-I0.021|0:05,,,,,3113,"firmware 2.80",250,0,,0,168070,250480,30378,,,,,,,,,,,,,,,,,,,,,,,,,,,,,,,,,,,,,,,,,,,
9543535,b1f4a74c-10ac-41fb-8be4-65c8555aaaec,1568138922,120,1568136139,,0,0,4.42,1136,1142,30,30,,,1,0,0.24,,,,246,144,159,118,,,72.76,45.6,73.37,1,62.69,1584,,,2.4,,104,102,,,,,,23,83,13.98,14.02,14.03,3.6,,,,,,,,,,,,,,,,"0,0,0,1,19,70,10,0,0","2,17,81,0,0",,,,,,141,,,,,,,,,,,,,,,,,,,,,,,,,,,,,,,,,,,,27.6,19,12,8,49,,1018,1,313,0,4,3,,1,0,I1.000|4:29-I1.000|4:16-I1.000|4:13-I1.000|4:15-I0.415|1:43,,,,,3113,"firmware 2.80",250,0,,0,168070,250480,30378,,,,,,,,,,,,,,,,,,,,,,,,,,,,,,,,,,,,,,,,,,,
9543548,00f1a113-8067-45b6-89e0-53498915d1a5,1568140312,120,1568136188,,0,0,6.13,1600,1600,23,24,,,1,0,0,,,,360,157,185,,,,63.49,45.69,63.77,1,63.2,3856,,,3.2,,100,100,,,,,,49,82,13.79,16.71,16.71,12.8,,,,,,,,,,,,,,,,"13,3,7,15,13,7,4,34,3","1,17,29,44,9",,,,,,140,,,,,,,,,,,,,,,,,,,,,,,,,,,,,,,,,,,,76.9,19,10,13,59,,1018,0,314,0,4,3,,1,0,I0.188|1:13-I0.594|1:58-I0.408|2:04-I0.618|1:57-I0.407|2:03-I0.614|1:55-I0.421|2:02-I0.609|1:55-I0.423|2:07-I0.620|1:53-I0.413|2:27-I0.613|1:58-I0.205|3:08,,,,,3113,"firmware 2.80",250,0,,0,168070,250480,30378,,,,,,,,,,,,,,,,,,,,,,,,,,,,,,,,,,,,,,,,,,,
9543549,7554fffa-4bd5-4e44-aee5-eced5d5709b5,1568142014,120,1568136189,,0,0,2.2,722,722,4,4,,,1,0,0,,,,147,136,141,,,,57.78,32.47,57.91,1,62.91,3844,,,1.8,,97,97,,,,,,11,82,10.95,11.06,11.06,-0.4,,,,,,,,,,,,,,,,"2,4,43,46,6,0,0,0,0","0,100,0,0,0",,,,,,111,,,,,,,,,,,,,,,,,,,,,,,,,,,,,,,,,,,,15.3,18,10,13,59,,1018,0,314,0,4,3,,1,0,I1.000|5:34-I1.000|5:21-I0.196|1:07,,,,,3113,"firmware 2.80",250,0,,0,168070,250480,30378,,,,,,,,,,,,,,,,,,,,,,,,,,,,,,,,,,,,,,,,,,,
9562953,1d8b2eac-248c-4ee0-ba3a-fed50cbb1eae,1568226665,120,1568222644,,0,0,0.91,318,318,2,4,,,1,0,0,,,,65,135,143,,,,53.96,27.44,53.96,1,62.78,2440,,,,,,93,,,,,,5,80,10.21,10.21,10.14,3.9,,,,,,,,,,,,,,,,"2,17,80,0,0,0,0,0,0","2,74,23,0,0",,,,,,107,,,,,,,,,,,,,,,,,,,,,,,,,,,,,,,,,,,,9.9,20,5,180,56,,1025,,,0,2,1,,1,0,,,,,,3113,"firmware 2.80",250,0,,0,168070,250480,30378,,,,,,,,,,,,,,,,,,,,,,,,,,,,,,,,,,,,,,,,,,,
9562961,0aafb940-09eb-4312-a842-6ca517702828,1568227004,120,1568222648,,0,0,4.1,927,927,0,1,,,1,0,0,,,,232,162,170,,,,72.51,52.64,72.48,1,64.2,3456,,,2.8,,105,105,,,,,,29,85,15.92,16.11,16.1,0.6,,,,,,,,,,,,,,,,"0,0,0,0,0,15,83,2,0","0,1,31,68,0",,,,,,156,,,,,,,,,,,,,,,,,,,,,,,,,,,,,,,,,,,,57.3,20,5,180,56,,1025,,,0,2,1,,1,0,I1.000|4:01-I0.004|0:02-I1.020|3:42-I1.031|3:58-I1.049|3:45,,,,,3113,"firmware 2.80",250,0,,0,168070,250480,30378,,,,,,,,,,,,,,,,,,,,,,,,,,,,,,,,,,,,,,,,,,,
9562966,7e71b8ac-da97-47ae-bb32-db067302c357,1568228453,120,1568222651,,0,0,2.73,768,772,17,17,,,1,0,0.08,,,,178,146,153,,,,63.89,39.55,64.38,1,64.02,4141,,,2.2,,98,98,,,,,,16,83,12.81,12.85,12.86,2.9,,,,,,,,,,,,,,,,"0,1,0,15,65,19,0,0,0","1,6,93,0,0",,,,,,128,,,,,,,,,,,,,,,,,,,,,,,,,,,,,,,,,,,,25.1,20,11,278,52,,1026,0,289,0,5,3,,1,0,,,,,,3113,"firmware 2.80",250,0,,0,168070,250480,30378,,,,,,,,,,,,,,,,,,,,,,,,,,,,,,,,,,,,,,,,,,,
9588310,a35ff425-b77f-4ff9-ac4f-4981fa33d335,1568312211,120,1568310009,,0,0,4.44,1188,1188,29,29,,,1,0,0.19,,,,276,147,158,,,,67.37,43.52,67.91,1,64.09,2739,,,2.5,,101,100,,,,,,26,81,13.45,13.54,13.55,3.4,,,,,,,,,,,,,,,,"0,0,0,0,39,59,1,0,0","1,5,94,0,0",,,,,,138,,,,,,,,,,,,,,,,,,,,,,,,,,,,,,,,,,,,30,22,8,230,57,,1030,0,273,0,3,3,,1,0,,,,,,3113,"firmware 2.80",250,0,,0,168070,250480,30378,,,,,,,,,,,,,,,,,,,,,,,,,,,,,,,,,,,,,,,,,,,
9588314,a418abb0-9cfb-4776-b0ac-12e43dad6116,1568313822,120,1568310063,,0,0,8.59,2405,2405,0,0,,,1,0,0,,,,523,152,185,,,,60.89,42.94,60.89,1,64.15,5760,,,3.4,,104,100,,,,,,68,79,12.85,15.94,15.95,18.4,,,,,,,,,,,,,,,,"17,3,10,21,5,2,4,37,0","1,32,25,29,14",,,,,,136,,,,,,,,,,,,,,,,,,,,,,,,,,,,,,,,,,,,86.5,22,8,230,57,,1030,0,273,0,3,3,,1,0,I0.609|3:13-I1.024|3:25-I0.616|3:11-I1.026|3:24-I0.607|3:21-I1.028|3:24-I0.610|3:23-I1.008|3:23-I0.612|3:37-I1.015|3:20-I0.435|6:24,,,,,3113,"firmware 2.80",250,0,,0,168070,250480,30378,,,,,,,,,,,,,,,,,,,,,,,,,,,,,,,,,,,,,,,,,,,
9588323,d2b65c53-8b09-4439-bd7c-668cd8312ff3,1568316312,120,1568310124,,0,0,2.14,714,714,3,4,,,1,0,0.03,,,,151,138,145,,,,55.61,31.77,55.67,1,63.8,5748,,,1.9,,95,95,,,,,,12,82,10.79,10.87,10.86,2.3,,,,,,,,,,,,,,,,"4,11,38,43,3,0,0,0,0","0,78,22,0,0",,,,,,110,,,,,,,,,,,,,,,,,,,,,,,,,,,,,,,,,,,,15.9,22,7,226,63,,1030,0,273,0,3,3,,1,0,I2.134|11:50-I0.005|0:03-I0.004|0:01,,,,,3113,"firmware 2.80",250,0,,0,168070,250480,30378,,,,,,,,,,,,,,,,,,,,,,,,,,,,,,,,,,,,,,,,,,,
9605842,247defd3-7726-4dd6-a124-8648c6f42434,1568390118,120,1568387223,,0,0,11.63,2870,3085,49,53,,,1,0,0.04,,,,710,158,178,,,,67.44,50.8,67.76,1,64.01,4479,,,3.6,,98,99,,,,,,84,83,14.57,14.71,14.72,1.7,,,,,,,,,,,,,,,,"0,0,0,2,6,58,35,0,0","0,3,59,39,0",,,,,,146,,,,,,,,,,,,,,,,,,,,,,,,,,,,,,,,,,,,73.7,23,10,344,61,,1031,3,262,0,5,3,,1,0,I1.000|4:20-I1.000|4:14-I1.000|4:13-I1.000|4:12-I1.000|4:11-I1.000|4:11-I1.000|4:00-I1.000|4:04-I1.000|3:55-I1.000|4:01-I1.000|3:56-I0.519|1:59-I0.106|0:33,,,,,3113,"firmware 2.80",250,0,,0,168070,250480,30378,,,,,,,,,,,,,,,,,,,,,,,,,,,,,,,,,,,,,,,,,,,
9615074,5e664d60-c077-4810-92fa-91ca45ada8cd,1568456466,120,1568453529,,0,0,15,4065,4095,44,44,,,1,0,0.01,,,,924,156,182,112,,,61.16,46.43,61.38,1,63.75,4493,,,4.1,,95,98,,,,,,116,83,13.28,14.33,14.36,5.2,,,,,,,,,,,,,,,,"2,1,5,30,29,10,11,11,0","0,6,52,41,1",,,,,,133,,,,,,,,,,,,,,,,,,,,,,,,,,,,,,,,,,,,90.5,15,20,25,88,,1032,2,264,0,4,3,,1,0,I1.000|5:07-I1.000|4:52-I1.000|5:06-I1.000|4:54-I1.000|4:56-I0.195|1:01-I0.307|1:01-I0.231|1:00-I0.303|1:01-I0.190|1:00-I0.301|1:01-I0.224|1:00-I0.290|1:01-I0.224|1:00-I0.305|1:01-I0.216|1:01-I0.280|1:02-I0.240|1:02-I0.302|1:01-I0.206|1:01-I0.283|1:01-I0.243|1:05-I0.292|1:01-I0.216|1:00-I0.301|1:01-I0.216|1:00-I0.298|1:02-I0.217|1:02-I0.284|1:01-I0.226|1:01-I0.287|1:01-I0.212|1:01-I0.306|1:01-I0.205|1:01-I0.304|1:01-I1.000|5:31-I1.000|5:06-I0.292|1:39,,,,,3113,"firmware 2.80",250,0,,0,168070,250480,30378,,,,,,,,,,,,,,,,,,,,,,,,,,,,,,,,,,,,,,,,,,,
9643459,76884c09-55ab-4269-8e17-c1042b9845c2,1568577056,120,1568573107,,0,0,9.5,3099,3113,40,34,,,1,0,0.06,,,,540,132,152,,,,60.34,36.13,60.71,1,63.08,2501,,,2.3,,,95,,,,,,46,79,11.06,11.15,11.22,-4.5,,,,,,,,,,,,,,,,"1,5,46,36,11,1,0,0,0","0,95,5,0,0",,,,,,116,,,,,,,,,,,,,,,,,,,,,,,,,,,,,,,,,,,,19.4,24,10,266,60,,1022,0,262,1,3,3,,1,0,I1.000|5:47-I1.000|5:36-I1.000|5:40-I1.000|5:41-I1.000|5:32-I1.000|5:32-I1.000|5:12-I1.000|4:59-I1.000|5:00-I0.500|2:39,,,,,3113,"firmware 2.80",250,0,,0,168070,250480,30378,,,,,,,,,,,,,,,,,,,,,,,,,,,,,,,,,,,,,,,,,,,
9661519,25fd7c64-048f-43a3-b5e8-4f5d549fe866,1568659316,120,1568656871,,0,0,15.01,3717,4114,49,51,,,1,0,0.03,,,,900,158,177,,,,67.15,51.55,67.41,1,62.77,2556,,,3.8,,100,97,,,,,,108,83,14.53,14.6,14.61,4.3,,,,,,,,,,,,,,,,"0,0,0,0,5,68,27,0,0","0,3,53,44,0",,,,,,146,,,,,,,,,,,,,,,,,,,,,,,,,,,,,,,,,,,,69.2,24,9,186,44,,1018,0,257,0,5,3,,1,0,I1.000|4:19-I1.000|4:10-I1.000|4:14-I1.000|4:13-I1.000|4:07-I1.000|4:05-I1.000|4:06-I1.000|4:07-I1.000|4:08-I1.000|4:04-I1.000|4:07-I1.000|3:58-I1.000|4:03-I1.000|4:05-I1.000|4:08-I0.011|0:02,,,,,3113,"firmware 2.80",250,0,,0,168070,250480,30378,,,,,,,,,,,,,,,,,,,,,,,,,,,,,,,,,,,,,,,,,,,
9676491,9bca5aee-20b9-414f-9ff0-3f1f9e2aa5d4,1568743605,120,1568739172,,0,0,8.83,2713,2713,32,34,,,1,0,0.02,,,,617,150,177,,,,55.28,38.57,55.51,1,62,2255,,,3.3,,99,94,,,,,,65,80,11.71,11.76,11.77,7.7,,,,,,,,,,,,,,,,"0,0,7,73,17,3,0,0,0","0,14,75,11,0",,,,,,122,,,,,,,,,,,,,,,,,,,,,,,,,,,,,,,,,,,,44.9,19,9,263,53,,1020,0,275,0,5,3,,1,0,I1.000|5:00-I1.000|5:10-I1.000|5:10-I1.000|5:11-I1.000|5:14-I1.000|5:18-I1.000|5:10-I1.000|5:08-I0.828|3:52,,,,,3113,"firmware 2.80",250,0,,0,168070,250480,30378,,,,,,,,,,,,,,,,,,,,,,,,,,,,,,,,,,,,,,,,,,,
9679138,1a28f956-5b7e-4a96-8f47-e89d5ccdb2a5,1568748430,120,1568742609,,0,0,1.72,750,761,5,5,,,1,0,0,0.01,,,137,131,148,,,,42.56,22.72,42.71,1,62.11,4746,,,1.5,,95,94,,,,,,11,80,8.32,9.67,9.67,25.4,,,,,,,,,,,,,,,,"31,19,43,7,0,0,0,0,0","0,88,12,0,0",,,,,,86,,,,,,,,,,,,,,,,,,,,,,,,,,,,,,,,,,,,14,18,16,177,60,,1021,0,278,0,5,3,,1,0,,,,,,3113,"firmware 2.80",250,0,,0,168070,250480,30378,,,,,,,,,,,,,,,,,,,,,,,,,,,,,,,,,,,,,,,,,,,
9679171,ad2c675d-877e-44c8-9e27-fa634f2c5991,1568746684,120,1568742652,,0,0,6.83,1734,1734,4,0,,,1,0,0,,,,412,161,187,,,,63.38,47.51,63.47,1,62.47,4758,,,3.3,,100,103,,,,,,56,85,14.24,16.38,16.4,13.3,,,,,,,,,,,,,,,,"13,4,12,8,4,2,15,41,0","0,15,27,48,10",,,,,,139,,,,,,,,,,,,,,,,,,,,,,,,,,,,,,,,,,,,84.8,17,16,177,60,,1021,0,278,0,5,3,,1,0,I1.003|3:26-I0.421|2:19-I1.015|3:25-I0.429|2:34-I0.996|3:26-I0.439|2:31-I1.010|3:28-I0.414|2:29-I1.010|3:19-I0.090|1:56,,,,,3113,"firmware 2.80",250,0,,0,168070,250480,30378,,,,,,,,,,,,,,,,,,,,,,,,,,,,,,,,,,,,,,,,,,,
9707459,47e3fd3c-3e77-404e-8cae-9defa84c1194,1568829869,120,1568827026,,0,0,13.47,3853,4208,76,68,,,1,0,0.14,,,,762,143,173,,,,64.3,43.25,64.8,1,62.34,3331,,,3.1,,100,98,,,,,,77,81,12.63,12.69,12.78,1.7,,,,,,,,,,,,,,,,"0,1,4,22,55,16,2,0,0","0,29,69,2,0",,,,,,129,,,,,,,,,,,,,,,,,,,,,,,,,,,,,,,,,,,,37.2,18,12,35,35,,1024,1,279,0,5,3,,1,0,I1.000|4:29-I1.000|4:33-I1.000|4:52-I1.000|4:50-I1.000|4:49-I1.000|4:57-I1.000|4:51-I1.000|4:49-I1.000|5:07-I1.000|4:49-I1.000|5:04-I1.000|4:34-I1.000|4:32-I0.470|1:57,,,,,3113,"firmware 2.80",250,0,,0,168070,250480,30378,,,,,,,,,,,,,,,,,,,,,,,,,,,,,,,,,,,,,,,,,,,
9735318,09397999-e377-4c62-adb4-c3d09b9384b1,1568898631,120,1568896639,,0,0,8.73,2959,2959,1,0,,,1,0,0.01,,,,548,145,179,,,,51.22,34.32,51.23,1,63.69,4197,,,3.1,,107,109,,,,,,66,77,10.64,15.6,15.62,19.2,,,,,,,,,,,,,,,,"52,2,2,2,3,3,4,28,3","2,41,32,25,0",,,,,,115,,,,,,,,,,,,,,,,,,,,,,,,,,,,,,,,,,,,47.3,17,19,23,47,,1028,5,282,0,3,3,,1,0,I0.398|1:19-I0.190|1:49-I0.406|1:17-I0.180|1:46-I0.405|1:16-I0.188|1:46-I0.400|1:17-I0.186|1:44-I0.409|1:18-I0.191|1:38-I0.404|1:15-I0.180|1:43-I0.402|1:13-I0.111|1:21-I0.069|0:24-I0.414|1:16-I0.174|1:48-I0.403|1:15-I0.184|1:49-I0.404|1:17-I0.164|1:48-I0.403|1:13-I0.179|1:52-I0.404|1:14-I0.173|1:54-I0.400|1:14-I0.180|1:59-I0.407|1:15-I0.180|2:10-I0.409|1:15-I0.129|4:56,,,,,3113,"firmware 2.80",250,0,,0,168070,250480,30378,,,,,,,,,,,,,,,,,,,,,,,,,,,,,,,,,,,,,,,,,,,
9735547,474d0f80-7687-4e22-b360-ba0b9a4aedad,1568896679,120,1568896787,,0,0,4.47,1240,1263,26,26,,,1,0,0.15,,,,265,143,160,,,,66.79,41.73,67.27,1,62.82,1584,,,2.5,,98,103,,,,,,25,82,12.94,13.25,13.28,-8.1,,,,,,,,,,,,,,,,"1,2,7,27,19,35,9,0,0","1,45,54,0,0",,,,,,132,,,,,,,,,,,,,,,,,,,,,,,,,,,,,,,,,,,,32.9,16,20,23,50,,1029,5,282,0,3,3,,1,0,I1.000|5:20-I1.000|4:57-I1.000|4:11-I1.000|4:03-I0.465|2:09,,,,,3113,"firmware 2.80",250,0,,0,168070,250480,30378,,,,,,,,,,,,,,,,,,,,,,,,,,,,,,,,,,,,,,,,,,,
9735566,8fb7c276-3520-4fd4-bb35-a34461cb60c8,1568901998,120,1568896805,,0,0,3.01,1155,1155,16,16,,,1,0,0.13,,,,199,127,137,,,,51.65,27.68,51.99,1,63.69,4169,,,1.4,,,100,,,,,,14,81,9.37,9.42,9.42,5.5,,,,,,,,,,,,,,,,"42,45,11,2,0,0,0,0,0","1,99,0,0,0",,,,,,97,,,,,,,,,,,,,,,,,,,,,,,,,,,,,,,,,,,,10.9,18,19,21,43,,1028,5,283,0,3,3,,1,0,I1.000|6:07-I1.000|6:34-I1.000|6:32-I0.006|0:02,,,,,3113,"firmware 2.80",250,0,,0,168070,250480,30378,,,,,,,,,,,,,,,,,,,,,,,,,,,,,,,,,,,,,,,,,,,
9765566,fed5eb1b-7e01-423a-95ff-51f880be6f30,1568991329,120,1568985434,,0,0,0.65,254,287,9,8,,,1,0,0,1,0.98,,51,135,147,,,,47.01,23.25,47.9,1,63.69,2695,,,,,,100,,,,,,4,85,9.46,9.39,9.54,4.6,,,,,,,,,,,,,,,,"45,29,22,4,0,0,0,0,0","4,66,31,0,0",,,,,,90,,,,,,,,,,,,,,,,,,,,,,,,,,,,,,,,,,,,8.9,17,8,98,40,,1028,4,278,0,3,3,,1,0,,,,,,3113,"firmware 2.80",250,0,,0,168070,250480,30378,,,,,,,,,,,,,,,,,,,,,,,,,,,,,,,,,,,,,,,,,,,
9817185,75263808-42be-44c5-be7a-f3254db88df5,1569152998,120,1569232446,,0,0,7.73,2460,2815,180,175,,,1,2.8,0.83,1.02,0.96,461,546,149,174,,,,53.41,36.67,54.99,1,62.12,2258,,,3.2,,95,98,,,,,,57,83,11.8,11.63,11.93,1.5,,,,,,,,,,,,,,,,"11,12,14,24,39,1,0,0,0","1,6,86,6,0",,,,,,114,,,,,,,,,,,,,,,,,,,,,,,,,,,,,,,,,,,,38.7,19,6,82,48,,1013,4,270,0,3,3,,1,0,I1.000|6:26-I1.000|4:54-I1.000|5:06-I1.000|5:25-I1.000|4:59-I1.000|4:44-I1.000|5:49-I0.729|3:37,,,,,3113,"firmware 2.80",250,0,,0,168070,250480,30378,,,,,,,,,,,,,,,,,,,,,,,,,,,,,,,,,,,,,,,,,,"5,5,5",
9824320,281c503a-30a6-436b-88d9-ea2cde969dac,1569258358,120,1569256934,,0,0,15.01,3588,3618,53,53,,,1,0,0.03,,,,886,163,175,,,,67.06,53.7,67.36,1,61.92,3027,,,4.4,,102,99,,,,,,116,85,15.07,15.12,15.14,3.9,,,,,,,,,,,,,,,,"0,0,0,0,2,42,55,1,0","0,2,28,70,0",,,,,,148,,,,,,,,,,,,,,,,,,,,,,,,,,,,,,,,,,,,74,19,13,216,66,,1018,1,294,0,5,3,,1,0,I1.000|4:02-I1.000|4:10-I1.000|4:03-I1.000|4:02-I1.000|4:02-I1.000|4:01-I1.000|3:56-I1.000|4:01-I1.000|3:51-I1.000|3:59-I1.000|3:55-I1.000|3:52-I1.000|4:00-I1.000|3:57-I1.000|3:57-I0.012|0:02,,,,,3113,"firmware 2.80",250,0,,0,168070,250480,30378,,,,,,,,,,,,,,,,,,,,,,,,,,,,,,,,,,,,,,,,,,,
9824323,ebb7a88e-cde5-4ad1-9cb9-86e89cf9331b,1569262004,120,1569256989,,0,0,1.34,395,442,7,8,,,1,0,0.07,,,,84,150,168,,,,58.18,34.79,58.5,1,61.92,3020,,,1.8,,,100,,,,,,9,85,12.19,13.61,13.54,-1.6,,,,,,,,,,,,,,,,"17,7,20,17,10,6,16,6,2","0,27,51,22,0",,,,,,120,,,,,,,,,,,,,,,,,,,,,,,,,,,,,,,,,,,,25.2,18,11,213,68,,1018,0,293,0,5,3,,1,0,I0.250|1:35-I0.105|0:19-I0.112|0:38-I0.096|0:19-I0.116|0:38-I0.100|0:20-I0.114|0:39-I0.096|0:19-I0.117|0:38-I0.106|0:20-I0.129|0:50,,,,,3113,"firmware 2.80",250,0,,0,168070,250480,30378,,,,,,,,,,,,,,,,,,,,,,,,,,,,,,,,,,,,,,,,,,,
9847419,8592edb7-6fe5-49d4-af35-590805219a94,1569348392,120,1569345845,,0,0,14.02,3651,4008,51,53,,,1,0,0,,,,723,151,182,,,,67.2,48.38,67.49,1,61.57,2959,,,3.7,,104,98,,,,,,93,84,13.8,14.41,14.42,9.4,,,,,,,,,,,,,,,,"0,3,7,10,16,41,17,6,0","0,24,50,25,0",,,,,,137,,,,,,,,,,,,,,,,,,,,,,,,,,,,,,,,,,,,93,17,3,,87,,1010,,,0,6,1,,1,0,I1.000|4:22-I1.000|4:20-I1.000|4:14-I1.000|4:19-I1.000|4:05-I0.843|3:31-I1.000|3:33-I1.000|3:32-I1.000|3:39-I1.000|4:17-I1.000|4:27-I1.000|4:46-I1.000|5:14-I1.000|5:32-I0.174|0:59,,,,,3113,"firmware 2.80",250,0,,0,168070,250480,30378,,,,,,,,,,,,,,,,,,,,,,,,,,,,,,,,,,,,,,,,,,,
9864539,ba2b6b1e-3271-4c6d-a5f2-5b3f68e88e4b,1569433825,120,1569430896,,0,0,15,3656,4130,99,92,,,1,0,0.18,0.99,,,915,167,184,,,,63.15,52.5,63.71,1,61.22,4544,,,4.6,,100,97,,,,,,133,86,14.83,14.91,14.98,1.3,,,,,,,,,,,,,,,,"1,0,1,1,6,36,55,0,0","0,2,15,82,1",,,,,,143,,,,,,,,,,,,,,,,,,,,,,,,,,,,,,,,,,,,93.9,18,16,215,69,,1008,1,282,0,4,3,,1,0,I1.000|4:05-I1.000|3:56-I1.000|3:58-I1.000|4:19-I1.000|4:02-I1.000|3:54-I1.000|3:54-I1.000|4:12-I1.000|3:57-I1.000|4:00-I1.000|4:08-I1.000|4:10-I1.000|3:54-I1.000|3:56-I1.000|4:30-I0.001|0:01,,,,,3113,"firmware 2.80",250,0,,0,168070,250480,30378,,,,,,,,,,,,,,,,,,,,,,,,,,,,,,,,,,,,,,,,,,,
9881047,52c7a32a-23ea-478f-a632-53d2d143b917,1569527101,120,1569522786,,0,0,6.1,1514,2850,63,63,,,1,0.7,0.41,0.95,1.07,,330,147,167,113,,,73.95,48.47,74.9,1,62.45,2304,,,2.9,,105,101,,,,,,33,84,14.58,14.7,14.73,8.1,,,,,,,,,,,,,,,,"0,2,4,2,13,26,50,2,0","0,18,78,4,0",,,,,,144,,,,,,,,,,,,,,,,,,,,,,,,,,,,,,,,,,,,36.6,20,28,211,68,,1012,0,282,1,5,3,,1,0,I1.000|4:02-I1.000|4:07-I1.000|3:57-I1.000|3:53-I1.000|3:51-I1.000|4:57-I0.099|0:27,,,,,3113,"firmware 2.80",250,0,,0,168070,250480,30378,,,,,,,,,,,,,,,,,,,,,,,,,,,,,,,,,,,,,,,,,,,
9886871,8d9370d1-094c-406c-95e3-fb6ed24c8ca9,1569574119,120,1569570755,,0,0,10.11,2462,2920,50,67,,,1,0,0.11,,1.02,,619,165,183,,,,64.37,51.1,64.63,1,62.14,2923,,,3.8,,103,98,,,,,,84,86,14.74,14.87,14.83,7.3,,,,,,,,,,,,,,,,"0,0,0,2,7,43,47,0,0","0,5,24,70,1",,,,,,143,,,,,,,,,,,,,,,,,,,,,,,,,,,,,,,,,,,,83.5,15,12,211,86,,1012,0,296,0,4,3,,1,0,I1.000|4:07-I1.000|3:53-I1.000|3:58-I1.000|3:55-I1.000|3:56-I1.000|3:54-I1.000|4:01-I1.000|4:07-I1.000|4:21-I1.000|4:17-I0.110|0:35,,,,,3113,"firmware 2.80",250,0,,0,168070,250480,30378,,,,,,,,,,,,,,,,,,,,,,,,,,,,,,,,,,,,,,,,,,,
9886873,af3557da-9623-42ce-bd04-65cdd796b3f4,1569577082,120,1569570759,,0,0,2.29,698,736,30,14,,,1,0.8,0.54,1.03,,,165,153,172,,,,54.34,35.49,55.69,1,61.86,4201,,,2.3,,95,96,,,,,,17,85,12.18,12.03,12.49,-3,,,,,,,,,,,,,,,,"5,2,10,37,42,4,0,0,0","0,1,88,11,0",,,,,,116,,,,,,,,,,,,,,,,,,,,,,,,,,,,,,,,,,,,35.6,16,13,213,81,,1012,1,299,0,5,3,,1,0,I1.000|5:12-I1.000|4:51-I0.294|1:35,,,,,3113,"firmware 2.80",250,0,,0,168070,250480,30378,,,,,,,,,,,,,,,,,,,,,,,,,,,,,,,,,,,,,,,,,,,
9903355,94d7cb2b-8671-4232-84a9-bd8b64213923,1569662683,120,1569659619,,0,0,13.19,3811,3989,345,345,,,1,3.9,0.79,1.03,1.09,472,873,156,174,,,,56.5,42.68,58.33,1,61.72,4288,,,3.8,,96,97,,,,,,106,83,13.16,13.34,13.47,-4.4,,,,,,,,,,,,,,,,"6,5,18,24,14,13,16,3,0","0,2,72,25,0",,,,,,125,,,,,,,,,,,,,,,,,,,,,,,,,,,,,,,,,,,,56.2,13,14,200,94,,1015,1,303,0,4,3,,1,0,I1.000|5:46-I1.000|5:08-I1.000|4:52-I1.000|5:31-I1.000|5:28-I1.000|5:27-I1.000|5:52-I1.000|4:46-I1.000|4:08-I1.000|4:03-I1.000|3:49-I1.000|3:51-I1.000|3:44-I0.189|1:06,,,,,3113,"firmware 2.80",250,0,,0,168070,250480,30378,,,,,,,,,,,,,,,,,,,,,,,,,,,,,,,,,,,,,,,,,,3,
9928484,95070227-a0fe-4c6c-ac22-12b32ca6465c,1569778163,120,1569775300,,0,0,13.01,3080,3457,27,28,,,1,0,0.02,,,,774,167,200,,,,65.47,53.73,65.63,1,61.39,4449,,,4.1,,100,100,,,,,,110,83,15.21,15.28,15.28,-3.9,,,,,,,,,,,,,,,,"0,0,0,0,4,27,68,0,0","0,2,19,74,6",,,,,,153,,,,,,,,,,,,,,,,,,,,,,,,,,,,,,,,,,,,104.9,17,15,234,75,,1006,1,276,0,5,3,,1,0,I1.000|4:28-I1.000|4:09-I1.000|3:55-I1.000|4:01-I1.000|3:51-I1.000|3:53-I1.000|3:50-I1.000|3:58-I1.000|3:53-I1.000|3:50-I1.000|3:54-I1.000|3:50-I1.000|3:47-I0.011|0:02,,,,,3113,"firmware 2.80",250,0,,0,168070,250480,30378,,,,,,,,,,,,,,,,,,,,,,,,,,,,,,,,,,,,,,,,,,,
9928486,13865fa1-22fc-4ed6-a694-c408925ddecf,1569781650,120,1569775323,,0,0,2.01,740,752,2,5,,,1,0,0,,,,139,134,162,,,,51.05,28.16,51.02,1,61.39,4437,,,1.5,,,100,,,,,,11,82,9.74,9.89,9.88,-5.5,,,,,,,,,,,,,,,,"13,44,41,1,0,0,0,0,0","0,90,9,0,0",,,,,,99,,,,,,,,,,,,,,,,,,,,,,,,,,,,,,,,,,,,13.3,17,15,227,79,,1005,0,279,0,5,3,,1,0,I1.000|6:15-I1.000|6:03-I0.009|0:02,,,,,3113,"firmware 2.80",250,0,,0,168070,250480,30378,,,,,,,,,,,,,,,,,,,,,,,,,,,,,,,,,,,,,,,,,,,
9940716,3725a725-b331-423e-81e2-3543366ef185,1569866606,120,1569863913,,0,0,4.45,1386,1386,24,22,,,1,0,0.23,,,,260,134,150,,,,62.76,36.39,63.21,1,61.34,3011,,,2.1,,100,99,,,,,,22,80,11.57,11.66,11.68,2.5,,,,,,,,,,,,,,,,"5,2,18,42,28,4,0,0,0","0,94,5,0,0",,,,,,120,,,,,,,,,,,,,,,,,,,,,,,,,,,,,,,,,,,,16.6,17,10,227,68,,1016,0,266,0,5,3,,1,0,I1.000|5:33-I1.000|4:53-I1.000|5:02-I1.000|5:21-I0.445|2:17,,,,,3113,"firmware 2.80",250,0,,0,168070,250480,30378,,,,,,,,,,,,,,,,,,,,,,,,,,,,,,,,,,,,,,,,,,,
9940724,4526c1bf-0b73-40eb-845e-1055643f3983,1569870469,120,1569863974,,0,0,1,415,421,2,0,,,1,0,0.15,,,,67,124,131,,,,48.18,22.74,48.41,1,61.61,5751,,,,,,100,,,,,,4,81,8.72,8.9,8.91,-6.2,,,,,,,,,,,,,,,,"71,23,6,0,0,0,0,0,0","0,100,0,0,0",,,,,,89,,,,,,,,,,,,,,,,,,,,,,,,,,,,,,,,,,,,6.6,16,5,198,72,,1016,0,267,1,4,3,,1,0,I1.000|6:52-I0.002|0:03,,,,,3113,"firmware 2.80",250,0,,0,168070,250480,30378,,,,,,,,,,,,,,,,,,,,,,,,,,,,,,,,,,,,,,,,,,,
9940728,9e991f3c-5122-4ca8-80f0-ac70dc4cc0f5,1569868236,120,1569863976,,0,0,6.3,2130,2130,8,10,,,1,0,0,,,,406,143,177,,,,52.31,33.69,52.37,1,61.61,5760,,,2.7,,,99,,,,,,44,82,10.58,15.31,15.34,18.8,,,,,,,,,,,,,,,,"56,2,2,2,2,2,4,24,6","0,46,39,15,0",,,,,,108,,,,,,,,,,,,,,,,,,,,,,,,,,,,,,,,,,,,38.4,17,7,208,69,,1016,0,266,0,4,3,,1,0,I0.504|1:39-I0.126|1:30-I0.298|0:57-I0.192|1:31-I0.505|1:36-I0.177|1:31-I0.293|0:55-I0.362|3:04-I0.496|1:37-I0.121|1:24-I0.288|0:56-I0.191|1:32-I0.506|1:35-I0.155|1:30-I0.298|0:56-I0.210|2:52-I0.307|0:54-I0.124|1:30-I0.200|0:35-I0.193|1:38-I0.302|0:55-I0.144|1:22-I0.203|0:34-I0.105|2:59,,,,,3113,"firmware 2.80",250,0,,0,168070,250480,30378,,,,,,,,,,,,,,,,,,,,,,,,,,,,,,,,,,,,,,,,,,,
9956855,f117d4d7-62fe-4fcb-88a6-54d659753395,1569953246,120,1569950404,,0,0,15.11,3973,4039,44,45,,,1,0,0.04,,,,864,150,177,,,,67,48.12,67.24,1,61.59,4342,,,3.7,,104,97,,,,,,96,82,13.69,14.06,14.05,0.3,,,,,,,,,,,,,,,,"0,0,2,10,31,36,18,2,0","0,26,58,16,0",,,,,,139,,,,,,,,,,,,,,,,,,,,,,,,,,,,,,,,,,,,67.7,19,22,208,83,,1005,0,268,0,6,3,,1,0,I1.000|4:39-I1.000|4:52-I1.000|4:55-I1.000|4:48-I1.000|4:37-I1.000|4:25-I1.000|4:17-I1.000|4:15-I1.000|4:02-I1.000|3:59-I1.000|3:48-I1.000|4:02-I1.000|4:07-I1.000|4:32-I1.000|4:22-I0.114|0:30,,,,,3113,"firmware 2.80",250,0,,0,168070,250480,30378,,,,,,,,,,,,,,,,,,,,,,,,,,,,,,,,,,,,,,,,,,,
9974074,4674d138-2c35-4675-97f8-9287a62e0af1,1570025356,120,1570021683,,0,0,10.74,3307,3394,26,30,,,1,0,0.02,,,,630,140,155,,,,60.31,39.01,60.46,1,61.27,3152,,,2.7,,95,97,,,,,,60,81,11.69,11.73,11.73,4.8,,,,,,,,,,,,,,,,"0,1,13,57,27,1,0,0,0","0,46,54,0,0",,,,,,120,,,,,,,,,,,,,,,,,,,,,,,,,,,,,,,,,,,,24.4,11,12,20,96,,1012,2,294,0,6,3,,1,0,I1.000|4:57-I1.000|5:10-I1.000|5:01-I1.000|5:04-I1.000|5:13-I1.000|5:14-I1.000|5:08-I1.000|5:06-I1.000|5:12-I1.000|5:11-I0.739|3:51,,,,,3113,"firmware 2.80",250,0,,0,168070,250480,30378,,,,,,,,,,,,,,,,,,,,,,,,,,,,,,,,,,,,,,,,,,,
9985897,c2784a81-62cf-4ef0-bca6-1cdee34f9a42,1570091550,120,1570084472,,0,0,0.02,26,39,0,0,,,1,0,0,,,,1,73,75,,,,18.16,,18.16,1,61.27,2104,,,,,,100,,,,,,0,2,1.84,1.72,1.72,,,,,,,,,,,,,,,,,"100,0,0,0,0,0,0,0,0","100,0,0,0,0",,,,,,,,,,,,,,,,,,,,,,,,,,,,,,,,,,,,,,,,,,,9,19,241,91,,1019,0,303,0,4,3,,1,0,I0.006|0:03-I0.010|0:23,,,,,3113,"firmware 2.80",250,0,,0,168070,250480,30378,,,,,,,,,,,,,,,,,,,,,,,,,,,,,,,,,,,,,,,,,,,
9994052,4614bb2a-9b98-4bc4-bb92-3c4b4e3f2294,1570119849,120,1570116546,,0,0,13.34,3519,3643,338,339,,,1,4,0.85,1.06,1.17,506,768,153,183,,,,64.96,47.48,66.99,1,61.1,4432,,,3.7,,101,99,,,,,,94,83,14.43,15.29,15.2,-7.7,,,,,,,,,,,,,,,,"9,2,5,17,21,17,10,17,3","0,17,49,33,0",,,,,,137,,,,,,,,,,,,,,,,,,,,,,,,,,,,,,,,,,,,74.5,10,12,237,94,,1017,1,275,0,4,3,,1,0,I1.000|6:13-I1.000|5:12-I0.807|3:50-I1.000|4:24-I1.000|4:36-I1.000|4:48-I0.577|2:35-I1.000|5:37-I0.467|1:58-I1.000|3:39-I1.000|3:28-I1.000|3:24-I1.000|3:12-I1.000|3:11-I0.484|2:31,,,,,3113,"firmware 2.80",250,0,,0,168070,250480,30378,,,,,,,,,,,,,,,,,,,,,,,,,,,,,,,,,,,,,,,,,,3,
10012282,6b2b3c7f-b31c-4b87-b80e-0305c083eb0a,1570196122,120,1570195148,,0,0,3.03,1140,1411,148,17,,,1,2.8,0.86,1.03,0.84,514,243,146,163,,,,44.63,28.35,49.75,1,60.86,3199,,,2.5,,94,96,,,,,,25,82,11.31,9.79,11.83,-7.1,,,,,,,,,,,,,,,,"41,14,28,16,1,0,0,0,0","2,17,79,2,0",,,,,,97,,,,,,,,,,,,,,,,,,,,,,,,,,,,,,,,,,,,30.4,8,14,193,100,,1008,3,286,0,6,3,,1,0,I1.000|6:36-I1.000|6:03-I0.449|2:41-I0.585|3:41,,,,,3113,"firmware 2.80",250,0,,0,168070,250480,30378,,,,,,,,,,,,,,,,,,,,,,,,,,,,,,,,,,,,,,,,,,4,
10012287,eb9fab10-19b7-4843-9102-7121d66f6cd7,1570197560,120,1570195178,,0,0,9.23,3673,3673,370,365,,,1,4.2,0.78,1.61,1.15,348,635,143,178,,,,42.78,28.47,44.93,1,60.85,5760,,,3.1,,100,99,,,,,,80,83,9.2,10.48,12.67,9.9,,,,,,,,,,,,,,,,"59,10,4,4,14,9,1,0,0","0,54,13,33,0",,,,,,91,,,,,,,,,,,,,,,,,,,,,,,,,,,,,,,,,,,,41.5,7,14,193,100,,1008,3,286,0,6,3,,1,0,I0.297|1:17-I0.316|2:12-I0.287|1:21-I0.322|2:13-I0.293|1:20-I0.323|2:21-I0.285|1:19-I0.326|2:29-I0.288|1:22-I0.320|2:39-I0.292|1:23-I0.315|2:31-I0.294|1:22-I0.333|2:58-I0.297|1:26-I0.325|2:36-I0.295|1:25-I0.322|2:47-I0.291|1:27-I0.325|4:12-I0.303|1:27-I0.324|2:32-I0.294|1:28-I0.333|2:38-I0.294|1:21-I0.321|2:56-I0.298|1:23-I0.322|2:52-I0.301|1:20-I0.296|2:38,,,,,3113,"firmware 2.80",250,0,,0,168070,250480,30378,,,,,,,,,,,,,,,,,,,,,,,,,,,,,,,,,,,,,,,,,,"5,5,5,5",
10012291,f0d81df9-3ff4-45fd-a1ea-481592b1f33a,1570201476,120,1570195204,,0,0,1.62,650,650,0,115,,,1,1.1,0.77,,0.99,,97,121,136,,,,51.59,24.93,47.11,1,60.86,5745,,,,,,100,,,,,,7,82,8.17,9.08,8.19,2.7,,,,,,,,,,,,,,,,"56,41,3,0,0,0,0,0,0","2,98,0,0,0",,,,,,91,,,,,,,,,,,,,,,,,,,,,,,,,,,,,,,,,,,,7.3,8,12,210,100,,1007,2,283,0,6,3,,1,0,I1.000|6:39-I0.619|4:11,,,,,3113,"firmware 2.80",250,0,,0,168070,250480,30378,,,,,,,,,,,,,,,,,,,,,,,,,,,,,,,,,,,,,,,,,,,
10022178,1daf71fd-0e5d-42ac-a4c8-c6e55a113d5b,1570270809,120,1570266184,,0,0,3.37,1584,2193,67,68,,,1,1.6,0.73,1.04,0.95,299,274,137,158,121,,,36.74,21.73,37.63,1,60.01,4563,,,2.2,,90,83,,,,,,27,81,7.83,7.88,8.34,10.3,,,,,,,,,,,,,,,,"92,5,1,1,1,0,0,0,0","0,63,37,0,0",,,,,,79,,,,,,,,,,,,,,,,,,,,,,,,,,,,,,,,,,,,22.3,9,16,5,83,,1014,1,278,0,5,3,,1,0,I1.000|7:44-I1.000|8:31-I1.000|7:52-I0.365|2:16,,,,,3113,"firmware 2.80",250,0,,0,168070,250480,30378,,,,,,,,,,,,,,,,,,,,,,,,,,,,,,,,,,,,,,,,,,5,
10033239,84156ecc-c4a0-4665-a394-d4216962ee4d,1570353637,120,1570352501,,0,0,19.04,5853,5892,476,475,,,1,4.4,0.81,1.04,1.02,447,1133,149,170,,,,55.74,40.88,57.47,1,59.82,3573,,,3.6,,97,98,,,,,,134,82,12.27,12.18,12.45,-3,,,,,,,,,,,,,,,,"8,9,21,20,20,17,4,0,0","0,6,92,2,0",,,,,,119,,,,,,,,,,,,,,,,,,,,,,,,,,,,,,,,,,,,36.8,7,14,81,85,,1018,1,257,0,5,3,,1,0,I1.000|6:34-I1.000|4:56-I1.000|5:07-I1.000|5:30-I1.000|5:04-I1.000|4:36-I1.000|5:15-I1.000|5:30-I1.000|5:20-I1.000|5:50-I1.000|5:48-I1.000|5:50-I1.000|6:09-I1.000|4:39-I1.000|4:33-I1.000|4:06-I1.000|4:06-I1.000|4:09-I1.000|4:19-I0.036|0:13,,,,,3113,"firmware 2.80",250,0,,0,168070,250480,30378,,,,,,,,,,,,,,,,,,,,,,,,,,,,,,,,,,,,,,,,,,"3,5,5",
10065692,813e56c9-3ffe-4a67-93f8-6808b514c496,1570470352,120,1570468535,,0,0,4.62,1287,1472,33,35,,,1,0,0.23,,,,261,143,159,,,,66.44,41.61,66.99,1,61.12,1396,,,2.5,,101,106,,,,,,26,81,12.9,13.3,13.29,2.5,,,,,,,,,,,,,,,,"7,1,5,4,29,48,5,0,0","1,33,67,0,0",,,,,,133,,,,,,,,,,,,,,,,,,,,,,,,,,,,,,,,,,,,30.7,13,8,226,75,,1019,0,258,0,5,3,,1,0,I1.000|5:07-I1.000|4:17-I1.000|4:17-I1.000|4:22-I0.618|3:24,,,,,3113,"firmware 2.80",250,0,,0,168070,250480,30378,,,,,,,,,,,,,,,,,,,,,,,,,,,,,,,,,,,,,,,,,,,
10067800,4dacc96c-4850-4541-a6c9-46b5338a1c18,1570471849,120,1570472296,,0,0,9.29,3051,3051,1,0,,,1,0,0,,,,540,145,189,,,,53.25,35.78,53.27,1,62.42,3789,,,3.2,,108,98,,,,,,75,81,10.96,15.86,15.88,25.5,,,,,,,,,,,,,,,,"45,1,1,1,1,1,18,34,0","6,37,16,37,4",,,,,,113,,,,,,,,,,,,,,,,,,,,,,,,,,,,,,,,,,,,73.4,13,8,226,75,,1019,0,258,0,5,3,,1,0,I0.401|1:30-I0.410|1:22-I0.411|1:19-I0.412|1:17-I0.342|3:43-I0.399|1:29-I0.411|1:25-I0.401|1:22-I0.408|1:19-I0.328|4:07-I0.401|1:29-I0.406|1:25-I0.403|1:22-I0.401|1:19-I0.334|4:17-I0.395|1:27-I0.401|1:24-I0.397|1:23-I0.404|1:20-I0.311|6:59-I1.469|5:04-I0.050|4:30,,,,,3113,"firmware 2.80",250,0,,0,168070,250480,30378,,,,,,,,,,,,,,,,,,,,,,,,,,,,,,,,,,,,,,,,,,,
10067802,204cc8a6-1f71-495e-bb15-a4ed6769f6d9,1570475101,120,1570472301,,0,0,1.02,485,485,0,0,,,1,0,0,,,,61,114,122,,,,44.55,19.4,44.55,1,62.42,3778,,,,,,100,,,,,,4,80,7.59,7.7,7.7,-0.1,,,,,,,,,,,,,,,,"95,5,0,0,0,0,0,0,0","4,96,0,0,0",,,,,,79,,,,,,,,,,,,,,,,,,,,,,,,,,,,,,,,,,,,4.3,13,6,196,89,,1019,0,258,1,5,3,,1,0,I1.000|7:54-I0.023|0:11,,,,,3113,"firmware 2.80",250,0,,0,168070,250480,30378,,,,,,,,,,,,,,,,,,,,,,,,,,,,,,,,,,,,,,,,,,,
10087333,494aa1b6-0c83-4344-8bc9-f7cd34751a76,1570558073,120,1570570353,,0,0,13.94,3850,3873,64,64,,,1,0,0.09,,,,808,146,173,113,,,62.32,45.17,62.68,1,62.36,2489,,,3.3,,98,100,,,,,,93,82,13.04,13.37,13.38,-4.3,,,,,,,,,,,,,,,,"0,1,3,24,39,18,14,1,0","0,44,43,13,0",,,,,,132,,,,,,,,,,,,,,,,,,,,,,,,,,,,,,,,,,,,60.8,12,7,262,100,,1011,0,244,0,6,3,,1,0,I1.000|4:53-I1.000|4:58-I1.000|4:59-I1.000|4:56-I1.000|5:04-I1.000|4:48-I1.000|4:51-I1.000|4:52-I1.000|4:48-I1.000|4:14-I1.000|4:08-I1.000|4:03-I1.000|4:02-I0.937|3:34,,,,,3113,"firmware 2.80",250,0,,0,168070,250480,30378,,,,,,,,,,,,,,,,,,,,,,,,,,,,,,,,,,,,,,,,,,,
10087334,fdb8fecf-7e17-43cc-aa44-3458bf7641f4,1570562287,120,1570570354,,0,0,2.41,687,687,0,2,,,1,0,0,,,,150,148,174,,,,58.83,38.51,58.77,1,62.08,3045,,,2.2,,96,94,,,,,,18,84,12.57,14.24,14.25,12.4,,,,,,,,,,,,,,,,"3,17,27,15,8,7,10,11,2","1,29,42,28,0",,,,,,125,,,,,,,,,,,,,,,,,,,,,,,,,,,,,,,,,,,,35.2,13,3,286,98,,1011,0,247,1,6,3,,1,0,I0.172|1:07-I0.194|0:43-I0.211|1:12-I0.191|0:40-I0.209|1:08-I0.204|0:40-I0.197|1:10-I0.207|0:39-I0.202|1:10-I0.207|0:38-I0.410|2:20,,,,,3113,"firmware 2.80",250,0,,0,168070,250480,30378,,,,,,,,,,,,,,,,,,,,,,,,,,,,,,,,,,,,,,,,,,,
10094200,73ce6419-b6e3-4fab-a618-ffde25d9892b,1570614448,120,1570614813,,0,0,23.55,6803,7484,116,118,,,1,0,0.1,,,,1416,150,166,,,,56.8,44.69,57.14,1,61.75,3823,,,3.9,,96,98,,,,,,180,83,12.47,12.5,12.53,-0.6,,,,,,,,,,,,,,,,"0,1,3,24,58,13,0,0,0","0,7,91,2,0",,,,,,125,,,,,,,,,,,,,,,,,,,,,,,,,,,,,,,,,,,,47.8,12,9,213,95,,1013,1,263,0,5,3,,1,0,I1.000|5:05-I1.000|5:04-I1.000|4:58-I1.000|5:11-I1.000|4:47-I1.000|4:44-I1.000|4:50-I1.000|4:46-I1.000|4:51-I1.000|5:04-I1.000|4:50-I1.000|4:57-I1.000|4:37-I1.000|5:01-I1.000|4:48-I1.000|4:43-I1.000|4:36-I1.000|4:39-I1.000|4:35-I1.000|4:35-I1.000|4:39-I1.000|4:40-I1.000|4:41-I0.553|2:40,,,,,3113,"firmware 2.80",250,0,,0,168070,250480,30378,,,,,,,,,,,,,,,,,,,,,,,,,,,,,,,,,,,,,,,,,,,
10110128,11f59bcf-d809-41ea-af5c-00a7a35506f1,1570708409,120,1570705174,,0,0,8.69,3004,3627,370,375,,,1,5.1,0.86,1.06,1.13,667,625,146,181,,,,47.24,33.52,49.7,1,59.52,2388,,,3.2,,104,97,,,,,,76,83,11.66,11.21,12.37,2.3,-35.6,272,272,,1,320,320,,,,,,,,,"34,11,14,12,20,7,2,0,0","1,41,33,25,0","4,26,32,26,12",,,,,105,,,,,,,,,,,,,,,,,,,,,,,,,,,,,,,,,,,,61.1,9,3,267,63,,1020,3,291,0,9,3,,1,0,I1.000|4:40-I1.000|4:40-I1.000|5:37-I1.000|6:17-I1.000|5:17-I1.000|6:42-I1.000|6:22-I1.000|7:02-I0.687|3:28,,,,,3113,"firmware 2.80",250,0,,0,168070,250480,30378,,,,,,,,,,,,,,,,,,,,,,,,,,,,,,,,,,,,,,,,,,"2,5,5",
10122512,29a5ae5e-bd9e-4903-b5ab-684df5ca0fb0,1570777337,120,1570776364,,0,0,13.51,5959,6100,924,939,,,1,8.3,0.88,0.95,0.86,825,1353,161,193,,,,30.33,25.92,32.91,1,58.61,5088,,,5,,97,95,,,,,,220,78,10.79,10.49,12.35,-15.7,-0.3,245,245,,1,327,327,,,,,,,,,"64,4,5,6,6,8,7,0,0","0,10,34,48,8","13,28,32,15,13",,,,,87,,,,,,,,,,,,,,,,,,,,,,,,,,,,,,,,,,,,113.9,2,2,174,86,,1025,0,270,0,3,3,,1,0,I1.000|6:11-I1.000|6:17-I1.000|6:37-I1.000|15:02-I1.000|11:09-I1.000|11:31-I1.000|10:11-I1.000|7:26-I1.000|4:18-I1.000|3:57-I1.000|4:07-I1.000|4:26-I1.000|4:48-I0.514|3:20,,,,,3113,"firmware 2.80",250,0,,0,168070,250480,30378,,,,,,,,,,,,,,,,,,,,,,,,,,,,,,,,,,,,,,,,,,"0,4",
10130703,31eae418-d475-404b-96b7-992caaf40f0e,1570793542,120,1570801303,,0,0,14.05,12341,14706,695,692,,,1,7.1,0.88,,,360,1132,108,142,,,,,,,1,58.61,4675,,,2,,,100,,,,,,97,54,,4.38,,-2.6,,,,,,,,,,,,,,,,"90,10,0,0,0,0","22,78,0,0,0",,,,,,,,,,,,,,,,,,,,,,,,,,,,,,,,,,,,,,,,,,10.4,10,6,11,65,,1023,3,273,0,5,3,,1,0,,,,,,3113,"firmware 2.80",250,0,,0,168075,,30378,,,,,,,,,,,,,,,,,,,,,,,,,,,,,,,,,,,,,,,,,,"2,2,4,5,5",
10143592,6baffb58-d2a9-4c55-855f-090b7c9f2e4c,1570865496,120,1570859793,,0,0,2.72,1258,1398,203,209,,,1,5,1,,,917,223,138,165,,,,35.5,21.89,38.72,1,57.93,3697,,,2.2,,92,95,,,,,,26,80,10.47,8.53,11.81,-6.1,3.5,241,241,,1,321,321,,,,,,,,,"76,7,11,5,0,0,0,0,0","0,53,43,4,0","8,40,22,15,14",,,,,81,,,,,,,,,,,,,,,,,,,,,,,,,,,,,,,,,,,,26.3,4,4,56,67,,1021,0,275,0,3,3,,1,0,I1.000|7:52-I1.000|5:56-I0.723|7:11,,,,,3113,"firmware 2.80",250,0,,0,168070,250480,30378,,,,,,,,,,,,,,,,,,,,,,,,,,,,,,,,,,,,,,,,,,"3,3",
10144491,a0c72bfd-e645-4c07-b7b9-cb9158194c59,1570876092,120,1570869849,,0,0,0.59,485,485,0,89,,,1,1.2,1,,,,66,114,122,,,,,,,1,57.94,3530,,,,,,,,,,,,5,60,,4.48,,21.4,,,,,,,,,,,,,,,,"88,12,0,0,0,0","5,95,0,0,0",,,,,,,,,,,,,,,,,,,,,,,,,,,,,,,,,,,,,,,,,,4.7,10,3,154,51,,1021,2,272,0,3,3,,1,0,,,,,,3113,"firmware 2.80",250,0,,0,168075,,30378,,,,,,,,,,,,,,,,,,,,,,,,,,,,,,,,,,,,,,,,,,,
10149501,7eeb3c10-7f3b-4f7e-a00a-dddca701c306,1570877637,120,1570897626,,0,0,16.58,17461,25874,1153,1081,,,1,8.9,0.89,,,392,1411,100,145,,,,,,,1,57.94,3085,,,,,,,,,,,,106,53,,3.83,,-7.4,,,,,,,,,,,,,,,,"97,3,0,0,0,0","46,54,0,0,0",,,,,,,,,,,,,,,,,,,,,,,,,,,,,,,,,,,,,,,,,,7.8,10,3,154,51,,1021,2,272,0,3,3,,1,0,,,,,,3113,"firmware 2.80",250,0,,0,168075,,30378,,,,,,,,,,,,,,,,,,,,,,,,,,,,,,,,,,,,,,,,,,"0,2,3,3",
10183233,f3ebf6e1-2e73-454e-a887-4b283f64b01b,1571074216,120,1571071756,,0,0,3.59,1104,1146,22,23,,,1,0,0.17,,,,201,137,155,,,,59.34,36.44,59.77,1,59.82,781,,,2.1,,97,98,,,,,,20,80,11.66,11.74,11.73,-4.1,-2,260,260,,1,269,269,,,,,,,,,"1,1,10,62,25,1,0,0,0","1,67,32,0,0","0,11,73,15,0",,,,,122,,,,,,,,,,,,,,,,,,,,,,,,,,,,,,,,,,,,17.9,25,9,11,54,,1011,0,267,0,3,3,,1,0,I1.000|5:16-I1.000|5:03-I1.000|5:06-I0.591|3:00,,,,,3113,"firmware 2.80",250,0,,0,168070,250480,30378,,11809,,,,,,,,,,,,,,,,,,,,,,,,,,,,,,,,,,,,,,,,,
10183238,0edf563f-a37b-48ec-9b89-83bb7b1300a1,1571078368,120,1571071806,,0,0,1.04,476,476,0,0,,,1,0,0,,,,77,129,136,,,,39.13,20.35,39.13,1,61.01,3830,,,,,,100,,,,,,7,82,7.84,7.98,8,-5.7,-4.2,159,159,,1,166,166,,,,,,,,,"100,0,0,0,0,0,0,0,0","0,100,0,0,0","2,93,5,0,0",,,,,80,,,,,,,,,,,,,,,,,,,,,,,,,,,,,,,,,,,,8.7,22,6,72,62,,1010,0,268,1,3,3,,1,0,,,,,,3113,"firmware 2.80",250,0,,0,168070,250480,30378,,11811,,,,,,,,,,,,,,,,,,,,,,,,,,,,,,,,,,,,,,,,,
10183239,f29edb74-cca4-4e73-8d1a-94669b839c0b,1571075592,120,1571071808,,0,0,8.82,2742,2742,4,0,,,1,0,0,,,,562,160,192,,,,47.28,38.04,47.33,1,60.8,3838,,,4.1,,110,95,,,,,,109,83,11.69,16.26,16.28,30.3,0.6,282,282,,1,409,409,,,,,,,,,"39,1,1,1,1,1,21,36,0","0,29,12,22,36","32,6,2,13,47",,,,,116,,,,,,,,,,,,,,,,,,,,,,,,,,,,,,,,,,,,132,24,8,11,54,,1011,0,267,0,3,3,,1,0,I0.396|1:29-I0.413|1:26-I0.404|1:21-I0.415|1:17-I0.205|2:09-I0.406|1:30-I0.406|1:26-I0.402|1:22-I0.409|1:18-I0.201|2:21-I0.406|1:29-I0.411|1:25-I0.410|1:22-I0.413|1:21-I0.205|2:06-I0.411|1:31-I0.401|1:24-I0.414|1:25-I0.412|1:27-I0.121|6:13-I1.466|5:02-I0.096|5:20,,,,,3113,"firmware 2.80",250,0,,0,168070,250480,30378,,11812,,,,,,,,,,,,,,,,,,,,,,,,,,,,,,,,,,,,,,,,,
10204632,95e42e0f-da27-4a2f-ae13-e85c7a26446f,1571160888,120,1571154971,,0,0,2.27,715,715,16,16,,,1,0,0.08,,,,136,132,139,,,,60.36,34.14,60.89,1,61.1,2277,,,1.6,,101,101,,,,,,11,80,11.4,11.39,11.39,-2.6,-6,252,252,,1,254,254,,,,,,,,,"1,5,13,65,16,0,0,0,0","2,98,0,0,0","0,7,91,3,0",,,,,119,,,,,,,,,,,,,,,,,,,,,,,,,,,,,,,,,,,,13.8,16,20,262,72,,1008,0,290,0,6,3,,1,0,,,,,,3113,"firmware 2.80",250,0,,0,168070,250480,30378,,29000,,,,,,,,,,,,,,,,,,,,,,,,,,,,,,,,,,,,,,,,,
10206320,0c7bf90d-e1b1-4337-80ac-f6aae5fa2c26,1571163042,120,1571159331,,0,0,11.85,2945,2952,50,51,,,1,0,0.02,,,,719,162,176,,,,61.17,50.45,61.48,1,61.09,4364,,,4.1,,102,98,,,,,,107,83,14.5,14.57,14.58,6.8,3.9,338,338,,1,344,344,,,,,,,,,"0,0,0,2,7,60,31,0,0","0,5,21,73,0","0,1,17,73,8",,,,,145,,,,,,,,,,,,,,,,,,,,,,,,,,,,,,,,,,,,76.6,15,13,252,86,,1009,0,291,0,6,3,,1,0,,,,,,3113,"firmware 2.80",250,0,,0,168070,250480,30378,,29938,,,,,,,,,,,,,,,,,,,,,,,,,,,,,,,,,,,,,,,,,
10227048,0756eaf0-d2bc-4257-99db-49c047f473e3,1571247080,120,1571245716,,0,0,1.7,420,665,3,3,,,1,0,0,,,,85,141,166,,,,74.97,43.59,75.14,1,61.52,2092,,,1.7,,103,103,,,,,,9,83,14.54,14.76,14.71,4.5,1.9,342,342,,1,353,353,,,,,,,,,"2,0,0,3,4,40,50,0,0","4,42,42,13,0","1,1,14,71,12",,,,,146,,,,,,,,,,,,,,,,,,,,,,,,,,,,,,,,,,,,19,19,17,207,52,,1014,0,292,0,5,3,,1,0,,,,,,3113,"firmware 2.80",250,0,,0,168070,250480,30378,,45846,,,,,,,,,,,,,,,,,,,,,,,,,,,,,,,,,,,,,,,,,
10227056,88b4469d-ecdf-4dff-aa4c-741761002b83,1571247793,120,1571245784,,0,0,3.76,994,994,32,33,,,1,0,0,,,,237,163,183,132,,,56.15,43.63,56.72,1,61.54,4298,,,2.9,,,100,,,,,,38,87,13.62,16.21,16.24,5.3,-0.6,327,327,,1,433,433,,,,,,,,,"21,9,7,8,8,7,8,17,15","0,7,31,60,2","5,32,13,5,44",,,,,130,,,,,,,,,,,,,,,,,,,,,,,,,,,,,,,,,,,,71.3,18,18,194,52,,1014,0,292,0,5,3,,1,0,I0.091|0:37-I0.300|0:55-I0.118|0:52-I0.298|0:55-I0.111|0:56-I0.300|0:55-I0.118|0:54-I0.306|0:56-I0.112|0:54-I0.304|0:56-I0.218|1:57-I0.199|0:35-I0.120|0:40-I0.205|0:35-I0.129|0:47-I0.198|0:36-I0.108|0:40-I0.209|0:40-I0.097|0:37-I0.196|0:34-I0.026|0:05,,,,,3113,"firmware 2.80",250,0,,0,168070,250480,30378,,45854,,,,,,,,,,,,,,,,,,,,,,,,,,,,,,,,,,,,,,,,,
10227058,1ad0d245-ea96-40c5-b1ec-5e08f6daec83,1571249113,120,1571245788,,0,0,10.69,3140,3254,21,22,,,1,0,0.1,,,,621,144,174,,,,58.84,41.21,58.98,1,61.32,4454,,,3,,98,98,,,,,,72,82,12.25,13.11,13.09,-2.1,0.8,278,278,,1,310,310,,,,,,,,,"0,0,8,51,32,2,5,2,0","0,30,64,6,0","0,3,76,17,4",,,,,125,,,,,,,,,,,,,,,,,,,,,,,,,,,,,,,,,,,,43,18,18,194,52,,1014,0,292,0,5,3,,1,0,,,,,,3113,"firmware 2.80",250,0,,0,168070,250480,30378,,45856,,,,,,,,,,,,,,,,,,,,,,,,,,,,,,,,,,,,,,,,,
10253018,e930d807-7112-4918-959f-e0b9b9e650d4,1571335820,120,1571332653,,0,0,14.97,3611,3867,55,57,,,1,0,0.1,,,,861,161,177,,,,64.06,53.13,64.34,1,61.77,4320,,,4.2,,102,99,,,,,,129,85,14.93,15.09,15.1,0.8,-2.3,350,350,,1,362,362,,,,,,,,,"0,0,1,2,9,31,55,2,0","0,2,33,65,0","0,2,18,61,19",,,,,146,,,,,,,,,,,,,,,,,,,,,,,,,,,,,,,,,,,,72.1,16,5,228,81,,1014,0,288,1,6,3,,1,0,I4.231|18:07-I0.012|0:04-I1.000|3:55-I1.000|3:53-I1.000|3:45-I1.000|3:50-I1.000|3:52-I1.000|3:52-I1.000|3:54-I1.000|3:51-I1.000|3:47-I0.615|2:37-I0.085|0:19-I0.097|0:29-I0.087|0:19-I0.107|0:28-I0.101|0:20-I0.107|0:30-I0.102|0:21-I0.103|0:32-I0.099|0:22-I0.102|0:33-I0.096|0:20-I0.028|0:11,,,,,3113,"firmware 2.80",250,0,,0,168070,250480,30378,,64581,,,,,,,,,,,,,,,,,,,,,,,,,,,,,,,,,,,,,,,,,
10280181,712adebb-b8ea-4ada-817a-b6c5fa69b4e7,1571427208,120,1571420192,,0,0,0.44,140,140,1,4,,,1,0.6,0.46,,0.97,,25,127,139,,,,62.45,28.5,62.1,1,61.77,2859,,,,,,100,,,,,,2,83,11.14,11.33,11.03,15.1,-10.8,247,247,,1,238,238,,,,,,,,,"0,0,14,80,6,0,0,0,0","9,91,0,0,0","4,8,77,12,0",,,,,114,,,,,,,,,,,,,,,,,,,,,,,,,,,,,,,,,,,,3.8,12,22,229,67,,1012,0,299,1,3,3,,1,0,,,,,,3113,"firmware 2.80",250,0,,0,168070,250480,30378,,86758,,,,,,,,,,,,,,,,,,,,,,,,,,,,,,,,,,,,,,,,,
10299479,4e6cdeb7-bd98-44f0-9534-5a2ceb055748,1571508793,120,1571503123,,0,0,3.05,1276,1296,20,26,,,1,0,0.19,,,,211,,,,,,,24.94,,1,61.77,1480,,,,,,100,,,,,,28,80,8.57,8.66,8.62,,,176,176,,1,182,182,,,,,,,,,"84,13,3,0,0,0,0,0,0",,"2,75,22,0,0",,,,,90,,,,,,,,,,,,,,,,,,,,,,,,,,,,,,,,,,,,,11,5,352,97,,1013,0,274,1,9,3,,1,0,I1.000|6:34-I1.000|7:12-I1.000|7:09-I0.054|0:21,,,,,3113,"firmware 2.80",250,0,,0,168070,250480,30378,,101721,,,,,,,,,,,,,,,,,,,,,,,,,,,,,,,,,,,,,,,,,
10303814,bd605570-ce9a-40c8-95a0-79a8bbe1f1c8,1571563210,120,1571560302,,0,0,12.92,3266,3428,76,71,,,1,0.4,0.27,,,,938,181,205,,,,50.19,49.77,50.58,1,61.34,5760,,,5,,,91,,,,,,193,82,14.28,14.45,14.54,8.8,4.6,336,336,,1,353,353,,,,,,,,,"0,0,1,9,16,37,37,1,0","0,3,15,20,62","0,3,22,62,12",,,,,145,,,,,,,,,,,,,,,,,,,,,,,,,,,,,,,,,,,,232.7,11,5,300,94,,1015,1,273,0,9,3,,1,0,I1.000|4:56-I1.000|4:16-I1.000|4:16-I1.000|4:09-I1.000|4:00-I1.000|3:58-I1.000|4:02-I1.000|3:58-I1.000|3:59-I1.000|3:50-I1.000|3:54-I1.000|4:56-I0.916|4:13,,,,,3113,"firmware 2.80",250,0,,0,168070,250480,30378,,105372,,,,,,,,,,,,,,,,,,,,,,,,,,,,,,,,,,,,,,,,,
10321131,310da021-9e00-47e2-8ac0-9af3c77cc510,1571649970,120,1571646213,,0,0,3.65,1169,1295,13,23,,,1,0,0.17,,,,239,,,,,,,34.77,,1,61.34,4351,,,,,,100,,,,,,25,82,11.2,11.66,11.62,,,243,243,,1,264,264,,,,,,,,,"2,10,28,48,5,5,2,0,0",,"0,19,68,12,1",,,,,114,,,,,,,,,,,,,,,,,,,,,,,,,,,,,,,,,,,,,8,6,17,97,,1019,1,265,0,9,3,,1,0,I1.000|5:39-I1.000|5:23-I0.960|5:14-I0.132|0:38-I0.009|0:03-I0.200|1:05-I0.333|1:23-I0.014|0:03,,,,,3113,"firmware 2.80",250,0,,0,168070,250480,30378,,120103,,,,,,,,,,,,,,,,,,,,,,,,,,,,,,,,,,,,,,,,,
10321147,0ea41e74-1f78-421f-985d-9517a2251e9c,1571651364,120,1571646522,,0,0,3.72,1066,1066,1,0,,,1,0,0,,,,239,,,,,,,39.68,,1,61.34,4332,,,,,,100,,,,,,23,86,12.57,14.36,14.36,,,291,291,,1,347,347,,,,,,,,,"29,1,2,2,3,12,41,9,0",,"18,10,9,36,27",,,,,122,,,,,,,,,,,,,,,,,,,,,,,,,,,,,,,,,,,,,8,5,17,97,,1019,1,265,0,9,3,,1,0,I0.335|1:11-I0.065|0:41-I0.334|1:13-I0.070|0:41-I0.338|1:14-I0.061|0:40-I0.338|1:15-I0.041|0:44-I0.336|1:14-I0.046|0:41-I0.333|1:17-I0.020|0:42-I0.334|1:17-I0.008|0:02-I0.334|1:21-I0.028|0:44-I0.330|1:21-I0.008|0:02-I0.351|1:23-I0.011|0:04,,,,,3113,"firmware 2.80",250,0,,0,168070,250480,30378,,120115,,,,,,,,,,,,,,,,,,,,,,,,,,,,,,,,,,,,,,,,,
10321183,df727aea-4ac4-4a57-a46e-3665b11695d8,1571652527,120,1571646813,,0,0,1.68,542,615,17,15,,,1,0.5,0.38,,,,112,,,,,,,32.22,,1,61.34,4321,,,,,,100,,,,,,11,82,11.28,11.27,11.5,,,264,264,,1,288,288,,,,,,,,,"6,4,10,69,9,2,0,0,0",,"0,10,69,16,4",,,,,113,,,,,,,,,,,,,,,,,,,,,,,,,,,,,,,,,,,,,10,5,17,94,,1019,1,264,0,9,3,,1,0,I1.000|5:28-I0.678|3:34,,,,,3113,"firmware 2.80",250,0,,0,168070,250480,30378,,120146,,,,,,,,,,,,,,,,,,,,,,,,,,,,,,,,,,,,,,,,,
10349791,a3e79d80-937b-4072-9dfa-2c05dcc8e625,1571738220,120,1571734323,,0,0,1.93,616,702,13,15,,,1,0.2,0.32,,,,119,135,147,99,,,57.75,33.1,58.15,1,61.21,2890,,,1.7,,97,96,,,,,,11,81,11.33,11.3,11.35,0.2,-0.6,251,251,,1,265,265,,,,,,,,,"2,2,17,66,14,0,0,0,0","4,76,20,0,0","2,10,70,16,1",,,,,116,,,,,,,,,,,,,,,,,,,,,,,,,,,,,,,,,,,,15,13,2,130,88,,1024,1,265,0,9,3,,1,0,I1.000|5:24-I0.931|4:52,,,,,3113,"firmware 2.80",250,0,,0,168070,250480,30378,,145815,,,,,,,,,,,,,,,,,,,,,,,,,,,,,,,,,,,,,,,,,
10349792,8b8570af-f3a1-4988-bf43-9d92e26e6611,1571739103,120,1571734324,,0,0,8.01,1816,1816,39,35,,,1,0,0.13,,,,470,171,185,,,,63.01,54.78,63.43,1,60.95,4474,,,3.9,,107,93,,,,,,83,85,15.91,15.92,15.98,10.7,9.9,385,385,,1,393,393,,,,,,,,,"0,0,0,0,0,2,95,3,0","1,5,12,65,18","0,0,2,63,35",,,,,156,,,,,,,,,,,,,,,,,,,,,,,,,,,,,,,,,,,,120.5,13,2,130,88,,1024,1,265,0,9,3,,1,0,I1.000|3:44-I1.000|3:48-I1.000|3:45-I1.000|3:46-I1.000|3:51-I1.000|3:49-I1.000|3:46-I1.000|3:46-I0.011|0:02,,,,,3113,"firmware 2.80",250,0,,0,168070,250480,30378,,145816,,,,,,,,,,,,,,,,,,,,,,,,,,,,,,,,,,,,,,,,,
10349804,70ac04eb-4936-46f8-b2b3-2c9d9e355ca5,1571740963,120,1571734442,,0,0,1.29,443,462,19,13,,,1,0.9,0.49,1.29,,,96,145,160,120,,,48.07,29.13,49.23,1,60.96,4462,,,1.7,,95,95,,,,,,10,82,10.73,10.58,11.13,-11.9,-27,236,236,,1,259,259,,,,,,,,,"13,11,40,35,0,0,0,0,0","0,17,83,0,0","2,25,59,15,0",,,,,107,,,,,,,,,,,,,,,,,,,,,,,,,,,,,,,,,,,,17.6,14,7,45,92,,1024,2,266,0,5,3,,1,0,I1.000|5:47-I0.289|1:36,,,,,3113,"firmware 2.80",250,0,,0,168070,250480,30378,,145826,,,,,,,,,,,,,,,,,,,,,,,,,,,,,,,,,,,,,,,,,
10371768,06a30d0b-99f7-4701-bdf8-495bae6a4e9f,1571830113,120,1571836814,,0,0,8.66,7122,7472,356,360,,,1,4.5,0.81,,,303,432,85,118,66,,,,,,1,61.21,2861,,,,,,100,,,,,,23,57,,4.72,,13.6,,,,,,,,,,,,,,,,"72,28,0,0,0,0","83,17,0,0,0",,,,,,,,,,,,,,,,,,,,,,,,,,,,,,,,,,,,,,,,,,3.9,13,7,96,91,,1020,2,267,0,9,3,,1,0,,,,,,3113,"firmware 2.80",250,0,,0,168075,,30378,,162653,,,,,,,,,,,,,,,,,,,,,,,,,,,,,,,,,,,,,,,,"3,4",
10376767,5934fef7-26a5-46ec-8cd9-d71069508a2a,1571844070,120,1571853734,,0,0,3.84,2023,2347,35,36,,,1,0.5,0.32,1.76,0.58,,247,112,140,,,,38.53,18.95,38.95,1,62.38,4279,,,1,,,100,,,,,,18,77,6.82,9.25,9.68,36.6,-20.1,147,138,,1,251,249,,,,,,,,,"80,12,3,1,1,1,1,1,0","17,83,0,0,0","38,43,13,2,3",,,,,74,,,,,,,,,,,,,,,,,,,,,,,,,,,,,,,,,,,,7.2,21,22,147,62,,1017,1,269,0,5,3,,1,0,I1.000|6:51-I0.838|5:47-I0.107|0:21-I0.106|1:31-I1.000|10:20-I0.792|8:52,,,,,3113,"firmware 2.80",250,0,,0,168070,250480,30378,,166710,,,,,,,,,,,,,,,,,,,,,,,,,,,,,,,,,,,,,,,,,
10376771,e3980fc7-9f2c-499d-9a7f-7c9ce1301453,1571841898,120,1571853739,,0,0,6.85,1817,1951,65,60,,,1,0.2,0.27,,,,387,146,154,,,,65.51,45.13,66.34,1,62.38,4320,,,2.9,,102,102,,,,,,43,82,13.62,13.67,13.81,-0.4,-33.6,320,320,,1,377,377,,,,,,,,,"2,1,1,4,25,59,8,0,0","0,21,79,0,0","1,5,28,60,6",,,,,138,,,,,,,,,,,,,,,,,,,,,,,,,,,,,,,,,,,,33.5,17,11,108,76,,1018,2,269,0,5,3,,1,0,I1.000|4:48-I1.000|4:26-I1.000|4:24-I1.000|4:18-I1.000|4:17-I1.000|4:22-I0.847|3:43,,,,,3113,"firmware 2.80",250,0,,0,168070,250480,30378,,166714,,,,,,,,,,,,,,,,,,,,,,,,,,,,,,,,,,,,,,,,,
10382331,a0704d88-5f80-4f96-9374-8cb2af939a93,1571905071,120,1571901883,,0,0,9.01,2245,2245,45,45,,,1,0,0.21,,,,552,161,169,,,,61.54,49.38,61.92,1,62.28,3804,,,3.6,,102,99,,,,,,79,84,14.44,14.51,14.54,6.2,8,339,339,,1,350,350,,,,,,,,,"0,0,0,1,9,63,27,0,0","0,1,23,75,0","0,0,19,69,11",,,,,143,,,,,,,,,,,,,,,,,,,,,,,,,,,,,,,,,,,,63.4,13,26,139,94,,1014,0,265,0,5,3,,1,0,I1.000|4:17-I1.000|4:09-I1.000|4:03-I1.000|4:00-I1.000|4:06-I1.000|4:05-I1.000|4:12-I1.000|4:11-I1.000|4:20-I0.006|0:01,,,,,3113,"firmware 2.80",250,0,,0,168070,250480,30378,,170648,,,,,,,,,,,,,,,,,,,,,,,,,,,,,,,,,,,,,,,,,
10382336,24b0ebf5-c0b1-4bb4-9221-92da6319fe77,1571907465,120,1571901908,,0,0,3.45,962,975,0,1,,,1,0,0,,,,222,155,173,,,,56.64,40.74,56.62,1,62.27,4325,,,2.6,,101,100,,,,,,29,85,12.91,13.8,13.79,0.9,-3.2,290,290,,1,319,319,,,,,,,,,"1,1,21,25,16,7,25,4,0","0,9,49,41,0","0,9,51,30,10",,,,,127,,,,,,,,,,,,,,,,,,,,,,,,,,,,,,,,,,,,42.6,13,22,139,90,,1014,0,265,0,5,3,,1,0,I0.335|1:44-I0.347|1:20-I0.333|1:44-I0.342|1:19-I0.351|1:50-I0.346|1:17-I0.355|1:58-I0.342|1:23-I0.344|2:00-I0.355|1:21-I0.003|0:05,,,,,3113,"firmware 2.80",250,0,,0,168070,250480,30378,,170653,,,,,,,,,,,,,,,,,,,,,,,,,,,,,,,,,,,,,,,,,
10382339,eaed55d5-0524-4ce6-8013-275b94154aa4,1571908475,120,1571901912,,0,0,1.62,466,518,24,13,,,1,0.5,0.36,1.4,,,100,143,151,,,,60.95,36.54,62.58,1,62.21,4316,,,1.7,,100,100,,,,,,10,84,12.86,12.96,13.5,-11.4,-35.4,300,300,,1,340,340,,,,,,,,,"0,3,5,23,51,11,3,3,0","0,24,76,0,0","2,7,43,39,9",,,,,124,,,,,,,,,,,,,,,,,,,,,,,,,,,,,,,,,,,,17.7,13,22,139,90,,1014,0,265,0,5,3,,1,0,I1.000|4:49-I0.624|2:57,,,,,3113,"firmware 2.80",250,0,,0,168070,250480,30378,,170656,,,,,,,,,,,,,,,,,,,,,,,,,,,,,,,,,,,,,,,,,
10414539,1e017e81-ac73-4729-a40e-50ceaca597cd,1572004380,120,1572009468,1572179047,0,0,11.03,10554,11881,491,490,,,1,5.9,0.87,,,296,1466,96,138,,,,,,,1,62.28,2528,,,1.2,,,100,,,,,,55,55,,4.48,,-18.9,-26.5,92,92,,,145,145,,,,,,,,,"78,22,0,0,0,0","66,34,0,0,0","60,33,5,1,0",,,,,,,,,,,,,,,,,,,,,,,,,,,,,,,,,,,,,,,,,8,11,4,170,100,,1024,2,274,0,4,3,,1,0,I1.000|12:03-I1.000|15:18-I1.000|28:59-I1.000|12:31-I1.000|14:49-I1.000|20:13-I1.000|18:10-I1.000|16:24-I1.000|11:24-I1.000|13:21-I1.000|12:21-I0.030|0:21,,,,,3113,"firmware 2.80",250,0,,0,168075,,30378,,195215,,,,,,,,,,,,,,,,,,,,,,,,,,,,,,,,,,,,,,,,"1,4",
10416179,27bf9434-9e1c-425d-b627-849baf4ec49d,1572017955,120,1572014606,,0,0,12.01,3469,3667,415,411,,,1,4.9,0.83,1.01,1.07,703,748,152,170,,,,55.76,42.39,58.17,1,60.1,4412,,,3.5,,100,98,,,,,,99,83,13.6,13.94,14.35,-8.7,12.5,327,327,,1,373,373,,,,,,,,,"16,11,8,15,14,14,16,6,1","1,12,68,19,0","1,11,35,30,23",,,,,125,,,,,,,,,,,,,,,,,,,,,,,,,,,,,,,,,,,,49.2,14,4,222,100,,1024,1,280,0,5,3,,1,0,I1.000|5:10-I1.000|5:59-I1.000|6:05-I1.000|5:32-I1.000|4:38-I1.000|4:51-I1.000|6:21-I1.000|4:16-I1.000|3:48-I1.000|3:34-I1.000|3:27-I1.000|4:04-I0.013|0:05,,,,,3113,"firmware 2.80",250,0,,0,168070,250480,30378,,196431,,,,,,,,,,,,,,,,,,,,,,,,,,,,,,,,,,,,,,,,"3,4",
10430950,1ac8fa79-912d-41a1-91e7-aa4523935bcd,1572110801,120,1572107030,,0,0,2.45,836,836,117,0,,,1,2.5,0.83,0.94,,503,164,137,150,,,,52.2,31.33,58.42,1,61.48,2912,,,2,,99,100,,,,,,16,81,12.63,10.65,12.74,-6.2,-32.1,324,324,,1,357,357,,,,,,,,,"26,3,15,48,8,1,0,0,0","2,57,41,0,0","1,3,36,49,10",,,,,109,,,,,,,,,,,,,,,,,,,,,,,,,,,,,,,,,,,,17.2,16,11,175,76,,1017,0,237,0,3,3,,1,0,I1.000|6:08-I1.000|5:14-I0.453|2:34,,,,,3113,"firmware 2.80",250,0,,0,168070,250480,30378,,207653,,,,,,,,,,,,,,,,,,,,,,,,,,,,,,,,,,,,,,,,4,
10430956,dafe44d0-c69c-4e7e-8913-268cadbf7752,1572111780,120,1572107037,,0,0,6.2,1736,1736,225,214,,,1,3,0.77,1.3,1.23,533,376,153,180,,,,57.41,42.09,60.12,1,61.83,5760,,,3,,100,97,,,,,,53,85,13.18,13.07,14.08,8.5,7.7,314,314,,1,383,383,,,,,,,,,"1,3,9,15,36,26,8,0,0","0,32,21,47,0","7,20,24,17,32",,,,,126,,,,,,,,,,,,,,,,,,,,,,,,,,,,,,,,,,,,55.7,15,10,175,76,,1017,0,237,0,3,3,,1,0,I0.314|1:20-I0.328|1:43-I0.290|1:19-I0.360|1:37-I0.320|1:19-I0.328|1:34-I0.306|1:20-I0.336|1:37-I0.310|1:22-I0.321|1:39-I0.295|1:20-I0.322|1:29-I0.306|1:23-I0.311|1:33-I0.299|1:21-I0.312|1:34-I0.285|1:24-I0.297|1:34-I0.289|1:12-I0.257|1:15-I0.014|0:02,,,,,3113,"firmware 2.80",250,0,,0,168070,250480,30378,,207655,,,,,,,,,,,,,,,,,,,,,,,,,,,,,,,,,,,,,,,,"5,5,5,5",
10430999,6d75ad47-79ba-4893-be6e-58f91a2289e6,1572113585,120,1572107098,,0,0,1.55,513,513,4,110,,,1,1.2,1,,1.07,,78,119,133,,,,64.09,31.02,58.92,1,61.96,5751,,,,,,100,,,,,,5,80,9.78,11.29,10.13,-7.4,17,164,164,,1,178,178,,,,,,,,,"9,22,20,26,19,4,0,0,0","0,100,0,0,0","10,67,23,0,0",,,,,113,,,,,,,,,,,,,,,,,,,,,,,,,,,,,,,,,,,,5.5,15,11,175,83,,1017,0,237,1,3,3,,1,0,I1.000|5:40-I0.546|2:53,,,,,3113,"firmware 2.80",250,0,,0,168070,250480,30378,,207665,,,,,,,,,,,,,,,,,,,,,,,,,,,,,,,,,,,,,,,,,
10448649,111f70a6-5a20-4a8c-b4ca-3d518734e7e2,1572190009,60,1572193275,,0,0,20.14,6020,6802,388,398,,,1,3.7,0.35,0.96,1.04,593,1064,143,165,,,,58.12,42.43,59.47,1,62.04,4320,,,3.6,,103,99,,,,,,139,82,12.69,12.69,13.34,4.5,-5.3,291,291,,1,346,346,,,,,,,,,"14,5,6,8,25,33,9,0,0","1,33,63,3,0","5,12,34,38,11",,,,,122,,,,,,,,,,,,,,,,,,,,,,,,,,,,,,,,,,,,43,17,11,290,76,,1021,1,235,0,9,3,,1,0,I1.000|4:24-I1.000|4:15-I1.000|4:06-I1.000|4:24-I1.000|4:28-I1.000|4:13-I1.000|4:30-I1.000|7:38-I1.000|4:23-I1.000|5:40-I1.000|6:57-I1.000|5:15-I1.000|4:46-I1.000|4:22-I1.000|4:40-I1.000|7:11-I1.000|4:29-I1.000|4:41-I1.000|4:45-I1.000|4:28-I0.140|0:46,,,,,3113,"firmware 2.80",250,0,,0,168070,250480,30378,,221126,,,,,,,,,,,,,,,,,,,,,,,,,,,,,,,,,,,,,,,,"3,4",
10469845,7a9d3278-2ed5-4bf9-8751-94f295a31614,1572283175,60,1572284590,,0,0,4.56,1322,1334,19,21,,,1,0,0.18,,,,270,140,156,,,,62.07,39.67,62.36,1,62,2858,,,2.3,,100,100,,,,,,27,82,12.4,12.56,12.56,3.1,-2.8,279,279,,1,295,295,,,,,,,,,"2,1,4,27,45,20,1,0,0","1,48,51,0,0","1,3,68,25,4",,,,,126,,,,,,,,,,,,,,,,,,,,,,,,,,,,,,,,,,,,22.4,10,24,47,69,,1021,0,254,1,4,3,,1,0,I1.000|4:59-I1.000|4:45-I1.000|4:33-I1.000|4:49-I0.557|2:57,,,,,3113,"firmware 2.80",250,0,,0,168070,250480,30378,,239594,,,,,,,,,,,,,,,,,,,,,,,,,,,,,,,,,,,,,,,,,
10469848,eccacbd9-631f-4808-887b-47ea5a4eaba2,1572284840,60,1572284613,,0,0,10.09,2286,2286,0,1,,,1,0,0,,,,565,164,179,,,,67.32,55.6,67.31,1,63,4320,,,3.7,,106,96,,,,,,89,86,15.88,16.37,16.37,7.1,7.5,386,386,,1,402,402,,,,,,,,,"0,0,0,3,14,8,50,25,0","0,4,23,73,0","0,0,14,35,51",,,,,154,,,,,,,,,,,,,,,,,,,,,,,,,,,,,,,,,,,,84.2,9,24,47,70,,1021,0,255,1,4,3,,1,0,I1.017|3:33-I1.008|3:32-I0.602|2:53-I1.010|3:32-I1.008|3:34-I0.605|2:40-I1.002|3:32-I1.005|3:38-I0.611|3:00-I1.007|3:39-I1.004|3:38-I0.212|0:55,,,,,3113,"firmware 2.80",250,0,,0,168070,250480,30378,,239597,,,,,,,,,,,,,,,,,,,,,,,,,,,,,,,,,,,,,,,,,
10488137,b3c9736d-e436-4f40-83b8-706e638bcde5,1572372492,60,1572378286,,0,0,14.9,3592,3645,47,48,,,1,0,0.06,,,,865,159,183,,,,65.32,53.15,65.57,1,63.12,4320,,,4.2,,101,102,,,,,,122,85,14.93,15.29,15.32,2.5,-6.4,356,356,,1,376,376,,,,,,,,,"0,0,0,1,5,58,24,12,0","0,2,62,35,0","0,1,11,69,19",,,,,146,,,,,,,,,,,,,,,,,,,,,,,,,,,,,,,,,,,,94,9,15,25,77,,1025,0,277,1,4,3,Karlsruhe,1,0,I1.000|4:25-I1.000|4:08-I1.000|4:05-I1.000|4:06-I1.000|4:04-I1.000|4:02-I1.000|4:05-I1.000|4:08-I0.024|0:07-I0.291|1:00-I0.249|1:01-I0.287|1:00-I0.232|1:01-I0.298|1:01-I0.249|1:00-I0.301|1:02-I0.249|1:01-I0.295|1:00-I0.253|1:01-I0.310|1:02-I0.246|1:00-I0.297|1:00-I0.250|1:02-I0.307|1:01-I0.247|1:00-I0.302|1:00-I0.238|1:01-I0.309|1:02-I1.000|4:22-I0.668|3:06,,,,,3113,"firmware 2.80",250,0,,0,168070,250480,30378,,253489,,,,,,,,,,,,,,,,,,,,,,,,,,,,,,,,,,,,,,,,,
10526566,c039bbda-ae53-42ee-9699-4e4aa78a66dd,1572453029,60,1572548763,,0,0,0.28,91,91,0,1,,,1,0,0,,,,18,134,143,,,,57,26.96,56.75,1,63.25,2703,,,,,,100,,,,,,1,81,10.75,10.9,10.78,4.1,-15.1,233,233,,1,230,230,,,,,,,,,"0,0,33,67,0,0,0,0,0","0,58,42,0,0","0,8,92,0,0",,,,,114,,,,,,,,,,,,,,,,,,,,,,,,,,,,,,,,,,,,2.4,8,12,43,75,,1024,0,286,0,3,3,Eggenstein-Leopoldshafen,1,0,,,,,,3113,"firmware 2.80",250,0,,0,168070,250480,30378,,282067,,,,,,,,,,,,,,,,,,,,,,,,,,,,,,,,,,,,,,,,,
10526567,b48c2e90-334a-4a53-9c03-9b7e90df6053,1572449792,60,1572548765,,0,0,8.32,2276,2301,30,29,,,1,0,0.1,,,,493,145,154,,,,63.65,44.04,63.95,1,63.25,2718,,,2.8,,100,100,,,,,,52,81,13.18,13.28,13.32,-1,-1.1,300,300,,1,310,310,,,,,,,,,"1,0,3,11,43,35,6,0,0","0,9,91,0,0","1,4,41,51,4",,,,,135,,,,,,,,,,,,,,,,,,,,,,,,,,,,,,,,,,,,29,10,18,44,67,,1024,0,286,0,3,3,Eggenstein-Leopoldshafen,1,0,I1.000|4:53-I1.000|4:31-I1.000|4:33-I1.000|4:29-I1.000|4:45-I1.000|4:28-I1.000|4:30-I1.000|4:19-I0.323|1:27,,,,,3113,"firmware 2.80",250,0,,0,168070,250480,30378,,282068,,,,,,,,,,,,,,,,,,,,,,,,,,,,,,,,,,,,,,,,,
10526571,969ed681-df46-4b73-b3cd-1e2d63cadd2d,1572452185,60,1572548771,,0,0,2.37,816,816,17,17,,,1,0,0,,,,108,118,141,,,,61.6,30.91,62.15,1,63.25,2704,,,,,,100,,,,,,8,70,10.44,13.2,13.21,5.9,-27.9,240,240,,1,381,381,,,,,,,,,"54,5,6,3,4,6,5,8,9","1,99,0,0,0","41,25,3,4,26",,,,,124,,,,,,,,,,,,,,,,,,,,,,,,,,,,,,,,,,,,6.3,10,18,44,67,,1024,0,286,0,3,3,Eggenstein-Leopoldshafen,1,0,I0.152|0:23-I0.092|1:03-I0.128|0:22-I0.129|1:02-I0.137|0:22-I0.102|1:02-I0.129|0:21-I0.138|1:06-I0.137|0:22-I0.096|1:03-I0.127|0:21-I0.125|1:10-I0.121|0:22-I0.099|1:06-I0.129|0:21-I0.109|1:03-I0.131|0:21-I0.111|1:09-I0.135|0:21-I0.038|0:15,,,,,3113,"firmware 2.80",250,0,,0,168070,250480,30378,,282070,,,,,,,,,,,,,,,,,,,,,,,,,,,,,,,,,,,,,,,,,
10526574,d8008913-0609-4601-b801-0ecb1ac393f8,1572545312,60,1572548799,,0,0,15.04,3481,3490,79,80,,,1,0,0.09,,,,896,165,184,,,,64.95,55.75,65.37,1,63.56,4320,,,4.6,,99,97,,,,,,137,85,15.56,15.89,15.93,-0.7,-2.7,371,371,,1,391,391,,,,,,,,,"1,0,1,2,6,17,58,14,0","0,1,25,73,2","1,5,14,43,38",,,,,152,,,,,,,,,,,,,,,,,,,,,,,,,,,,,,,,,,,,99.9,9,13,25,75,,1020,0,295,1,5,3,Karlsruhe,1,0,I1.000|4:15-I1.000|4:40-I1.000|4:21-I1.000|3:50-I1.000|3:55-I1.000|3:49-I1.000|3:43-I1.000|3:36-I1.000|3:52-I1.000|3:40-I1.000|3:39-I1.000|3:42-I1.000|3:39-I1.000|3:33-I1.000|3:37-I0.044|0:10,,,,,3113,"firmware 2.80",250,0,,0,168070,250480,30378,,282073,,,,,,,,,,,,,,,,,,,,,,,,,,,,,,,,,,,,,,,,,
10526575,de74f91f-e662-4133-a636-6313b85e9687,1572548829,60,1572548800,,0,0,3.04,968,1086,5,5,,,1,0,0,,,,202,143,164,,,,53.76,34.56,53.87,1,63.32,4465,,,2.2,,95,96,,,,,,21,83,11.35,12.49,12.5,11.8,6.8,250,250,,1,298,298,,,,,,,,,"13,24,15,14,15,8,9,2,0","0,38,60,2,0","5,21,53,12,9",,,,,114,,,,,,,,,,,,,,,,,,,,,,,,,,,,,,,,,,,,27.7,9,13,25,75,,1020,0,295,1,5,3,Karlsruhe,1,0,I1.000|5:24-I0.059|0:21-I0.091|0:18-I0.111|0:32-I0.096|0:19-I0.110|0:29-I0.097|0:19-I0.111|0:32-I0.097|0:19-I0.109|0:35-I0.093|0:20-I0.112|0:35-I0.098|0:20-I0.860|5:43,,,,,3113,"firmware 2.80",250,0,,0,168070,250480,30378,,282074,,,,,,,,,,,,,,,,,,,,,,,,,,,,,,,,,,,,,,,,,
10543606,7af0c6e0-cf81-48c2-841c-1bb2fef727ad,1572618309,60,1572619204,,0,0,12.19,3926,4036,41,46,,,1,0,0.03,,,,691,137,176,102,,,56.05,37.37,56.26,1,63.19,3256,,,2.8,,95,98,,,,,,75,80,11.16,11.5,11.5,4.3,-0.6,243,243,,1,259,259,,,,,,,,,"11,3,8,47,28,2,1,0,0","0,69,29,2,0","6,11,72,10,1",,,,,116,,,,,,,,,,,,,,,,,,,,,,,,,,,,,,,,,,,,32.2,9,8,227,100,,1011,1,281,0,4,3,Karlsruhe,1,0,I1.000|5:37-I1.000|5:11-I1.000|5:07-I1.000|5:08-I1.000|4:52-I1.000|4:57-I1.000|5:05-I1.000|5:00-I1.000|5:06-I1.000|6:25-I1.000|6:43-I1.000|5:06-I0.193|1:07,,,,,3113,"firmware 2.80",250,0,,0,168070,250480,30378,,295046,,,,,,,,,,,,,,,,,,,,,,,,,,,,,,,,,,,,,,,,,
10561632,0dd83dc8-ed4b-4cf2-8308-1f03a9ea430d,1572704114,60,1572703083,,0,0,4,1242,2401,47,47,,,1,0,0.11,1.28,0.9,,251,140,158,110,,,57.03,36.28,57.86,1,62.85,1853,,,2.2,,95,103,,,,,,26,80,11.57,12.84,13.02,-7.6,-50.9,265,265,,1,330,330,,,,,,,,,"17,4,9,31,26,2,8,3,0","1,41,58,0,0","2,22,44,24,8",,,,,121,,,,,,,,,,,,,,,,,,,,,,,,,,,,,,,,,,,,23.2,17,18,221,81,,997,1,298,0,5,3,Rülzheim,1,0,,,,,,3113,"firmware 2.80",250,0,,0,168070,250480,30378,,304492,,,,,,,,,,,,,,,,,,,,,,,,,,,,,,,,,,,,,,,,,
10561997,f78e5e61-0bad-43e8-b0de-1977ce4b9e5e,1572706948,60,1572705365,,0,0,8.35,1913,1913,72,73,,,1,0.2,0.25,1.11,0.92,,521,174,187,,,,60.49,54.24,61.12,1,62.37,4605,,,4.1,,103,95,,,,,,93,89,15.75,15.84,15.95,10.2,11.9,379,379,,1,398,398,,,,,,,,,"0,0,0,0,0,21,73,6,0","1,3,12,58,27","0,1,12,51,35",,,,,147,,,,,,,,,,,,,,,,,,,,,,,,,,,,,,,,,,,,120.6,16,15,216,81,,997,1,299,0,5,3,Rülzheim,1,0,I3.349|12:33-I1.651|6:20-I1.653|6:21-I1.700|6:39,,,,,3113,"firmware 2.80",250,0,,0,168070,250480,30378,,304771,,,,,,,,,,,,,,,,,,,,,,8.4,1913,,,0,"Südpfalz-Cross in Rülzheim",,,,,,,0,0,30378,10561997,18221,,,
10562512,3e433617-a8ca-470c-bb8a-161cd194e8cf,1572709516,60,1572708004,,0,0,2.87,999,1322,36,37,,,1,0,0.06,,,,179,132,160,112,,,53.36,30.99,54.16,1,62.59,4561,,,2,,95,95,,,,,,17,84,10.35,11.74,11.81,-19,-51.8,227,227,,1,284,284,,,,,,,,,"39,23,10,10,4,5,7,1,0","2,69,29,0,0","1,42,41,9,7",,,,,103,,,,,,,,,,,,,,,,,,,,,,,,,,,,,,,,,,,,23.2,16,13,222,83,,997,0,300,0,5,3,Rülzheim,1,0,I1.000|7:06-I0.836|4:48-I0.107|0:33-I0.095|0:21-I0.102|0:32-I0.099|0:21-I0.104|0:33-I0.094|0:20-I0.103|0:35-I0.097|0:21-I0.106|0:36-I0.101|0:21-I0.023|0:12,,,,,3113,"firmware 2.80",250,0,,0,168070,250480,30378,,305076,,,,,,,,,,,,,,,,,,,,,,,,,,,,,,,,,,,,,,,,,
10581536,dfc16529-6134-4051-bb64-1dc6a5e935e7,1572779658,60,1572781070,,0,0,15.1,4806,4826,46,47,,,1,0,0.04,,,,807,135,157,,,,57.95,38.54,58.16,1,62.39,3346,,,2.6,,95,96,,,,,,86,81,11.3,11.35,11.35,-1.4,-2.8,251,251,,1,254,254,,,,,,,,,"0,2,25,63,10,0,0,0,0","0,91,9,0,0","0,4,92,4,0",,,,,116,,,,,,,,,,,,,,,,,,,,,,,,,,,,,,,,,,,,20.3,14,4,177,75,,989,1,335,0,4,3,Karlsruhe,1,0,I1.000|5:43-I1.000|5:24-I1.000|5:27-I1.000|5:20-I1.000|5:12-I1.000|5:22-I1.000|5:20-I1.000|5:08-I1.000|5:06-I1.000|5:03-I1.000|5:14-I1.000|5:14-I1.000|5:10-I1.000|5:21-I1.000|5:25-I0.098|0:39,,,,,3113,"firmware 2.80",250,0,,0,168070,250480,30378,,320381,,,,,,,,,,,,,,,,,,,,,,,,,,,,,,,,,,,,,,,,,
10601046,f84d37af-eb91-438f-bc48-8c091cf68775,1572889899,60,1572888458,,0,0,2.94,999,1295,7,14,,,1,0,0.23,,,,181,130,141,,,,56,31.94,56,1,62.15,1569,,,1.6,,96,96,,,,,,15,81,10.54,10.67,10.61,0.6,4,228,228,,1,237,237,,,,,,,,,"4,8,56,32,0,0,0,0,0","2,97,1,0,0","1,18,77,5,0",,,,,109,,,,,,,,,,,,,,,,,,,,,,,,,,,,,,,,,,,,12.3,13,23,205,85,,994,0,287,1,4,3,Karlsruhe,1,0,,,,,,3113,"firmware 2.80",250,0,,0,168070,250480,30378,,335602,,,,,,,,,,,,,,,,,,,,,,,,,,,,,,,,,,,,,,,,,
10601051,ca0a0bfb-77aa-4ee6-b149-fc9a9acbc169,1572891231,60,1572888466,,0,0,1.64,541,649,5,1,,,1,0,0.12,,,,90,125,164,,,,60.85,31.33,61.26,1,62.15,1559,,,,,,100,,,,,,7,82,10.93,12.52,12.45,10.9,25.1,243,243,,1,293,293,,,,,,,,,"4,33,51,2,0,1,3,7,0","1,93,4,2,0","0,17,71,4,7",,,,,111,,,,,,,,,,,,,,,,,,,,,,,,,,,,,,,,,,,,7.8,12,22,205,85,,994,0,287,1,4,3,Karlsruhe,1,0,,,,,,3113,"firmware 2.80",250,0,,0,168070,250480,30378,,335606,,,,,,,,,,,,,,,,,,,,,,,,,,,,,,,,,,,,,,,,,
10620829,99d958eb-1d41-4c55-81fc-bebb8799dcc5,1572977357,60,1572977979,,0,0,14.82,3891,3921,58,57,,,1,0,0.07,,,,852,156,174,,,,60.44,48.13,60.74,1,62,2105,,,3.9,,101,99,,,,,,121,83,13.7,14.02,14.04,4.9,0.2,315,315,,1,332,332,,,,,,,,,"2,1,4,8,18,49,19,1,0","0,11,56,32,0","2,2,37,51,8",,,,,138,,,,,,,,,,,,,,,,,,,,,,,,,,,,,,,,,,,,56.4,11,3,142,69,,1000,0,333,1,6,3,Karlsruhe,1,0,I1.000|4:32-I1.000|4:21-I1.000|4:18-I1.000|4:18-I1.000|4:07-I1.000|4:17-I1.000|4:04-I1.000|4:08-I1.000|4:13-I1.000|4:02-I0.548|2:21-I0.719|3:01-I0.214|1:00-I0.503|2:01-I0.198|1:01-I0.268|1:02-I0.206|1:01-I0.268|1:00-I0.215|1:00-I0.267|0:59-I1.000|5:56-I0.411|2:09,,,,,3113,"firmware 2.80",250,0,,0,168070,250480,30378,,352868,,,,,,,,,,,,,,,,,,,,,,,,,,,,,,,,,,,,,,,,,
10636106,2244f8a9-f801-4983-99e0-a9ac9f22ece4,1573058399,60,1573057689,,0,0,9.9,2751,2789,38,37,,,1,0,0.13,,,,509,146,175,,,,61.85,43.73,62.15,1,62.08,1454,,,3.2,,100,100,,,,,,71,83,12.97,14.22,14.23,11.9,-5.7,297,297,,1,348,348,,,,,,,,,"10,4,9,22,9,8,32,5,1","0,49,19,32,0","7,10,36,28,19",,,,,130,,,,,,,,,,,,,,,,,,,,,,,,,,,,,,,,,,,,70.6,10,11,196,93,,1006,0,309,1,5,3,Eggenstein-Leopoldshafen,1,0,I1.000|5:25-I1.000|3:54-I1.000|3:55-I1.000|3:46-I1.000|3:47-I1.000|3:42-I1.000|4:57-I1.000|5:16-I0.346|1:56-I0.120|0:23-I0.092|1:02-I0.123|0:25-I0.095|0:56-I0.135|0:23-I0.107|1:09-I0.125|0:24-I0.085|0:56-I0.134|0:21-I0.081|0:50-I0.128|0:23-I0.331|1:59,,,,,3113,"firmware 2.80",250,0,,0,168070,250480,30378,,366204,,,,,,,,,,,,,,,,,,,,,,,,,,,,,,,,,,,,,,,,,
10657400,39e8cf32-bf3c-40e0-8d13-432a623ccabe,1573148063,60,1573151432,,0,0,1.37,432,432,5,10,,,1,0,0.15,,0.9,,93,142,157,,,,54.92,32.32,54.92,1,61.78,475,,,1.5,,97,99,,,,,,9,83,11.29,11.49,11.4,-13.5,-22.9,249,249,,1,258,258,,,,,,,,,"0,2,39,31,29,0,0,0,0","0,33,67,0,0","0,11,79,10,0",,,,,115,,,,,,,,,,,,,,,,,,,,,,,,,,,,,,,,,,,,16,9,18,204,90,,1005,0,316,1,5,3,Karlsruhe,1,0,I1.000|5:20-I0.370|1:53,,,,,3113,"firmware 2.80",250,0,,0,168070,250480,30378,,383881,,,,,,,,,,,,,,,,,,,,,,,,,,,,,,,,,,,,,,,,,
10657408,cce0bc43-a647-4a4b-90b8-711efe1a0c52,1573150099,60,1573151468,,0,0,13.62,3557,3666,51,52,,,1,0,0.11,,,,738,152,171,101,,,63.15,48.11,63.44,1,62.08,1872,,,3.6,,102,101,,,,,,102,85,13.79,14.13,14.14,6.1,4.7,320,320,,1,336,336,,,,,,,,,"0,0,0,17,21,37,24,1,0","1,13,72,15,0","0,1,41,50,7",,,,,135,,,,,,,,,,,,,,,,,,,,,,,,,,,,,,,,,,,,54.6,9,16,206,87,,1005,0,314,1,5,3,Karlsruhe,1,0,I1.000|4:19-I1.000|4:11-I1.000|4:07-I1.000|4:00-I1.000|4:00-I1.000|4:23-I1.000|4:01-I1.000|3:57-I1.000|4:05-I1.000|4:22-I1.000|4:46-I1.000|4:51-I1.000|5:05-I0.615|3:11,,,,,3113,"firmware 2.80",250,0,,0,168070,250480,30378,,383889,,,,,,,,,,,,,,,,,,,,,,,,,,,,,,,,,,,,,,,,,
10657410,d25d0635-202b-4002-af4f-0ebf4ba16952,1573154514,60,1573151473,,0,0,1.35,394,413,10,4,,,1,0,0.08,,,,80,137,153,,,,63.31,35.21,64.23,1,62.16,1717,,,1.2,,102,101,,,,,,7,85,12.48,12.64,12.73,9.8,8,288,288,,1,302,302,,,,,,,,,"1,9,11,17,33,28,1,0,0","1,54,44,0,0","0,12,37,51,0",,,,,121,,,,,,,,,,,,,,,,,,,,,,,,,,,,,,,,,,,,12.4,8,15,188,89,,1006,0,309,1,4,3,Karlsruhe,1,0,I1.000|4:39-I0.350|1:55,,,,,3113,"firmware 2.80",250,0,,0,168070,250480,30378,,383891,,,,,,,,,,,,,,,,,,,,,,,,,,,,,,,,,,,,,,,,,
10681072,ea16c7f5-c9e6-4122-adb4-c5955bb2b5c9,1573289813,60,1573288833,,0,0,7.96,2487,2504,179,179,,,1,2.7,0.84,0.98,1.01,449,543,149,176,,,,52.05,37.55,53.49,1,61.21,1817,,,3.1,,95,98,,,,,,64,82,11.96,11.99,12.08,5.8,13.3,276,276,,1,292,292,,,,,,,,,"12,9,14,20,33,11,1,0,0","0,18,77,5,0","0,10,59,29,2",,,,,117,,,,,,,,,,,,,,,,,,,,,,,,,,,,,,,,,,,,38.3,5,7,202,100,,1011,0,336,0,5,3,Neu-Anspach,1,0,I1.000|6:31-I1.000|4:46-I0.560|2:31-I1.000|5:19-I1.000|5:20-I1.000|4:49-I1.000|4:46-I1.000|5:20-I0.400|2:06,,,,,3113,"firmware 2.80",250,0,,0,168070,250480,30378,,401768,,,,,,,,,,,,,,,,,,,,,,,,,,,,,,,,,,,,,,,,"5,5",
10770489,61dc6f7a-41c1-407e-85ec-7f9f12a430a6,1573493238,60,1573655643,,0,0,4.41,1381,1566,14,12,,,1,0,0.01,,,,252,133,152,,,,60.23,36.14,60.5,1,61.16,619,,,2,,100,100,,,,,,23,82,11.49,11.52,11.54,-1.2,-5.3,257,257,,1,261,261,,,,,,,,,"2,1,9,66,21,0,0,0,0","2,83,14,0,0","2,4,87,7,0",,,,,117,,,,,,,,,,,,,,,,,,,,,,,,,,,,,,,,,,,,15.9,3,0,50,95,,1008,0,311,1,4,3,Karlsruhe,1,0,I1.000|5:11-I1.000|5:09-I1.000|5:04-I1.000|5:33-I0.413|2:04,,,,,3113,"firmware 2.80",250,0,,0,168070,250480,30378,,473072,,,,,,,,,,,,,,,,,,,,,,,,,,,,,,,,,,,,,,,,,
10770492,c9c247e4-a036-46f2-b4ea-8d3b531dbf58,1573582091,60,1573655648,,0,0,16.29,4317,4375,65,66,,,1,0,0.08,,,,992,160,185,,,,57.57,47.96,57.85,1,61.05,3999,,,4.8,,100,100,,,,,,158,84,13.58,14.78,14.79,12.8,-2.9,319,319,,1,357,357,,,,,,,,,"10,0,0,6,12,32,33,7,0","0,10,42,39,9","9,3,20,49,20",,,,,135,,,,,,,,,,,,,,,,,,,,,,,,,,,,,,,,,,,,113.5,6,12,214,77,,1007,0,332,1,5,3,Karlsruhe,1,0,I1.000|4:57-I1.000|4:36-I1.000|4:18-I1.000|4:22-I1.000|3:58-I1.000|4:06-I1.000|4:01-I1.000|4:03-I0.351|1:31-I0.563|2:01-I0.261|1:01-I0.568|2:00-I0.237|1:00-I0.563|2:00-I0.240|1:03-I0.557|2:00-I0.234|1:00-I0.301|1:03-I0.264|1:00-I0.227|0:59-I0.554|2:01-I0.245|1:07-I0.522|2:01-I0.190|2:11-I0.575|2:01-I0.222|1:01-I0.558|2:01-I0.200|1:00-I0.562|2:04-I0.297|5:30,,,,,3113,"firmware 2.80",250,0,,0,168070,250480,30378,,473075,,,,,,,,,,,,,,,,,,,,,,,,,,,,,,,,,,,,,,,,,
10773710,14e9f6d3-21c1-430f-aae3-b44caf03ca72,1573665853,60,1573665386,,0,0,9.54,2437,2437,33,33,,,1,0,0,,,,559,154,161,,,,63.7,48.14,63.97,1,61.9,2736,,,3.3,,102,104,,,,,,71,83,14.1,14.15,14.16,3.8,5.6,333,333,,1,339,339,,,,,,,,,"0,0,0,3,10,76,10,0,0","0,1,99,0,0","0,2,15,78,6",,,,,141,,,,,,,,,,,,,,,,,,,,,,,,,,,,,,,,,,,,41.8,6,16,211,81,,1007,0,333,1,5,3,Karlsruhe,1,0,I1.000|4:21-I1.000|4:13-I1.000|4:09-I1.000|4:10-I1.000|4:12-I1.000|4:14-I1.000|4:14-I1.000|4:15-I1.000|4:28-I0.543|2:22,,,,,3113,"firmware 2.80",250,0,,0,168070,250480,30378,,475821,,,,,,,,,,,,,,,,,,,,,,,,,,,,,,,,,,,,,,,,,
10773712,f3196687-a72c-4d61-bda3-d5d1602548f3,1573668434,60,1573665394,,0,0,1.22,328,328,0,1,,,1,0,0,,,,67,148,161,,,,63.24,38.18,63.18,1,61.9,2730,,,1.4,,,100,,,,,,8,86,13.36,14.12,14.08,6.3,-7.9,311,311,,1,367,367,,,,,,,,,"5,3,13,16,23,15,16,10,0","0,15,82,3,0","3,22,27,12,35",,,,,130,,,,,,,,,,,,,,,,,,,,,,,,,,,,,,,,,,,,19.6,5,15,208,83,,1007,0,334,1,5,3,Karlsruhe,1,0,I0.107|0:20-I0.122|0:43-I0.097|0:21-I0.098|0:34-I0.104|0:22-I0.108|0:38-I0.103|0:22-I0.083|0:26-I0.227|0:55-I0.111|0:23-I0.062|0:25,,,,,3113,"firmware 2.80",250,0,,0,168070,250480,30378,,475823,,,,,,,,,,,,,,,,,,,,,,,,,,,,,,,,,,,,,,,,,
10806758,481c8008-530f-4063-b904-2fe8013f4729,1573754942,60,1573756116,,0,0,15.7,3886,4047,65,67,,,1,0,0.05,,,,954,164,186,,,,60.34,51.76,60.64,1,61.44,4591,,,4.6,,99,98,,,,,,148,84,14.55,14.71,14.71,0.3,-4.8,341,341,,1,353,353,,,,,,,,,"0,0,0,1,19,40,40,1,0","0,2,29,68,0","0,1,24,61,15",,,,,144,,,,,,,,,,,,,,,,,,,,,,,,,,,,,,,,,,,,96.3,4,6,44,80,,1002,0,316,1,5,3,Karlsruhe,1,0,I1.000|4:33-I1.000|4:31-I1.000|4:28-I1.000|4:23-I1.000|4:04-I1.000|4:11-I1.000|4:04-I1.000|3:58-I1.000|3:59-I1.000|3:47-I1.000|3:51-I1.000|3:42-I1.000|3:56-I0.735|3:17-I0.099|0:18-I0.107|0:30-I0.095|0:20-I0.110|0:31-I0.099|0:21-I0.110|0:31-I0.094|0:20-I0.107|0:31-I0.099|0:20-I0.105|0:31-I0.095|0:21-I0.107|0:29-I0.093|0:21-I0.112|0:31-I0.097|0:21-I0.107|0:30-I0.093|0:20-I0.109|0:30-I0.100|0:21-I0.028|0:08,,,,,3113,"firmware 3.30",250,0,,0,168070,250480,30378,,504250,,,,,,,,,,,,,,,,,,,,,,,,,,,,,,,,,,,,,,,,,
10839784,db0d1395-ee88-43b4-8915-d0a8d2a796be,1573839108,60,1573839668,,0,0,13.76,3626,3668,46,47,,,1,0,0.06,,,,787,154,176,,,,61.3,47.65,61.55,1,61.48,4320,,,3.9,,98,100,,,,,,109,83,13.65,14,14.01,2.4,-4.1,317,317,,1,333,333,,,,,,,,,"1,0,4,14,24,31,25,0,0","0,8,59,32,0","0,2,36,53,9",,,,,137,,,,,,,,,,,,,,,,,,,,,,,,,,,,,,,,,,,,79.6,4,5,51,84,,1005,0,315,1,4,3,Karlsruhe,1,0,I1.000|5:02-I1.000|4:48-I1.000|4:38-I1.000|4:29-I1.000|4:20-I1.000|4:17-I1.000|4:06-I1.000|4:02-I1.000|3:58-I1.000|3:55-I1.000|3:53-I1.000|3:47-I1.000|5:19-I0.761|3:53,,,,,3113,"firmware 3.30",250,0,,0,168070,250480,30378,,533281,,,,,,,,,,,,,,,,,,,,,,,,,,,,,,,,,,,,,,,,,
10847476,1225daaa-e6e9-49be-9ea7-60fd0d5975d5,1573894457,60,1573894120,,0,0,9.87,3090,3109,27,32,,,1,0,0.07,,,,634,148,166,,,,52.4,38.02,52.55,1,61.19,3408,,,3.2,,96,96,,,,,,77,80,11.48,12.18,12.2,7.8,-16.1,257,257,,1,291,291,,,,,,,,,"12,2,6,26,49,2,2,2,0","0,13,86,0,0","10,5,62,18,4",,,,,120,,,,,,,,,,,,,,,,,,,,,,,,,,,,,,,,,,,,35.5,1,8,189,100,,1010,0,333,0,9,3,Karlsruhe,1,0,I1.000|5:07-I1.000|5:06-I1.000|4:54-I1.000|4:52-I1.000|4:46-I1.000|4:44-I0.962|4:37-I0.093|0:20-I0.077|0:57-I0.088|0:18-I0.061|0:40-I0.080|0:18-I0.077|0:50-I0.082|0:18-I0.068|0:38-I0.081|0:19-I0.070|0:56-I0.079|0:18-I0.064|0:37-I0.084|0:17-I0.057|0:36-I0.083|0:19-I0.459|3:07-I0.114|0:23-I0.137|0:42-I0.077|0:17-I0.982|5:14,,,,,3113,"firmware 3.30",250,0,,0,168070,250480,30378,,540294,,,,,,,,,,,,,,,,,,,,,,,,,,,,,,,,,,,,,,,,,
10876852,91966f3a-3f95-4cfa-a2e1-43ee6d1467ae,1574010217,60,1574010038,,0,0,10.88,3213,3312,35,35,,,1,0,0.07,,,,652,145,166,,,,57.91,41,58.14,1,60.92,2753,,,3,,99,99,,,,,,75,81,12.19,12.19,12.23,4.2,4.6,274,274,,1,281,281,,,,,,,,,"0,1,4,31,61,3,0,0,0","1,16,82,1,0","0,4,72,24,1",,,,,125,,,,,,,,,,,,,,,,,,,,,,,,,,,,,,,,,,,,32.1,5,7,40,93,,1004,,,1,5,1,Karlsruhe,1,0,I1.000|4:58-I1.000|5:00-I1.000|4:51-I1.000|4:47-I1.000|4:40-I1.000|4:50-I1.000|4:55-I1.000|4:51-I1.000|5:06-I1.000|5:04-I0.881|4:30,,,,,3113,"firmware 3.30",250,0,,0,168070,250480,30378,,565676,,,,,,,,,,,,,,,,,,,,,,,,,,,,,,,,,,,,,,,,,
10914781,9adab116-7fe2-4550-97bc-20fa1dc270ff,1574186882,60,1574187576,,0,0,14.94,3688,3696,52,53,,,1,0,0.07,,,,875,159,177,,,,63.43,51.72,63.7,1,61.31,2448,,,4.2,,98,101,,,,,,125,83,14.58,14.69,14.71,2.2,0.3,344,344,,1,353,353,,,,,,,,,"0,0,0,2,10,49,38,0,0","0,1,52,47,0","0,1,16,72,12",,,,,146,,,,,,,,,,,,,,,,,,,,,,,,,,,,,,,,,,,,75.6,5,4,172,97,,1019,0,346,1,4,3,Karlsruhe,1,0,I1.000|4:30-I1.000|4:20-I1.000|4:27-I1.000|4:16-I1.000|4:06-I1.000|4:05-I1.000|4:00-I1.000|4:05-I1.000|4:03-I1.000|3:58-I1.000|3:54-I1.000|3:50-I1.000|3:47-I1.000|4:02-I0.935|4:03,,,,,3113,"firmware 3.30",250,0,,0,168070,250480,30378,,599057,,,,,,,,,,,,,,,,,,,,,,,,,,,,,,,,,,,,,,,,,
10956872,ab16e360-1c4e-489d-9828-57605732596e,1574359700,60,1574416054,,0,0,13.37,3430,3430,56,59,,,1,0,0.08,,,,799,158,180,,,,61.05,49.05,61.35,1,61.78,2304,,,4,,98,100,,,,,,113,83,14.03,14.56,14.57,2,-4.3,329,329,,1,350,350,,,,,,,,,"0,0,1,12,19,47,16,6,0","0,1,70,30,0","0,1,33,52,15",,,,,141,,,,,,,,,,,,,,,,,,,,,,,,,,,,,,,,,,,,82.7,3,5,29,94,,1010,0,322,1,4,3,Karlsruhe,1,0,I1.000|4:46-I1.000|4:29-I1.000|4:23-I1.000|4:21-I1.000|4:13-I1.000|4:15-I1.000|4:16-I1.000|4:19-I0.549|2:22-I1.000|3:41-I0.494|2:12-I1.000|3:33-I0.475|2:22-I1.000|3:36-I0.852|4:24,,,,,3113,"firmware 3.30",250,0,,0,168070,250480,30378,,635585,,,,,,,,,,,,,,,,,,,,,,,,,,,,,,,,,,,,,,,,,
10957465,38aecf22-f2fb-4478-83ee-8336c0fabc0b,1574422521,60,1574422686,,0,0,12.34,3265,3595,55,58,,,1,0,0.07,,,,726,152,171,,,,62.14,47.04,62.47,1,62.03,2016,,,3.4,,97,102,,,,,,91,84,13.6,14.16,14.16,-1.7,-11.1,317,317,,1,341,341,,,,,,,,,"1,2,4,6,34,38,12,4,0","0,3,86,11,0","0,3,37,48,12",,,,,135,,,,,,,,,,,,,,,,,,,,,,,,,,,,,,,,,,,,43.9,3,11,358,98,,1009,1,323,0,9,3,Karlsruhe,1,0,I1.000|4:44-I1.000|4:42-I1.000|4:35-I1.000|4:31-I1.000|4:20-I1.000|4:20-I1.000|4:17-I1.000|4:00-I1.000|4:14-I0.896|4:29-I0.508|1:45-I0.205|1:06-I0.304|1:02-I0.204|1:04-I0.500|1:46-I0.211|1:08-I0.302|1:04-I0.209|1:17,,,,,3113,"firmware 3.30",250,0,,0,168070,250480,30378,,636078,,,,,,,,,,,,,,,,,,,,,,,,,,,,,,,,,,,,,,,,,
10971621,2b6b6133-5a7e-4a62-99ac-8605ccf50ade,1574500460,60,1574498916,,0,0,6.01,1999,2026,28,27,,,1,0,0.07,,,,443,148,164,,,,48.63,34.26,48.92,1,60.92,1945,,,3,,92,92,,,,,,50,81,10.85,10.95,10.98,-2.9,-8.6,237,237,,1,245,245,,,,,,,,,"2,10,51,33,3,2,0,0,0","0,3,95,2,0","0,14,82,4,0",,,,,111,,,,,,,,,,,,,,,,,,,,,,,,,,,,,,,,,,,,34.3,5,23,39,85,,998,0,292,0,4,3,Karlsruhe,1,0,I1.000|5:52-I1.000|5:39-I1.000|5:29-I1.000|5:33-I1.000|5:10-I1.000|5:34-I0.012|0:02,,,,,3113,"firmware 3.30",250,0,,0,168070,250480,30378,,648524,,,,,,,,,,,,,,,,,,,,,,,,,,,,,,,,,,,,,,,,,
10999025,98060e64-8e6d-4dd8-ad24-8798010599f2,1574603526,60,1574605356,,0,0,4.04,1103,1103,31,30,,,1,0,0.27,1.07,0.95,,249,151,165,119,,,60.34,42.23,60.93,1,61.4,1106,,,2.7,,105,101,,,,,,30,83,13.24,13.2,13.36,5.7,-2.8,309,309,,1,322,322,,,,,,,,,"1,1,1,8,35,54,0,0,0","1,4,76,19,0","0,4,41,48,7",,,,,132,,,,,,,,,,,,,,,,,,,,,,,,,,,,,,,,,,,,43.1,8,1,267,82,,1009,1,276,0,3,3,Darmstadt,1,0,I1.000|4:41-I1.000|4:28-I1.000|4:30-I1.000|4:31-I0.042|0:13,,,,,3113,"firmware 3.30",250,0,,0,168070,250480,30378,,671460,,,,,,,,,,,,,,,,,,,,,,,,,,,,,,,,,,,,,,,,,
10999050,87012b48-c32f-4cfc-9af9-e137fcb54d7a,1574606732,60,1574605477,,0,0,9.54,2146,2146,53,54,,,1,0,0.2,,,,566,174,186,,,,61.87,55.87,62.29,1,60.99,4567,,,4.3,,101,94,,,,,,104,89,16.03,16.15,16.19,8.7,11.2,387,387,,1,394,394,,,,,,,,,"0,0,0,0,0,11,81,8,0","1,2,5,84,9","0,0,6,50,43",,,,,150,,,,,,,,,,,,,,,,,,,,,,,,,,,,,,,,,,,,109.4,8,1,263,78,,1009,0,277,0,3,3,Darmstadt,1,0,I1.000|3:30-I1.000|3:38-I1.000|3:43-I1.000|3:43-I1.000|3:51-I1.000|3:43-I1.000|3:52-I1.000|3:52-I1.000|3:51-I0.544|2:03,,,,,3113,"firmware 3.30",250,0,,0,168070,250480,30378,,671477,,,,,,,,,,,,,,,,,,,,,,,,,,,,,,,,,,,,,,,,,
10999755,f2880846-16a1-4220-8e51-29b4325b56f5,1574609835,60,1574609204,,0,0,2.51,891,891,29,30,,,1,1,0.59,1.09,0.89,,174,136,149,108,,,50.18,29.97,50.87,1,61.14,4536,,,2,,95,95,,,,,,16,85,10.17,10.28,10.44,1.5,-7.1,223,223,,1,238,238,,,,,,,,,"8,27,44,21,0,0,0,0,0","1,75,24,0,0","4,26,63,7,0",,,,,99,,,,,,,,,,,,,,,,,,,,,,,,,,,,,,,,,,,,15.5,8,1,270,79,,1009,0,277,0,3,3,Darmstadt,1,0,I1.000|5:34-I1.000|5:59-I0.507|3:18,,,,,3113,"firmware 3.30",250,0,,0,168070,250480,30378,,672059,,,,,,,,,,,,,,,,,,,,,,,,,,,,,,,,,,,,,,,,,
11007138,,1574240220,,1574668662,,0,0,14.76,3940,,,,,,0,,,,,,963,,,,,,,47.2,,1,,,,,,,,,,,,,,86,,,,,,,,,,,,,,,,,,,,,,,,,,,,,,,,,,,,,,,,,,,,,,,,,,,,,,,,,,,,,,,,,,,,,,,,,,1,,,0,0,,,,,,,,,0,,0,168070,250480,30378,,,,,,,,,,,,,,,,,,,,,,,,,,,,,,,,,,,,,,,,,,,
11013975,9f19fa56-3112-4ffc-aaed-a5def163ea7b,1574702881,60,1574701953,,0,0,7.12,2235,2499,35,35,,,1,0,0.07,,,,404,134,146,,,,59.5,37.08,59.86,1,61.27,2960,,,2.2,,96,100,,,,,,38,80,11.47,11.54,11.55,4.7,6.6,253,253,,1,259,259,,,,,,,,,"2,3,21,48,23,3,0,0,0","1,89,10,0,0","0,11,77,11,0",,,,,119,,,,,,,,,,,,,,,,,,,,,,,,,,,,,,,,,,,,18.2,7,5,26,96,,1012,0,259,1,4,3,Karlsruhe,1,0,I1.000|5:29-I1.000|5:08-I1.000|4:56-I1.000|5:17-I1.000|5:18-I1.000|5:03-I1.000|5:24-I0.124|0:39,,,,,3113,"firmware 3.30",250,0,,0,168070,250480,30378,,683503,,,,,,,,,,,,,,,,,,,,,,,,,,,,,,,,,,,,,,,,,
11030123,819dc1f2-bc3d-4e5e-9a5d-f843147e5176,1574791749,60,1574791956,,0,0,13.74,3439,3499,63,64,,,1,0,0.06,,,,840,164,182,,,,59.52,50.57,59.85,1,60.91,4539,,,4.4,,99,99,,,,,,133,84,14.4,14.67,14.67,8.7,6.1,340,340,,1,353,353,,,,,,,,,"0,0,0,10,15,30,44,1,0","0,2,34,63,1","0,1,21,67,11",,,,,143,,,,,,,,,,,,,,,,,,,,,,,,,,,,,,,,,,,,104.2,9,2,78,92,,1007,0,251,1,3,3,Karlsruhe,1,0,I1.000|4:29-I1.000|4:14-I1.000|4:06-I1.000|3:59-I1.000|3:54-I1.000|3:58-I1.000|3:52-I1.000|3:49-I1.000|3:49-I1.000|3:48-I1.000|4:10-I1.000|5:06-I1.000|4:34-I0.740|3:29,,,,,3113,"firmware 3.30",250,0,,0,168070,250480,30378,,697335,,,,,,,,,,,,,,,,,,,,,,,,,,,,,,,,,,,,,,,,,
11045628,18d0be7c-e186-4420-af09-5dd450ddef88,1574871056,60,1574870708,,0,0,9.82,2970,3066,29,28,,,1,0,0.13,,,,544,139,150,,,,59.46,39.58,59.68,1,60.97,3059,,,2.7,,103,100,,,,,,58,80,11.91,12.72,12.76,8.4,-16.3,268,268,,1,313,313,,,,,,,,,"9,1,4,27,50,6,1,2,1","0,55,44,0,0","8,5,59,24,4",,,,,124,,,,,,,,,,,,,,,,,,,,,,,,,,,,,,,,,,,,23.5,13,24,203,65,,996,0,280,0,5,3,Eggenstein-Leopoldshafen,1,0,I1.000|5:07-I1.000|4:46-I1.000|4:43-I1.000|4:45-I1.000|4:51-I1.000|4:50-I1.000|4:56-I1.000|4:58-I0.299|1:31-I0.128|0:25-I0.098|1:07-I0.123|0:25-I0.098|0:55-I0.134|0:26-I0.085|0:54-I0.116|0:25-I0.077|0:51-I0.122|0:23-I0.091|0:50-I0.126|0:25-I0.323|1:58,,,,,3113,"firmware 3.30",250,0,,0,168070,250480,30378,,710257,,,,,,,,,,,,,,,,,,,,,,,,,,,,,,,,,,,,,,,,,
11062042,5e4f2dcc-fbe1-4a3d-8d23-7337ccc05960,1574945110,60,1574945351,,0,0,11.6,3349,3783,33,36,,,1,0,0.04,,,,705,147,165,,,,58.45,42.3,58.64,1,60.8,2264,,,3.2,,103,98,,,,,,83,81,12.46,12.52,12.52,6.1,14.4,286,286,,1,308,308,,,,,,,,,"0,0,1,18,69,10,0,0,0","0,9,90,1,0","0,2,68,30,0",,,,,128,,,,,,,,,,,,,,,,,,,,,,,,,,,,,,,,,,,,35.8,12,35,222,83,,1000,1,273,0,5,3,Karlsruhe,1,0,I1.000|4:56-I1.000|4:45-I1.000|4:35-I1.000|4:38-I1.000|4:35-I1.000|4:59-I1.000|4:53-I1.000|4:50-I1.000|4:51-I1.000|4:51-I1.000|4:45-I0.599|3:09,,,,,3113,"firmware 3.30",250,0,,0,168070,250480,30378,,723320,,,,,,,,,,,,,,,,,,,,,,,,,,,,,,,,,,,,,,,,,
11074190,5fcbfde9-45d7-4c20-b90c-84a3ec11abe7,1575040967,60,1575041133,,0,0,13.25,3556,3616,354,354,,,1,3.9,0.77,1.01,1.06,508,807,158,178,,,,57.74,46.51,59.65,1,60.46,2363,,,3.9,,101,98,,,,,,118,84,14.14,14.13,14.28,-4.7,21.9,339,339,,1,365,365,,,,,,,,,"2,4,3,18,29,13,26,3,0","0,2,57,41,0","0,5,31,42,22",,,,,133,,,,,,,,,,,,,,,,,,,,,,,,,,,,,,,,,,,,73.4,5,15,293,71,,1013,0,294,0,3,3,Neu-Anspach,1,0,I1.000|5:44-I1.000|4:46-I1.000|4:32-I1.000|4:58-I1.000|5:04-I1.000|4:48-I1.000|5:09-I1.000|4:29-I1.000|3:53-I1.000|3:53-I1.000|3:38-I1.000|3:39-I1.000|3:45-I0.249|0:58,,,,,3113,"firmware 3.30",250,0,,0,168070,250480,30378,,733225,,,,,,,,,,,,,,,,,,,,,,,,,,,,,,,,,,,,,,,,3,
11087935,9cd8de65-bd48-4b9f-b4cd-a783bc6b4b2c,1575112669,60,1575111491,,0,0,8.01,2279,2295,165,164,,,1,2.7,0.84,0.98,1.02,501,463,144,160,,,,61.2,41.95,62.77,1,61.05,1396,,,2.9,,103,102,,,,,,53,82,13.16,13.07,13.24,2.1,8.5,310,310,,1,325,325,,,,,,,,,"8,1,5,19,25,39,3,0,0","1,25,74,0,0","0,5,38,48,9",,,,,129,,,,,,,,,,,,,,,,,,,,,,,,,,,,,,,,,,,,33.4,5,5,210,80,,1025,1,283,0,3,3,Neu-Anspach,1,0,I1.000|5:55-I1.000|4:22-I1.000|4:33-I1.000|5:03-I1.000|4:33-I1.000|4:12-I1.000|4:54-I1.000|4:24-I0.010|0:03,,,,,3113,"firmware 3.30",250,0,,0,168070,250480,30378,,744362,,,,,,,,,,,,,,,,,,,,,,,,,,,,,,,,,,,,,,,,"5,5",
11105873,e8a3d961-f96a-4527-b797-587d687dbb34,1575191297,60,1575193717,,0,0,19.05,5808,5844,465,464,,,1,4.3,0.84,1,1.08,450,1058,146,164,,,,55.16,41.28,56.83,1,60.21,1959,,,3.4,,96,97,,,,,,140,83,12.36,12.34,12.47,-1.7,7.1,288,288,,1,309,309,,,,,,,,,"5,12,22,16,22,20,3,0,0","0,23,77,0,0","0,8,51,35,6",,,,,119,,,,,,,,,,,,,,,,,,,,,,,,,,,,,,,,,,,,35.7,0,11,27,81,,1021,0,252,0,4,3,Neu-Anspach,1,0,I1.000|6:25-I1.000|4:38-I1.000|4:53-I1.000|5:38-I1.000|5:04-I1.000|4:33-I1.000|5:13-I1.000|5:21-I1.000|5:04-I1.000|5:50-I1.000|5:52-I1.000|6:05-I1.000|5:56-I1.000|4:42-I1.000|4:24-I1.000|4:18-I1.000|4:11-I1.000|4:09-I1.000|4:16-I0.049|0:16,,,,,3113,"firmware 3.30",250,0,,0,168070,250480,30378,,759066,,,,,,,,,,,,,,,,,,,,,,,,,,,,,,,,,,,,,,,,"3,5,5",
11129626,a316bb50-1fcd-4c90-8f9f-b552ea2f2b96,1575303040,60,1575303874,,0,0,13.02,3844,4224,37,39,,,1,0,0.05,,,,684,139,167,,,,61.26,41.58,61.46,1,60.76,1106,,,2.8,,97,103,,,,,,77,81,12.17,13.12,13.13,-1.3,-20.1,275,275,,1,311,311,,,,,,,,,"5,5,8,22,44,5,10,1,0","0,64,33,3,0","3,9,60,23,6",,,,,125,,,,,,,,,,,,,,,,,,,,,,,,,,,,,,,,,,,,34.3,4,9,67,55,,1027,0,258,1,3,3,Karlsruhe,1,0,I1.000|5:27-I1.000|5:07-I1.000|5:04-I1.000|4:47-I1.000|4:51-I1.000|4:49-I1.000|4:43-I1.000|4:42-I1.000|4:49-I0.625|3:13-I1.006|3:42-I0.190|2:21-I1.014|3:42-I1.184|6:45,,,,,3113,"firmware 3.30",250,0,,0,168070,250480,30378,,779785,,,,,,,,,,,,,,,,,,,,,,,,,,,,,,,,,,,,,,,,,
11145415,02995692-0b41-4ae0-8646-f0d303d7a683,1575396539,60,1575396553,,0,0,13.85,3414,3416,63,63,,,1,0,0.05,,,,776,156,171,108,,,65.35,51.51,65.71,1,62.07,1872,,,3.8,,104,105,,,,,,107,84,14.61,14.76,14.76,2.9,0.9,346,346,,1,356,356,,,,,,,,,"0,0,1,1,7,53,37,1,0","0,1,66,32,0","0,1,11,77,11",,,,,145,,,,,,,,,,,,,,,,,,,,,,,,,,,,,,,,,,,,64,3,11,19,79,,1028,0,245,1,3,3,Karlsruhe,1,0,I6.034|25:00-I1.000|3:50-I1.000|3:52-I1.000|3:56-I1.000|3:48-I1.000|4:07-I1.000|4:21-I1.000|4:23-I0.816|3:37,,,,,3113,"firmware 3.30",250,0,,0,168070,250480,30378,,793232,,,,,,,,,,,,,,,,,,,,,,,,,,,,,,,,,,,,,,,,,
11159340,86cd19b0-f101-4ed0-804c-6f349af3998f,1575481710,60,1575481564,,0,0,10.92,3188,3219,8,8,,,1,0,0.02,,,,628,146,173,,,,58.19,41.57,58.25,1,62.39,1396,,,3.2,,98,103,,,,,,78,83,12.33,14.33,14.33,2,-16.6,284,284,,1,356,356,,,,,,,,,"12,8,19,19,17,2,7,16,0","0,30,60,10,0","3,12,53,11,21",,,,,124,,,,,,,,,,,,,,,,,,,,,,,,,,,,,,,,,,,,45,2,12,156,86,,1022,0,243,1,3,3,Karlsruhe,1,0,I1.000|5:13-I1.000|4:53-I1.000|5:15-I1.000|5:10-I0.177|0:58-I0.503|1:44-I0.114|0:29-I0.313|1:01-I0.110|0:36-I0.507|1:42-I0.103|0:34-I0.302|1:02-I0.398|2:28-I0.512|1:42-I0.101|0:33-I0.305|1:01-I0.101|0:33-I0.503|1:48-I0.104|0:38-I0.304|1:03-I0.438|3:10-I0.316|1:01-I0.112|0:48-I0.203|0:40-I1.000|6:12-I0.392|2:50,,,,,3113,"firmware 3.30",250,0,,0,168070,250480,30378,,804295,,,,,,,,,,,,,,,,,,,,,,,,,,,,,,,,,,,,,,,,,
11176123,1c5a4337-33a3-4c35-b85a-ef7798ee46d1,1575545831,60,1575546096,,0,0,13.85,3449,3525,43,44,,,1,0,0,,,,882,168,189,128,,,57.7,50.9,57.92,1,61.84,4071,,,4.7,,100,97,,,,,,145,84,14.46,14.75,14.75,9.7,12.8,340,340,,1,353,353,,,,,,,,,"0,0,0,1,10,65,17,6,0","0,1,17,76,6","0,1,15,72,12",,,,,143,,,,,,,,,,,,,,,,,,,,,,,,,,,,,,,,,,,,107.6,-3,7,209,100,,1024,1,260,0,9,3,Karlsruhe,1,0,I1.000|4:28-I1.000|4:20-I1.000|4:07-I0.897|3:43-I0.562|2:01-I0.243|1:00-I0.566|2:01-I0.235|1:01-I0.574|2:00-I0.228|1:00-I0.563|2:01-I0.241|1:01-I0.297|1:00-I0.222|1:01-I0.276|1:00-I1.000|4:24-I1.000|4:19-I1.000|4:17-I1.000|4:16-I1.000|4:20-I0.949|4:09,,,,,3113,"firmware 3.30",250,0,,0,168070,250480,30378,,819975,,,,,,,,,,,,,,,,,,,,,,,,,,,,,,,,,,,,,,,,,
11195544,db8715b1-7f80-4165-8b48-88bece8b8617,1575639368,60,1575637448,,0,0,5.01,1508,1563,21,27,,,1,0,0.08,,,,299,138,163,,,,60.37,38.16,60.6,1,61.71,2550,,,2.3,,100,98,,,,,,30,80,11.91,11.99,11.97,0.8,0.9,266,266,,1,273,273,,,,,,,,,"0,2,7,47,42,2,0,0,0","1,54,45,0,0","0,5,74,21,0",,,,,125,,,,,,,,,,,,,,,,,,,,,,,,,,,,,,,,,,,,21.5,6,14,244,70,,1018,1,276,0,5,3,Karlsruhe,1,0,I1.000|4:58-I1.000|5:03-I1.000|5:10-I1.000|4:59-I1.000|4:55-I0.007|0:02,,,,,3113,"firmware 3.30",250,0,,0,168070,250480,30378,,835164,,,,,,,,,,,,,,,,,,,,,,,,,,,,,,,,,,,,,,,,,
11221641,c4dcafe6-4b41-4a84-97f4-54f30aee4c9b,1575800503,60,1575798883,,0,0,5.59,1748,1856,154,157,,,1,2.6,0.74,0.98,0.99,450,375,148,174,,,,52.48,36.71,54.23,1,60.73,1634,,,2.7,,96,98,,,,,,44,81,12.08,11.92,12.2,-2.7,11,281,281,,1,309,309,,,,,,,,,"14,5,16,30,20,15,1,0,0","0,12,85,3,0","0,15,53,25,7",,,,,118,,,,,,,,,,,,,,,,,,,,,,,,,,,,,,,,,,,,32.9,6,23,217,95,,1009,0,237,0,4,3,Neu-Anspach,1,0,I1.000|6:16-I1.000|5:23-I1.000|5:14-I1.000|5:13-I1.000|4:23-I0.585|2:39,,,,,3113,"firmware 3.30",250,0,,0,168070,250480,30378,,855325,,,,,,,,,,,,,,,,,,,,,,,,,,,,,,,,,,,,,,,,"4,5",
11249030,144bfb41-e6fb-4e4b-be41-6a2f60e98a72,1575911478,60,1575911827,,0,0,15.29,3561,3715,2,0,,,1,0,0,,,,868,166,181,,,,63.86,55.42,63.88,1,61.57,2880,,,4.4,,105,100,,,,,,142,84,15.45,15.71,15.7,1.2,-1,373,373,,1,382,382,,,,,,,,,"0,0,0,0,0,41,54,5,0","0,1,19,80,0","0,0,1,71,28",,,,,153,,,,,,,,,,,,,,,,,,,,,,,,,,,,,,,,,,,,85.6,7,18,263,89,,1007,0,276,1,6,3,Karlsruhe,1,0,I0.407|1:40-I0.406|1:36-I0.412|1:44-I0.408|1:32-I0.409|1:43-I0.408|1:30-I0.407|1:43-I0.407|1:30-I0.409|1:43-I0.404|1:30-I0.404|1:42-I0.406|1:28-I0.410|1:43-I0.408|1:27-I0.399|1:41-I0.403|1:29-I0.399|1:41-I0.404|1:29-I0.417|1:39-I0.407|1:28-I0.402|1:36-I0.406|1:26-I0.406|1:37-I0.409|1:28-I0.410|1:43-I0.409|1:29-I0.412|1:41-I0.416|1:29-I0.401|1:42-I0.406|1:29-I0.407|1:41-I0.412|1:27-I0.412|1:39-I0.409|1:25-I0.402|1:34-I0.416|1:29-I0.406|1:43-I0.203|0:44-I0.009|0:01,,,,,3113,"firmware 3.30",250,0,,0,168070,250480,30378,,877750,,,,,,,,,,,,,,,,,,,,,,,,,,,,,,,,,,,,,,,,,
11266516,5a4d030b-3e61-49ab-b29a-df651b115567,1576001365,60,1576002006,,0,0,13.76,3467,3516,54,54,,,1,0,0.06,,,,801,155,170,,,,64.19,50.19,64.51,1,62.39,2592,,,3.7,,103,101,,,,,,104,83,14.3,14.33,14.34,2.5,2.9,338,338,,1,344,344,,,,,,,,,"0,0,0,0,6,81,12,0,0","0,2,91,7,0","0,0,14,82,4",,,,,143,,,,,,,,,,,,,,,,,,,,,,,,,,,,,,,,,,,,50.9,2,6,183,82,,1026,0,294,1,3,3,Karlsruhe,1,0,I1.000|4:13-I1.000|4:25-I1.000|4:19-I1.000|4:13-I1.000|4:06-I1.000|4:07-I1.000|4:08-I1.000|4:08-I1.000|4:08-I1.000|4:09-I1.000|4:15-I1.000|4:06-I1.000|4:09-I0.757|3:19,,,,,3113,"firmware 3.30",250,0,,0,168070,250480,30378,,893019,,,,,,,,,,,,,,,,,,,,,,,,,,,,,,,,,,,,,,,,,
11285756,eead8c70-2eb2-4f7c-9d27-7c5ee2d73c7c,1576089218,60,1576087598,,0,0,4.44,1405,1609,28,28,,,1,0,0.24,,,,287,140,155,,,,55.71,35.71,56.14,1,61.53,1683,,,2.4,,98,96,,,,,,29,80,11.38,11.4,11.42,2.5,-0.3,255,255,,1,263,263,,,,,,,,,"1,5,22,56,17,0,0,0,0","1,42,57,0,0","0,8,80,12,1",,,,,119,,,,,,,,,,,,,,,,,,,,,,,,,,,,,,,,,,,,23.7,2,18,220,93,,1009,,,1,6,1,Karlsruhe,1,0,I1.000|5:18-I1.000|5:08-I1.000|5:07-I1.000|5:27-I0.443|2:26,,,,,3113,"firmware 3.30",250,0,,0,168070,250480,30378,,910585,,,,,,,,,,,,,,,,,,,,,,,,,,,,,,,,,,,,,,,,,
11303852,97211de7-a4cf-48bf-b80e-b10795d64451,1576174171,60,1576174561,,0,0,4.4,1312,1342,12,6,,,1,0,0,,,,320,141,153,,,,59.39,38.29,59.69,1,61.52,,,101,,,,,,,,,,27,81,12.13,12.14,12.25,-0.1,-2.6,274,274,,1,284,284,,,,,,,,,"1,1,3,37,55,2,1,0,0","0,34,65,0,0","1,3,72,24,0",,,,,124,,,,,,,,,,,,,,,,,,,,,,,,,,,,,,,,,,,,22.6,2,9,177,77,,1002,0,353,1,5,3,Karlsruhe,1,0,I1.000|5:02-I1.000|5:01-I1.000|4:55-I1.000|4:58,,,,,3113,"firmware 3.30",250,0,,0,168070,250480,30378,,926629,,,,,,,,,,,,,,,,,,,,,,,,,,,,,,,,,,,,,,,,,
11311707,e0cd0bec-082f-41ca-8144-cac48dd48405,1576237915,60,1576238207,,0,0,11.12,3216,3381,38,42,,,1,0,0.08,,,,669,148,170,,,,57.79,42.08,58.01,1,60.85,1775,,,3.3,,99,99,,,,,,82,82,12.44,12.82,12.82,0,-6.5,285,285,,1,301,301,,,,,,,,,"0,5,6,36,32,11,10,0,0","0,12,83,5,0","0,3,66,29,2",,,,,127,,,,,,,,,,,,,,,,,,,,,,,,,,,,,,,,,,,,43.1,6,27,230,84,,981,1,334,0,6,3,Karlsruhe,1,0,I1.000|4:26-I1.000|4:55-I1.000|5:00-I1.000|4:52-I1.000|5:03-I1.000|5:06-I0.071|0:22-I0.400|1:38-I0.410|1:57-I0.309|1:10-I0.297|1:27-I0.196|0:46-I0.209|1:00-I0.099|0:22-I0.102|0:30-I0.208|0:46-I0.210|1:01-I0.307|1:09-I0.306|1:33-I0.405|1:33-I1.000|5:33-I0.594|3:25,,,,,3113,"firmware 3.30",250,0,,0,168070,250480,30378,,933512,,,,,,,,,,,,,,,,,,,,,,,,,,,,,,,,,,,,,,,,,
11346527,9be123f8-f529-4ce8-a45b-08a54890dd22,1576407767,60,1576418108,,0,0,18.02,3949,3949,196,275,,,1,1.3,0.39,0.99,1,562,1058,176,192,124,,,62.72,60.22,63.22,1,60.78,4358,,,5,,102,91,,,,,,199,87,16.39,16.67,16.49,6,3.3,400,400,,1,409,409,,,,,,,,,"0,0,0,0,2,13,55,29,1","0,1,5,68,26","0,1,6,44,49",,,,,157,,,,,,,,,,,,,,,,,,,,,,,,,,,,,,,,,,,,123.9,5,28,248,85,,1003,0,326,0,5,3,Breinigerberg,1,0,I1.000|3:34-I1.000|4:02-I1.000|3:30-I1.000|3:25-I1.000|3:23-I1.000|3:27-I1.000|3:53-I1.000|3:36-I1.000|3:31-I1.000|3:44-I1.000|3:36-I1.000|3:58-I1.000|3:43-I1.000|3:35-I1.000|4:01-I1.000|3:42-I1.000|3:38-I1.000|3:28-I0.016|0:02,,,,,3113,"firmware 3.30",250,0,,0,168070,250480,30378,,964646,,,,,,,,,,,,,,,,,,,,,,18,3949,,,0,"57. Aachener Winterlauf",,,,,,,0,0,30378,11346527,996,,5,
11416510,b4727cb7-bded-4cd4-9af5-d0b1b6e784c7,1576785669,60,1576782155,,0,0,0.01,8,8,0,0,,,1,0,0,,,,1,88,89,,,,28.66,,28.66,1,60.78,1,,,,,,100,,,,,,0,76,6.5,6.5,6.5,,-45.5,26,26,,1,25,25,,,,,,,,,"100,0,0,0,0,0,0,0,0","100,0,0,0,0","100,0,0,0,0",,,,,49,,,,,,,,,,,,,,,,,,,,,,,,,,,,,,,,,,,,,6,2,124,88,,1010,0,317,1,4,3,Karlsruhe,1,0,,,,,,3113,"firmware 3.90",250,0,,0,168070,250480,30378,,1025581,,,,,,,,,,,,,,,,,,,,,,,,,,,,,,,,,,,,,,,,,
11429700,ddb80165-0348-467f-9e95-17fa1e038cd4,1576859706,60,1576856313,,0,0,0.25,118,118,4,6,,,1,0,0.2,,,,20,128,143,,,,38.02,17.03,38.39,1,60.78,0,,,,,,100,,,,,,1,76,7.57,8.01,7.89,22.8,26.1,140,140,,1,174,174,,,,,,,,,"86,8,6,0,0,0,0,0,0","3,81,17,0,0","46,25,25,3,0",,,,,84,,,,,,,,,,,,,,,,,,,,,,,,,,,,,,,,,,,,2.8,8,8,221,91,,993,0,331,1,6,3,Karlsruhe,1,0,,,,,,3113,"firmware 3.90",250,0,,0,168070,250480,30378,,1037273,,,,,,,,,,,,,,,,,,,,,,,,,,,,,,,,,,,,,,,,,
11456701,655c00aa-5f6f-43e3-bb63-c67e48f65168,1577015820,60,1577016634,,0,0,12.33,4144,4274,306,73,,,1,2.8,0.37,1.02,0.74,505,798,152,179,,,,46.26,35.58,48.77,1,60.25,2732,,,3.8,,94,100,,,,,,118,83,11.51,10.92,12.49,-8.2,21.3,275,275,,1,340,340,,,,,,,,,"17,8,20,37,14,2,1,0,0","0,18,54,28,0","4,7,66,16,8",,,,,108,,,,,,,,,,,,,,,,,,,,,,,,,,,,,,,,,,,,60.1,5,11,181,91,,986,0,374,0,6,3,Neu-Anspach,1,0,I1.000|5:26-I1.000|5:32-I1.000|5:19-I1.000|6:46-I1.000|6:16-I1.000|6:00-I1.000|6:00-I1.000|5:13-I1.000|5:19-I1.000|5:15-I1.000|4:57-I1.000|5:12-I0.333|1:51,,,,,3113,"firmware 3.90",250,0,,0,168070,250480,30378,,1060037,,,,,,,,,,,,,,,,,,,,,,,,,,,,,,,,,,,,,,,,"3,5",
11480678,7b05d11e-563f-4988-a713-520df190f4a0,1577095087,60,1577093842,,0,0,7.66,2253,2267,161,157,,,1,2.6,0.62,1.01,0.92,426,514,157,176,,,,52.05,40.23,53.44,1,60.12,3530,,,3.4,,100,99,,,,,,72,84,12.63,12.39,12.91,2.1,-2.9,293,293,,1,327,327,,,,,,,,,"6,2,11,17,36,29,0,0,0","0,3,63,35,0","3,13,35,41,8",,,,,121,,,,,,,,,,,,,,,,,,,,,,,,,,,,,,,,,,,,53.6,6,17,256,90,,1004,0,378,0,6,3,Balve,1,0,I1.000|4:36-I1.000|5:08-I1.000|4:52-I1.000|4:41-I1.000|4:52-I1.000|4:15-I1.000|5:41-I0.656|3:28,,,,,3113,"firmware 3.90",250,0,,0,168070,250480,30378,,1081625,,,,,,,,,,,,,,,,,,,,,,,,,,,,,,,,,,,,,,,,"5,5",
11480695,f7c493ef-c7cf-4494-9f3d-d495674ddef9,1577093622,60,1577093877,,0,0,1.66,560,560,10,27,,,0,1,0.64,1.03,0.93,,128,153,169,,,,45.62,30.57,45.38,1,60.25,1497,,,2.2,,,100,,,,,,16,83,10.37,10.68,10.55,0.5,-12.8,224,224,,1,237,237,,,,,,,,,"0,0,86,14,0,0,0,0,0","0,5,80,15,0","0,27,67,6,0",,,,,107,,,,,,,,,,,,,,,,,,,,,,,,,,,,,,,,,,,,35.3,,,,,,,,,,1,,,1,0,I1.000|5:42-I0.657|3:38,,,,,3113,"firmware 3.90",250,0,,0,168070,250480,30378,,1081640,,,,,,,,,,,,,,,,,,,,,,,,,,,,,,,,,,,,,,,,,
11506586,82c3b9e0-b5bd-4311-a094-5c969a5e5051,1577185893,60,1577203053,,0,0,16.07,4754,5063,338,347,,,1,3.9,0.58,0.98,0.86,641,949,149,170,,,,55.67,42.17,57.08,1,60.03,3220,,,3.8,,97,100,,,,,,129,84,12.49,21.8,21.74,-0.6,-53.1,288,288,,1,433,433,,,,,,,,,"13,4,7,12,21,40,3,0,1","3,11,72,14,0","9,10,32,34,14",,,,,121,,,,,,,,,,,,,,,,,,,,,,,,,,,,,,,,,,,,51.5,4,20,183,96,,1008,0,322,0,6,3,Möhnesee,1,0,I1.000|5:21-I1.000|5:07-I1.000|4:37-I1.000|4:37-I1.000|5:34-I1.000|4:34-I1.000|4:27-I1.000|5:47-I1.000|4:27-I1.000|4:23-I1.000|4:16-I1.000|4:14-I1.000|4:09-I1.000|4:57-I1.000|4:07-I1.000|8:34-I0.065|0:03,,,,,3113,"firmware 3.90",250,0,,0,168070,250480,30378,,1103289,,,,,,,,,,,,,,,,,,,,,,,,,,,,,,,,,,,,,,,,"4,4,4,5,5",
11515242,02e9ce2f-a671-4a28-9d10-3ee97cf6b715,1577281293,60,1577281954,,0,0,14.49,4094,4101,352,351,,,1,4.4,0.73,1.05,0.99,603,945,158,189,,,,54.19,44.12,55.83,1,59.88,4414,,,4.4,,101,99,,,,,,135,83,13.29,13.35,13.55,2.2,30.9,318,318,,1,365,365,,,,,,,,,"3,10,8,20,18,19,21,0,0","0,3,61,33,3","0,6,42,38,14",,,,,128,,,,,,,,,,,,,,,,,,,,,,,,,,,,,,,,,,,,88.2,6,15,311,94,,1021,0,338,0,6,3,Balve,1,0,I1.000|5:04-I1.000|5:28-I1.000|6:05-I1.000|5:05-I1.000|5:07-I1.000|5:14-I1.000|4:49-I1.000|4:32-I1.000|4:01-I1.000|3:55-I1.000|3:49-I1.000|3:53-I1.000|4:53-I1.000|4:11-I0.493|2:08,,,,,3113,"firmware 4.00",250,0,,0,168070,250480,30378,,1110694,,,,,,,,,,,,,,,,,,,,,,,,,,,,,,,,,,,,,,,,"4,4",
11527695,f3a5d1cf-f4c4-45e7-a313-f32e0086214a,1577354443,60,1577354652,,0,0,15.01,3550,3594,390,396,,,1,3.1,0.64,1.11,0.91,410,910,173,185,,,,58.7,54.37,60.56,1,59.81,4377,,,5,,104,95,,,,,,166,84,15.29,15.37,15.59,3.9,-6.4,375,375,,1,417,417,,,,,,,,,"0,0,0,0,1,34,64,1,0","0,1,7,70,21","0,2,25,36,37",,,,,151,,,,,,,,,,,,,,,,,,,,,,,,,,,,,,,,,,,,127.1,3,5,181,95,,1026,0,323,0,4,3,Sundern,1,0,I1.000|4:12-I1.000|3:50-I1.000|4:00-I1.000|3:57-I1.000|4:00-I1.000|3:54-I1.000|3:51-I1.000|3:57-I1.000|3:46-I1.000|3:41-I1.000|3:42-I1.000|3:50-I1.000|4:01-I1.000|4:10-I1.000|4:17-I0.011|0:02,,,,,3113,"firmware 4.00",250,0,,0,168070,250480,30378,,1121144,,,,,,,,,,,,,,,,,,,,,,,,,,,,,,,,,,,,,,,,"4,5,5",
11562142,33b4e9e2-9ee1-4794-bd55-2495e3faccf6,1577458914,60,1577457213,,0,0,4.5,1239,1753,72,72,,,1,1.8,0.65,1.01,1.04,301,272,150,163,,,,60.27,42.12,61.46,1,59.84,2591,,,2.6,,98,100,,,,,,33,82,13.28,13.66,13.61,-4.6,15.7,309,309,,1,325,325,,,,,,,,,"0,0,5,39,17,16,21,1,0","1,8,83,8,0","0,6,32,55,6",,,,,133,,,,,,,,,,,,,,,,,,,,,,,,,,,,,,,,,,,,38.4,3,6,63,86,,1032,0,359,0,3,3,Balve,1,0,I1.000|5:08-I1.000|5:01-I1.000|4:19-I1.000|3:54-I0.500|2:17,,,,,3113,"firmware 4.00",250,0,,0,168070,250480,30378,,1147237,,,,,,,,,,,,,,,,,,,,,,,,,,,,,,,,,,,,,,,,4,
11579376,97a667f0-cc7f-47ee-84fe-d2c1074a50b3,1577547852,60,1577546770,,0,0,7.98,2282,2282,169,169,,,1,2.7,0.82,1.04,1.06,487,479,146,161,,,,59.7,41.69,61.26,1,60.01,1454,,,3.1,,103,100,,,,,,55,82,13.08,13.02,13.13,3.5,9.3,304,304,,1,319,319,,,,,,,,,"8,1,7,21,23,30,10,0,0","0,24,76,1,0","0,4,45,45,6",,,,,128,,,,,,,,,,,,,,,,,,,,,,,,,,,,,,,,,,,,35.9,0,5,99,83,,1041,0,328,0,5,3,Neu-Anspach,1,0,I1.000|6:08-I1.000|4:27-I1.000|4:28-I1.000|5:05-I1.000|4:49-I1.000|4:12-I1.000|4:44-I0.981|4:09,,,,,3113,"firmware 4.00",250,0,,0,168070,250480,30378,,1161083,,,,,,,,,,,,,,,,,,,,,,,,,,,,,,,,,,,,,,,,"5,5",
11590396,1c4badc4-1928-4ab4-a380-994ca787b6e8,1577615170,60,1577615541,,0,0,13.33,3833,3841,340,338,,,1,3.9,0.77,1.1,1.17,461,796,149,160,,,,57.66,42.95,59.49,1,59.72,1758,,,3.4,,101,99,,,,,,99,83,13.23,13.49,13.5,-4.6,23.6,312,312,,1,339,339,,,,,,,,,"6,5,21,23,12,12,21,2,0","0,4,96,0,0","0,5,44,41,10",,,,,126,,,,,,,,,,,,,,,,,,,,,,,,,,,,,,,,,,,,36.1,-2,3,98,83,,1041,0,307,0,5,3,Neu-Anspach,1,0,I1.000|6:06-I1.000|5:16-I1.000|4:51-I1.000|5:32-I1.000|5:19-I1.000|5:31-I1.000|5:40-I1.000|4:59-I1.000|4:06-I1.000|3:56-I1.000|3:50-I1.000|3:38-I1.000|3:48-I0.327|1:21,,,,,3113,"firmware 4.00",250,0,,0,168070,250480,30378,,1169707,,,,,,,,,,,,,,,,,,,,,,,,,,,,,,,,,,,,,,,,3,
11640514,0e149197-cdc8-4b65-b52b-2ef7eb86e193,1577798994,60,1577799268,,0,0,15,3231,3231,24,18,,,1,0,0.03,,,,859,177,186,126,,,63.48,60.59,63.63,1,60.12,4801,,,5,,106,92,,,,,,167,87,16.74,16.74,16.76,6.7,7.7,411,411,,1,412,412,,,,,,,,,"0,0,0,0,0,0,79,21,0","1,1,3,60,36","0,0,0,34,66",,,,,160,,,,,,,,,,,,,,,,,,,,,,,,,,,,,,,,,,,,130.8,5,3,279,79,,1035,0,295,0,4,3,Werl,1,0,I1.000|3:26-I1.000|3:34-I1.000|3:34-I1.000|3:32-I1.000|3:34-I1.000|3:31-I1.000|3:41-I1.000|3:39-I1.000|3:38-I1.000|3:35-I1.000|3:38-I1.000|3:40-I1.000|3:40-I1.000|3:40-I0.998|3:30,,,,,3113,"firmware 4.00",250,0,,0,168070,250480,30378,,1208172,,,,,,,,,,,,,,,,,,,,,,15,3231,,,0,Silvesterlauf,,,,,,,0,0,30378,11640514,,,,
11661334,b682644f-840d-4502-a4f5-40d8289dbdd6,1577876492,60,1577874460,,0,0,4.87,1471,1471,68,68,,,1,1.4,0.51,0.97,1.06,239,304,143,159,,,,57.38,37.94,58.37,1,60.04,3547,,,2.5,,98,99,,,,,,32,82,12.1,12.3,12.17,-9,4.8,277,277,,1,286,286,,,,,,,,,"3,2,25,31,14,23,1,0,0","0,31,69,0,0","0,4,71,23,2",,,,,121,,,,,,,,,,,,,,,,,,,,,,,,,,,,,,,,,,,,26.2,0,7,158,67,,1034,0,290,0,3,3,Balve,1,0,I1.000|5:29-I1.000|5:26-I1.000|5:18-I1.000|4:18-I0.868|4:01,,,,,3113,"firmware 4.00",250,0,,0,168070,250480,30378,,1226030,,,,,,,,,,,,,,,,,,,,,,,,,,,,,,,,,,,,,,,,5,
11713035,0f97903b-6208-49a3-a4c6-32314557d112,1577981447,60,1577981212,,0,0,10.88,2943,3027,33,39,,,1,0,0.04,,,,616,147,156,,,,63.35,45.43,63.55,1,60.53,2160,,,3.3,,100,98,,,,,,73,81,13.3,13.38,13.38,4.2,5.3,315,315,,1,322,322,,,,,,,,,"0,1,0,3,50,44,2,0,0","1,4,95,0,0","0,1,34,62,3",,,,,137,,,,,,,,,,,,,,,,,,,,,,,,,,,,,,,,,,,,33.8,2,3,310,76,,1029,0,353,0,3,3,Karlsruhe,1,0,I1.000|4:42-I1.000|4:29-I1.000|4:20-I1.000|4:18-I1.000|4:19-I1.000|4:27-I1.000|4:31-I1.000|4:34-I1.000|4:40-I1.000|4:38-I0.879|4:05,,,,,3113,"firmware 4.00",250,0,,0,168070,250480,30378,,1269341,,,,,,,,,,,,,,,,,,,,,,,,,,,,,,,,,,,,,,,,,
11725902,e9db5fc6-732b-493e-8c35-57fa00174d87,1578039132,60,1578038782,,0,0,10.32,3014,3086,75,78,,,4,0,0.12,,,,648,148,158,,,,57.09,41.38,57.59,1,60.15,1956,,,3.3,,98,99,,,,,,76,82,12.32,12.4,12.4,1.2,3.7,285,285,,1,291,291,,,,,,,,,"1,1,4,22,65,7,0,0,0","0,8,91,0,0","1,2,62,35,0",,,,,125,,,,,,,,,,,,,,,,,,,,,,,,,,,,,,,,,,,,34.8,2,10,218,85,,1025,0,331,0,4,3,Karlsruhe,1,0,I1.000|5:28-I1.000|4:56-I1.000|4:47-I1.000|4:46-I1.000|4:45-I1.000|4:48-I1.000|4:55-I1.000|4:48-I1.000|4:52-I1.000|4:38-I0.319|1:32,,,,,3113,"firmware 4.00",250,0,,0,168070,250480,30378,,1278776,,,,,,,,,,,,,,,,,,,,,,,,,,,,,,,,,,,,,,,,,
11764006,3f2dbc62-bc06-48a0-9c40-75a46a6b7498,1578128331,60,1578129704,,0,0,15.03,4294,4825,96,104,,,4,0,0.15,,,,885,148,166,,,,58.67,43.68,59.09,1,59.93,1582,,,3.4,,103,97,,,,,,108,82,12.59,12.63,12.64,4.7,2,289,289,,1,297,297,,,,,,,,,"0,1,1,13,73,12,0,0,0","0,9,89,1,0","1,2,57,38,1",,,,,128,,,,,,,,,,,,,,,,,,,,,,,,,,,,,,,,,,,,39.6,3,12,252,87,,1033,0,316,0,4,3,Karlsruhe,1,0,I1.000|4:59-I1.000|4:46-I1.000|4:48-I1.000|4:42-I1.000|4:42-I1.000|4:43-I1.000|4:36-I1.000|4:40-I1.000|4:39-I1.000|4:43-I1.000|4:46-I1.000|4:50-I1.000|4:45-I1.000|4:49-I1.000|5:02-I0.033|0:03,,,,,3113,"firmware 4.00",250,0,,0,168070,250480,30378,,1310116,,,,,,,,,,,,,,,,,,,,,,,,,,,,,,,,,,,,,,,,,
11808943,65fff141-8c94-482d-803d-541b2411b084,1578236090,60,1578234838,,0,0,8.43,2262,2262,60,62,,,4,0,0.07,,,,514,154,171,,,,59.95,45.09,60.46,1,60.07,1396,,,3.4,,102,100,,,,,,66,81,13.41,13.49,13.51,4.6,7.4,318,318,,1,328,328,,,,,,,,,"0,0,0,5,37,56,1,0,0","0,1,85,14,0","0,0,37,57,5",,,,,138,,,,,,,,,,,,,,,,,,,,,,,,,,,,,,,,,,,,49.1,7,2,233,79,,1037,0,309,0,3,3,Karlsruhe,1,0,I1.000|4:43-I1.000|4:34-I1.000|4:22-I1.000|4:24-I1.000|4:25-I1.000|4:19-I1.000|4:26-I1.000|4:31-I0.428|1:58,,,,,3113,"firmware 4.00",250,0,,0,168070,250480,30378,,1349233,,,,,,,,,,,,,,,,,,,,,,,,,,,,,,,,,,,,,,,,,
11834584,a8d55d4b-fe6a-4ea4-87b8-f1dcd1db9a41,1578324820,60,1578325631,,0,0,14.65,3820,4165,74,72,,,4,0,0.1,,,,787,148,161,,,,65.68,48.47,66.1,1,61.22,1338,,,3.3,,101,99,,,,,,95,82,13.82,13.86,13.88,3.9,3.2,331,331,,1,339,339,,,,,,,,,"0,0,0,1,17,77,4,0,0","0,5,95,0,0","0,0,21,74,5",,,,,140,,,,,,,,,,,,,,,,,,,,,,,,,,,,,,,,,,,,34.1,3,2,204,77,,1028,0,306,0,3,3,Karlsruhe,1,0,I1.000|4:29-I1.000|4:21-I1.000|4:16-I1.000|4:17-I1.000|4:15-I1.000|4:16-I1.000|4:14-I1.000|4:09-I1.000|4:19-I1.000|4:19-I1.000|4:24-I1.000|4:21-I1.000|4:28-I1.000|4:29-I0.652|3:04,,,,,3113,"firmware 4.00",250,0,,0,168070,250480,30378,,1369685,,,,,,,,,,,,,,,,,,,,,,,,,,,,,,,,,,,,,,,,,
11864269,0e800029-8eeb-4bc5-b309-de96f45ce89f,1578418591,60,1578421483,,0,0,1.38,379,379,5,3,,,4,0,0.15,,,,83,145,155,103,,,63.34,37.8,63.74,1,61.57,410,,,1.6,0,104,105,,,,,,8,83,13.12,13.25,13.36,-16.9,-17.7,309,309,,1,321,321,,,,,,,,,"3,1,0,4,38,50,5,0,0","0,8,92,0,0","3,3,21,69,3",,,,,132,,,,,,,,,,,,,,,,,,,,,,,,,,,,,,,,,,,,17,4,5,215,82,,1031,0,326,1,5,3,Karlsruhe,1,0,I1.000|4:40-I0.376|1:39,,,,,3113,"firmware 4.00",250,0,,0,168070,250480,30378,,1394999,,,,,,,,,,,,,,,,,,,,,,,,,,,,,,,,,,,,,,,,,
11864277,f919e76d-dc61-4f0c-b409-c33ad625ea35,1578420477,60,1578421487,,0,0,15.04,4137,4336,79,84,,,4,0,0.09,,,,802,145,181,,,,63.22,45.65,63.61,1,62.12,1728,,,3.5,2.5,100,102,,,,,,101,83,13.08,14.05,14.06,6.9,-2.3,311,311,,1,348,348,,,,,,,,,"2,1,7,15,41,18,5,10,0","0,29,59,11,0","1,2,47,37,13",,,,,131,,,,,,,,,,,,,,,,,,,,,,,,,,,,,,,,,,,,65.8,4,5,184,83,,1032,0,326,1,5,3,Karlsruhe,1,0,I1.000|5:13-I1.000|4:54-I1.000|4:35-I1.000|4:29-I1.000|4:28-I0.993|4:31-I0.582|2:02-I0.432|2:01-I0.579|2:01-I0.782|3:37-I0.603|2:01-I0.484|2:08-I0.600|2:01-I0.412|2:01-I0.624|2:01-I1.000|4:54-I1.000|4:36-I1.000|6:10-I0.949|5:15,,,,,3113,"firmware 4.00",250,0,,0,168070,250480,30378,,1395006,,,,,,,,,,,,,,,,,,,,,,,,,,,,,,,,,,,,,,,,,
11885088,5f7afbc0-23e8-41c0-9ed8-9592adbf05b9,1578500210,60,1578498414,,0,0,6.01,1679,1696,43,50,,,4,0,0.14,,,,380,150,166,,,,59.2,42.13,59.64,1,61.6,1474,,,2.9,0.3,97,99,,,,,,44,81,12.84,12.96,12.95,1.6,3.8,301,301,,1,309,309,,,,,,,,,"0,0,1,10,68,22,0,0,0","0,1,90,9,0","0,1,49,49,0",,,,,133,,,,,,,,,,,,,,,,,,,,,,,,,,,,,,,,,,,,33.5,6,9,236,80,,1029,0,303,0,6,3,Karlsruhe,1,0,I1.000|4:37-I1.000|4:36-I1.000|4:33-I1.000|4:42-I1.000|4:41-I1.000|4:48-I0.007|0:02,,,,,3113,"firmware 4.00",250,0,,0,168070,250480,30378,,1412099,,,,,,,,,,,,,,,,,,,,,,,,,,,,,,,,,,,,,,,,,
11915238,20b02ea3-8018-4250-95aa-91e37db2e854,1578593329,60,1578595337,,0,0,9.33,2727,4434,70,72,,,4,0,0.11,,,,511,139,165,,,,62.02,41.05,62.58,1,61.36,1312,,,3,0,98,100,,,,,,55,81,12.33,12.46,12.49,2.6,0,287,287,,1,296,296,,,,,,,,,"0,0,1,37,56,3,3,0,0","0,60,39,1,0","0,0,67,31,1",,,,,127,,,,,,,,,,,,,,,,,,,,,,,,,,,,,,,,,,,,25.9,9,8,208,78,,1018,0,310,1,5,3,Karlsruhe,1,0,I1.000|5:01-I1.000|4:48-I1.000|5:00-I1.000|4:58-I1.000|4:52-I1.000|5:00-I1.000|4:30-I1.000|4:49-I1.000|4:51-I0.328|1:37,,,,,3113,"firmware 4.00",250,0,,0,168070,250480,30378,,1437390,,,,,,,,,,,,,,,,,,,,,,,,,,,,,,,,,,,,,,,,,
11978666,3769c1d5-66da-4570-bccd-057cb108dbe6,1578735767,60,1578735584,,0,0,11.24,3025,3139,107,112,,,4,0.5,0.37,1,1.02,,674,150,166,,,,61.99,45.81,62.69,1,61.55,1396,,,3.4,0,103,100,,,,,,82,82,13.41,13.43,13.47,1.6,2,321,321,,1,329,329,,,,,,,,,"0,0,0,6,40,53,1,0,0","0,9,83,8,0","0,1,26,68,5",,,,,136,,,,,,,,,,,,,,,,,,,,,,,,,,,,,,,,,,,,43.9,2,3,158,95,,1036,0,312,0,3,3,Möglingen,1,0,I1.000|4:38-I1.000|4:28-I1.000|4:34-I1.000|4:24-I1.000|4:35-I1.000|4:41-I1.000|4:32-I1.000|4:22-I1.000|4:24-I1.000|4:31-I1.000|4:12-I0.241|1:05,,,,,3113,"firmware 4.00",250,0,,0,168070,250480,30378,,1497213,,,,,,,,,,,,,,,,,,,,,,,,,,,,,,,,,,,,,,,,,
12014941,65278340-88f5-47e2-811c-e7fed20d5e8f,1578831972,60,1578830116,,0,0,5.43,1391,1432,30,32,,,4,0,0.23,1.02,0.99,,316,150,170,,,,65.89,46.38,66.32,1,62.46,1164,,,3,0,104,100,,,,,,38,84,14.1,14.13,14.1,3.4,8.6,340,340,,1,342,342,,,,,,,,,"1,1,2,3,16,43,35,0,0","1,20,58,22,0","0,1,8,86,4",,,,,139,,,,,,,,,,,,,,,,,,,,,,,,,,,,,,,,,,,,48.5,4,6,209,72,,1028,1,283,0,5,3,Möglingen,1,0,I1.000|4:48-I1.000|4:26-I1.000|4:20-I1.000|3:55-I1.000|3:57-I0.430|1:45,,,,,3113,"firmware 4.00",250,0,,0,168070,250480,30378,,1528631,,,,,,,,,,,,,,,,,,,,,,,,,,,,,,,,,,,,,,,,,
12046580,07db7dc7-82f8-487a-a1bb-3450bfcf30d0,1578932295,60,1578933533,,0,0,13.81,3670,4076,56,58,,,4,0,0.08,,,,787,147,157,,,,64.75,47.2,65.07,1,62.47,1338,,,3.3,0,102,100,,,,,,92,81,13.54,13.58,13.59,3.8,4,320,320,,1,328,328,,,,,,,,,"0,0,1,4,24,68,2,0,0","0,7,93,0,0","0,2,28,67,4",,,,,139,,,,,,,,,,,,,,,,,,,,,,,,,,,,,,,,,,,,32.8,6,4,178,80,,1020,0,332,0,4,3,Karlsruhe,1,0,I1.000|4:34-I1.000|4:26-I1.000|4:22-I1.000|4:20-I1.000|4:18-I1.000|4:22-I1.000|4:18-I1.000|4:23-I1.000|4:16-I1.000|4:23-I1.000|4:27-I1.000|4:24-I1.000|4:41-I0.806|3:56,,,,,3113,"firmware 4.00",250,0,,0,168070,250480,30378,,1553572,,,,,,,,,,,,,,,,,,,,,,,,,,,,,,,,,,,,,,,,,
12071968,3f37d48f-5a1f-4e7a-992f-5efa11926bf1,1579025270,60,1579025633,,0,0,13.7,3488,3521,84,86,,,4,0,0.08,,,,779,148,166,,,,67.65,49.57,68.15,1,63.26,1454,,,3.5,0.1,101,99,,,,,,90,83,14.14,14.26,14.26,0.1,-0.5,341,341,,1,348,348,,,,,,,,,"0,0,0,1,24,50,26,0,0","0,15,78,6,0","0,0,18,75,6",,,,,142,,,,,,,,,,,,,,,,,,,,,,,,,,,,,,,,,,,,47.1,9,9,207,59,,1016,0,320,1,4,3,Karlsruhe,1,0,I1.000|4:32-I1.000|4:37-I1.000|4:27-I1.000|4:27-I1.000|4:30-I1.000|4:28-I1.000|3:55-I1.000|4:08-I1.000|4:09-I1.000|4:01-I1.000|3:58-I1.000|3:57-I1.000|3:59-I0.699|3:01,,,,,3113,"firmware 4.00",250,0,,0,168070,250480,30378,,1575963,,,,,,,,,,,,,,,,,,,,,,,,,,,,,,,,,,,,,,,,,
12096018,8244eba8-dfea-4735-9067-0d123ce8d935,1579101749,60,1579102534,,0,0,11.41,3337,3553,72,75,,,4,0,0.22,,,,740,148,165,,,,56.99,41.62,57.42,1,62.05,2120,,,3.3,0,96,98,,,,,,84,83,12.31,12.36,12.37,4.2,-20.7,291,291,,1,320,320,,,,,,,,,"1,1,3,22,69,4,0,0,0","0,6,92,1,0","0,4,60,35,1",,,,,124,,,,,,,,,,,,,,,,,,,,,,,,,,,,,,,,,,,,37.1,11,16,218,59,,1018,0,309,0,5,3,Eggenstein-Leopoldshafen,1,0,I1.000|5:09-I1.000|4:57-I1.000|4:52-I1.000|4:38-I1.000|4:39-I1.000|4:50-I1.000|4:52-I1.000|4:57-I1.000|4:48-I1.000|4:57-I1.000|4:54-I0.407|2:05,,,,,3113,"firmware 4.00",250,0,,0,168070,250480,30378,,1596842,,,,,,,,,,,,,,,,,,,,,,,,,,,,,,,,,,,,,,,,,
12127517,16b8ddb2-0714-4331-8efb-35dca8120943,1579198050,60,1579198063,,0,0,11.8,3275,3352,77,81,,,4,0,0.11,,,,783,157,178,113,,,55.92,44.35,56.34,1,61.08,2886,,,4,1,97,97,,,,,,106,82,12.97,13.1,13.12,-1.1,-6.1,305,305,,1,313,313,,,,,,,,,"0,0,1,17,46,32,3,0,0","0,8,43,49,0","0,0,44,55,1",,,,,132,,,,,,,,,,,,,,,,,,,,,,,,,,,,,,,,,,,,66.8,8,6,108,78,,1025,0,322,1,3,3,Karlsruhe,1,0,I1.000|5:07-I1.000|4:52-I1.000|4:41-I1.000|4:49-I1.000|4:54-I1.000|4:51-I1.000|4:41-I1.000|4:19-I1.000|4:28-I1.000|4:13-I1.000|4:14-I0.800|3:25,,,,,3113,"firmware 4.00",250,0,,0,168070,250480,30378,,1622111,,,,,,,,,,,,,,,,,,,,,,,,,,,,,,,,,,,,,,,,,
12141477,68df03b3-05dd-47f3-9f26-50299cbc2c9c,1579263252,60,1579263337,,0,0,9.65,2734,2972,76,81,,,4,0,0.12,,,,558,145,167,109,,,60.95,42.68,61.51,1,61.25,1872,,,3,0.6,102,100,,,,,,65,83,12.7,13.29,13.29,4.5,-4.6,293,293,,1,320,320,,,,,,,,,"3,2,11,18,36,20,7,3,0","0,25,74,1,0","0,9,52,32,7",,,,,128,,,,,,,,,,,,,,,,,,,,,,,,,,,,,,,,,,,,37,8,9,217,74,,1020,1,323,0,5,3,Karlsruhe,1,0,I1.000|4:48-I1.000|4:51-I1.000|4:42-I1.000|4:48-I0.645|2:58-I0.183|0:36-I0.213|0:54-I0.196|0:38-I0.260|1:25-I0.199|0:46-I0.206|1:01-I0.198|0:47-I0.210|1:01-I0.195|0:44-I1.000|4:33-I1.000|4:43-I1.000|5:27-I0.150|0:51,,,,,3113,"firmware 4.00",250,0,,0,168070,250480,30378,,1633562,,,,,,,,,,,,,,,,,,,,,,,,,,,,,,,,,,,,,,,,,
12158383,6d4be27a-da5c-4aba-a277-d10d51ec27f5,1579343874,60,1579345226,,0,0,16.67,4442,4598,113,114,,,4,0,0.13,,,,1000,153,170,,,,61.03,47.75,61.54,1,61.31,2016,,,3.8,0,99,100,,,,,,127,83,13.52,13.56,13.59,2.3,1.3,320,320,,1,329,329,,,,,,,,,"0,0,0,3,36,57,3,0,0","0,4,90,5,0","0,1,28,67,4",,,,,136,,,,,,,,,,,,,,,,,,,,,,,,,,,,,,,,,,,,48.1,5,15,240,88,,1029,0,417,0,5,3,Karlsruhe,1,0,I1.000|4:54-I1.000|4:29-I1.000|4:28-I1.000|4:24-I1.000|4:26-I1.000|4:27-I1.000|4:28-I1.000|4:26-I1.000|4:21-I1.000|4:17-I1.000|4:37-I1.000|4:18-I1.000|4:19-I1.000|4:24-I1.000|4:19-I1.000|4:32-I0.673|2:55,,,,,3113,"firmware 4.00",250,0,,0,168070,250480,30378,,1647325,,,,,,,,,,,,,,,,,,,,,,,,,,,,,,,,,,,,,,,,,
12196311,3997d9fb-1644-4617-be47-e5b1ca106368,1579450565,60,1579450218,,0,0,10.58,2869,3182,90,97,,,4,0,0.16,,,,596,145,156,,,,64.35,45.21,64.97,1,61.77,1280,,,3.1,0,103,101,,,,,,67,81,13.27,13.35,13.36,-0.6,-0.2,313,313,,1,320,320,,,,,,,,,"0,0,1,4,44,49,1,0,0","0,10,90,0,0","0,3,25,71,1",,,,,137,,,,,,,,,,,,,,,,,,,,,,,,,,,,,,,,,,,,29.7,4,3,,86,,1037,,,0,8,1,Karlsruhe,1,0,I1.000|4:41-I1.000|4:33-I1.000|4:27-I1.000|4:29-I1.000|4:23-I1.000|4:22-I1.000|4:31-I1.000|4:33-I1.000|4:34-I1.000|4:28-I0.582|2:48,,,,,3113,"firmware 4.00",250,0,,0,168070,250480,30378,,1673375,,,,,,,,,,,,,,,,,,,,,,,,,,,,,,,,,,,,,,,,,
12228291,3e126894-6f96-4496-9258-27e29735f548,1579544839,60,1579545218,,0,0,3.05,915,915,28,28,,,4,0,0.14,,,,176,133,152,104,,,63.51,37.06,64.23,1,62.11,526,,,1.9,0,104,101,,,,,,15,81,11.98,12.13,12.17,-1.2,-4.7,280,280,,1,289,289,,,,,,,,,"1,0,5,48,36,9,0,0,0","1,93,6,0,0","0,2,63,34,0",,,,,123,,,,,,,,,,,,,,,,,,,,,,,,,,,,,,,,,,,,14.9,2,10,55,75,,1045,0,349,1,3,3,Karlsruhe,1,0,,,,,,3113,"firmware 4.00",250,0,,0,168070,250480,30378,,1700105,,,,,,,,,,,,,,,,,,,,,,,,,,,,,,,,,,,,,,,,,
12232641,db712014-1c70-4ba1-9390-95202e786ca3,1579546055,60,1579554526,,0,0,7.19,1714,1714,105,103,,,4,0,0,,,,401,157,180,,,,67.48,51.31,68.72,1,63.8,1702,,,3.1,2.6,105,102,,,,,,56,86,15.11,16.34,16.35,7.4,6.8,374,374,,1,417,417,,,,,,,,,"14,4,2,3,3,3,32,37,0","0,14,34,52,0","0,18,7,14,62",,,,,146,,,,,,,,,,,,,,,,,,,,,,,,,,,,,,,,,,,,64.7,1,10,55,76,,1045,0,349,1,3,3,Karlsruhe,1,0,I1.027|3:30-I0.227|1:24-I1.031|3:31-I0.200|1:32-I1.017|3:29-I0.209|1:28-I1.023|3:32-I0.202|1:30-I1.008|3:36-I0.213|1:24-I1.010|3:37-I0.019|0:03,,,,,3113,"firmware 4.00",250,0,,0,168070,250480,30378,,1703821,,,,,,,,,,,,,,,,,,,,,,,,,,,,,,,,,,,,,,,,,
12232694,76fbce1f-11a7-42fe-af0f-2378847fbd84,1579548341,60,1579554585,,0,0,0.76,310,310,5,7,,,4,0,0,,,,48,117,126,,,,50.45,22.49,50.69,1,63.8,1688,,,0.3,0,,100,,,,,,3,82,8.75,8.8,8.73,-1.1,-8.4,186,186,,1,186,186,,,,,,,,,"61,37,2,0,0,0,0,0,0","4,96,0,0,0","2,52,47,0,0",,,,,90,,,,,,,,,,,,,,,,,,,,,,,,,,,,,,,,,,,,4,1,10,55,76,,1045,0,349,1,3,3,Karlsruhe,1,0,,,,,,3113,"firmware 4.00",250,0,,0,168070,250480,30378,,1703873,,,,,,,,,,,,,,,,,,,,,,,,,,,,,,,,,,,,,,,,,
12256477,472682a9-243b-46ab-9346-9247d1b48233,1579630071,60,1579630370,,0,0,11.91,3068,3101,88,89,,,4,0,0.11,,,,762,158,178,,,,60.74,48.4,61.29,1,63.28,2611,,,4,0.3,96,100,,,,,,103,83,13.97,14.44,14.47,-6.6,-8.6,335,335,,1,356,356,,,,,,,,,"0,0,0,15,32,13,39,1,0","0,6,37,57,0","0,0,37,41,21",,,,,140,,,,,,,,,,,,,,,,,,,,,,,,,,,,,,,,,,,,78.5,0,6,62,74,,1040,0,356,1,3,3,Karlsruhe,1,0,I1.000|4:46-I1.000|5:01-I1.000|4:41-I1.000|4:37-I1.000|4:34-I1.000|4:36-I1.000|4:17-I1.000|3:48-I1.000|3:47-I1.000|3:46-I1.000|3:43-I0.909|3:33,,,,,3113,"firmware 4.00",250,0,,0,168070,250480,30378,,1724452,,,,,,,,,,,,,,,,,,,,,,,,,,,,,,,,,,,,,,,,,
12256555,b21cf0d4-a22d-4f47-bc28-206554a6ccf7,1579633527,60,1579630409,,0,0,0.42,112,112,9,9,,,4,0,0,,,,21,135,154,,,,72.13,34.92,74.05,1,63.28,2602,,,0.3,0.1,,100,,,,,,2,87,13.36,14.96,15.08,-33.8,-65.5,324,324,,1,389,389,,,,,,,,,"0,0,26,16,8,17,16,17,0","0,69,31,0,0","0,6,48,9,37",,,,,129,,,,,,,,,,,,,,,,,,,,,,,,,,,,,,,,,,,,3.8,0,6,56,77,,1040,0,353,1,3,3,Karlsruhe,1,0,I0.193|1:03-I0.228|0:49,,,,,3113,"firmware 4.00",250,0,,0,168070,250480,30378,,1724514,,,,,,,,,,,,,,,,,,,,,,,,,,,,,,,,,,,,,,,,,
12280966,08f7a5ff-ae42-4903-a950-77998692869b,1579679183,60,1579711624,,0,0,10.35,3107,3223,75,82,,,4,0,0.16,,,,732,153,169,,,,52.68,40.08,53.11,1,62.82,3015,,,3.7,0,96,93,,,,,,92,82,11.97,12.07,12.05,9.5,32.9,279,279,,1,346,346,,,,,,,,,"1,2,10,29,56,2,0,0,0","0,9,51,39,0","0,5,72,22,1",,,,,122,,,,,,,,,,,,,,,,,,,,,,,,,,,,,,,,,,,,59,-3,6,93,81,,1037,0,313,0,5,3,Karlsruhe,1,0,I1.000|5:36-I1.000|5:21-I1.000|4:44-I1.000|4:42-I1.000|4:55-I1.000|4:54-I1.000|4:57-I1.000|4:55-I1.000|4:58-I1.000|4:59-I0.352|1:48,,,,,3113,"firmware 4.00",250,0,,0,168070,250480,30378,,1742841,,,,,,,,,,,,,,,,,,,,,,,,,,,,,,,,,,,,,,,,,
12281011,a80f6e0e-2b5d-4208-9b96-667b071d9682,1579712509,60,1579711731,,0,0,10.48,2573,2611,82,76,,,4,0,0.21,,,,681,170,184,,,,57.64,50.74,58.24,1,62.82,4320,,,4.5,0,,100,,,,,,113,83,14.7,14.72,14.78,6.1,7.9,356,356,,1,365,365,,,,,,,,,"0,0,0,1,6,54,40,0,0","0,1,17,80,2","0,1,11,71,17",,,,,147,,,,,,,,,,,,,,,,,,,,,,,,,,,,,,,,,,,,108,0,5,47,67,,1036,0,316,1,3,3,Eggenstein-Leopoldshafen,1,0,I1.000|4:24-I1.000|4:09-I1.000|4:12-I1.000|4:03-I1.000|3:56-I1.000|4:00-I1.000|3:58-I1.000|3:59-I1.000|4:02-I1.000|4:09-I0.478|2:00,,,,,3113,"firmware 4.00",250,0,,0,168070,250480,30378,,1742864,,,,,,,,,,,,,,,,,,,,,,,,,,,,,,,,,,,,,,,,,
12307012,af0b5758-17bd-4c91-9634-56ba4a8a680b,1579802836,60,1579803698,,0,0,13.71,3419,3464,69,71,,,4,0,0.08,,,,853,163,181,,,,60.35,50.78,60.71,1,62.93,4320,,,4.2,2.3,99,101,,,,,,125,83,14.45,15.09,15.1,-0.2,0,351,351,,1,377,377,,,,,,,,,"2,1,3,12,15,11,54,2,0","0,2,30,67,0","1,1,28,42,29",,,,,145,,,,,,,,,,,,,,,,,,,,,,,,,,,,,,,,,,,,72.2,1,8,59,79,,1028,0,315,1,3,3,Karlsruhe,1,0,I1.000|4:44-I1.000|5:04-I1.000|3:42-I1.000|3:52-I1.000|3:43-I1.000|3:48-I1.000|4:34-I1.000|3:43-I1.000|3:45-I1.000|3:43-I1.000|5:02-I1.000|3:37-I1.000|3:46-I0.706|3:58,,,,,3113,"firmware 4.00",250,0,,0,168070,250480,30378,,1764748,,,,,,,,,,,,,,,,,,,,,,,,,,,,,,,,,,,,,,,,,
12322930,93bcc3a2-c65c-49c3-990b-4602cbd019c9,1579875435,60,1579874050,,0,0,5.96,1834,1881,45,47,,,4,0,0.21,,,,431,156,169,,,,49.69,37.56,50.13,1,62.93,3138,,,3.1,0,,100,,,,,,47,79,11.71,11.78,11.78,2,2.5,270,270,,1,277,277,,,,,,,,,"1,3,18,36,41,0,0,0,0","19,4,40,37,0","0,5,74,21,0",,,,,123,,,,,,,,,,,,,,,,,,,,,,,,,,,,,,,,,,,,58.3,5,3,304,64,,1024,1,305,0,3,3,Karlsruhe,1,0,I1.000|5:43-I1.000|5:24-I1.000|5:03-I1.000|4:52-I1.000|4:50-I0.964|4:42,,,,,3113,"firmware 4.00",250,0,,0,168070,250480,30378,,1777970,,,,,,,,,,,,,,,,,,,,,,,,,,,,,,,,,,,,,,,,,
12339754,8c1d1b0d-0ecc-4d39-8f39-849d59c7f296,1579944097,60,1579943543,,0,0,8.25,2681,2778,70,72,,,4,0.9,0.48,1.52,0.84,,547,145,175,,,,51.46,35.93,51.99,1,62.93,1978,,,2.9,2,,100,,,,,,64,81,11.01,13.47,13.97,21.9,2.1,253,253,,1,387,387,,,,,,,,,"30,9,21,14,3,2,7,13,0","0,35,55,10,0","12,39,24,4,21",,,,,114,,,,,,,,,,,,,,,,,,,,,,,,,,,,,,,,,,,,38.6,-1,4,170,88,,1024,0,292,0,5,3,Möglingen,1,0,I1.000|5:21-I0.142|0:49-I0.321|1:07-I0.356|2:06-I0.318|1:08-I0.348|2:01-I0.313|1:05-I0.358|2:02-I0.323|1:06-I0.355|2:20-I0.319|1:06-I0.357|2:31-I0.317|1:05-I0.356|2:34-I0.308|1:02-I0.341|2:45-I0.315|1:03-I0.353|2:53-I0.311|1:03-I0.356|3:06-I0.315|1:01-I0.766|5:25,,,,,3113,"firmware 4.00",250,0,,0,168070,250480,30378,,1791760,,,,,,,,,,,,,,,,,,,,,,,,,,,,,,,,,,,,,,,,,
12487994,1510e3a7-3ef6-4ace-84f9-f93512317ada,1580152630,60,1580481527,,0,0,0.62,170,170,10,12,,,4,0.3,0.33,,,,40,,,,,,,34.84,,1,62,650,,,,,,100,,,,,,3,84,12.81,15.85,15.81,,,309,309,,1,419,419,,,,,,,,,"30,12,8,4,2,1,27,17,0",,"0,36,14,9,41",,,,,130,,,,,,,,,,,,,,,,,,,,,,,,,,,,,,,,,,,,,7,9,220,93,,1008,,,1,6,1,Karlsruhe,1,0,I0.202|1:24-I0.414|1:26,,,,,3113,"firmware 4.00",250,0,,0,168070,250480,30378,,1911728,,,,,,,,,,,,,,,,,,,,,,,,,,,,,,,,,,,,,,,,,
12488011,dd8f6894-17f3-43d4-bdc2-f08711c27fed,1580318962,60,1580481537,,0,0,2.09,677,686,37,34,,,4,0,0.1,,,,138,136,145,105,,,56.18,32.8,57.51,1,61.87,899,,,1.8,0,96,98,,,,,,12,79,11.21,11.31,11.51,-12.6,-17.9,259,259,,1,269,269,,,,,,,,,"0,9,34,47,8,1,0,0,0","1,83,16,0,0","1,4,84,11,0",,,,,117,,,,,,,,,,,,,,,,,,,,,,,,,,,,,,,,,,,,15.2,4,19,257,86,,1015,0,369,1,6,3,Karlsruhe,1,0,I1.000|5:44-I1.000|5:05-I0.092|0:28,,,,,3113,"firmware 4.00",250,0,,0,168070,250480,30378,,1911747,,,,,,,,,,,,,,,,,,,,,,,,,,,,,,,,,,,,,,,,,
12488078,1f4e8112-7b97-4046-8666-11e98eef4b05,1580234907,60,1580481588,,0,0,3.08,893,920,13,13,,,4,0,0,,,,202,148,163,,,,57.61,38.59,57.91,1,62,874,,,2.4,0,,100,,,,,,23,81,12.42,12.47,12.49,8.6,6.8,289,289,,1,294,294,,,,,,,,,"1,1,2,15,75,6,0,0,0","4,4,86,6,0","1,2,60,37,0",,,,,128,,,,,,,,,,,,,,,,,,,,,,,,,,,,,,,,,,,,35.7,4,27,250,84,,1006,0,439,1,4,3,Karlsruhe,1,0,I0.964|4:36-I2.103|10:09-I0.001|0:01-I0.009|0:07,,,,,3113,"firmware 4.00",250,0,,0,168070,250480,30378,,1911809,,,,,,,,,,,,,,,,,,,,,,,,,,,,,,,,,,,,,,,,,
12488101,6aea5de8-8459-48b3-a7aa-0ae2d9e64cb1,1580320113,60,1580481599,,0,0,9.4,2823,2860,51,54,,,4,0,0.13,,,,554,140,152,108,,,59.42,39.79,59.8,1,61.18,1810,,,2.7,0,96,98,,,,,,58,81,11.97,12.06,12.06,1.2,1.7,277,277,,1,283,283,,,,,,,,,"1,2,4,41,50,2,0,0,0","0,47,53,0,0","0,4,68,28,0",,,,,123,,,,,,,,,,,,,,,,,,,,,,,,,,,,,,,,,,,,23.4,4,19,257,86,,1015,0,369,1,6,3,Karlsruhe,1,0,I1.000|5:12-I1.000|5:02-I1.000|4:56-I1.000|4:56-I1.000|4:55-I1.000|4:57-I1.000|4:57-I1.000|4:49-I1.000|5:20-I0.401|1:59,,,,,3113,"firmware 4.00",250,0,,0,168070,250480,30378,,1911832,,,,,,,,,,,,,,,,,,,,,,,,,,,,,,,,,,,,,,,,,
12488114,767e3048-46bf-4b99-86ef-0df503ce2afa,1580407755,60,1580481614,,0,0,13.68,3502,3553,65,67,,,4,0,0.06,,,,757,152,173,,,,64.73,49.25,65.1,1,62.58,1872,,,3.7,0,105,101,,,,,,101,82,14.07,14.34,14.34,6.6,3.8,338,338,,1,351,351,,,,,,,,,"0,0,0,9,21,39,30,1,0","1,11,61,27,0","0,0,21,68,11",,,,,143,,,,,,,,,,,,,,,,,,,,,,,,,,,,,,,,,,,,69.5,8,16,220,84,,1011,0,299,1,6,3,Karlsruhe,1,0,I1.000|4:28-I1.000|4:31-I1.000|4:27-I0.115|0:34-I1.000|4:01-I1.000|4:00-I1.000|4:01-I1.000|4:01-I1.000|3:55-I1.000|3:53-I1.000|3:50-I1.000|4:21-I1.000|4:28-I1.000|4:58-I0.567|2:53,,,,,3113,"firmware 4.00",250,0,,0,168070,250480,30378,,1911845,,,,,,,,,,,,,,,,,,,,,,,,,,,,,,,,,,,,,,,,,
12488130,2f10b5cd-b7da-4910-8242-45dc64602899,1580236082,60,1580481632,,0,0,8.52,2114,2114,59,59,,,4,0,0.12,,,,494,159,179,,,,63.03,49.46,63.57,1,62.4,2016,,,3.4,2.1,105,97,,,,,,73,83,14.53,15.78,15.79,6,7.7,357,357,,1,401,401,,,,,,,,,"15,1,1,1,1,3,67,11,0","0,13,32,55,0","11,5,2,33,48",,,,,146,,,,,,,,,,,,,,,,,,,,,,,,,,,,,,,,,,,,71,3,26,248,83,,1007,0,437,1,4,3,Karlsruhe,1,0,I1.000|3:36-I1.000|3:36-I0.171|1:59-I1.000|3:31-I1.000|3:42-I0.186|1:58-I1.000|3:38-I1.000|3:38-I0.151|2:01-I1.000|3:44-I1.000|3:46-I0.015|0:04,,,,,3113,"firmware 4.00",250,0,,0,168070,250480,30378,,1911861,,,,,,,,,,,,,,,,,,,,,,,,,,,,,,,,,,,,,,,,,
12488134,efef7ab4-11fb-4b6f-b1a0-0f07f65e33dc,1580150961,60,1580481639,,0,0,4.39,1391,1396,31,34,,,4,0,0.28,,,,292,,,,,,,35.63,,1,62,656,,,,,,100,,,,,,30,79,11.34,11.51,11.49,,,254,254,,1,265,265,,,,,,,,,"2,5,30,35,27,1,0,0,0",,"0,10,74,16,0",,,,,120,,,,,,,,,,,,,,,,,,,,,,,,,,,,,,,,,,,,,7,14,224,85,,1009,0,327,1,6,3,Karlsruhe,1,0,I1.000|5:45-I1.000|5:30-I1.000|4:55-I1.000|5:03-I0.389|1:58,,,,,3113,"firmware 4.00",250,0,,0,168070,250480,30378,,1911865,,,,,,,,,,,,,,,,,,,,,,,,,,,,,,,,,,,,,,,,,
12488176,97724cb0-aefc-4701-b991-c16ee1a8020a,1580471054,60,1580481691,,0,0,13.79,3535,3612,82,84,,,4,0,0.11,,,,877,161,177,,,,59.42,49.21,59.85,1,62.2,3395,,,4.4,0,103,97,,,,,,125,82,14.04,14.13,14.13,9.7,9.9,334,334,,1,343,343,,,,,,,,,"0,0,0,1,14,75,10,0,0","0,1,41,58,0","0,1,18,76,6",,,,,143,,,,,,,,,,,,,,,,,,,,,,,,,,,,,,,,,,,,81.4,12,22,237,91,,1015,1,299,0,4,3,Karlsruhe,1,0,I1.000|4:27-I1.000|4:21-I1.000|4:15-I1.000|4:12-I1.000|4:15-I1.000|4:16-I1.000|4:11-I1.000|4:15-I1.000|4:15-I1.000|4:07-I1.000|4:16-I1.000|4:11-I1.000|4:26-I0.793|3:27,,,,,3113,"firmware 4.00",250,0,,0,168070,250480,30378,,1911906,,,,,,,,,,,,,,,,,,,,,,,,,,,,,,,,,,,,,,,,,
12488244,a814966c-0d32-4181-bf3f-8ac567370f48,1580069555,60,1580481909,,0,0,9.8,2751,3011,78,75,,,4,0,0.11,,,,627,150,164,,,,58.85,43.19,59.45,1,62,1987,,,3.3,0,,94,,,,,,74,80,12.85,13,13.03,14.6,15.1,302,302,,1,310,310,,,,,,,,,"0,0,6,20,34,39,1,0,0","0,15,72,12,0","0,2,43,55,0",,,,,134,,,,,,,,,,,,,,,,,,,,,,,,,,,,,,,,,,,,48.3,2,5,166,87,,1020,0,291,1,5,3,Karlsruhe,1,0,I1.000|4:51-I1.000|4:37-I1.000|4:30-I1.000|4:20-I1.000|4:26-I1.000|4:25-I1.000|4:32-I1.000|4:43-I1.000|5:11-I0.804|4:17,,,,,3113,"firmware 4.00",250,0,,0,168070,250480,30378,,1911970,,,,,,,,,,,,,,,,,,,,,,,,,,,,,,,,,,,,,,,,,
12535686,f8e6ac7b-608e-4aac-968a-fbd7340636c2,1580574973,60,1580653958,,0,0,2.03,664,676,15,17,,,4,0.1,0.28,0.96,0.92,,130,133,152,,,,57.08,32.34,57.53,1,61.96,1713,,,1.6,0,98,97,,,,,,11,80,10.99,11,11.06,3.4,4.8,247,247,,1,261,261,,,,,,,,,"1,1,41,57,0,0,0,0,0","3,77,20,0,0","0,15,74,11,0",,,,,115,,,,,,,,,,,,,,,,,,,,,,,,,,,,,,,,,,,,14.9,11,22,245,83,,1010,0,315,0,6,3,Möglingen,1,0,I1.000|5:28-I1.000|5:27-I0.028|0:09,,,,,3113,"firmware 4.00",250,0,,0,168070,250480,30378,,1950152,,,,,,,,,,,,,,,,,,,,,,,,,,,,,,,,,,,,,,,,,
12535687,d1ef9850-6e59-4c3f-b5e5-1537e750236b,1580575868,60,1580653960,,0,0,7.95,2795,2795,73,72,,,4,1.2,0.58,1.71,0.8,,469,134,165,,,,51.73,32.65,52.33,1,61.96,2160,,,2.4,1.7,,100,,,,,,49,81,10.13,13.7,14.35,12.9,-4.8,229,229,,1,402,402,,,,,,,,,"58,10,3,1,1,2,8,16,0","0,74,24,2,0","17,55,3,2,24",,,,,105,,,,,,,,,,,,,,,,,,,,,,,,,,,,,,,,,,,,21.4,11,21,245,83,,1010,0,315,0,6,3,Möglingen,1,0,I0.313|1:05-I0.357|2:29-I0.315|1:06-I0.345|2:31-I0.311|1:06-I0.349|2:22-I0.315|1:06-I0.344|2:39-I0.311|1:05-I0.351|2:20-I0.313|1:07-I0.347|2:55-I0.315|1:03-I0.350|2:53-I0.315|1:03-I0.350|2:57-I0.313|1:04-I0.352|3:02-I0.313|1:05-I0.358|3:12-I0.314|1:01-I0.354|3:26-I0.314|1:03-I0.330|2:53,,,,,3113,"firmware 4.00",250,0,,0,168070,250480,30378,,1950153,,,,,,,,,,,,,,,,,,,,,,,,,,,,,,,,,,,,,,,,,
12535690,07471562-6ff1-4b9f-b93d-0be2144c9f81,1580578674,60,1580653965,,0,0,0.54,243,243,2,0,,,4,0,0,,,,37,124,129,,,,41.87,19.3,42.25,1,61.96,2156,,,0.2,0,,100,,,,,,3,82,8.15,8.08,8.19,-10,-18,175,175,,1,178,178,,,,,,,,,"100,0,0,0,0,0,0,0,0","0,100,0,0,0","0,94,6,0,0",,,,,81,,,,,,,,,,,,,,,,,,,,,,,,,,,,,,,,,,,,4.4,11,21,255,85,,1011,0,327,1,6,3,Möglingen,1,0,,,,,,3113,"firmware 4.00",250,0,,0,168070,250480,30378,,1950156,,,,,,,,,,,,,,,,,,,,,,,,,,,,,,,,,,,,,,,,,
12587150,46c32ca7-75f3-4657-ab04-d0253b5238f3,1580743190,60,1580851387,,0,0,14.01,3543,3576,73,78,,,4,0,0.12,,,,859,160,173,,,,60.99,50.05,61.36,1,61.55,2548,,,4.1,0,102,98,,,,,,120,81,14.22,14.33,14.32,1.3,2.1,340,340,,1,347,347,,,,,,,,,"0,0,0,1,11,67,21,0,0","0,2,43,55,0","0,1,16,74,9",,,,,146,,,,,,,,,,,,,,,,,,,,,,,,,,,,,,,,,,,,64.6,10,20,251,82,,1018,0,325,0,6,3,Karlsruhe,1,0,I1.000|4:42-I1.000|4:16-I1.000|4:15-I1.000|4:14-I1.000|4:10-I1.000|4:13-I1.000|4:21-I1.000|4:03-I1.000|4:06-I1.000|4:05-I1.000|4:11-I1.000|4:10-I1.000|4:09-I1.000|4:06-I0.010|0:01,,,,,3113,"firmware 4.00",250,0,,0,168070,250480,30378,,1991300,,,,,,,,,,,,,,,,,,,,,,,,,,,,,,,,,,,,,,,,,
12587151,09a66cff-46fe-4629-a7c0-57b01508b753,1580839763,60,1580851391,,0,0,3.03,764,764,17,16,,,4,0,0.12,,,,167,144,154,115,,,71.07,45.27,71.6,1,62.61,1048,,,2.2,0,105,103,,,,,,17,82,14.28,14.33,14.36,4.7,3.6,343,343,,1,347,347,,,,,,,,,"0,0,0,0,12,75,14,0,0","3,17,81,0,0","0,1,8,86,5",,,,,145,,,,,,,,,,,,,,,,,,,,,,,,,,,,,,,,,,,,25.6,4,15,256,80,,1021,0,409,1,6,3,Karlsruhe,1,0,I1.000|4:16-I1.000|4:13-I1.000|4:09-I0.030|0:07,,,,,3113,"firmware 4.00",250,0,,0,168070,250480,30378,,1991301,,,,,,,,,,,,,,,,,,,,,,,,,,,,,,,,,,,,,,,,,
12587152,874bd455-915d-4be2-a444-9ac386b5cf56,1580840956,60,1580851395,,0,0,8.83,2412,2558,106,101,,,4,0,0.06,,,,504,150,177,,,,60.86,44.28,61.81,1,63.8,1984,,,3.1,2.4,101,108,,,,,,66,84,13.24,16.11,16.12,18.4,1.2,321,321,,1,420,420,,,,,,,,,"23,4,12,10,3,2,6,38,0","0,31,42,27,0","7,19,26,6,43",,,,,131,,,,,,,,,,,,,,,,,,,,,,,,,,,,,,,,,,,,55.6,4,14,273,85,,1022,0,406,1,6,3,Karlsruhe,1,0,I0.802|2:41-I0.409|2:13-I0.997|3:21-I0.401|2:14-I1.014|3:21-I0.397|2:30-I1.007|3:23-I0.404|2:46-I0.998|3:23-I0.611|3:25-I0.307|0:58-I0.307|2:02-I0.305|0:56-I0.305|2:19-I0.302|0:57-I0.264|3:44,,,,,3113,"firmware 4.00",250,0,,0,168070,250480,30378,,1991302,,,,,,,,,,,,,,,,,,,,,,,,,,,,,,,,,,,,,,,,,
12617712,e434250e-bb68-4a0c-b38b-96cc705ffbd7,1580923183,60,1580995716,,0,0,9.2,2652,2727,55,56,,,4,0,0.11,,,,546,140,163,,,,62.51,41.69,62.96,1,63.58,1352,,,2.9,0,99,100,,,,,,55,80,12.49,12.71,12.72,3.7,1.4,293,293,,1,304,304,,,,,,,,,"3,3,5,22,46,18,3,0,0","1,43,56,0,0","0,3,54,40,2",,,,,130,,,,,,,,,,,,,,,,,,,,,,,,,,,,,,,,,,,,31.1,5,4,39,69,,1037,0,343,1,3,3,Eggenstein-Leopoldshafen,1,0,I4.742|22:48-I0.004|0:01-I1.000|4:23-I1.000|4:08-I1.000|4:51-I1.000|5:23-I0.450|2:38,,,,,3113,"firmware 4.00",250,0,,0,168070,250480,30378,,2014897,,,,,,,,,,,,,,,,,,,,,,,,,,,,,,,,,,,,,,,,,
12623081,acab85f6-28e9-4ec7-948b-5caed8393714,1581012521,60,1581013653,,0,0,14.28,3699,3877,64,65,,,4,0,0.04,,,,811,150,167,,,,64.99,48.74,65.35,1,63.78,1454,,,3.5,0.8,99,100,,,,,,98,83,13.92,14.38,14.43,-0.2,-13.3,333,333,,1,359,359,,,,,,,,,"2,2,4,4,15,60,9,3,1","0,8,85,7,0","0,5,20,67,9",,,,,140,,,,,,,,,,,,,,,,,,,,,,,,,,,,,,,,,,,,45.6,3,5,67,76,,1032,0,343,1,3,3,Karlsruhe,1,0,I1.000|4:41-I1.000|4:33-I1.000|4:15-I1.000|4:12-I1.000|4:08-I1.000|4:09-I1.000|4:11-I1.000|4:16-I1.000|4:12-I1.000|4:06-I1.000|4:09-I0.925|4:23-I0.213|0:36-I0.175|1:01-I0.203|0:39-I0.166|0:51-I0.211|0:40-I0.175|1:01-I0.201|0:40-I0.220|1:05-I0.210|0:38-I0.581|3:14,,,,,3113,"firmware 4.00",250,0,,0,168070,250480,30378,,2019377,,,,,,,,,,,,,,,,,,,,,,,,,,,,,,,,,,,,,,,,,
12641898,7a2c49bd-3bd3-4b86-aaaa-00a8ce7c6594,1581092700,60,1581092766,,0,0,10.89,3276,3509,60,55,,,4,0,0.12,,,,679,142,158,,,,58.21,40.13,58.64,1,62.5,1986,,,3,0.1,97,95,,,,,,71,80,11.96,12.04,12.05,5.9,7,275,275,,1,282,282,,,,,,,,,"1,1,4,48,45,1,0,0,0","0,38,61,0,0","0,2,74,24,0",,,,,125,,,,,,,,,,,,,,,,,,,,,,,,,,,,,,,,,,,,29.1,7,5,340,50,,1025,,,0,2,1,Karlsruhe,1,0,I1.000|5:22-I1.000|5:05-I1.000|4:54-I1.000|4:55-I1.000|4:43-I1.000|4:51-I1.000|4:58-I1.000|5:10-I1.000|5:02-I1.000|5:03-I0.886|4:33,,,,,3113,"firmware 4.10",250,0,,0,168070,250480,30378,,2036023,,,,,,,,,,,,,,,,,,,,,,,,,,,,,,,,,,,,,,,,,
12660586,6cdd6514-4731-45e5-bd0c-c19eb15f255e,1581157833,60,1581158182,,0,0,15.01,3777,3819,71,72,,,4,0,0.14,,,,963,167,179,,,,57.5,50.6,57.83,1,61.62,4848,,,4.9,0,98,96,,,,,,153,82,14.32,14.43,14.48,7.4,7.4,343,343,,1,354,354,,,,,,,,,"0,0,0,4,8,68,20,0,0","0,1,16,83,0","0,1,16,76,8",,,,,145,,,,,,,,,,,,,,,,,,,,,,,,,,,,,,,,,,,,91.4,2,2,242,76,,1026,1,311,0,4,3,Karlsruhe,1,0,I1.000|4:17-I1.000|4:20-I1.000|4:07-I1.000|4:09-I1.000|4:07-I1.000|4:02-I1.000|3:59-I1.000|4:07-I1.000|4:06-I1.000|4:11-I1.000|4:05-I1.000|4:10-I1.000|4:09-I1.000|4:09-I1.000|5:00-I0.007|0:02,,,,,3113,"firmware 4.10",250,0,,0,168070,250480,30378,,2053231,,,,,,,,,,,,,,,,,,,,,,,,,,,,,,,,,,,,,,,,,
12708538,cd0ec652-0fc6-4325-9ffa-5693dc628774,1581349338,60,1581349474,,0,0,14.02,3437,3575,69,65,,,4,0,0.03,,,,775,155,170,,,,66.41,51.89,66.84,1,62.04,4320,,,3.8,0.1,103,100,,,,,,105,82,14.71,14.76,14.78,2.3,1.6,341,341,,1,347,347,,,,,,,,,"0,0,0,0,6,56,37,1,0","0,2,74,24,0","0,0,15,78,6",,,,,149,,,,,,,,,,,,,,,,,,,,,,,,,,,,,,,,,,,,55.7,8,31,244,70,,1010,0,317,0,11,3,Karlsruhe,1,0,I1.000|4:23-I1.000|4:18-I1.000|4:09-I1.000|4:04-I1.000|3:59-I1.000|4:01-I1.000|3:59-I1.000|3:58-I1.000|4:04-I1.000|4:01-I1.000|4:02-I1.000|4:02-I1.000|4:07-I1.000|4:05-I0.019|0:04,,,,,3113,"firmware 4.10",250,0,,0,168070,250480,30378,,2090149,,,,,,,,,,,,,,,,,,,,,,,,,,,,,,,,,,,,,,,,,
12728418,590d9d06-bd32-4ca0-8ba0-bfda1f53cf62,1581444528,60,1581445485,,0,0,13.7,3485,3490,63,68,,,4,0,0.08,,,,759,150,166,,,,66.47,49.62,66.82,1,62.89,2880,,,3.4,0.1,100,103,,,,,,93,82,14.15,14.22,14.21,3.8,1.5,321,321,,1,327,327,,,,,,,,,"0,0,0,1,10,78,11,0,0","0,3,92,5,0","0,1,26,71,2",,,,,144,,,,,,,,,,,,,,,,,,,,,,,,,,,,,,,,,,,,45.5,4,25,246,79,,1014,0,321,1,5,3,Karlsruhe,1,0,I1.000|4:25-I1.000|4:16-I1.000|4:22-I1.000|4:17-I1.000|4:03-I1.000|4:13-I1.000|4:08-I1.000|4:11-I1.000|4:12-I1.000|4:11-I1.000|4:16-I1.000|4:12-I1.000|4:16-I0.697|3:03,,,,,3113,"firmware 4.10",250,0,,0,168070,250480,30378,,2105068,,,,,,,,,,,,,,,,,,,,,,,,,,,,,,,,,,,,,,,,,
12744645,f4a73083-5873-4174-936c-bf16a9f4ac23,1581523244,60,1581522544,,0,0,9.29,2626,2672,55,56,,,4,0,0.09,,,,501,139,150,,,,64.64,42.68,65.11,1,63.11,1454,,,2.6,0,100,101,,,,,,51,80,12.77,12.84,12.87,-1.3,-3.5,287,287,,1,296,296,,,,,,,,,"1,1,2,13,69,12,2,0,0","0,59,41,0,0","0,3,67,27,2",,,,,133,,,,,,,,,,,,,,,,,,,,,,,,,,,,,,,,,,,,22,7,26,252,73,,1019,0,368,0,6,3,Eggenstein-Leopoldshafen,1,0,I1.000|5:13-I1.000|4:52-I1.000|4:34-I1.000|4:36-I1.000|4:40-I1.000|4:38-I1.000|4:37-I1.000|4:40-I1.000|4:45-I0.294|1:12,,,,,3113,"firmware 4.10",250,0,,0,168070,250480,30378,,2116971,,,,,,,,,,,,,,,,,,,,,,,,,,,,,,,,,,,,,,,,,
12769330,8793dfbb-b79d-41cc-8990-ef522c5793bf,1581617293,60,1581618220,,0,0,13.73,3277,3332,50,53,,,4,0,0.11,,,,776,158,177,,,,66.75,53.44,67.03,1,63.61,2304,,,4.1,0,105,100,,,,,,109,83,15.08,15.18,15.18,5.2,3.7,351,351,,1,359,359,,,,,,,,,"0,0,0,0,4,39,55,2,0","0,4,46,50,0","0,0,14,74,12",,,,,151,,,,,,,,,,,,,,,,,,,,,,,,,,,,,,,,,,,,80.8,7,21,226,85,,1005,0,415,1,6,3,Karlsruhe,1,0,I1.000|4:24-I1.000|4:20-I1.000|4:09-I1.000|4:10-I1.000|4:01-I1.000|3:53-I1.000|3:48-I1.000|3:52-I1.000|3:51-I1.000|3:51-I1.000|3:47-I1.000|3:44-I1.000|3:44-I0.728|3:02,,,,,3113,"firmware 4.10",250,0,,0,168070,250480,30378,,2136528,,,,,,,,,,,,,,,,,,,,,,,,,,,,,,,,,,,,,,,,,
12789470,80ee6288-4ec0-4375-8090-947fe9092468,1581703157,60,1581704139,,0,0,11.95,2986,3616,94,95,,,4,0,0.11,,,,700,155,169,112,,,64.86,50.16,65.48,1,63.34,2179,,,3.6,0,100,100,,,,,,91,81,14.42,14.45,14.48,3.3,4.1,334,334,,1,339,339,,,,,,,,,"0,0,0,2,7,71,20,0,0","0,4,70,26,0","0,1,15,80,4",,,,,148,,,,,,,,,,,,,,,,,,,,,,,,,,,,,,,,,,,,55,8,8,235,82,,1027,0,307,1,4,3,Karlsruhe,1,0,I1.000|4:32-I1.000|4:16-I1.000|4:12-I1.000|4:07-I1.000|4:09-I1.000|4:05-I1.000|3:57-I1.000|4:10-I1.000|4:09-I1.000|4:06-I1.000|4:08-I0.945|3:54,,,,,3113,"firmware 4.10",250,0,,0,168070,250480,30378,,2153383,,,,,,,,,,,,,,,,,,,,,,,,,,,,,,,,,,,,,,,,,
12789471,7aca4d43-3b5c-4101-9f2e-05f851da509d,1581707079,60,1581704141,,0,0,1.26,420,420,13,15,,,4,0,0,,,,83,134,139,,,,55.25,30.06,55.84,1,63.2,2171,,,1.1,0,98,99,,,,,,7,82,10.69,10.74,10.69,-3.4,-4.4,229,229,,1,232,232,,,,,,,,,"3,13,41,44,0,0,0,0,0","0,100,0,0,0","0,14,86,0,0",,,,,110,,,,,,,,,,,,,,,,,,,,,,,,,,,,,,,,,,,,10.9,7,6,227,86,,1027,0,304,1,4,3,Karlsruhe,1,0,I1.000|5:37-I0.255|1:23,,,,,3113,"firmware 4.10",250,0,,0,168070,250480,30378,,2153384,,,,,,,,,,,,,,,,,,,,,,,,,,,,,,,,,,,,,,,,,
12797758,7ce43f33-7da7-4a11-9ce2-42b227823f42,1581754254,60,1581753698,,0,0,8.33,2567,2891,54,60,,,4,0,0.13,,,,582,154,176,,,,50.53,38.28,50.89,1,62.95,2250,,,3.4,2,93,98,,,,,,77,82,11.68,13.03,13.03,11.3,3.1,254,254,,1,304,304,,,,,,,,,"9,12,29,29,5,3,6,8,0","0,8,61,31,0","1,23,55,11,9",,,,,119,,,,,,,,,,,,,,,,,,,,,,,,,,,,,,,,,,,,55.9,2,4,198,92,,1026,0,320,0,4,3,Karlsruhe,1,0,I1.000|5:42-I0.763|3:59-I0.357|2:01-I0.292|1:01-I0.389|2:00-I0.295|1:01-I0.335|2:01-I0.297|1:01-I0.379|2:01-I0.277|1:01-I0.329|2:01-I0.308|1:01-I0.393|2:09-I0.275|1:01-I0.302|2:02-I0.288|1:01-I1.000|5:47-I1.000|5:38-I0.053|0:20,,,,,3113,"firmware 4.10",250,0,,0,168070,250480,30378,,2160894,,,,,,,,,,,,,,,,,,,,,,,,,,,,,,,,,,,,,,,,,
12829087,5564827b-5331-475e-bc3b-8ff1af7b89e3,1581851362,60,1581864857,,0,0,16.41,14436,16932,207,210,,,4,1.5,0.48,,,80,945,88,121,,,,,,,1,62.95,398,,,0.9,0,,100,,,,,,56,57,,4.75,,-13.5,,,,,,,,,,,,,,,,"79,21,0,0,0,0","76,24,0,0,0",,,,,,,,,,,,,,,,,,,,,,,,,,,,,,,,,,,,,,,,,,6.2,11,14,187,61,,1017,1,290,0,4,3,Möglingen,1,0,,,,,,3113,"firmware 4.10",250,0,,0,168075,,30378,,2183300,,,,,,,,,,,,,,,,,,,,,,,,,,,,,,,,,,,,,,,,"5,5",
12832596,8acf0cbd-bb02-4424-b833-c7c7f2c459f7,1581877118,60,1581875472,,0,0,5.56,1763,1823,32,33,,,4,0,0.22,1.03,,,320,134,145,,,,58.76,36.09,59.16,1,61.89,1513,,,2.2,0,96,97,,,,,,30,79,11.37,11.42,11.43,-5.3,5.8,252,252,,1,258,258,,,,,,,,,"0,4,21,60,15,1,0,0,0","0,93,7,0,0","0,3,93,4,0",,,,,120,,,,,,,,,,,,,,,,,,,,,,,,,,,,,,,,,,,,16.4,13,14,199,52,,1014,0,288,1,4,3,Möglingen,1,0,I1.000|5:42-I1.000|5:22-I1.000|5:24-I1.000|5:06-I1.000|5:03-I0.556|2:45,,,,,3113,"firmware 4.10",250,0,,0,168070,250480,30378,,2186234,,,,,,,,,,,,,,,,,,,,,,,,,,,,,,,,,,,,,,,,,
12848984,c8fa0d5b-987b-4129-b2a8-75be2ddd36fa,1581951103,60,1581951620,,0,0,15.14,3764,3940,95,96,,,4,0,0.19,0.96,1.03,,817,153,168,113,,,66.49,51.35,67.01,1,62.81,1728,,,3.6,0.6,104,101,,,,,,109,82,14.51,14.56,14.58,-0.2,0.6,337,337,,1,344,344,,,,,,,,,"0,0,0,0,6,70,24,0,0","0,2,83,14,0","0,0,12,86,2",,,,,147,,,,,,,,,,,,,,,,,,,,,,,,,,,,,,,,,,,,47.9,10,19,242,79,,1018,1,353,0,6,3,Möglingen,1,0,I1.000|4:24-I1.000|4:07-I1.000|4:11-I1.000|4:12-I1.000|4:06-I1.000|4:14-I1.000|4:07-I1.000|4:02-I1.000|4:03-I1.000|4:02-I1.000|4:03-I1.000|4:14-I1.000|4:00-I1.000|4:15-I1.000|4:06-I0.140|0:38,,,,,3113,"firmware 4.10",250,0,,0,168070,250480,30378,,2198715,,,,,,,,,,,,,,,,,,,,,,,,,,,,,,,,,,,,,,,,,
12874547,79165856-4d3c-4c43-8bce-78ecd7fccebb,1582049281,60,1582050017,,0,0,13.8,3611,3969,69,71,,,4,0,0.08,,,,708,147,176,,,,66.01,48.05,66.4,1,63.76,1396,,,3.4,1,101,102,,,,,,91,84,13.78,14.74,14.74,4,1.3,314,314,,1,349,349,,,,,,,,,"3,1,8,16,10,22,32,7,0","1,27,57,16,0","3,4,36,41,16",,,,,136,,,,,,,,,,,,,,,,,,,,,,,,,,,,,,,,,,,,50.9,6,16,231,69,,1027,0,352,1,3,3,Karlsruhe,1,0,I1.000|4:26-I1.000|4:13-I1.000|4:18-I0.137|0:37-I2.486|9:03-I0.707|4:34-I1.961|7:01-I1.227|5:38-I1.348|5:00-I0.492|2:31-I2.442|12:51,,,,,3113,"firmware 4.10",250,0,,0,168070,250480,30378,,2220093,,,,,,,,,,,,,,,,,,,,,,,,,,,,,,,,,,,,,,,,,
12902046,da3ce642-4a76-449e-9fa3-b70b38e57893,1582134797,60,1582135626,,0,0,11.73,3835,4229,89,89,,,4,0,0.14,,,,675,138,164,,,,54.52,36.61,55.03,1,63.5,1262,,,2.9,1.1,94,98,,,,,,76,82,11.02,13.26,13.27,-7.5,-27.1,239,239,,1,325,325,,,,,,,,,"11,34,36,5,1,1,2,10,0","0,61,38,1,0","1,37,49,3,11",,,,,112,,,,,,,,,,,,,,,,,,,,,,,,,,,,,,,,,,,,31.5,5,12,259,73,,1026,0,342,1,4,3,Karlsruhe,1,0,I4.587|27:13-I0.505|1:41-I0.220|1:17-I0.297|0:57-I0.136|0:55-I0.501|1:39-I0.207|1:28-I0.309|0:58-I0.423|3:03-I0.307|1:00-I0.204|1:16-I0.206|0:39-I0.111|0:44-I0.299|1:01-I0.207|1:20-I0.205|0:39-I3.008|18:05,,,,,3113,"firmware 4.10",250,0,,0,168070,250480,30378,,2244307,,,,,,,,,,,,,,,,,,,,,,,,,,,,,,,,,,,,,,,,,
12926045,0e2bb850-48a3-4f84-8da3-06d7b2953fdb,1582221992,60,1582223154,,0,0,15.05,3451,3765,76,84,,,4,0,0.04,,,,813,156,180,,,,71.47,56.36,71.87,1,64.53,2304,,,4.1,2.1,102,103,,,,,,111,84,15.69,16,15.99,0.5,-2.6,370,370,,1,383,383,,,,,,,,,"0,0,0,0,5,24,56,14,0","0,11,53,35,0","0,1,11,55,33",,,,,156,,,,,,,,,,,,,,,,,,,,,,,,,,,,,,,,,,,,82.6,10,14,233,70,,1018,0,319,1,4,3,Karlsruhe,1,0,I1.750|7:38-I1.000|4:15-I0.436|1:45-I1.000|3:53-I1.000|3:46-I1.000|3:56-I1.000|3:51-I1.000|3:49-I1.000|3:52-I1.000|3:42-I1.000|3:45-I1.000|3:33-I1.000|3:26-I1.000|3:30-I0.862|2:48,,,,,3113,"firmware 4.10",250,0,,0,168070,250480,30378,,2264335,,,,,,,,,,,,,,,,,,,,,,,,,,,,,,,,,,,,,,,,,
12926072,da4a55b2-db7d-4b56-a17d-ba408e197fe4,1582225800,60,1582223194,,0,0,0.86,293,293,10,13,,,4,0,0,,,,60,136,155,,,,52.79,28.07,53.32,1,64.27,2299,,,0.8,0,,95,,,,,,5,83,10.45,10.57,10.52,-9.9,-11.9,219,219,,1,225,225,,,,,,,,,"8,7,63,23,0,0,0,0,0","0,92,8,0,0","0,17,83,0,0",,,,,106,,,,,,,,,,,,,,,,,,,,,,,,,,,,,,,,,,,,9.1,9,14,234,73,,1018,0,320,1,4,3,Karlsruhe,1,0,,,,,,3113,"firmware 4.10",250,0,,0,168070,250480,30378,,2264361,,,,,,,,,,,,,,,,,,,,,,,,,,,,,,,,,,,,,,,,,
12946554,b73ea7ce-c689-418a-8658-f5910ca9d1d9,1582304051,60,1582303926,,0,0,10.22,3085,3280,113,120,,,4,0,0.16,,,,578,138,160,,,,60.16,39.78,60.93,1,64.51,1467,,,2.7,0.4,96,101,,,,,,61,81,11.91,13.85,13.85,10.9,-14.5,264,264,,1,329,329,,,,,,,,,"12,2,13,23,27,5,12,6,0","0,65,35,0,0","9,10,50,21,10",,,,,123,,,,,,,,,,,,,,,,,,,,,,,,,,,,,,,,,,,,28.2,8,14,247,61,,1030,0,341,0,5,3,Karlsruhe,1,0,I1.000|5:07-I1.000|4:53-I1.000|4:51-I1.000|4:43-I0.544|2:47-I0.991|3:37-I0.406|2:03-I0.793|2:53-I0.173|3:20-I0.604|2:08-I0.392|2:40-I0.408|1:21-I0.410|2:30-I0.183|0:37-I1.315|7:57,,,,,3113,"firmware 4.10",250,0,,0,168070,250480,30378,,2282104,,,,,,,,,,,,,,,,,,,,,,,,,,,,,,,,,,,,,,,,,
12964781,2e0f09f4-675f-42f7-aee0-3da7efd92e28,1582378035,60,1582381239,,0,0,15.01,3605,3980,128,125,,,4,0,0.2,1.14,0.93,,875,160,177,,,,65.01,53.41,65.71,1,64.35,2404,,,4,1.5,103,99,,,,,,123,82,15.07,15,15.15,5.2,2.4,353,353,,1,357,357,,,,,,,,,"0,0,0,0,1,42,58,0,0","0,4,36,60,0","0,1,19,55,24",,,,,152,,,,,,,,,,,,,,,,,,,,,,,,,,,,,,,,,,,,66.2,11,23,240,52,,1026,2,323,0,4,3,Karlsruhe,1,0,I1.000|4:05-I1.000|3:59-I1.000|4:04-I1.000|3:58-I1.000|3:58-I1.000|3:55-I1.000|3:58-I1.000|3:58-I1.000|3:58-I1.000|4:02-I1.000|4:06-I1.000|4:02-I1.000|4:02-I1.000|4:05-I1.000|3:54-I0.010|0:02,,,,,3113,"firmware 4.10",250,0,,0,168070,250480,30378,,2296719,,,,,,,,,,,,,,,,,,,,,,,,,,,,,,,,,,,,,,,,,
12964782,f5ebf77d-7e08-4382-ae16-d2e8d1b22693,1582382100,60,1582381241,,0,0,1.2,392,395,4,7,,,4,0,0,0.98,0.92,,78,134,141,,,,56.64,30.58,56.7,1,64.23,2397,,,1.1,0,98,98,,,,,,6,82,10.96,11.14,11.09,-1.3,-4.8,242,242,,1,247,247,,,,,,,,,"4,16,26,41,12,0,0,0,0","0,98,2,0,0","1,24,63,13,1",,,,,112,,,,,,,,,,,,,,,,,,,,,,,,,,,,,,,,,,,,10.8,12,22,239,51,,1026,1,319,0,4,3,Karlsruhe,1,0,I1.000|5:26-I0.202|1:06,,,,,3113,"firmware 4.10",250,0,,0,168070,250480,30378,,2296720,,,,,,,,,,,,,,,,,,,,,,,,,,,,,,,,,,,,,,,,,
12979074,9bc53680-7d87-4ec3-9477-42c79fb72ec0,1582447530,60,1582454913,,0,0,25.17,9709,10716,798,703,,,4,5.8,0.7,1.05,1.05,443,1596,140,164,,,,43.63,31.88,45.55,1,62.63,3477,,,3.7,0.1,95,95,,,,,,203,78,10.47,10.35,11.33,8.3,-4.6,235,235,,1,268,268,,,,,,,,,"38,10,18,17,11,5,1,0,0","1,42,56,0,0","15,28,34,13,11",,,,,100,,,,,,,,,,,,,,,,,,,,,,,,,,,,,,,,,,,,31.5,9,27,242,81,,1024,0,329,0,11,3,Ettlingen,1,0,I1.000|5:48-I1.000|5:40-I1.000|5:40-I1.000|6:20-I1.000|5:23-I1.000|5:57-I1.000|5:32-I1.000|5:33-I1.000|5:53-I1.000|6:36-I1.000|6:11-I1.000|6:37-I1.000|5:50-I1.000|9:36-I1.000|8:47-I1.000|13:57-I1.000|9:21-I1.000|4:45-I1.000|4:40-I1.000|4:26-I1.000|5:20-I1.000|7:37-I1.000|5:20-I1.000|4:59-I1.000|5:05-I0.168|0:57,,,,,3113,"firmware 4.10",250,0,,0,168070,250480,30378,,2308403,,,,,,,,,,,,,,,,,,,,,,,,,,,,,,,,,,,,,,,,"2,4,4,4,5,5",
13027379,ef35e322-2641-4f2b-981c-d89f1f009f6f,1582565174,60,1582658322,,0,0,14,4711,4887,123,126,,,4,0,0.16,1.11,0.89,,666,126,151,,,,58.82,35.89,59.45,1,62.73,1483,,,2.3,0.2,,102,,,,,,65,80,10.77,11.04,11.17,-0.5,-22.9,236,236,,1,254,254,,,,,,,,,"14,26,29,15,11,2,2,2,0","0,95,4,0,0","3,32,48,12,5",,,,,111,,,,,,,,,,,,,,,,,,,,,,,,,,,,,,,,,,,,15.9,12,19,239,84,,1014,0,356,1,4,3,Karlsruhe,1,0,I1.000|5:21-I1.000|5:11-I1.000|5:48-I1.000|5:46-I1.000|5:48-I1.000|5:52-I1.000|5:59-I1.000|6:10-I1.000|5:53-I1.000|4:45-I0.689|3:48-I0.204|0:39-I0.416|2:30-I0.198|0:39-I0.424|2:35-I0.198|0:38-I0.414|2:29-I0.201|0:38-I0.430|2:44-I0.201|0:39-I0.022|0:08-I0.602|4:32,,,,,3113,"firmware 4.10",250,0,,0,168070,250480,30378,,2346060,,,,,,,,,,,,,,,,,,,,,,,,,,,,,,,,,,,,,,,,,
13027398,21a47022-3189-470e-b245-ca87c086b7f9,1582654163,60,1582658359,,0,0,14.91,3558,3695,78,77,,,4,0,0.12,1.07,0.91,,754,157,179,,,,67.39,53.78,67.83,1,63.68,2448,,,4.1,1.5,104,100,,,,,,118,86,15.17,15.59,15.68,5.5,3.1,360,360,,1,379,379,,,,,,,,,"2,1,3,3,15,29,20,27,0","0,12,41,46,0","1,4,23,36,36",,,,,146,,,,,,,,,,,,,,,,,,,,,,,,,,,,,,,,,,,,90.7,7,19,245,89,,1003,0,361,1,6,3,Karlsruhe,1,0,I1.000|4:10-I1.000|4:13-I1.000|4:18-I0.165|0:42-I1.000|3:28-I1.000|3:26-I1.000|3:27-I1.000|3:28-I1.000|4:48-I0.329|1:28-I1.000|3:21-I1.000|3:30-I1.000|3:32-I1.000|3:29-I1.000|4:50-I1.000|4:46-I0.416|2:24,,,,,3113,"firmware 4.10",250,0,,0,168070,250480,30378,,2346078,,,,,,,,,,,,,,,,,,,,,,,,,,,,,,,,,,,,,,,,,
13043346,0626f650-cfd2-4e9d-af84-52bb9273d9ac,1582736990,60,1582738965,,0,0,11.73,3594,4571,114,120,,,4,0,0.14,1.05,0.93,,850,161,177,,,,47.69,39.5,48.23,1,62.71,4326,,,4.1,0.5,91,96,,,,,,127,81,11.8,12.07,12.16,-0.2,-11.7,263,263,,1,276,276,,,,,,,,,"6,3,15,29,34,6,7,0,0","0,5,30,65,0","4,17,47,27,5",,,,,121,,,,,,,,,,,,,,,,,,,,,,,,,,,,,,,,,,,,69.6,5,11,230,80,,1005,,,0,8,1,Karlsruhe,1,0,I1.000|5:26-I1.000|5:23-I1.000|5:29-I1.000|4:54-I1.000|5:04-I1.000|4:49-I1.000|4:53-I1.000|4:51-I0.758|3:39-I0.407|1:35-I0.211|2:08-I0.300|1:10-I0.307|1:42-I0.198|0:46-I0.202|1:06-I0.101|0:22-I0.104|0:35-I0.198|0:45-I0.207|1:11-I0.303|1:08-I0.304|1:43-I0.131|1:16,,,,,3113,"firmware 4.10",250,0,,0,168070,250480,30378,,2358590,,,,,,,,,,,,,,,,,,,,,,,,,,,,,,,,,,,,,,,,,
13067912,12254c6c-a268-4a58-88bf-0031871accfe,1582826933,60,1582828813,,0,0,18,4265,4891,84,88,,,4,0,0.06,,0.89,,937,153,166,,,,70.58,55.02,70.96,1,64.21,4320,,,3.9,0.1,103,106,,,,,,123,85,15.23,15.36,15.42,2.2,-1.1,361,361,,1,369,369,,,,,,,,,"2,0,0,1,5,25,63,4,0","0,7,77,15,0","1,4,20,43,33",,,,,149,,,,,,,,,,,,,,,,,,,,,,,,,,,,,,,,,,,,53.3,3,34,287,94,,993,0,394,1,6,3,Karlsruhe,1,0,I1.000|4:24-I1.000|4:19-I1.000|4:01-I1.000|4:02-I1.000|3:50-I1.000|3:43-I1.000|3:44-I1.000|3:47-I1.000|3:51-I1.000|3:50-I1.000|3:48-I1.000|3:41-I1.000|3:50-I1.000|4:00-I1.000|3:51-I1.000|3:47-I0.724|2:53-I0.299|1:03-I0.119|0:37-I0.304|1:04-I0.117|0:41-I0.304|1:07-I0.130|1:11,,,,,3113,"firmware 4.10",250,0,,0,168070,250480,30378,,2380377,,,,,,,,,,,,,,,,,,,,,,,,,,,,,,,,,,,,,,,,,
13086452,f16214d7-0afd-453c-a4d6-bb5326de3048,1582909000,60,1582909124,,0,0,14.02,3349,3473,74,80,,,4,0,0.2,1.02,1.02,,780,156,170,,,,67.94,53.47,68.35,1,64.59,4320,,,3.7,0.4,103,100,,,,,,105,83,15.13,15.1,15.17,2.5,2.9,354,354,,1,357,357,,,,,,,,,"0,0,0,0,2,37,60,0,0","0,3,64,33,0","0,0,8,81,11",,,,,151,,,,,,,,,,,,,,,,,,,,,,,,,,,,,,,,,,,,53.9,5,9,186,71,,1018,0,342,0,5,3,Möglingen,1,0,I1.000|4:12-I1.000|3:58-I1.000|3:47-I1.000|3:50-I1.000|3:52-I1.000|4:02-I1.000|3:56-I1.000|3:58-I1.000|4:01-I1.000|3:57-I1.000|4:17-I1.000|4:01-I1.000|4:02-I1.000|3:52-I0.015|0:04,,,,,3113,"firmware 4.10",250,0,,0,168070,250480,30378,,2395462,,,,,,,,,,,,,,,,,,,,,,,,,,,,,,,,,,,,,,,,,
13107099,6680f7f9-5238-43c7-8c87-594d69ea067a,1582995260,60,1582995497,,0,0,14.01,3503,3529,78,81,,,4,0,0.17,0.99,1.02,,794,153,167,112,,,66.03,50.71,66.46,1,64.63,3456,,,3.6,0,100,100,,,,,,100,82,14.48,14.47,14.51,-0.6,-1.4,336,336,,1,339,339,,,,,,,,,"0,0,0,0,13,58,28,0,0","0,2,89,9,0","0,1,17,75,7",,,,,146,,,,,,,,,,,,,,,,,,,,,,,,,,,,,,,,,,,,42.2,13,25,193,62,,998,0,405,0,11,3,Möglingen,1,0,I1.000|4:29-I1.000|4:11-I1.000|3:59-I1.000|4:08-I1.000|4:09-I1.000|4:25-I1.000|4:09-I1.000|4:11-I1.000|4:14-I1.000|4:00-I1.000|4:15-I1.000|4:03-I1.000|4:05-I1.000|4:03-I0.012|0:02,,,,,3113,"firmware 4.10",250,0,,0,168070,250480,30378,,2412189,,,,,,,,,,,,,,,,,,,,,,,,,,,,,,,,,,,,,,,,,
13128762,24099c56-3187-4db6-947f-92ac7ca522b8,1583078217,60,1583079022,,0,0,10.04,2380,2492,85,90,,,4,0,0.16,1.11,0.91,,565,155,166,,,,69.23,52.71,69.91,1,65.43,2448,,,3.4,0.3,103,103,,,,,,72,82,15.24,15.2,15.33,2.1,1.9,361,361,,1,366,366,,,,,,,,,"0,0,0,0,0,34,65,0,0","0,4,85,11,0","0,1,18,52,28",,,,,154,,,,,,,,,,,,,,,,,,,,,,,,,,,,,,,,,,,,42.7,13,13,219,58,,998,1,379,0,4,3,Karlsruhe,1,0,I1.000|3:55-I1.000|3:55-I1.000|3:49-I1.000|3:57-I1.000|3:56-I1.000|4:00-I1.000|4:02-I1.000|3:56-I1.000|3:56-I1.000|4:05-I0.039|0:08,,,,,3113,"firmware 4.10",250,0,,0,168070,250480,30378,,2430655,,,,,,,,,,,,,,,,,,,,,,,,,,,,,,,,,,,,,,,,,
13128780,4cc8003b-b6af-4947-b7fb-331dc9573b85,1583080799,60,1583079056,,0,0,6.01,1601,1620,55,57,,,4,0.3,0.27,1.17,0.9,,348,144,155,,,,66.39,44.56,67.12,1,64.84,3809,,,2.7,0,93,100,,,,,,37,82,13.54,13.69,13.84,3.2,-0.1,315,315,,1,327,327,,,,,,,,,"0,2,4,9,23,46,15,0,0","0,24,76,0,0","1,12,35,33,19",,,,,137,,,,,,,,,,,,,,,,,,,,,,,,,,,,,,,,,,,,30.2,12,12,209,58,,997,0,378,0,4,3,Eggenstein-Leopoldshafen,1,0,I1.000|4:47-I1.000|4:13-I1.000|4:12-I1.000|4:05-I1.000|4:16-I1.000|5:06-I0.005|0:02,,,,,3113,"firmware 4.10",250,0,,0,168070,250480,30378,,2430672,,,,,,,,,,,,,,,,,,,,,,,,,,,,,,,,,,,,,,,,,
13144490,31731789-870e-4739-a4aa-76fd58eb0628,1583170299,60,1583169966,,0,0,9.04,2777,3088,81,85,,,4,0,0.11,1.12,0.88,,600,144,163,,,,55.68,38.64,56.26,1,64.71,2588,,,3,0.7,96,92,,,,,,64,81,11.76,11.85,11.95,4.8,-7.6,260,260,,1,271,271,,,,,,,,,"0,2,16,66,11,2,2,2,0","0,35,63,2,0","1,19,56,20,5",,,,,121,,,,,,,,,,,,,,,,,,,,,,,,,,,,,,,,,,,,37,10,8,197,74,,989,0,406,0,6,3,Karlsruhe,1,0,I1.000|5:13-I1.000|5:12-I1.000|5:14-I1.000|5:18-I1.000|5:17-I1.000|5:11-I1.000|5:23-I0.519|2:47-I0.200|0:39-I0.428|2:13-I0.216|0:42-I0.445|2:17-I0.205|0:41-I0.022|0:09,,,,,3113,"firmware 4.10",250,0,,0,168070,250480,30378,,2443530,,,,,,,,,,,,,,,,,,,,,,,,,,,,,,,,,,,,,,,,,
13169461,b581c7b1-44ce-4f8d-9113-a2d711fb2ef5,1583258833,60,1583260001,,0,0,13.77,3599,3687,90,92,,,4,0,0.13,1.13,0.9,,726,143,160,,,,68.62,48.11,69.16,1,65.57,1396,,,3,0.1,101,103,,,,,,80,82,13.82,13.89,13.96,0.9,-0.8,321,321,,1,327,327,,,,,,,,,"0,0,0,5,26,55,13,0,0","1,34,66,0,0","0,5,35,45,14",,,,,140,,,,,,,,,,,,,,,,,,,,,,,,,,,,,,,,,,,,29,4,8,214,79,,1008,0,431,1,5,3,Karlsruhe,1,0,I1.000|4:43-I1.000|4:30-I1.000|4:20-I1.000|4:22-I1.000|4:16-I1.000|4:18-I1.000|4:05-I1.000|3:55-I1.000|4:00-I1.000|4:04-I1.000|4:29-I1.000|4:23-I1.000|4:42-I0.773|3:52,,,,,3113,"firmware 4.10",250,0,,0,168070,250480,30378,,2461731,,,,,,,,,,,,,,,,,,,,,,,,,,,,,,,,,,,,,,,,,
13183681,31f5f0a7-b6c9-4b1d-991e-afa7b94de7e0,1583338702,60,1583339226,,0,0,14.52,3601,3810,84,82,,,4,0,0.17,1.11,0.91,,790,147,158,,,,70.54,51.33,71.06,1,65.21,1551,,,3.2,0,103,98,,,,,,88,81,14.57,14.53,14.65,2,-0.4,342,342,,1,346,346,,,,,,,,,"0,0,0,0,6,70,24,0,0","0,8,92,0,0","0,4,29,43,24",,,,,149,,,,,,,,,,,,,,,,,,,,,,,,,,,,,,,,,,,,33.7,8,11,241,60,,1013,0,382,0,5,3,Eggenstein-Leopoldshafen,1,0,I1.000|4:13-I1.000|4:10-I1.000|4:09-I1.000|4:14-I1.000|4:10-I1.000|4:06-I1.000|4:10-I1.000|4:08-I1.000|4:11-I1.000|3:58-I1.000|4:11-I1.000|4:06-I1.000|4:08-I1.000|4:04-I0.522|2:03,,,,,3113,"firmware 4.10",250,0,,0,168070,250480,30378,,2472079,,,,,,,,,,,,,,,,,,,,,,,,,,,,,,,,,,,,,,,,,
13205633,dc9495e9-d1ad-4034-9223-c5f9febcfc56,1583431690,60,1583432922,,0,0,14.47,3492,3710,98,102,,,4,0,0.06,1.07,0.9,,810,154,170,,,,68.35,52.96,68.9,1,65.6,1872,,,3.7,0.5,100,101,,,,,,106,83,14.98,15.14,15.22,4,1.8,354,354,,1,364,364,,,,,,,,,"1,1,2,1,11,24,59,1,0","0,14,49,37,0","0,5,20,44,31",,,,,150,,,,,,,,,,,,,,,,,,,,,,,,,,,,,,,,,,,,58.3,9,17,204,88,,990,0,318,1,6,3,Karlsruhe,1,0,I1.000|4:36-I1.000|4:23-I1.000|4:26-I0.064|0:17-I1.000|3:46-I1.000|3:47-I1.000|3:48-I1.000|3:44-I1.000|3:43-I1.000|3:45-I1.000|3:47-I1.000|4:00-I1.000|3:46-I1.000|3:53-I1.000|4:01-I0.402|2:30,,,,,3113,"firmware 4.10",250,0,,0,168070,250480,30378,,2487167,,,,,,,,,,,,,,,,,,,,,,,,,,,,,,,,,,,,,,,,,
13215482,3b41fbd2-cfb3-4be5-b98a-72f74bebb198,1583491901,60,1583491209,,0,0,10.04,2513,2594,84,84,,,4,0,0.12,1.12,0.89,,626,160,173,,,,61.77,49.47,62.41,1,64.55,2788,,,3.7,0,96,95,,,,,,86,82,14.45,14.43,14.55,6.9,4.4,340,340,,1,345,345,,,,,,,,,"0,0,0,0,9,68,23,0,0","0,3,34,63,0","0,5,27,44,24",,,,,146,,,,,,,,,,,,,,,,,,,,,,,,,,,,,,,,,,,,60.2,5,29,243,92,,996,2,365,0,6,3,Karlsruhe,1,0,I1.000|4:22-I1.000|4:14-I1.000|4:00-I1.000|4:04-I1.000|4:07-I1.000|4:07-I1.000|4:07-I1.000|4:16-I1.000|4:13-I1.000|4:10-I0.041|0:12,,,,,3113,"firmware 4.10",250,0,,0,168070,250480,30378,,2495141,,,,,,,,,,,,,,,,,,,,,,,,,,,,,,,,,,,,,,,,,
13249716,26cc5700-c35b-44b5-aa14-8bac920fc714,1583658614,60,1583657075,,0,0,7.35,1839,1847,84,82,,,4,0,0.06,1.09,0.87,,443,156,171,,,,64.15,48.54,65.08,1,64.03,1589,,,3.2,0.2,97,99,,,,,,57,82,14.47,14.46,14.6,2.1,1.8,341,341,,1,348,348,,,,,,,,,"0,0,0,1,11,68,19,1,1","0,2,69,28,0","0,5,29,41,25",,,,,146,,,,,,,,,,,,,,,,,,,,,,,,,,,,,,,,,,,,47.7,2,8,212,76,,1024,1,393,0,3,3,Pasing,1,0,I1.000|3:50-I1.000|4:13-I1.000|4:18-I1.000|4:04-I1.000|4:21-I1.000|4:14-I1.000|4:08-I0.353|1:30,,,,,3113,"firmware 4.10",250,0,,0,168070,250480,30378,,2520984,,,,,,,,,,,,,,,,,,,,,,,,,,,,,,,,,,,,,,,,,
13275473,dc1a8136-05c7-427d-977c-cf9130040ce9,1583773411,60,1583775799,,0,0,15.14,4406,5773,103,110,,,4,0,0.12,1.09,0.92,,792,139,162,,,,62.36,42.78,62.85,1,63.97,1204,,,3,0.1,102,100,,,,,,89,82,12.42,12.64,12.74,1.8,4.7,279,279,,1,291,291,,,,,,,,,"1,3,12,32,29,13,10,0,0","1,54,45,0,0","0,13,53,27,7",,,,,126,,,,,,,,,,,,,,,,,,,,,,,,,,,,,,,,,,,,30.5,8,14,245,77,,1018,0,418,0,5,3,Karlsruhe,1,0,I1.000|4:10-I1.000|4:08-I1.000|3:57-I1.000|4:05-I1.000|5:20-I1.000|5:38-I1.000|5:26-I1.000|5:12-I1.000|4:57-I1.000|4:53-I1.000|4:51-I1.000|5:08-I1.000|5:02-I1.000|4:57-I1.000|4:58-I0.137|0:45,,,,,3113,"firmware 4.10",250,0,,0,168070,250480,30378,,2540726,,,,,,,,,,,,,,,,,,,,,,,,,,,,,,,,,,,,,,,,,
13290870,4926dd2f-0afe-48c5-905a-3f3635023cb5,1583863784,60,1583864924,,0,0,17.25,4068,4457,107,112,,,4,0,0.07,1.1,0.88,,956,162,181,,,,65.27,55.14,65.75,1,63.95,3752,,,4.8,2.4,103,100,,,,,,154,85,15.31,15.71,15.77,7.9,3.9,364,364,,1,380,380,,,,,,,,,"3,3,3,2,7,17,47,18,0","0,13,23,63,0","0,6,20,36,38",,,,,150,,,,,,,,,,,,,,,,,,,,,,,,,,,,,,,,,,,,96.8,9,30,229,84,,1013,0,337,1,4,3,Karlsruhe,1,0,I1.000|4:26-I1.000|4:15-I1.000|4:11-I0.170|0:49-I1.000|3:33-I1.000|3:27-I1.000|3:33-I0.455|1:59-I1.000|3:31-I1.000|3:32-I1.000|3:34-I0.418|2:03-I1.000|3:32-I1.000|3:38-I1.000|3:37-I0.370|2:02-I1.000|3:35-I1.000|3:42-I1.000|3:30-I0.833|5:17,,,,,3113,"firmware 4.10",250,0,,0,168070,250480,30378,,2552641,,,,,,,,,,,,,,,,,,,,,,,,,,,,,,,,,,,,,,,,,
13305328,3e01e325-78bd-4dd8-b1c2-ad21bcbbfcc8,1583942345,60,1583942735,,0,0,14.01,3670,3726,97,97,,,4,0,0.17,1.12,0.93,,717,147,166,,,,65.92,48.04,66.48,1,64.11,2592,,,3.3,0,102,101,,,,,,91,81,13.79,13.92,14.04,4.8,7,320,320,,1,330,330,,,,,,,,,"0,1,1,6,35,36,21,0,0","0,28,58,13,0","0,6,38,41,16",,,,,141,,,,,,,,,,,,,,,,,,,,,,,,,,,,,,,,,,,,49.8,15,25,240,68,,1017,1,306,0,5,3,Eggenstein-Leopoldshafen,1,0,I1.000|4:19-I1.000|3:55-I1.000|3:54-I1.000|3:55-I1.000|3:50-I1.000|4:26-I1.000|4:40-I1.000|4:32-I1.000|4:23-I1.000|4:30-I1.000|4:30-I1.000|4:24-I1.000|4:54-I1.000|4:56-I0.006|0:02,,,,,3113,"firmware 4.10",250,0,,0,168070,250480,30378,,2564603,,,,,,,,,,,,,,,,,,,,,,,,,,,,,,,,,,,,,,,,,
13319299,64e7563e-b088-41c5-958d-2fca577c9b13,1584036520,60,1584036584,,0,0,11.75,2967,3164,78,77,,,4,0,0.12,1.11,0.95,,630,148,165,,,,68.34,49.49,68.91,1,65.01,1454,,,3.2,0.4,102,104,,,,,,75,82,14.31,14.38,14.46,4.7,3.3,334,334,,1,340,340,,,,,,,,,"0,0,0,4,17,51,27,1,0","0,14,79,7,0","0,2,30,52,16",,,,,145,,,,,,,,,,,,,,,,,,,,,,,,,,,,,,,,,,,,44.4,11,16,305,82,,1015,0,327,1,6,3,Karlsruhe,1,0,I1.000|4:26-I1.000|4:12-I1.000|4:05-I1.000|4:07-I1.000|3:58-I1.000|3:58-I1.000|3:55-I1.000|3:50-I1.000|4:21-I1.000|4:24-I1.000|4:31-I0.751|3:40,,,,,3113,"firmware 4.10",250,0,,0,168070,250480,30378,,2576261,,,,,,,,,,,,,,,,,,,,,,,,,,,,,,,,,,,,,,,,,
13327764,36139ca3-65c6-4aba-88ab-35455436861a,1584103418,60,1584103810,,0,0,14.01,3334,3590,49,43,,,0,0,0.09,1.07,,,788,156,164,,,,68.26,53.7,68.59,1,64.9,1941,,,3.7,0.2,105,98,,,,,,102,82,15.17,15.15,15.22,1.2,-0.3,358,358,,1,360,360,,,,,,,,,"0,0,0,0,2,38,60,0,0","0,3,87,11,0","0,1,19,53,26",,,,,154,,,,,,,,,,,,,,,,,,,,,,,,,,,,,,,,,,,,46.4,9,22,257,60,,1023,3,382,0,5,3,Karlsruhe,1,0,I1.000|3:58-I1.000|4:03-I1.000|3:52-I1.000|3:57-I1.000|3:55-I1.000|3:54-I1.000|3:57-I1.000|3:58-I1.000|3:56-I1.000|3:53-I1.000|4:02-I1.000|4:02-I1.000|4:01-I1.000|4:03-I0.010|0:02,,,,,3113,,250,0,,0,168070,250480,30378,,2583141,,,,,,,,,,,,,,,,,,,,,,,,,,,,,,,,,,,,,,,,,
13327791,36987723-79d0-43a8-9d43-92e39c242004,1584107037,60,1584104015,,0,0,0.78,242,242,1,4,,,0,0,0,,0.9,,51,138,144,110,,,58.16,30.92,57.97,1,64.9,1932,,,0.8,0,,100,,,,,,4,81,11.45,11.72,11.68,-2.1,-11.2,253,253,,1,261,261,,,,,,,,,"4,5,22,27,43,0,0,0,0","0,75,25,0,0","0,17,62,19,1",,,,,119,,,,,,,,,,,,,,,,,,,,,,,,,,,,,,,,,,,,8.9,10,21,259,55,,1023,2,381,0,5,3,Karlsruhe,1,0,,,,,,3113,,250,0,,0,168070,250480,30378,,2583166,,,,,,,,,,,,,,,,,,,,,,,,,,,,,,,,,,,,,,,,,
13336714,e1294be3-32fc-4eae-b192-e9b7919580a5,1584180367,60,1584180192,,0,0,13.03,3137,3226,75,86,,,0,0,0.22,1.03,0.96,,784,162,178,,,,63.62,52.7,64.01,1,64.33,2931,,,4.1,1.2,103,98,,,,,,113,82,15,15.01,15.05,-1.7,-0.8,351,351,,1,354,354,,,,,,,,,"0,0,0,0,4,44,51,0,0","0,2,23,76,0","0,1,17,63,18",,,,,152,,,,,,,,,,,,,,,,,,,,,,,,,,,,,,,,,,,,66.4,5,9,172,80,,1022,1,415,0,3,3,Balve,1,0,I1.000|4:18-I1.000|4:16-I1.000|4:01-I1.000|4:18-I1.000|4:07-I1.000|4:08-I1.000|3:52-I1.000|3:54-I1.000|3:56-I1.000|3:48-I1.000|3:54-I1.000|3:46-I1.000|3:54-I0.025|0:04,,,,,3113,,250,0,,0,168070,250480,30378,,2590411,,,,,,,,,,,,,,,,,,,,,,,,,,,,,,,,,,,,,,,,,
13350737,f449679d-b2da-44ad-8f84-b77492dd4a9f,1584267929,60,1584269286,,0,0,16.01,4483,4806,334,348,,,0,3.7,0.72,1.04,1.06,447,876,145,162,,,,61.84,44.94,63.38,1,63.86,2441,,,3.3,0,102,97,,,,,,106,81,13.39,13.19,13.54,-7.1,-2,299,299,,1,305,305,,,,,,,,,"0,7,10,17,28,27,10,2,0","0,25,74,0,0","0,2,50,44,3",,,,,132,,,,,,,,,,,,,,,,,,,,,,,,,,,,,,,,,,,,35.9,9,22,187,67,,1017,1,381,0,4,3,Balve,1,0,I1.000|4:53-I1.000|5:29-I1.000|5:47-I1.000|5:06-I1.000|4:55-I1.000|5:08-I1.000|4:54-I1.000|4:24-I1.000|4:00-I1.000|4:01-I1.000|4:03-I1.000|4:53-I1.000|4:23-I1.000|4:41-I1.000|4:23-I1.000|3:41-I0.005|0:01,,,,,3113,,250,0,,0,168070,250480,30378,,2601167,,,,,,,,,,,,,,,,,,,,,,,,,,,,,,,,,,,,,,,,"4,5",
13379180,f5e6d7ae-9c4c-41b0-a1be-ae1653f6d428,1584382759,60,1584383347,,0,0,2.78,1059,1150,56,20,,,0,1.4,0.65,1.11,0.93,,153,117,141,,,,54.88,27.77,57.13,1,63.86,587,,,0.9,0,,100,,,,,,11,79,9.94,9.75,10.37,2,-12.1,214,214,,1,230,230,,,,,,,,,"63,14,6,3,10,4,0,0,0","0,100,0,0,0","3,41,45,9,2",,,,,100,,,,,,,,,,,,,,,,,,,,,,,,,,,,,,,,,,,,8.3,12,5,318,70,,1022,0,387,0,5,3,Balve,1,0,I1.000|6:40-I1.000|7:00-I0.779|3:59,,,,,3113,,250,0,,0,168070,250480,30378,,2619783,,,,,,,,,,,,,,,,,,,,,,,,,,,,,,,,,,,,,,,,,
13379184,854bef54-eb4d-403e-878e-0a9de6cd8322,1584384015,60,1584383375,,0,0,7.59,2190,2190,33,50,,,0,0,0.05,,0.32,,406,141,172,,,,61.86,41.12,62.02,1,66,1164,,,2.6,2,109,110,,,,,,49,78,12.36,14.9,15.04,6.5,-2.3,297,297,,1,372,372,,,,,,,,,"36,1,1,2,2,3,8,48,0","0,41,49,10,0","33,5,2,12,49",,,,,133,,,,,,,,,,,,,,,,,,,,,,,,,,,,,,,,,,,,32.7,11,5,318,70,,1022,0,387,1,5,3,Balve,1,0,I0.812|2:44-I0.152|1:59-I0.810|2:44-I0.143|2:03-I0.824|2:43-I0.155|2:00-I0.818|2:43-I0.151|2:01-I0.823|2:44-I0.139|2:02-I0.819|2:45-I0.142|2:03-I0.818|2:46-I0.125|2:03-I0.813|2:46-I0.046|0:23,,,,,3113,,250,0,,0,168070,250480,30378,,2619787,,,,,,,,,,,,,,,,,,,,,,,,,,,,,,,,,,,,,,,,,
13382738,737439c7-5a25-4ba0-8b66-eaf575e8164d,1584386288,60,1584412357,,0,0,1.61,521,521,14,20,,,4,0.8,0.5,1.09,0.96,,112,139,157,105,,,54.7,31.96,55.03,1,65.7,1152,,,1.6,0,96,95,,,,,,10,80,11.18,11.27,11.25,2.8,2.2,240,240,,1,243,243,,,,,,,,,"11,15,12,25,36,0,0,0,0","0,52,48,0,0","0,22,65,13,0",,,,,116,,,,,,,,,,,,,,,,,,,,,,,,,,,,,,,,,,,,17.3,11,4,2,73,,1023,0,390,1,5,3,Balve,1,0,I1.000|5:31-I0.612|3:11,,,,,3113,,250,0,,0,168070,250480,30378,,2622519,,,,,,,,,,,,,,,,,,,,,,,,,,,,,,,,,,,,,,,,,
13401752,916863a8-2e62-4ef3-adf5-50bc3a32cb6b,1584462091,60,1584463231,,0,0,16.01,4287,4547,320,366,,,0,3.4,0.74,0.99,1.02,518,883,147,161,,,,64.15,47.33,65.51,1,65.24,1851,,,3.4,0,96,98,,,,,,105,81,13.93,13.8,14.04,-10.4,-5.9,313,313,,1,320,320,,,,,,,,,"0,2,10,15,21,28,23,1,0","0,19,80,0,0","0,4,37,51,8",,,,,138,,,,,,,,,,,,,,,,,,,,,,,,,,,,,,,,,,,,35.8,12,11,248,50,,1029,1,352,0,3,3,Balve,1,0,I1.000|4:18-I1.000|5:13-I1.000|5:26-I1.000|4:53-I1.000|4:49-I1.000|5:08-I1.000|4:51-I1.000|4:31-I1.000|4:05-I1.000|3:49-I1.000|3:49-I1.000|4:32-I1.000|4:02-I1.000|4:28-I1.000|3:53-I1.000|3:39-I0.009|0:03,,,,,3113,,250,0,,0,168070,250480,30378,,2640003,,,,,,,,,,,,,,,,,,,,,,,,,,,,,,,,,,,,,,,,"4,5",
13475022,d78a66d9-0072-43c0-b823-4a315d67a455,1584624522,60,1584861814,,0,0,12.51,3604,3789,260,249,,,0,2.9,0.73,0.99,1.08,454,704,143,159,,,,60.83,42.65,62.46,1,64.04,2117,,,3.1,0,97,97,,,,,,79,80,13.06,12.86,13.11,-7.7,1.1,290,290,,1,293,293,,,,,,,,,"1,9,11,25,21,21,12,0,0","0,38,62,0,0","0,4,55,40,1",,,,,130,,,,,,,,,,,,,,,,,,,,,,,,,,,,,,,,,,,,30,14,7,335,57,,1026,4,316,0,3,3,Balve,1,0,I1.000|5:01-I1.000|5:38-I1.000|5:49-I1.000|5:10-I1.000|5:03-I1.000|5:27-I1.000|4:24-I1.000|3:57-I1.000|4:04-I1.000|4:28-I1.000|4:14-I1.000|4:23-I0.509|2:26,,,,,3113,,250,0,,0,168070,250480,30378,,2705385,,,,,,,,,,,,,,,,,,,,,,,,,,,,,,,,,,,,,,,,4,
13475023,8a21e2d5-a2e2-42a3-9f86-e17ad1ef5774,1584540132,60,1584861816,,0,0,13.98,3396,3458,127,125,,,0,0.5,0.33,1.04,1.03,,809,156,179,,,,66.54,52.43,67.3,1,65.34,2016,,,3.7,0.5,98,101,,,,,,105,82,15.02,14.94,15.09,-3.5,-3.2,349,349,,1,353,353,,,,,,,,,"0,0,0,1,5,57,34,4,0","0,4,74,22,0","0,1,11,76,12",,,,,151,,,,,,,,,,,,,,,,,,,,,,,,,,,,,,,,,,,,54.8,15,12,236,56,,1027,2,327,0,5,3,Balve,1,0,I1.000|4:28-I1.000|4:10-I1.000|4:08-I1.000|4:16-I1.000|4:09-I1.000|4:15-I1.000|4:12-I1.000|3:47-I1.000|3:50-I1.000|3:48-I1.000|3:52-I1.000|4:18-I1.000|3:53-I0.982|3:31,,,,,3113,,250,0,,0,168070,250480,30378,,2705386,,,,,,,,,,,,,,,,,,,,,,,,,,,,,,,,,,,,,,,,,
13475026,4ecd6089-789a-4a9a-9b4b-b875ba6bf564,1584808597,60,1584861826,,0,0,5.17,1362,1374,16,232,,,0,1.1,0.78,,1.01,,270,138,154,,,,71.2,44.74,67.8,1,63.42,4320,,,2.2,0,103,99,,,,,,26,82,12.74,13.88,12.83,-3.5,-7.9,260,260,,1,265,265,,,,,,,,,"1,1,2,9,24,47,16,0,0","0,74,26,0,0","0,16,60,22,2",,,,,139,,,,,,,,,,,,,,,,,,,,,,,,,,,,,,,,,,,,18.2,4,21,75,63,,1027,1,375,0,3,3,Balve,1,0,I1.000|4:35-I1.000|4:15-I1.000|4:15-I1.000|3:56-I1.000|4:51-I0.174|0:49,,,,,3113,,250,0,,0,168070,250480,30378,,2705389,,,,,,,,,,,,,,,,,,,,,,,,,,,,,,,,,,,,,,,,,
13475027,330c61a2-cbc0-4107-abf6-7a12a31c6bf8,1584807109,60,1584861828,,0,0,4.71,1238,1238,216,10,,,0,3.2,0.86,1.15,,683,291,156,178,,,,60.36,44.6,67.12,1,63.29,4032,,,3,0,102,101,,,,,,40,84,16.21,13.89,16.44,14,14.8,399,399,,1,404,404,,,,,,,,,"0,0,1,18,22,35,21,2,0","0,23,18,59,0","0,0,7,45,48",,,,,136,,,,,,,,,,,,,,,,,,,,,,,,,,,,,,,,,,,,69.7,4,21,75,63,,1027,1,375,0,3,3,Balve,1,0,I1.000|5:02-I1.000|4:35-I1.000|4:03-I1.000|4:09-I0.705|2:48-I0.009|0:01,,,,,3113,,250,0,,0,168070,250480,30378,,2705390,,,,,,,,,,,,,,,,,,,,,,,,,,,,,,,,,,,,,,,,4,
13475028,98359499-67aa-46de-b197-f40ef019b827,1584705147,60,1584861830,,0,0,20.06,5333,5395,487,475,,,0,4.3,0.8,1.08,0.99,573,1244,158,192,,,,58.42,48.59,60.22,1,63.06,4045,,,4.4,3,100,98,,,,,,178,83,14.35,14.18,14.47,-0.2,1.6,321,321,,1,326,326,,,,,,,,,"1,2,14,14,27,12,20,10,0","0,5,58,30,7","0,1,31,60,7",,,,,136,,,,,,,,,,,,,,,,,,,,,,,,,,,,,,,,,,,,114,8,13,28,90,,1025,3,319,0,4,3,Balve,1,0,I1.000|4:58-I1.000|5:12-I1.000|5:26-I1.000|4:41-I1.000|4:47-I1.000|4:49-I1.000|4:39-I1.000|4:19-I1.000|3:49-I1.000|3:46-I1.000|4:15-I1.000|5:22-I1.000|5:18-I1.000|5:23-I1.000|4:14-I1.000|3:54-I1.000|3:32-I1.000|3:41-I1.000|3:24-I1.000|3:11-I0.062|0:15,,,,,3113,,250,0,,0,168070,250480,30378,,2705391,,,,,,,,,,,,,,,,,,,,,,,,,,,,,,,,,,,,,,,,"4,4",
13475029,7517abbd-cf89-4961-a25b-0526bc95db34,1584806526,60,1584861831,,0,0,1.6,489,489,36,8,,,0,1.2,0.62,1.05,0.95,,88,128,141,,,,65.03,34.08,68.27,1,63.06,2438,,,1,0,,100,,,,,,7,80,12.61,11.73,12.73,3.4,0.5,291,291,,1,298,298,,,,,,,,,"0,5,5,58,27,4,0,0,0","1,99,0,0,0","1,8,46,42,3",,,,,123,,,,,,,,,,,,,,,,,,,,,,,,,,,,,,,,,,,,9.6,7,22,75,53,,1027,1,375,0,3,3,Balve,1,0,I1.000|5:10-I0.600|2:59,,,,,3113,,250,0,,0,168070,250480,30378,,2705392,,,,,,,,,,,,,,,,,,,,,,,,,,,,,,,,,,,,,,,,,
13478762,addff4ca-ca70-4348-8153-4a02174e2889,1584874343,60,1584877065,,0,0,21.22,5818,6184,466,480,,,0,4.1,0.71,1.03,1.01,498,1212,150,174,,,,60.59,47.1,62.18,1,63.31,4099,,,3.7,0.4,102,97,,,,,,157,82,13.74,13.65,13.92,-0.2,0.9,307,307,,1,316,316,,,,,,,,,"1,3,13,17,24,19,17,5,0","0,15,66,18,0","0,5,39,49,7",,,,,133,,,,,,,,,,,,,,,,,,,,,,,,,,,,,,,,,,,,59.9,4,19,96,48,,1033,2,393,0,3,3,Balve,1,0,I1.000|4:47-I1.000|5:39-I1.000|5:25-I1.000|5:02-I1.000|4:59-I1.000|5:13-I1.000|4:51-I1.000|4:28-I1.000|4:58-I1.000|4:38-I1.000|4:41-I1.000|4:24-I1.000|4:55-I1.000|4:05-I1.000|4:05-I1.000|4:39-I1.000|4:06-I1.000|3:14-I1.000|3:35-I1.000|3:49-I1.000|4:13-I0.221|1:09,,,,,3113,,250,0,,0,168070,250480,30378,,2708775,,,,,,,,,,,,,,,,,,,,,,,,,,,,,,,,,,,,,,,,"4,5,5,5",
13494247,e95da398-5027-4501-a847-fefc10971657,1584970149,60,1584968673,,0,0,6.38,1855,2081,170,161,,,0,2.8,0.82,1.06,0.91,717,344,145,175,,,,59.03,40.33,61.09,1,63.22,4346,,,2.9,0,103,99,,,,,,47,83,12.9,12.51,14.03,11.2,27,293,293,,1,332,332,,,,,,,,,"0,0,4,36,44,14,3,0,0","0,53,8,39,0","1,25,27,28,19",,,,,124,,,,,,,,,,,,,,,,,,,,,,,,,,,,,,,,,,,,59.5,7,16,130,33,,1035,3,391,0,3,3,Balve,1,0,I1.000|4:54-I1.000|4:40-I1.000|4:19-I1.000|4:56-I1.000|5:03-I1.000|5:03-I0.384|1:59,,,,,3113,,250,0,,0,168070,250480,30378,,2721242,,,,,,,,,,,,,,,,,,,,,,,,,,,,,,,,,,,,,,,,4,
13494248,2ea57880-cdca-4150-ac5f-2f03db751e56,1584969606,60,1584968675,,0,0,1.65,496,506,29,10,,,0,0.3,0.39,1.1,0.89,,106,141,155,,,,58.8,34.84,60.92,1,63.27,2608,,,1.8,0,100,99,,,,,,10,81,12.54,12,12.71,2.8,0.4,290,290,,1,296,296,,,,,,,,,"0,0,4,52,43,1,0,0,0","0,36,64,0,0","0,8,46,45,1",,,,,123,,,,,,,,,,,,,,,,,,,,,,,,,,,,,,,,,,,,17.3,7,15,130,33,,1035,3,391,0,3,3,Balve,1,0,I1.000|5:03-I0.652|3:13,,,,,3113,,250,0,,0,168070,250480,30378,,2721243,,,,,,,,,,,,,,,,,,,,,,,,,,,,,,,,,,,,,,,,,
13510951,c7f65272-b9a2-4b03-a15f-094e15ccfec7,1585069514,60,1585070689,,0,0,15.02,3673,3826,60,47,,,0,0,0.15,1.09,0.92,,729,154,178,,,,67.24,52.31,67.64,1,63.7,4032,,,3.8,1.6,104,100,,,,,,113,83,14.8,15,15.11,3,2.3,347,347,,1,359,359,,,,,,,,,"0,0,1,4,22,25,42,6,0","0,22,36,42,0","0,2,28,47,23",,,,,148,,,,,,,,,,,,,,,,,,,,,,,,,,,,,,,,,,,,75,6,9,122,43,,1031,0,348,0,3,3,Sundern,1,0,I1.000|4:23-I1.000|4:04-I1.000|4:02-I1.000|3:43-I1.000|3:40-I1.000|3:42-I0.422|2:01-I1.000|3:36-I1.000|3:35-I1.000|3:38-I0.443|2:02-I1.000|3:42-I1.000|4:47-I1.000|4:42-I1.000|4:27-I1.000|4:30-I0.153|0:41,,,,,3113,,250,0,,0,168070,250480,30378,,2734846,,,,,,,,,,,,,,,,,,,,,,,,,,,,,,,,,,,,,,,,,
13523611,73433734-9de0-45b6-a8b0-295d5869866b,1585147473,60,1585146905,,0,0,11.19,2980,2993,243,230,,,0,2.9,0.8,0.99,1.11,436,653,149,168,,,,63.39,46.36,65.19,1,63.71,2736,,,3.3,0.2,100,100,,,,,,78,81,14.21,14.19,14.3,-9.5,-0.4,313,313,,1,325,325,,,,,,,,,"0,7,11,17,22,9,23,11,0","0,10,82,7,0","0,14,40,35,12",,,,,139,,,,,,,,,,,,,,,,,,,,,,,,,,,,,,,,,,,,40.9,10,14,78,28,,1026,2,345,0,3,3,Balve,1,0,I1.000|5:10-I1.000|5:29-I1.000|5:38-I1.000|4:39-I1.000|4:38-I1.000|4:53-I1.000|4:05-I1.000|3:35-I1.000|3:41-I1.000|3:27-I1.000|3:33-I0.186|0:53,,,,,3113,,250,0,,0,168070,250480,30378,,2745425,,,,,,,,,,,,,,,,,,,,,,,,,,,,,,,,,,,,,,,,4,
13539951,c9bacec5-5a9d-4474-b66b-ca5db19f1103,1585226742,60,1585232498,,0,0,11.21,2761,2769,254,243,,,0,3.1,0.78,0.99,1.03,530,638,154,172,,,,66.64,50.78,68.6,1,64.02,2304,,,3.4,0,104,97,,,,,,82,83,15.34,15.2,15.46,-4.1,2.1,354,354,,1,361,361,,,,,,,,,"0,0,5,14,20,21,16,24,0","1,4,76,20,0","0,1,20,57,23",,,,,147,,,,,,,,,,,,,,,,,,,,,,,,,,,,,,,,,,,,49.7,8,18,83,43,,1024,3,381,0,3,3,Balve,1,0,I1.000|4:17-I1.000|4:46-I1.000|5:10-I1.000|4:26-I1.000|4:23-I1.000|4:41-I1.000|3:53-I1.000|3:30-I1.000|3:31-I1.000|3:11-I1.000|3:20-I0.214|0:54,,,,,3113,,250,0,,0,168070,250480,30378,,2758203,,,,,,,,,,,,,,,,,,,,,,,,,,,,,,,,,,,,,,,,4,
13560882,344990a1-6ac5-4acf-9e25-9718553d1496,1585324931,60,1585325826,,0,0,15.34,3997,4330,334,334,,,0,3.5,0.82,1.09,1.08,539,776,150,180,101,,,64.52,48.68,66.27,1,63.91,1941,,,3.6,1.3,101,99,,,,,,110,82,14.29,14.34,14.86,-1.1,-8.5,328,328,,1,349,349,,,,,,,,,"0,1,6,14,22,33,16,5,3","0,27,46,27,0","0,9,28,41,21",,,,,140,,,,,,,,,,,,,,,,,,,,,,,,,,,,,,,,,,,,63.1,14,14,76,51,,1018,1,376,0,3,3,Balve,1,0,I1.000|4:40-I1.000|4:53-I1.000|5:10-I1.000|4:24-I1.000|4:28-I1.000|4:33-I1.000|3:50-I1.000|3:34-I1.000|3:57-I1.000|4:03-I1.000|4:15-I1.000|4:58-I1.000|4:16-I0.462|1:54-I1.000|2:59-I0.881|4:40,,,,,3113,,250,0,,0,168070,250480,30378,,2775252,,,,,,,,,,,,,,,,,,,,,,,,,,,,,,,,,,,,,,,,"4,4",
13579974,1d4fcfef-4725-4c2c-a0b7-25d525e87a3b,1585404356,60,1585403478,,0,0,7.95,2556,2670,148,139,,,0,2.4,0.58,1.06,0.99,439,473,137,157,,,,56.17,36.3,57.55,1,62.74,1809,,,2.6,0,95,99,,,,,,48,80,11.64,11.35,11.97,1.6,10.8,252,252,,1,263,263,,,,,,,,,"8,7,18,45,19,2,0,0,0","1,70,30,0,0","0,19,62,17,1",,,,,117,,,,,,,,,,,,,,,,,,,,,,,,,,,,,,,,,,,,25,12,17,17,48,,1021,3,349,0,3,3,Balve,1,0,I1.000|5:42-I1.000|5:20-I1.000|5:31-I1.000|6:17-I1.000|5:06-I1.000|4:55-I1.000|4:51-I0.945|4:53,,,,,3113,,250,0,,0,168070,250480,30378,,2791963,,,,,,,,,,,,,,,,,,,,,,,,,,,,,,,,,,,,,,,,"4,5",
13592753,962022b1-6310-46bd-897c-6e5653763189,1585477399,120,1585474727,,0,0,16.01,4474,4474,352,347,,,0,3.7,0.81,1.04,0.98,432,959,151,174,,,,58.63,45.04,60.25,1,62.5,2016,,,3.7,0,104,99,,,,,,124,83,13.45,13.12,13.6,3.5,9.5,302,302,,1,310,310,,,,,,,,,"0,3,10,17,26,37,6,0,0","0,8,81,11,0","0,5,41,50,5",,,,,129,,,,,,,,,,,,,,,,,,,,,,,,,,,,,,,,,,,,50.8,2,20,3,81,,1025,1,413,0,4,3,Balve,1,0,I1.000|4:49-I1.000|5:11-I1.000|5:46-I1.000|4:45-I1.000|4:49-I1.000|5:09-I1.000|4:38-I1.000|4:26-I1.000|4:05-I1.000|3:59-I1.000|4:04-I1.000|4:45-I1.000|4:14-I1.000|4:56-I1.000|4:33-I1.000|4:23-I0.009|0:02,,,,,3113,,250,0,,0,168070,250480,30378,,2802419,,,,,,,,,,,,,,,,,,,,,,,,,,,,,,,,,,,,,,,,"4,5",
13619839,a7dd8f5b-ebca-4d1f-a93f-06597842c6fa,1585589717,120,1585586586,,0,0,14.02,3255,3272,101,102,,,0,0,0.22,1.06,0.99,,777,161,171,,,,67.17,55.26,67.76,1,63.4,2304,,,4,0.1,106,102,,,,,,114,84,15.59,15.54,15.65,1,3.6,369,369,,1,372,372,,,,,,,,,"0,0,0,0,1,23,73,3,0","0,1,33,66,0","0,0,7,68,24",,,,,154,,,,,,,,,,,,,,,,,,,,,,,,,,,,,,,,,,,,61.9,5,13,300,70,,1026,1,392,0,4,3,Balve,1,0,I1.000|4:11-I1.000|4:03-I1.000|3:49-I1.000|3:58-I1.000|3:48-I1.000|3:59-I1.000|4:05-I1.000|3:37-I1.000|3:45-I1.000|3:58-I1.000|3:48-I1.000|3:51-I1.000|3:38-I1.000|3:43-I0.015|0:03,,,,,3113,,250,0,,0,168070,250480,30378,,2824682,,,,,,,,,,,,,,,,,,,,,,,,,,,,,,,,,,,,,,,,,
13654121,31109d04-6bc4-41e0-9d02-f3e29121429d,1585663494,120,1585735777,,0,0,13.14,3713,3956,279,221,,,0,3,0.65,0.98,0.91,499,785,148,164,,,,59.47,43.78,61.36,1,63.15,1878,,,3.3,0,102,99,,,,,,94,82,13.37,13.01,13.51,1.7,5.7,301,301,,1,309,309,,,,,,,,,"2,8,6,15,24,38,6,0,0","0,10,89,1,0","0,6,42,46,6",,,,,129,,,,,,,,,,,,,,,,,,,,,,,,,,,,,,,,,,,,33.6,7,10,49,43,,1030,4,357,0,3,3,Balve,1,0,I1.000|4:53-I1.000|5:35-I1.000|5:49-I1.000|4:55-I1.000|4:59-I1.000|5:02-I1.000|4:38-I1.000|4:13-I1.000|4:16-I1.000|4:26-I1.000|4:10-I1.000|4:06-I1.000|4:12-I0.143|0:38,,,,,3113,,250,0,,0,168070,250480,30378,,2852948,,,,,,,,,,,,,,,,,,,,,,,,,,,,,,,,,,,,,,,,4,
13665752,f6559ab3-7df7-402d-81a9-67302ab6a668,1585763703,120,1585758063,,0,0,2.98,1079,1487,37,25,,,0,0.5,0.34,1.06,0.97,,188,127,143,,,,53.24,29.65,54.32,1,65.11,2134,,,1.3,0,94,94,,,,,,15,81,10.19,10.07,10.3,-3,-8.1,214,214,,1,219,219,,,,,,,,,"24,16,48,12,0,0,0,0,0","3,95,2,0,0","3,34,58,5,0",,,,,102,,,,,,,,,,,,,,,,,,,,,,,,,,,,,,,,,,,,11.9,7,8,327,51,,1019,1,374,0,3,3,Balve,1,0,I1.000|6:10-I1.000|6:10-I0.975|5:39,,,,,3113,,250,0,,0,168070,250480,30378,,2861104,,,,,,,,,,,,,,,,,,,,,,,,,,,,,,,,,,,,,,,,,
13665769,e5a02034-5a4b-49d0-86f5-bd04c14c7fb8,1585760136,120,1585758067,,0,0,3.55,1058,1115,65,38,,,0,0.8,0.4,1.06,0.97,321,233,145,162,,,,57.26,37.78,59.1,1,62.63,1301,,,2.4,0,99,98,,,,,,25,80,12.58,12.17,12.67,4.3,6.3,284,284,,1,288,288,,,,,,,,,"0,2,5,46,37,10,0,0,0","0,20,79,1,0","0,7,55,36,2",,,,,126,,,,,,,,,,,,,,,,,,,,,,,,,,,,,,,,,,,,29.1,7,9,329,47,,1020,2,371,0,3,3,Balve,1,0,,,,,,3113,,250,0,,0,168070,250480,30378,,2861121,,,,,,,,,,,,,,,,,,,,,,,,,,,,,,,,,,,,,,,,5,
13665780,3c41fbea-586a-4159-9999-61f6c824d5b4,1585761440,120,1585758069,,0,0,8.36,2210,2215,52,48,,,0,0,0.23,0.63,0.55,,437,149,179,,,,63.97,45.86,64.5,1,65.5,2160,,,3,2.1,107,109,,,,,,61,83,13.95,15.89,16.07,16.5,2.5,331,331,,1,397,397,,,,,,,,,"31,1,1,1,1,2,11,48,3","0,30,36,34,0","20,11,4,15,51",,,,,137,,,,,,,,,,,,,,,,,,,,,,,,,,,,,,,,,,,,51.1,7,9,329,47,,1020,2,371,0,3,3,Balve,1,0,I0.607|2:04-I0.631|2:08-I0.632|2:04-I0.225|2:03-I0.621|2:04-I0.619|2:03-I0.214|2:02-I0.615|1:56-I0.213|2:01-I0.604|2:10-I0.619|2:08-I0.617|2:05-I0.172|2:02-I0.598|1:59-I0.612|1:58-I0.111|2:15-I0.602|1:49-I0.049|1:59,,,,,3113,,250,0,,0,168070,250480,30378,,2861131,,,,,,,,,,,,,,,,,,,,,,,,,,,,,,,,,,,,,,,,,
13686322,f4305d52-7acd-4bea-a38d-e4b3f03e65ef,1585837411,120,1585835020,,0,0,15.5,4277,4479,335,323,,,0,3.6,0.74,1.04,1.03,453,878,146,160,,,,62.39,45.59,64.12,1,64.78,2015,,,3.3,0,98,98,,,,,,102,82,13.67,13.36,13.8,-3.9,2.2,307,307,,1,314,314,,,,,,,,,"1,6,8,13,28,25,19,0,0","0,17,83,0,0","0,5,38,50,7",,,,,133,,,,,,,,,,,,,,,,,,,,,,,,,,,,,,,,,,,,32.4,9,14,260,50,,1013,4,337,0,5,3,Balve,1,0,I1.000|4:59-I1.000|5:25-I1.000|5:48-I1.000|4:51-I1.000|4:53-I1.000|5:06-I1.000|4:48-I1.000|4:12-I1.000|3:53-I1.000|3:54-I1.000|3:58-I1.000|4:20-I1.000|4:22-I1.000|4:33-I1.000|4:13-I0.497|2:01,,,,,3113,,250,0,,0,168070,250480,30378,,2876379,,,,,,,,,,,,,,,,,,,,,,,,,,,,,,,,,,,,,,,,3,
13708952,457e8418-997f-46c3-9648-228e011fe9b3,1585933393,120,1585930539,,0,0,14.57,3806,4295,122,105,,,0,0.8,0.32,1.06,0.97,,759,145,167,,,,67.39,48.35,68.19,1,65.18,1338,,,3.1,0.4,103,101,,,,,,89,82,13.96,14.05,14.23,-1.2,-4.1,322,322,,1,333,333,,,,,,,,,"2,1,1,5,18,63,4,6,0","0,24,74,1,0","1,3,33,50,13",,,,,140,,,,,,,,,,,,,,,,,,,,,,,,,,,,,,,,,,,,33,8,12,274,66,,1017,1,319,0,4,3,Balve,1,0,I1.000|4:23-I1.000|4:21-I1.000|4:34-I1.000|4:23-I1.000|4:15-I1.000|4:25-I1.000|4:15-I1.000|4:28-I1.000|4:32-I1.000|4:21-I1.000|4:30-I1.000|4:16-I1.000|4:55-I1.000|3:20-I0.574|2:29,,,,,3113,,250,0,,0,168070,250480,30378,,2893331,,,,,,,,,,,,,,,,,,,,,,,,,,,,,,,,,,,,,,,,,
13757610,056b2cf9-d49c-4425-88ea-dea79da8ada4,1585992408,120,1586099856,,0,0,13.01,3146,3166,178,156,,,0,2.3,0.51,1.04,0.99,358,768,158,177,,,,65.68,52.43,66.93,1,65.26,2016,,,3.8,0.2,104,100,,,,,,102,84,15.26,15.01,15.35,2.3,2.4,359,359,,1,364,364,,,,,,,,,"0,0,0,3,10,38,42,7,0","0,1,66,33,0","0,2,19,51,28",,,,,148,,,,,,,,,,,,,,,,,,,,,,,,,,,,,,,,,,,,52.2,3,4,154,76,,1026,1,333,0,3,3,Balve,1,0,I1.000|4:06-I1.000|3:52-I1.000|4:07-I1.000|4:09-I1.000|4:16-I1.000|3:56-I1.000|4:26-I1.000|3:43-I1.000|3:52-I1.000|3:47-I1.000|3:52-I1.000|4:27-I1.000|3:50-I0.009|0:02,,,,,3113,,250,0,,0,168070,250480,30378,,2925435,,,,,,,,,,,,,,,,,,,,,,,,,,,,,,,,,,,,,,,,"5,5",
13757614,c03a009f-d538-460f-a714-a3be87fd574a,1586076553,120,1586099888,,0,0,14.66,4374,4704,342,337,,,0,4,0.66,0.98,0.9,711,976,151,184,106,,,54.08,41.45,55.66,1,63.84,2868,,,3.7,1.6,97,95,,,,,,123,81,12.85,12.97,13.2,0.8,-1.2,282,282,,1,296,296,,,,,,,,,"19,12,10,13,17,8,18,3,0","0,13,65,21,1","0,11,50,34,5",,,,,124,,,,,,,,,,,,,,,,,,,,,,,,,,,,,,,,,,,,75.7,6,10,142,68,,1026,1,306,0,3,3,Balve,1,0,I1.000|5:19-I1.000|5:54-I1.000|6:34-I1.000|6:44-I1.000|6:11-I1.000|4:33-I1.000|5:19-I1.000|4:54-I1.000|4:31-I1.000|4:28-I1.000|3:38-I1.000|3:38-I1.000|3:35-I1.000|3:39-I0.659|3:57,,,,,3113,,250,0,,0,168070,250480,30378,,2925438,,,,,,,,,,,,,,,,,,,,,,,,,,,,,,,,,,,,,,,,3,
13758507,1f127dda-910b-4743-843b-19d050d10e7d,1586090768,120,1586099953,,0,0,10.64,9328,9585,335,333,,,0,4.4,0.94,,,268,896,108,126,,,,,,,1,63.84,2608,,,2,0,,100,,,,,,74,56,,5.05,,-9,,,,,,,,,,,,,,,,"81,19,0,0,0,0","20,80,0,0,0",,,,,,,,,,,,,,,,,,,,,,,,,,,,,,,,,,,,,,,,,,7.7,14,19,149,42,,1025,5,310,0,3,3,Balve,1,0,,,,,,3113,,250,0,,0,168075,,30378,,2925451,,,,,,,,,,,,,,,,,,,,,,,,,,,,,,,,,,,,,,,,3,
13783000,9574486c-e14c-426c-927b-4eb1d0974762,1586185157,120,1586182629,,0,0,14.75,4106,4218,128,134,,,0,0.1,0.25,0.94,0.83,,805,150,184,101,,,59.46,44.95,60.07,1,63.89,2454,,,3.7,3.1,105,99,,,,,,118,81,13.04,13.84,14.12,13.1,4,301,301,,1,339,339,,,,,,,,,"13,3,7,8,23,23,13,11,0","0,28,45,25,2","6,13,31,29,21",,,,,133,,,,,,,,,,,,,,,,,,,,,,,,,,,,,,,,,,,,67.7,20,17,207,34,,1021,5,297,0,3,3,Balve,1,0,I1.000|4:34-I1.000|4:20-I1.000|4:10-I1.000|4:24-I1.000|3:41-I1.000|4:40-I0.779|3:36-I1.000|4:14-I1.000|4:31-I0.729|3:19-I1.000|3:17-I1.000|6:29-I0.003|0:01-I1.000|3:36-I1.000|6:30-I1.000|5:58-I0.237|1:07,,,,,3113,,250,0,,0,168070,250480,30378,,2942360,,,,,,,,,,,,,,,,,,,,,,,,,,,,,,,,,,,,,,,,,
13818678,d0b54126-aef3-4427-b11d-2a0b0f464404,1586276427,120,1586273592,,0,0,3.69,1065,1071,52,48,,,0,0.9,0.45,1.03,1.07,,218,139,159,,,,63,39.33,64.18,1,63.61,1216,,,2.2,0,98,100,,,,,,21,78,12.73,12.56,12.85,-6,-1.6,287,287,,1,292,292,,,,,,,,,"0,1,5,37,30,26,1,0,0","1,56,43,0,0","1,7,52,36,4",,,,,133,,,,,,,,,,,,,,,,,,,,,,,,,,,,,,,,,,,,22.2,18,9,41,48,,1031,2,322,0,5,3,Balve,1,0,I1.000|5:14-I1.000|5:03-I1.000|4:26-I0.686|3:02,,,,,3113,,250,0,,0,168070,250480,30378,,2962478,,,,,,,,,,,,,,,,,,,,,,,,,,,,,,,,,,,,,,,,,
13818684,19523903-e6e5-4845-9aac-869ba14cbd02,1586280349,120,1586273602,,0,0,1,387,387,4,5,,,0,0,0.2,1.01,0.79,,65,124,133,,,,50.43,24.67,50.62,1,64.04,3156,,,0.5,0,,100,,,,,,4,80,9.39,9.56,9.64,6.9,8.9,200,200,,1,208,208,,,,,,,,,"36,35,28,0,0,0,0,0,0","2,98,0,0,0","2,47,48,3,0",,,,,97,,,,,,,,,,,,,,,,,,,,,,,,,,,,,,,,,,,,6.1,18,9,45,48,,1031,1,323,0,5,3,Balve,1,0,I1.000|6:26-I0.003|0:01,,,,,3113,,250,0,,0,168070,250480,30378,,2962484,,,,,,,,,,,,,,,,,,,,,,,,,,,,,,,,,,,,,,,,,
13818685,409bce3e-e5cb-40d1-a930-21a246ca56b7,1586277760,120,1586273603,,0,0,10.02,2161,2189,30,33,,,0,0,0.07,,0.91,,539,165,182,,,,70.89,58.87,71.13,1,64.04,3168,,,3.8,1.1,104,98,,,,,,84,83,16.7,16.76,16.82,7.3,6.4,403,403,,1,409,409,,,,,,,,,"0,0,0,0,0,6,58,37,0","0,3,23,74,1","0,0,6,43,50",,,,,168,,,,,,,,,,,,,,,,,,,,,,,,,,,,,,,,,,,,87.4,18,9,41,48,,1031,2,322,0,5,3,Balve,1,0,I0.587|2:14-I0.608|2:02-I0.623|2:16-I0.619|2:02-I0.620|2:22-I0.612|2:03-I0.618|2:18-I0.601|2:03-I0.599|2:23-I0.606|2:05-I0.605|2:18-I0.603|2:06-I0.601|2:20-I0.611|2:03-I0.592|2:19-I0.595|2:03-I0.318|1:04,,,,,3113,,250,0,,0,168070,250480,30378,,2962485,,,,,,,,,,,,,,,,,,,,,,,,,,,,,,,,,,,,,,,,,
13847160,a958abe6-5941-496e-9f73-309cf67f0d8c,1586366638,120,1586364072,,0,0,2.91,887,995,71,0,,,0,0.9,0.45,1.04,,252,186,140,151,,,,58.34,36.25,61.88,1,63.58,1708,,,2.2,0,97,99,,,,,,18,79,12.84,11.83,12.88,4.4,1.8,295,295,,1,297,297,,,,,,,,,"0,0,6,54,39,1,0,0,0","1,30,69,0,0","1,3,44,49,2",,,,,125,,,,,,,,,,,,,,,,,,,,,,,,,,,,,,,,,,,,21.4,20,5,316,44,,1024,1,327,0,5,3,Balve,1,0,I1.000|5:08-I1.000|5:08-I0.909|4:30,,,,,3113,,250,0,,0,168070,250480,30378,,2980493,,,,,,,,,,,,,,,,,,,,,,,,,,,,,,,,,,,,,,,,5,
13847161,9d0b209f-76b2-438a-a7d6-024bc60a1d8a,1586367846,120,1586364074,,0,0,10.2,3173,3268,293,350,,,0,4.1,0.87,1.29,1.01,1004,532,137,171,93,,,58.51,38.4,60.18,1,63.9,2448,,,2.8,0.7,102,101,,,,,,63,81,11.93,11.86,13.47,6,13.5,267,267,,1,317,317,,,,,,,,,"8,2,8,38,35,9,0,1,0","0,63,27,10,0","6,27,32,17,18",,,,,119,,,,,,,,,,,,,,,,,,,,,,,,,,,,,,,,,,,,44.4,20,4,316,44,,1024,1,327,0,5,3,Balve,1,0,I0.814|4:07-I1.001|4:52-I0.812|4:03-I1.018|5:32-I0.956|4:41-I0.822|4:29-I0.967|4:48-I1.046|6:25-I2.118|10:27-I0.640|3:30,,,,,3113,,250,0,,0,168070,250480,30378,,2980494,,,,,,,,,,,,,,,,,,,,,,,,,,,,,,,,,,,,,,,,"4,4,4,4",
13870699,9111fa3d-1b1c-44f6-9f30-81cdf92af702,1586442767,120,1586439573,,0,0,14.46,3937,3940,265,259,,,0,2.7,0.57,0.99,1.01,476,819,149,178,,,,61.68,46.05,63.11,1,63.97,2016,,,3.5,0.2,104,100,,,,,,105,,13.77,14.02,14.22,0.1,-2.7,312,312,,1,329,329,,,,,,,,,"6,4,10,12,24,22,14,10,0","0,23,62,15,0","2,7,28,52,10",,,,,,,,,,,,,,,,,,,,,,,,,,,,,,,,,,,,,,,,,71.6,20,13,18,46,,1025,5,321,0,3,3,Balve,1,0,I1.000|4:41-I1.000|5:10-I1.000|5:35-I1.000|4:46-I1.000|4:44-I1.000|5:03-I1.000|4:37-I1.000|4:33-I1.000|4:21-I1.000|4:08-I1.000|3:28-I1.000|3:30-I1.000|3:25-I1.000|3:28-I0.463|4:08,,,,,3113,,250,0,,0,168070,250480,30378,,3000469,,,,,,,,,,,,,,,,,,,,,,,,,,,,,,,,,,,,,,,,4,
13892281,d429ab83-8922-4da9-9929-38e17ea36d24,1586513644,120,1586510114,,0,0,13.04,3443,3618,162,154,,,0,1.5,0.42,1.03,1.02,320,741,149,167,,,,64.07,47.35,65.1,1,63.86,,,,3.3,0,99,100,,,,,,89,81,13.93,13.81,14.08,-2,-3.9,319,319,,1,326,326,,,,,,,,,"0,1,3,12,23,41,20,0,0","0,10,86,4,0","0,3,35,52,10",,,,,140,,,,,,,,,,,,,,,20,,,,,,,,,,,,,,,,,,,,,36.8,13,6,28,68,,1028,2,305,0,3,3,Balve,1,0,I1.000|4:56-I1.000|4:23-I1.000|4:30-I1.000|4:31-I1.000|4:41-I1.000|4:38-I1.000|4:38-I1.000|4:03-I1.000|4:00-I1.000|3:56-I1.000|4:04-I1.000|4:44-I1.000|4:07-I0.036|0:11,,,,,3113,,250,0,,0,168070,250480,30378,,3017247,,,,,,,,,,,,,,,,,,,,,,,,,,,,,,,,,,,,,,,,"5,5,5",
13920127,75d71e93-532d-4665-b3ab-68e2cfe42b64,1586596570,120,1586595626,,0,0,17.13,5674,5849,338,330,,,0,2.9,0.47,1.17,0.83,328,980,142,171,,,,51.69,37.15,52.98,1,62.82,,,,3.4,0.1,99,95,,,,,,130,79,11.33,11.62,12.28,8.5,-23.7,255,255,,1,286,286,,,,,,,,,"21,5,7,21,34,12,1,0,0","0,30,61,8,0","16,11,39,25,8",,,,,115,,,,,,,,,,,,,,,15,,,,,,,,,,,,,,,,,,,,,47.6,9,6,137,54,,1027,1,306,0,5,3,Balve,1,0,I1.000|4:50-I1.000|4:35-I1.000|4:54-I1.000|5:08-I1.000|5:17-I1.000|5:33-I1.000|4:47-I1.000|4:50-I1.000|4:57-I1.000|4:38-I1.000|4:44-I1.000|4:37-I1.000|4:38-I0.759|3:48-I0.139|0:35-I0.156|1:41-I0.137|0:35-I0.152|1:53-I0.132|0:35-I0.153|1:51-I0.131|0:35-I0.152|1:50-I0.129|0:36-I0.151|1:49-I0.131|0:36-I0.160|2:08-I0.132|0:36-I0.168|2:05-I0.136|0:35-I1.000|8:04-I0.215|1:18,,,,,3113,,250,0,,0,168070,250480,30378,,3037956,,,,,,,,,,,,,,,,,,,,,,,,,,,,,,,,,,,,,,,,"4,4,5,5",
13941283,08cf0c53-ca38-4b0a-850d-34fba2b4bd8d,1586683488,120,1586681459,,0,0,13.95,4463,4731,158,152,,,0,1.4,0.43,1.06,0.97,191,810,141,161,114,,,54.45,38.06,55.24,1,62.68,,,,3.1,0.1,103,98,,,,,,94,80,11.46,11.39,11.71,8.4,0,252,252,,1,263,263,,,,,,,,,"5,7,26,35,23,4,0,0,0","0,46,54,0,0","1,18,62,17,2",,,,,117,,,,,,,,,,,,,,,20,,,,,,,,,,,,,,,,,,,,,30.3,14,7,219,57,,1018,1,325,0,3,3,Balve,1,0,I1.000|4:51-I1.000|5:06-I1.000|4:46-I1.000|5:13-I1.000|5:13-I1.000|5:33-I1.000|5:09-I1.000|5:54-I1.000|5:03-I1.000|5:35-I1.000|5:19-I1.000|5:25-I0.599|3:24-I1.000|5:56-I0.353|1:56,,,,,3113,,250,0,,0,168070,250480,30378,,3053038,,,,,,,,,,,,,,,,,,,,,,,,,,,,,,,,,,,,,,,,"5,5",
13967627,ed006c09-18eb-444c-aa7f-173d5c2fd0a9,1586757628,120,1586762048,,0,0,34,9853,10608,698,693,,,0,4.5,0.58,1.07,1,503,1947,155,177,,,,54.01,45.66,55.39,1,62.19,,,,4.9,0.5,101,97,,,,,,300,83,13.08,12.61,13.31,3.9,7.4,292,292,,1,303,303,,,,,,,,,"2,6,11,15,37,27,2,0,0","0,9,57,33,0","1,11,42,39,8",,,,,125,,,,,,,,,,,,,,,20,,,,,,,,,,,,,,,,,,,,,64.8,8,14,343,86,,1015,0,352,0,5,3,Balve,1,0,I1.000|4:50-I1.000|5:15-I1.000|5:46-I1.000|5:36-I1.000|5:35-I1.000|5:07-I1.000|4:31-I1.000|4:06-I1.000|5:05-I1.000|4:19-I1.000|4:44-I1.000|4:51-I1.000|5:32-I1.000|5:17-I1.000|5:08-I1.000|5:14-I1.000|5:00-I1.000|4:34-I1.000|4:45-I1.000|4:56-I1.000|4:48-I1.000|4:53-I1.000|4:55-I1.000|4:22-I1.000|4:23-I1.000|4:25-I1.000|4:38-I1.000|4:28-I1.000|4:36-I1.000|4:50-I1.000|4:34-I1.000|4:30-I1.000|4:23-I1.000|4:16-I0.003|0:01,,,,,3113,,250,0,,0,168070,250480,30378,,3073663,,,,,,,,,,,,,,,,,,,,,,,,,,,,,,,,,,,,,,,,"3,4,5,5",
14003898,e490fe45-773a-404d-97a2-bac6543f71d8,1586872757,120,1586868282,,0,0,8.79,2633,2679,186,167,,,0,2.7,0.74,1.08,1,488,534,145,169,,,,56.9,39.73,58.55,1,62.03,,,,2.9,0,103,99,,,,,,61,80,12.57,12.15,12.84,2.7,-1.3,279,279,,1,291,291,,,,,,,,,"3,2,12,38,28,16,1,1,0","0,18,80,2,0","1,9,54,32,4",,,,,125,,,,,,,,,,,,,,,18,,,,,,,,,,,,,,,,,,,,,30.9,7,10,346,56,,1026,3,332,0,4,3,Balve,1,0,I1.000|5:07-I1.000|5:12-I1.000|5:04-I1.000|4:50-I1.000|4:59-I0.766|3:47-I0.261|1:10-I1.000|5:30-I1.000|4:47-I0.761|3:27,,,,,3113,,250,0,,0,168070,250480,30378,,3098984,,,,,,,,,,,,,,,,,,,,,,,,,,,,,,,,,,,,,,,,"4,5",
14037937,3e0abed1-9442-4abf-bfb2-1d37316b8aaa,1586976235,120,1586974057,,0,0,2.03,557,557,22,16,,,0,0.2,0.3,1.05,0.69,,129,155,168,,,,57.78,39.52,58.76,1,62.12,,,,2.2,0.3,100,101,,,,,,16,80,13.31,13.39,13.73,8.4,0.7,312,312,,1,322,322,,,,,,,,,"7,0,1,2,20,65,4,0,0","1,3,70,25,0","6,4,25,51,14",,,,,137,,,,,,,,,,,,,,,20,,,,,,,,,,,,,,,,,,,,,31.9,15,3,357,48,,1022,0,316,0,5,3,Balve,1,0,,,,,,3113,,250,0,,0,168070,250480,30378,,3122950,,,,,,,,,,,,,,,,,,,,,,,,,,,,,,,,,,,,,,,,,
14038037,9feccc94-d2a5-4b1f-9587-d4a4f31657ce,1586979392,120,1586974249,,0,0,1.74,506,506,25,16,,,0,1.2,0.58,1.06,1.01,,112,145,159,,,,59.02,36.39,60.45,1,62.76,,,,2,0,100,100,,,,,,12,81,12.85,12.5,12.93,4.2,6.1,290,290,,1,293,293,,,,,,,,,"3,4,11,12,53,19,0,0,0","0,18,82,0,0","1,4,51,42,2",,,,,127,,,,,,,,,,,,,,,22,,,,,,,,,,,,,,,,,,,,,20.8,13,3,27,55,,1022,0,316,0,5,3,Balve,1,0,,,,,,3113,,250,0,,0,168070,250480,30378,,3123040,,,,,,,,,,,,,,,,,,,,,,,,,,,,,,,,,,,,,,,,,
14038046,a8322e5b-d972-48e8-9366-ffea0c69a31d,1586976971,120,1586974268,,0,0,8.41,2284,2284,53,56,,,0,0,0.06,1.12,0.22,,493,159,185,,,,56.38,44.44,56.79,1,62.75,,,,3.6,3.5,105,104,,,,,,84,83,13.67,15.88,16.09,2.3,-10,324,324,,1,399,399,,,,,,,,,"30,1,1,1,1,2,8,49,6","0,18,17,58,7","27,5,1,12,55",,,,,133,,,,,,,,,,,,,,,24,,,,,,,,,,,,,,,,,,,,,90.6,15,3,357,48,,1022,0,316,0,5,3,Balve,1,0,I0.593|2:02-I0.604|2:06-I0.603|2:07-I0.100|1:00-I0.589|2:03-I0.605|2:00-I0.111|1:01-I0.595|1:51-I0.197|3:32-I0.588|2:00-I0.603|2:02-I0.598|1:58-I0.058|1:03-I0.599|1:58-I0.604|2:00-I0.061|1:02-I0.606|1:51-I0.044|3:35-I0.608|1:44-I0.043|1:11,,,,,3113,,250,0,,0,168070,250480,30378,,3123049,,,,,,,,,,,,,,,,,,,,,,,,,,,,,,,,,,,,,,,,,
14060293,aa53a282-de02-454d-9877-9052661c7ffb,1587061206,120,1587058391,,0,0,14.01,3773,4251,240,224,,,0,2.6,0.61,1.02,1.04,367,837,154,171,,,,59.68,46.53,61.03,1,62.7,,,,3.8,0,98,100,,,,,,113,81,13.91,13.73,14.09,1,-0.3,315,315,,1,323,323,,,,,,,,,"7,1,3,9,19,43,18,1,0","0,10,61,28,0","1,4,35,50,10",,,,,138,,,,,,,,,,,,,,,16,,,,,,,,,,,,,,,,,,,,,50.8,19,7,129,35,,1015,1,365,0,5,3,Balve,1,0,,,,,,3113,,250,0,,0,168070,250480,30378,,3140125,,,,,,,,,,,,,,,,,,,,,,,,,,,,,,,,,,,,,,,,"4,5,5,5",
14078853,c9ed1932-c092-4921-b8aa-544a7aff2b71,1587129621,120,1587129019,,0,0,18.95,5392,5664,417,402,,,0,4,0.81,1.07,0.99,468,959,148,182,,,,58.96,44.71,60.62,1,62.47,,,,3.8,2.1,104,99,,,,,,147,81,13.08,13.03,13.95,6.4,-14.3,304,304,,1,339,339,,,,,,,,,"5,3,7,15,33,26,10,1,0","1,37,34,26,2","4,15,32,36,14",,,,,130,,,,,,,,,,,,,,,20,,,,,,,,,,,,,,,,,,,,,97.7,18,11,23,43,,1017,5,367,0,3,3,Balve,1,0,I1.040|5:02-I0.007|0:03-I0.006|0:02-I1.000|5:21-I1.000|5:08-I1.000|4:26-I1.000|4:35-I1.000|4:49-I1.000|4:22-I1.000|4:15-I1.000|4:17-I0.919|4:23-I1.000|4:35-I1.000|3:53-I1.000|3:56-I1.000|4:11-I0.024|0:18-I1.000|6:15-I1.000|4:38-I1.000|4:55-I1.000|4:48-I0.956|5:39,,,,,3113,,250,0,,0,168070,250480,30378,,3154039,,,,,,,,,,,,,,,,,,,,,,,,,,,,,,,,,,,,,,,,"4,4",
14097027,c6ca859b-ec4f-47c8-b15f-6b81729d8dca,1587199642,120,1587194114,,0,0,4.83,1599,1599,85,72,,,0,1.7,0.71,1.04,1,338,326,143,163,,,,51.24,34.01,52.53,1,62.28,,,,2.5,0,96,96,,,,,,36,80,11.18,10.95,11.35,4.4,12.6,245,245,,1,252,252,,,,,,,,,"4,11,42,34,9,0,0,0,0","0,37,62,1,0","1,19,65,15,0",,,,,113,,,,,,,,,,,,,,,19,,,,,,,,,,,,,,,,,,,,,30.1,10,4,88,76,,1016,1,350,0,5,3,Balve,1,0,I1.000|5:49-I1.000|5:38-I1.000|5:40-I1.000|5:02-I0.825|4:30,,,,,3113,,250,0,,0,168070,250480,30378,,3168854,,,,,,,,,,,,,,,,,,,,,,,,,,,,,,,,,,,,,,,,5,
14132901,41454791-2389-4279-8249-ef660452397f,1587288033,120,1587290445,,0,0,20.29,6004,6130,552,548,,,0,5,0.72,1.03,0.95,692,1229,152,176,,,,54.12,42.96,55.96,1,62.19,,,,3.9,0.3,100,100,,,,,,171,82,13,12.51,13.29,4.1,4.2,287,287,,1,299,299,,,,,,,,,"3,12,17,16,17,33,2,0,0","0,5,78,17,0","1,10,45,40,4",,,,,124,,,,,,,,,,,,,,,20,,,,,,,,,,,,,,,,,,,,,57.9,11,10,67,78,,1019,1,358,0,3,3,Balve,1,0,I1.000|5:24-I1.000|5:13-I1.000|6:08-I1.000|5:43-I1.000|5:30-I1.000|5:10-I1.000|4:43-I1.000|4:18-I1.000|4:17-I1.000|4:26-I1.000|4:24-I1.000|5:01-I1.000|6:10-I1.000|5:19-I1.000|5:03-I1.000|4:20-I1.000|4:15-I1.000|4:22-I1.000|4:42-I1.000|4:05-I0.288|1:31,,,,,3113,,250,0,,0,168070,250480,30378,,3196179,,,,,,,,,,,,,,,,,,,,,,,,,,,,,,,,,,,,,,,,"3,4",
14180963,580402a7-8b8a-4c85-ae0b-580a46f72b53,1587399910,120,1587397388,,0,0,3.9,1146,1163,63,43,,,0,1.2,0.48,1.03,1.07,288,233,141,161,,,,60.48,38.66,62.07,1,62.83,,,,2.3,0,103,102,,,,,,24,79,12.73,12.41,12.9,-2.5,-4,288,288,,1,294,294,,,,,,,,,"1,4,3,35,38,17,1,0,0","0,52,47,1,0","1,7,49,39,4",,,,,129,,,,,,,,,,,,,,,20,,,,,,,,,,,,,,,,,,,,,24.8,15,25,83,34,,1019,3,349,0,3,3,Balve,1,0,I1.000|5:10-I1.000|4:53-I1.000|5:04-I0.904|3:59,,,,,3113,,250,0,,0,168070,250480,30378,,3230547,,,,,,,,,,,,,,,,,,,,,,,,,,,,,,,,,,,,,,,,5,
14180970,7f117c37-269e-47ea-be91-efa1534125b1,1587401190,120,1587397395,,0,0,10.03,2400,2400,238,233,,,0,3.3,0.8,0.99,0.98,671,574,161,180,,,,64.7,52.14,66.65,1,62.94,,,,3.6,2,102,100,,,,,,86,84,15.8,15.33,15.97,-0.3,8.8,368,368,,1,377,377,,,,,,,,,"0,0,0,3,22,21,38,16,0","0,2,44,54,0","0,2,17,47,35",,,,,149,,,,,,,,,,,,,,,23,,,,,,,,,,,,,,,,,,,,,73.7,15,25,83,33,,1018,2,353,0,3,3,Balve,1,0,I1.000|4:16-I1.000|4:36-I1.000|4:22-I1.000|4:47-I1.000|3:53-I1.000|3:36-I1.000|3:47-I1.000|3:37-I1.000|3:26-I1.000|3:33-I0.025|0:05,,,,,3113,,250,0,,0,168070,250480,30378,,3230553,,,,,,,,,,,,,,,,,,,,,,,,,,,,,,,,,,,,,,,,4,
14180971,b5a2559b-acc6-4329-a10d-30c66404a006,1587404074,120,1587397396,,0,0,1.01,394,394,13,13,,,0,0,0,1.09,0.94,,65,124,130,,,,49.94,24.47,50.73,1,62.94,,,,0.6,0,,100,,,,,,5,83,9.34,9.32,9.45,5.7,11.3,201,201,,1,204,204,,,,,,,,,"36,57,7,0,0,0,0,0,0","2,98,0,0,0","3,46,48,3,0",,,,,93,,,,,,,,,,,,,,,20,,,,,,,,,,,,,,,,,,,,,6.2,15,24,82,33,,1018,1,353,0,3,3,Balve,1,0,I1.000|6:29-I0.013|0:05,,,,,3113,,250,0,,0,168070,250480,30378,,3230554,,,,,,,,,,,,,,,,,,,,,,,,,,,,,,,,,,,,,,,,,
14212006,f30d1247-a476-44f9-9b92-8071da2bce0d,1587493296,120,1587491005,,0,0,0.92,273,273,7,0,,,0,0,0,,,,56,137,147,,,,62.02,33.1,63.19,1,62.94,,,,0.9,0,,100,,,,,,5,79,12.46,12.27,12.59,2.6,-0.3,284,284,,1,289,289,,,,,,,,,"0,10,10,14,45,21,0,0,0","2,30,68,0,0","3,6,50,37,4",,,,,128,,,,,,,,,,,,,,,19,,,,,,,,,,,,,,,,,,,,,10.7,17,22,86,31,,1018,1,342,0,3,3,Balve,1,0,,,,,,3113,,250,0,,0,168070,250480,30378,,3252807,,,,,,,,,,,,,,,,,,,,,,,,,,,,,,,,,,,,,,,,,
14212009,6b443da2-fcc0-45f8-aeff-6c871dd99178,1587493746,120,1587491012,,0,0,14.13,3456,3513,87,85,,,0,0,0.21,1,0.98,,810,158,177,,,,64.76,52.05,65.26,1,63.08,,,,4,1,100,96,,,,,,114,82,14.8,14.79,14.86,2.5,-0.3,346,346,,1,350,350,,,,,,,,,"0,0,0,1,8,58,27,6,0","0,2,59,39,0","0,0,20,66,13",,,,,150,,,,,,,,,,,,,,,17,,,,,,,,,,,,,,,,,,,,,67.8,16,22,86,31,,1018,1,342,0,3,3,Balve,1,0,I1.000|4:12-I1.000|4:13-I1.000|4:10-I1.000|4:14-I1.000|4:14-I1.000|4:16-I1.000|4:08-I1.000|3:59-I1.000|4:02-I1.000|4:05-I1.000|4:16-I0.141|0:35-I0.155|0:29-I0.232|0:58-I0.145|0:30-I0.247|1:00-I0.157|0:30-I0.235|1:01-I0.147|0:31-I0.242|1:00-I0.163|0:30-I0.257|1:00-I0.165|0:30-I0.242|1:00-I0.165|0:30-I0.226|1:00-I0.167|0:31-I0.038|0:11,,,,,3113,,250,0,,0,168070,250480,30378,,3252809,,,,,,,,,,,,,,,,,,,,,,,,,,,,,,,,,,,,,,,,,
14212012,0e372e1d-4781-4a33-bfe9-67361c2696a5,1587497755,120,1587491016,,0,0,1.04,323,323,16,5,,,0,0,0.19,1.22,0.99,,65,136,149,,,,59.17,31.86,61.08,1,63,,,,1,0,,98,,,,,,6,80,11.99,11.7,12.64,18.1,27,273,273,,1,292,292,,,,,,,,,"0,4,10,54,32,0,0,0,0","2,64,34,0,0","0,12,61,22,6",,,,,121,,,,,,,,,,,,,,,21,,,,,,,,,,,,,,,,,,,,,10.2,16,20,88,35,,1018,0,332,0,3,3,Balve,1,0,I1.000|5:08-I0.043|0:15,,,,,3113,,250,0,,0,168070,250480,30378,,3252811,,,,,,,,,,,,,,,,,,,,,,,,,,,,,,,,,,,,,,,,,
14242155,0e2eab2a-aa7e-439f-a009-6724aaadae2a,1587579599,120,1587578141,,0,0,1,334,334,8,1,,,0,0,0,1.1,,,63,131,145,,,,56.67,29.21,57.72,1,62.87,,,,0.9,0,,98,,,,,,5,79,11.05,10.79,11.1,2.1,-2.1,240,240,,1,243,243,,,,,,,,,"0,16,46,38,0,0,0,0,0","6,80,13,0,0","0,5,90,5,0",,,,,114,,,,,,,,,,,,,,,15,,,,,,,,,,,,,,,,,,,,,9.8,18,16,82,29,,1020,1,320,0,3,3,Balve,1,0,I1.000|5:34-I0.002|0:01,,,,,3113,,250,0,,0,168070,250480,30378,,3276973,,,,,,,,,,,,,,,,,,,,,,,,,,,,,,,,,,,,,,,,,
14242157,efc612db-7a09-4735-bcc6-a4be602c04a1,1587580494,120,1587578144,,0,0,14.12,4470,4809,321,308,,,0,3.5,0.77,1.14,0.94,673,762,140,166,,,,55.68,38.57,57.31,1,62.9,,,,3.2,1.8,101,100,,,,,,95,81,11.74,11.91,12.81,13.5,14.9,241,241,,1,278,278,,,,,,,,,"14,4,14,33,23,4,3,4,1","0,52,44,3,0","7,32,29,27,6",,,,,117,,,,,,,,,,,,,,,19,,,,,,,,,,,,,,,,,,,,,39.8,18,15,82,29,,1020,1,320,0,3,3,Balve,1,0,I1.000|5:13-I1.000|5:09-I1.000|5:02-I1.000|5:16-I0.410|2:31-I0.217|0:44-I0.251|1:26-I0.213|0:43-I0.254|1:30-I0.212|0:42-I0.252|1:34-I0.214|0:43-I0.255|1:45-I0.213|0:42-I0.244|1:30-I0.211|0:41-I0.252|1:37-I0.219|0:41-I0.247|1:43-I0.213|0:42-I0.248|1:44-I0.218|0:42-I0.248|1:41-I0.218|0:40-I0.256|2:23-I0.223|1:01-I1.000|6:49-I1.000|4:50-I1.000|4:56-I1.000|5:11-I0.830|4:41,,,,,3113,,250,0,,0,168070,250480,30378,,3276975,,,,,,,,,,,,,,,,,,,,,,,,,,,,,,,,,,,,,,,,4,
14264132,7a823ad3-4e5b-4acd-bdf7-26e00430d6c1,1587658983,120,1587656888,,0,0,15.97,4658,4931,475,438,,,0,5.1,0.72,1,1.06,812,865,148,174,,,,57.19,42.85,59.46,1,62.79,,,,3.6,0.3,102,98,,,,,,122,81,13.32,12.83,13.77,-7,1.6,283,283,,1,299,299,,,,,,,,,"11,5,12,15,20,23,14,0,0","0,29,49,22,0","1,10,46,41,2",,,,,127,,,,,,,,,,,,,,,14,,,,,,,,,,,,,,,,,,,,,60,22,5,142,26,,1019,4,319,0,3,3,Balve,1,0,I1.000|4:57-I1.000|4:43-I1.000|4:54-I1.000|4:44-I1.000|5:07-I1.000|6:36-I1.000|5:49-I1.000|5:14-I1.000|5:50-I1.000|4:35-I1.000|4:50-I1.000|4:17-I1.000|3:58-I1.000|3:58-I1.000|4:02-I0.965|4:02,,,,,3113,,250,0,,0,168070,250480,30378,,3296316,,,,,,,,,,,,,,,,,,,,,,,,,,,,,,,,,,,,,,,,"2,5,5",
14284513,42623622-62ff-4146-8d69-7a05d1f2de6b,1587741326,120,1587738399,,0,0,3.89,1182,1182,61,47,,,0,1.5,0.64,1.07,1.16,285,231,138,160,,,,59.67,37.16,61.1,1,62.6,,,,2.2,0,98,100,,,,,,23,78,12.22,12,12.4,-7.6,-7.4,268,268,,1,274,274,,,,,,,,,"0,3,17,47,19,14,1,0,0","1,53,46,0,0","0,1,87,11,1",,,,,127,,,,,,,,,,,,,,,18,,,,,,,,,,,,,,,,,,,,,24.2,20,15,315,32,,1012,3,338,0,5,3,Balve,1,0,I1.000|5:23-I1.000|5:16-I1.000|5:02-I0.893|4:02,,,,,3113,,250,0,,0,168070,250480,30378,,3313456,,,,,,,,,,,,,,,,,,,,,,,,,,,,,,,,,,,,,,,,5,
14284521,e7c23cd8-be86-44f2-a7dc-5557e77220d0,1587744592,120,1587738434,,0,0,1.01,365,365,0,5,,,0,0,0,,,,69,132,139,,,,50.94,26.72,50.63,1,62.81,,,,0.9,0,94,94,,,,,,6,80,9.8,9.97,9.83,1.6,-1.5,204,204,,1,206,206,,,,,,,,,"14,37,49,1,0,0,0,0,0","0,100,0,0,0","0,37,63,0,0",,,,,104,,,,,,,,,,,,,,,22,,,,,,,,,,,,,,,,,,,,,9.3,20,15,316,31,,1011,3,339,0,5,3,Balve,1,0,I1.000|6:02-I0.011|0:04,,,,,3113,,250,0,,0,168070,250480,30378,,3313464,,,,,,,,,,,,,,,,,,,,,,,,,,,,,,,,,,,,,,,,,
14284526,73562b0d-e082-45cc-8dcb-0997ca0e92bc,1587742689,120,1587738439,,0,0,7.43,1843,1843,57,60,,,0,0,0.07,0.68,0.68,,420,159,184,,,,63.05,49.07,63.62,1,62.99,,,,3.3,3.3,108,102,,,,,,67,81,14.54,16.36,16.5,8.3,-69.5,362,362,,1,525,525,,,,,,,,,"27,5,3,2,2,2,3,45,11","1,24,16,54,5","14,18,9,3,56",,,,,149,,,,,,,,,,,,,,,21,,,,,,,,,,,,,,,,,,,,,81.1,20,14,315,32,,1012,3,338,0,5,3,Balve,1,0,I1.000|3:13-I0.239|1:59-I1.000|3:08-I0.243|1:58-I1.000|3:06-I0.253|1:59-I1.000|3:12-I0.227|2:02-I1.000|3:11-I0.234|2:00-I1.000|3:02-I0.236|1:54,,,,,3113,,250,0,,0,168070,250480,30378,,3313468,,,,,,,,,,,,,,,,,,,,,,,,,,,,,,,,,,,,,,,,,
14312287,b7f06c3b-8c0b-4498-9406-825073929645,1587821019,120,1587817937,,0,0,13.95,3986,4051,454,446,,,0,5.1,0.83,1.01,1.07,690,819,154,181,,,,55.47,43.42,57.75,1,62.68,,,,3.9,1.4,100,98,,,,,,122,82,13.74,13.18,14.07,-3,4.5,293,293,,1,304,304,,,,,,,,,"12,7,8,14,13,24,21,0,0","0,15,50,35,0","0,5,46,47,2",,,,,128,,,,,,,,,,,,,,,18,,,,,,,,,,,,,,,,,,,,,70.3,14,8,7,44,,1014,4,364,0,5,3,Balve,1,0,I1.000|4:55-I1.000|4:30-I1.000|4:39-I1.000|4:40-I1.000|4:37-I1.000|7:05-I1.000|5:42-I1.000|5:01-I1.000|5:35-I1.000|3:58-I1.000|3:58-I1.000|3:52-I1.000|3:58-I0.954|3:55,,,,,3113,,250,0,,0,168070,250480,30378,,3336735,,,,,,,,,,,,,,,,,,,,,,,,,,,,,,,,,,,,,,,,"2,5",
14333360,450f366f-2333-40e3-bb39-e7c61c3f7d8b,1587894578,120,1587892642,,0,0,16.18,5121,5203,469,453,,,0,5,0.76,1.01,1.07,625,879,141,172,,,,55.18,39.01,57.23,1,62.59,,,,3.2,0,100,97,,,,,,110,82,12.28,12.02,12.63,-8.1,-2,257,257,,1,270,270,,,,,,,,,"20,11,13,16,19,13,7,0,0","0,52,42,6,0","0,17,58,25,0",,,,,116,,,,,,,,,,,,,,,19,,,,,,,,,,,,,,,,,,,,,46.8,12,3,259,60,,1012,2,367,0,3,3,Balve,1,0,I1.000|5:31-I1.000|5:11-I1.000|5:10-I1.000|5:25-I1.000|5:17-I1.000|7:36-I1.000|6:31-I1.000|5:55-I1.000|6:21-I1.000|4:59-I1.000|5:05-I1.000|4:52-I1.000|4:25-I1.000|4:12-I1.000|3:59-I1.000|3:46-I0.183|1:05,,,,,3113,,250,0,,0,168070,250480,30378,,3353419,,,,,,,,,,,,,,,,,,,,,,,,,,,,,,,,,,,,,,,,"2,4",
14376740,8b989575-a062-4992-acc8-4f4dbf08c080,1588014468,120,1588012024,,0,0,4.31,1217,1714,77,51,,,0,1.3,0.47,0.87,0.9,566,238,139,157,97,,,64.73,40.78,66.65,1,63.33,,,,2.2,0.1,101,103,,,,,,25,82,13.4,13.54,13.84,-13.2,-24,294,294,,1,314,314,,,,,,,,,"17,8,5,9,16,22,12,10,0","1,48,51,0,0","0,4,54,30,12",,,,,130,,,,,,,,,,,,,,,19,,,,,,,,,,,,,,,,,,,,,21.5,18,7,259,33,,1007,0,369,0,3,3,Balve,1,0,I1.000|4:46-I1.000|5:01-I1.000|5:47-I0.238|0:57-I1.000|3:27-I0.073|0:18,,,,,3113,,250,0,,0,168070,250480,30378,,3388312,,,,,,,,,,,,,,,,,,,,,,,,,,,,,,,,,,,,,,,,5,
14376742,b07f3e89-78c4-460e-a6b5-e1f7cfebdb65,1588010863,120,1588012027,,0,0,3.84,1070,1427,65,43,,,0,1.4,0.63,1.05,1.09,302,218,142,162,96,,,63.98,41.1,65.78,1,62.84,,,,2.3,0,97,102,,,,,,23,81,13.41,13.1,13.53,-3.9,1,297,297,,1,303,303,,,,,,,,,"0,2,7,17,37,28,9,0,0","0,46,51,3,0","0,4,49,47,0",,,,,133,,,,,,,,,,,,,,,18,,,,,,,,,,,,,,,,,,,,,26.6,20,10,248,27,,1007,1,370,0,3,3,Balve,1,0,I1.000|5:04-I1.000|4:38-I1.000|4:39-I0.844|3:29,,,,,3113,,250,0,,0,168070,250480,30378,,3388314,,,,,,,,,,,,,,,,,,,,,,,,,,,,,,,,,,,,,,,,5,
14376745,046a308c-2c11-4c4a-9d45-69e310bb0f2f,1588012511,120,1588012033,,0,0,7.17,1816,1816,41,38,,,0,0,0.13,1.24,0.39,,398,154,187,,,,64.38,47.78,64.87,1,63.06,,,,3.1,3,111,103,,,,,,58,82,14.06,16.25,16.58,13.5,9.5,323,323,,1,399,399,,,,,,,,,"32,1,2,1,2,2,3,49,8","1,32,23,39,6","22,16,5,3,56",,,,,144,,,,,,,,,,,,,,,21,,,,,,,,,,,,,,,,,,,,,78.1,19,9,248,27,,1007,1,370,0,3,3,Balve,1,0,I1.000|3:15-I0.232|2:01-I1.000|3:08-I0.222|1:59-I1.000|3:12-I0.216|1:59-I1.000|3:12-I0.212|2:00-I1.000|3:11-I0.208|2:02-I1.000|3:06-I0.085|1:10,,,,,3113,,250,0,,0,168070,250480,30378,,3388317,,,,,,,,,,,,,,,,,,,,,,,,,,,,,,,,,,,,,,,,,
14394599,c2954a8b-0e2a-43fb-8a3c-1045be5998a8,1588094838,120,1588091791,,0,0,0.42,124,124,13,0,,,0,0.9,0.52,1.15,,,25,136,150,,,,62.99,31,67.85,1,63.33,,,,0.4,0,,100,,,,,,2,82,13.66,12.44,13.68,-2.6,-16.9,306,306,,1,303,303,,,,,,,,,"1,8,11,15,50,15,0,0,0","0,52,48,0,0","0,1,46,53,0",,,,,124,,,,,,,,,,,,,,,21,,,,,,,,,,,,,,,,,,,,,5.4,12,11,236,93,,1003,1,363,0,6,3,Balve,1,0,,,,,,3113,,250,0,,0,168070,250480,30378,,3401998,,,,,,,,,,,,,,,,,,,,,,,,,,,,,,,,,,,,,,,,,
14394603,f4fe5cad-89c5-4e3f-a758-d4f506c296b5,1588095528,120,1588091796,,0,0,11.12,3365,3420,340,345,,,0,4.6,0.8,1,1.09,662,584,140,168,,,,58.87,39.91,61.07,1,63.22,,,,3.1,0,100,99,,,,,,72,81,12.95,12.38,13.21,-8.2,4.5,273,273,,1,284,284,,,,,,,,,"14,7,12,10,26,25,5,0,0","0,48,45,7,0","0,10,54,36,0",,,,,122,,,,,,,,,,,,,,,19,,,,,,,,,,,,,,,,,,,,,38.5,12,11,236,93,,1003,1,363,0,6,3,Balve,1,0,I1.000|4:45-I1.000|5:18-I1.000|6:27-I1.000|6:28-I1.000|5:45-I1.000|4:56-I1.000|4:53-I1.000|4:14-I1.000|4:11-I1.000|4:15-I1.000|4:20-I0.116|0:33,,,,,3113,,250,0,,0,168070,250480,30378,,3402002,,,,,,,,,,,,,,,,,,,,,,,,,,,,,,,,,,,,,,,,3,
14427640,6fe445dd-48ad-4d76-95f6-07cd0ced6418,1588184535,120,1588182398,,0,0,16.37,4874,5026,464,448,,,0,5.3,0.78,0.97,0.96,627,891,144,167,,,,57.86,41.92,59.97,1,63.26,,,,3.4,0,104,100,,,,,,114,82,13.14,12.66,13.43,2.3,4.9,283,283,,1,303,303,,,,,,,,,"13,4,8,15,23,29,8,0,0","1,35,59,6,0","1,15,38,43,3",,,,,123,,,,,,,,,,,,,,,17,,,,,,,,,,,,,,,,,,,,,44.6,14,14,223,74,,1006,1,359,0,5,3,Balve,1,0,I1.000|5:06-I1.000|4:20-I1.000|4:20-I1.000|6:11-I1.000|7:23-I1.000|4:57-I1.000|5:56-I1.000|4:40-I1.000|4:41-I1.000|5:27-I1.000|4:38-I1.000|4:16-I1.000|4:02-I1.000|4:09-I1.000|4:51-I1.000|4:37-I0.366|1:39,,,,,3113,,250,0,,0,168070,250480,30378,,3426395,,,,,,,,,,,,,,,,,,,,,,,,,,,,,,,,,,,,,,,,"3,4,4,5",
14444538,c93207f2-3504-4084-9f74-1f2dbf33f926,1588256421,120,1588251337,,0,0,6.63,1967,1967,72,73,,,0,0.7,0.43,1.02,0.99,,372,137,149,,,,62.03,39.47,62.86,1,63.13,,,,2.4,0,103,100,,,,,,37,80,12.27,12.2,12.46,3.6,6.3,269,269,,1,278,278,,,,,,,,,"0,0,4,48,39,9,0,0,0","0,60,40,0,0","0,11,64,25,0",,,,,126,,,,,,,,,,,,,,,16,,,,,,,,,,,,,,,,,,,,,20,13,18,229,59,,1003,3,387,0,5,3,Balve,1,0,I1.000|4:47-I1.000|4:41-I1.000|4:47-I1.000|5:11-I1.000|5:18-I1.000|4:50-I0.632|3:14,,,,,3113,,250,0,,0,168070,250480,30378,,3440215,,,,,,,,,,,,,,,,,,,,,,,,,,,,,,,,,,,,,,,,,
14467350,43ff8fe3-9754-4507-b43f-d2b8a78629b2,1588325499,120,1588322962,,0,0,13.02,4119,4149,377,367,,,0,4.9,0.75,1.08,0.98,523,888,149,171,,,,51.25,38.36,53.14,1,62.7,,,,3.5,0.1,100,98,,,,,,110,80,12.6,12.2,12.94,8.2,19.3,259,259,,1,281,281,,,,,,,,,"17,5,13,16,23,21,4,1,0","0,18,67,14,0","3,16,54,24,3",,,,,119,,,,,,,,,,,,,,,15,,,,,,,,,,,,,,,,,,,,,52.3,8,16,211,94,,1002,2,390,0,6,3,Balve,1,0,I1.000|4:57-I1.000|5:08-I1.000|5:30-I1.000|5:58-I1.000|6:27-I1.000|8:40-I1.000|5:17-I1.000|4:45-I1.000|4:16-I1.000|4:08-I1.000|4:31-I0.694|3:27-I0.424|1:28-I0.881|3:59-I0.017|0:06,,,,,3113,,250,0,,0,168070,250480,30378,,3457250,,,,,,,,,,,,,,,,,,,,,,,,,,,,,,,,,,,,,,,,"2,5",
14536795,,1588525936,120,1588518796,,0,0,2,600,0,,,,,0,,,,,,131,,,,,,,35.65,,1,,,,,,,,,,,,,,13,,,,,,,,,,,,,,,,,,,,,,,,,,,,,,,,,,,,,,,,,,,,,,,,,,,,,,,,,,,,,,,,,,,,,,,,,,1,,,0,0,,,,,,connect,,,0,,0,168070,250480,30378,,3510619,,,,,,,,,,,,,,,,,,,,,,,,,,,,,,,,,,,,,,,,,
14536993,5949d720-6a87-456d-a0a7-4a2ca61a0366,1588516304,120,1588519349,,0,0,28.23,8421,8541,960,791,,,0,6.2,0.78,1,1.04,641,1435,148,171,,,,55.62,43.61,58.38,1,62.53,,,,4.1,1.1,105,98,,,,,,219,83,13.31,12.58,13.66,2.7,3.5,287,287,,1,301,301,,,,,,,,,"11,9,14,14,14,29,8,0,0","0,30,53,17,0","1,9,44,44,2",,,,,121,,,,,,,,,,,,,,,17,,,,,,,,,,,,,,,,,,,,,52.6,15,12,250,51,,1018,3,379,0,5,3,Balve,1,0,I1.000|4:40-I1.000|4:38-I1.000|5:37-I1.000|4:17-I1.000|4:56-I1.000|4:52-I1.000|6:57-I1.000|5:53-I1.000|5:14-I1.000|5:07-I1.000|4:08-I1.000|4:48-I1.000|4:10-I1.000|5:29-I1.000|5:20-I1.000|4:51-I1.000|3:58-I1.000|5:50-I1.000|4:58-I1.000|4:50-I1.000|4:23-I1.000|4:13-I1.000|4:46-I1.000|5:56-I1.000|5:32-I1.000|5:02-I1.000|4:17-I1.000|4:21-I0.228|1:16,,,,,3113,,250,0,,0,168070,250480,30378,,3510784,,,,,,,,,,,,,,,,,,,,,,,,,,,,,,,,,,,,,,,,"2,4,4,4,4",
14565033,b364bed0-b388-46df-9602-c159f21e9b87,1588616486,120,1588614294,,0,0,15.68,4061,4774,169,141,,,0,1,0.35,1.06,0.99,346,840,150,179,,,,65.01,49.11,66.02,1,63.5,,,,3.8,0.1,104,101,,,,,,111,82,14.16,14.36,14.57,6.4,1.6,319,319,,1,335,335,,,,,,,,,"3,3,6,3,22,28,29,6,0","1,20,60,19,0","1,7,21,63,7",,,,,141,,,,,,,,,,,,,,,20,,,,,,,,,,,,,,,,,,,,,69.4,13,13,16,60,,1018,1,389,0,5,3,Balve,1,0,I1.000|4:45-I1.000|4:35-I1.000|4:26-I1.000|4:07-I1.000|4:20-I1.000|4:09-I1.000|4:19-I1.000|4:02-I1.000|3:48-I1.000|4:01-I1.000|4:15-I1.000|3:49-I1.000|3:36-I1.000|3:22-I1.000|5:59-I0.676|4:07,,,,,3113,,250,0,,0,168070,250480,30378,,3531158,,,,,,,,,,,,,,,,,,,,,,,,,,,,,,,,,,,,,,,,5,
14586666,8add7c2b-9838-403b-8e5c-64d44db9f97b,1588700098,120,1588697110,,0,0,13.03,3449,3583,353,340,,,0,4.3,0.78,1,0.99,621,783,152,172,,,,62.11,47.21,64.27,1,63.58,,,,3.6,0.5,104,100,,,,,,98,82,14.63,14.41,14.81,-0.4,6.2,321,321,,1,329,329,,,,,,,,,"8,5,7,19,12,12,22,15,0","0,8,71,21,0","0,2,30,60,8",,,,,138,,,,,,,,,,,,,,,18,,,,,,,,,,,,,,,,,,,,,55.7,11,12,34,48,,1021,2,377,0,3,3,Balve,1,0,I1.000|4:48-I1.000|4:53-I1.000|5:05-I1.000|5:16-I1.000|5:32-I1.000|5:56-I1.000|4:10-I1.000|3:54-I1.000|3:37-I1.000|3:29-I1.000|3:35-I0.324|1:07-I1.000|3:20-I0.701|2:48,,,,,3113,,250,0,,0,168070,250480,30378,,3547580,,,,,,,,,,,,,,,,,,,,,,,,,,,,,,,,,,,,,,,,"3,5",
14607166,5e138e71-d0a4-4a87-bbdb-c9aa57f6000c,1588782404,120,1588779335,,0,0,13.08,3727,4019,344,314,,,0,4.2,0.77,1.02,1.09,598,661,144,179,,,,61.09,43.34,63.26,1,63.37,,,,3.4,0.4,100,100,,,,,,91,81,13.48,13.05,13.89,-6,9.2,288,288,,1,307,307,,,,,,,,,"5,5,10,13,23,36,9,0,0","1,52,25,23,0","1,8,53,32,7",,,,,130,,,,,,,,,,,,,,,20,,,,,,,,,,,,,,,,,,,,,67.1,16,9,15,32,,1025,3,367,0,3,3,Balve,1,0,I1.000|5:14-I1.000|5:06-I1.000|4:23-I1.000|4:42-I1.000|5:19-I1.000|6:40-I1.000|4:45-I1.000|4:29-I1.000|4:17-I1.000|4:00-I1.000|4:08-I1.000|4:20-I1.000|4:19-I0.081|0:24,,,,,3113,,250,0,,0,168070,250480,30378,,3565284,,,,,,,,,,,,,,,,,,,,,,,,,,,,,,,,,,,,,,,,"3,5",
14637693,f5c03c90-fbfe-4931-9b54-75b516bfa7ea,1588876700,120,1588873894,,0,0,1.49,463,646,33,3,,,0,0.6,0.4,1.16,,,93,135,143,,,,59.69,33.18,62.82,1,63.25,,,,1.4,0,100,98,,,,,,8,79,12.39,11.72,12.77,9.2,18.9,257,257,,1,266,266,,,,,,,,,"0,0,17,60,21,1,0,0,0","2,79,19,0,0","0,11,68,21,0",,,,,122,,,,,,,,,,,,,,,18,,,,,,,,,,,,,,,,,,,,,12.2,18,5,25,37,,1022,1,351,0,3,3,Sundern,1,0,I1.000|5:05-I0.491|2:38,,,,,3113,,250,0,,0,168070,250480,30378,,3588782,,,,,,,,,,,,,,,,,,,,,,,,,,,,,,,,,,,,,,,,,
14637721,f2bd39fe-1f4e-4fbd-a6d5-677e5b9a8f4f,1588877416,120,1588873960,,0,0,13.54,3420,3524,63,54,,,0,0,0.12,1.13,0.7,,681,155,185,,,,64,49.99,64.42,1,63.34,,,,3.6,3.1,101,99,,,,,,111,84,14.28,15.06,15.3,7.3,2.4,326,326,,1,363,363,,,,,,,,,"2,6,7,12,22,9,16,24,2","0,25,35,34,6","0,9,43,17,31",,,,,141,,,,,,,,,,,,,,,28,,,,,,,,,,,,,,,,,,,,,82.5,18,4,355,37,,1022,1,351,0,3,3,Sundern,1,0,I1.000|3:27-I1.000|3:31-I1.000|3:36-I1.000|4:47-I1.000|3:23-I1.000|4:59-I1.000|3:27-I0.691|3:45-I1.000|3:13-I1.000|5:42-I1.000|3:18-I1.000|5:03-I1.000|4:49-I0.852|4:01,,,,,3113,,250,0,,0,168070,250480,30378,,3588797,,,,,,,,,,,,,,,,,,,,,,,,,,,,,,,,,,,,,,,,,
14654105,a96f635d-bd9d-4abf-9021-efd7d2ba38dc,1588943607,120,1588941277,,0,0,12.91,3901,4095,360,335,,,0,4.4,0.8,1.07,1.1,604,687,149,180,,,,54.24,40.44,56.24,1,63.1,,,,4,1.8,99,99,,,,,,114,82,12.64,12.18,13.31,2.8,14.6,262,262,,1,293,293,,,,,,,,,"11,4,8,25,33,14,5,1,0","0,40,16,44,0","2,26,42,23,8",,,,,121,,,,,,,,,,,,,,,20,,,,,,,,,,,,,,,,,,,,,82.9,20,7,1,34,,1019,4,347,0,4,3,Balve,1,0,I1.000|4:54-I1.000|4:53-I0.132|0:30-I0.102|0:31-I0.124|0:31-I0.103|0:32-I0.134|0:31-I0.094|0:31-I0.134|0:32-I0.090|0:31-I0.136|0:32-I0.089|0:31-I0.132|0:31-I0.091|0:32-I0.127|0:32-I0.086|0:32-I0.119|0:31-I0.080|0:30-I0.124|0:30-I0.063|0:31-I0.096|0:31-I0.043|0:31-I0.094|0:30-I0.053|0:31-I0.132|0:31-I0.065|0:31-I0.111|0:31-I0.106|0:31-I0.093|0:31-I0.050|0:30-I0.136|0:31-I0.052|0:30-I0.120|0:31-I0.050|0:30-I0.134|0:31-I0.092|0:32-I0.158|0:32-I0.103|0:32-I0.136|0:31-I0.079|0:33-I0.165|0:31-I0.112|0:32-I0.102|0:31-I0.058|0:33-I0.096|0:31-I0.047|0:31-I0.090|0:32-I0.049|0:31-I0.122|0:32-I0.094|0:31-I0.170|0:34-I0.094|0:31-I0.144|0:31-I0.099|0:32-I0.123|0:31-I0.056|0:30-I0.114|0:31-I0.055|0:31-I0.148|0:34-I1.000|5:03-I1.000|5:05-I1.000|4:54-I1.000|5:03-I1.000|4:54-I0.110|0:36,,,,,3113,,250,0,,0,168070,250480,30378,,3600614,,,,,,,,,,,,,,,,,,,,,,,,,,,,,,,,,,,,,,,,"4,4,5",
14675002,b7bda93b-c1e7-4e17-8d5c-7185b68148b2,1589023779,120,1589020445,,0,0,13.71,3653,3800,183,224,,,0,2.5,0.59,0.99,1.01,331,860,161,181,,,,56.65,47.03,57.38,1,62.6,,,,4.1,1.5,103,96,,,,,,131,82,13.74,13.71,13.88,3.6,6.4,311,311,,1,318,318,,,,,,,,,"1,2,3,9,23,43,17,0,0","0,1,39,59,0","0,2,39,56,4",,,,,137,,,,,,,,,,,,,,,24,,,,,,,,,,,,,,,,,,,,,80.3,21,6,75,40,,1015,3,349,0,4,3,Balve,1,0,I1.000|4:01-I1.000|4:15-I1.000|4:25-I1.000|4:28-I1.000|4:22-I1.000|4:53-I1.000|4:17-I1.000|4:24-I1.000|4:40-I1.000|4:06-I1.000|4:19-I1.000|4:19-I1.000|5:23-I0.708|3:03,,,,,3113,,250,0,,0,168070,250480,30378,,3616998,,,,,,,,,,,,,,,,,,,,,,,,,,,,,,,,,,,,,,,,"4,5",
14675003,48ce789e-e674-4949-a279-5e503ef165bf,1589023050,120,1589020445,,0,0,1.26,390,390,47,0,,,0,1.5,0.68,0.98,,457,90,151,163,,,,51.68,32.69,56.48,1,63.01,,,,1.9,0,98,99,,,,,,10,80,13.37,11.82,13.42,5.5,3,316,316,,1,317,317,,,,,,,,,"0,11,15,33,37,3,0,0,0","1,7,83,9,0","0,0,27,73,0",,,,,121,,,,,,,,,,,,,,,20,,,,,,,,,,,,,,,,,,,,,25.5,21,5,75,41,,1015,3,349,0,4,3,Balve,1,0,I1.000|5:02-I0.259|1:28,,,,,3113,,250,0,,0,168070,250480,30378,,3616999,,,,,,,,,,,,,,,,,,,,,,,,,,,,,,,,,,,,,,,,5,
14704399,f46b27a7-f913-48cc-8917-abe4c846832e,1589110055,120,1589113452,,0,0,31.73,9811,10525,788,751,,,0,4.8,0.76,1.02,1.03,493,1609,144,168,,,,55.23,42.12,57.01,1,62.39,,,,4,0,99,97,,,,,,228,82,12.34,11.84,12.59,2.3,-7.7,273,273,,1,289,289,,,,,,,,,"7,8,15,26,33,10,0,0,0","0,35,61,4,0","0,10,57,32,1",,,,,118,,,,,,,,,,,,,,,22,,,,,,,,,,,,,,,,,,,,,43.7,20,4,228,52,,1006,3,359,0,4,3,Balve,1,0,I1.000|5:22-I1.000|5:13-I1.000|5:23-I1.000|5:31-I1.000|6:12-I1.000|5:18-I1.000|5:45-I1.000|5:18-I1.000|4:38-I1.000|4:12-I1.000|5:21-I1.000|4:48-I1.000|5:00-I1.000|4:58-I1.000|4:59-I1.000|5:50-I1.000|5:07-I1.000|5:03-I1.000|4:54-I1.000|5:09-I1.000|5:10-I1.000|5:40-I1.000|5:30-I1.000|5:12-I1.000|5:00-I1.000|5:30-I1.000|5:02-I1.000|4:41-I1.000|4:43-I1.000|4:35-I1.000|4:44-I0.730|3:42,,,,,3113,,250,0,,0,168070,250480,30378,,3638428,,,,,,,,,,,,,,,,,,,,,,,,,,,,,,,,,,,,,,,,"4,4,4,4,5",
14730250,60ecb193-9427-426e-80b2-b1ec72525380,1589212351,120,1589209892,,0,0,13.22,3767,4496,370,343,,,0,4.6,0.8,1.05,1,576,712,143,160,,,,61.66,43.38,63.96,1,62.48,,,,3.2,0.1,102,99,,,,,,84,82,13.51,13.02,13.8,1.9,14.4,303,303,,1,315,315,,,,,,,,,"7,5,9,20,17,29,13,0,0","0,32,67,0,0","0,3,50,40,6",,,,,128,,,,,,,,,,,,,,,15,,,,,,,,,,,,,,,,,,,,,32.3,8,28,22,56,,1010,3,355,0,4,3,Balve,1,0,I1.000|4:57-I1.000|5:03-I1.000|5:14-I1.000|5:31-I1.000|5:38-I1.000|4:47-I1.000|5:49-I1.000|4:25-I1.000|4:20-I1.000|4:00-I1.000|4:02-I1.000|4:04-I1.000|4:08-I0.216|0:49,,,,,3113,,250,0,,0,168070,250480,30378,,3659602,,,,,,,,,,,,,,,,,,,,,,,,,,,,,,,,,,,,,,,,"3,5",
14743466,,1589216800,120,1589263653,,0,0,2,600,0,,,,,0,,,,,,131,,,,,,,35.65,,1,,,,,,,,,,,,,,13,,,,,,,,,,,,,,,,,,,,,,,,,,,,,,,,,,,,,,,,,,,,,,,,,,,,,,,,,,,,,,,,,,,,,,,,,,1,,,0,0,,,,,,connect,,,0,,0,168070,250480,30378,,3669810,,,,,,,,,,,,,,,,,,,,,,,,,,,,,,,,,,,,,,,,,
14764666,5cc95b66-540c-4861-b769-f68c679becc5,1589308169,120,1589306648,,0,0,15.48,4533,4579,515,513,,,0,5.6,0.77,1.03,0.97,727,950,151,172,,,,55.34,42.55,57.63,1,62.47,,,,3.7,0.3,104,98,,,,,,126,83,13.5,12.87,13.92,3.2,12.9,310,310,,1,327,327,,,,,,,,,"16,8,6,10,13,32,13,0,0","0,10,78,12,0","0,5,39,48,8",,,,,123,,,,,,,,,,,,,,,19,,,,,,,,,,,,,,,,,,,,,49.9,10,8,289,51,,1017,1,365,0,3,3,Balve,1,0,I1.000|4:29-I1.000|4:58-I1.000|4:15-I1.000|5:07-I1.000|5:04-I1.000|6:30-I1.000|6:14-I1.000|5:49-I1.000|5:03-I1.000|4:27-I1.000|4:01-I1.000|3:59-I1.000|4:05-I1.000|4:01-I1.000|5:15-I0.483|2:16,,,,,3113,,250,0,,0,168070,250480,30378,,3686135,,,,,,,,,,,,,,,,,,,,,,,,,,,,,,,,,,,,,,,,"2,5,5",
14803106,cfec96c0-777e-4f65-89d1-ef01bdfff5c2,1589394268,120,1589390604,,0,0,12.83,3227,3363,120,133,,,0,0.3,0.28,1,1.06,,717,153,178,,,,65.54,50.03,66.22,1,62.69,,,,3.7,2,100,101,,,,,,96,84,14.48,14.66,14.72,2.4,-1.6,348,348,,1,358,358,,,,,,,,,"0,0,1,14,24,29,17,13,1","0,15,55,30,0","0,0,22,59,19",,,,,142,,,,,,,,,,,,,,,17,,,,,,,,,,,,,,,,,,,,,66.5,11,9,25,53,,1011,1,378,0,4,3,Balve,1,0,I1.000|5:13-I1.000|4:44-I1.000|4:37-I0.511|2:15-I0.298|1:01-I0.239|1:01-I0.272|1:02-I0.210|1:01-I0.291|1:01-I0.224|0:59-I0.320|1:00-I0.205|1:02-I0.315|1:01-I0.214|1:01-I0.299|1:00-I0.223|1:02-I0.291|1:01-I0.192|1:00-I0.293|1:00-I0.226|1:01-I0.305|1:00-I0.230|1:00-I0.284|1:00-I0.201|1:00-I0.313|1:01-I0.239|1:00-I0.322|1:02-I0.243|1:00-I0.325|1:00-I1.000|4:19-I1.000|4:12-I0.747|3:09,,,,,3113,,250,0,,0,168070,250480,30378,,3716441,,,,,,,,,,,,,,,,,,,,,,,,,,,,,,,,,,,,,,,,,
14830495,feb94e0a-8c28-42a5-855b-51cdcf7b7d7f,1589476106,120,1589472919,,0,0,5.34,1560,1588,75,50,,,0,1,0.41,1.03,0.98,297,346,145,158,,,,58.69,39.69,60.05,1,62.42,,,,2.7,0,98,100,,,,,,37,80,12.7,12.58,12.97,-3.7,-1.1,298,298,,1,306,306,,,,,,,,,"3,3,7,38,24,19,7,0,0","1,11,88,0,0","0,2,55,40,2",,,,,128,,,,,,,,,,,,,,,16,,,,,,,,,,,,,,,,,,,,,27.5,10,14,29,45,,1019,3,358,0,3,3,Balve,1,0,I1.000|5:28-I1.000|5:00-I1.000|5:08-I1.000|4:27-I0.698|3:15-I0.620|2:28-I0.022|0:14,,,,,3113,,250,0,,0,168070,250480,30378,,3739785,,,,,,,,,,,,,,,,,,,,,,,,,,,,,,,,,,,,,,,,5,
14830496,a92414bf-e570-4803-b96d-4a7e1a9bd340,1589478321,120,1589472923,,0,0,0.62,119,119,5,0,,,0,0,0.02,,,,24,139,157,,,,,52.62,,1,62.42,,,,0.4,0.2,,100,,,,,,2,92,19.2,18.92,19.29,15.9,18.4,501,501,,1,505,505,,,,,,,,,"0,0,0,0,0,0,0,99,1","0,50,50,0,0","0,0,0,0,100",,,,,170,,,,,,,,,,,,,,,20,,,,,,,,,,,,,,,,,,,,,3.9,11,14,32,46,,1019,2,355,0,3,3,Balve,1,0,I0.599|1:55-I0.023|0:04,,,,,3113,,250,0,,0,168070,250480,30378,,3739786,,,,,,,,,,,,,,,,,,,,,,,,,,,,,,,,,,,,,,,,,
14830498,9025ee40-f8c6-4cf3-a767-4797be41e64c,1589478655,120,1589472925,,0,0,3.68,1054,1134,55,52,,,0,1.4,0.62,1.1,1.3,407,222,142,172,,,,61.85,39.68,63.05,1,62.32,,,,2.3,1,98,100,,,,,,23,82,12.94,14.13,13.85,-3.5,-18,301,301,,1,330,330,,,,,,,,,"9,5,24,34,4,5,4,5,11","1,41,49,9,0","0,6,56,21,17",,,,,128,,,,,,,,,,,,,,,19,,,,,,,,,,,,,,,,,,,,,33.8,10,14,32,46,,1019,2,355,0,3,3,Balve,1,0,I1.000|5:23-I1.000|5:12-I1.000|2:56-I0.678|4:03,,,,,3113,,250,0,,0,168070,250480,30378,,3739788,,,,,,,,,,,,,,,,,,,,,,,,,,,,,,,,,,,,,,,,5,
14851342,e043a8f8-1916-4efd-bb1d-bc92ed82d92b,1589554011,120,1589552313,,0,0,17.39,5005,5296,429,410,,,0,4.3,0.71,1.03,1.1,528,939,146,169,,,,59.23,43.82,61.12,1,62.07,,,,3.5,0.1,102,99,,,,,,123,82,13.26,12.99,13.52,-3.9,4.4,306,306,,1,318,318,,,,,,,,,"4,8,14,15,27,21,7,3,0","0,30,66,4,0","0,5,38,53,4",,,,,127,,,,,,,,,,,,,,,20,,,,,,,,,,,,,,,,,,,,,43.1,13,11,355,41,,1021,5,358,0,3,3,Balve,1,0,I1.000|4:47-I1.000|5:49-I1.000|4:32-I1.000|4:41-I1.000|5:29-I1.000|4:47-I1.000|4:57-I1.000|5:19-I1.000|5:31-I1.000|5:02-I1.000|5:48-I1.000|4:42-I1.000|4:28-I1.000|4:06-I1.000|4:06-I0.666|2:42-I1.000|3:16-I0.356|1:37-I0.369|1:46,,,,,3113,,250,0,,0,168070,250480,30378,,3756781,,,,,,,,,,,,,,,,,,,,,,,,,,,,,,,,,,,,,,,,"4,4,4",
14868762,ef5c65ba-af4d-4dac-89ee-9ac6b4f42378,1589624514,120,1589620802,,0,0,11.79,3149,3377,319,296,,,0,4,0.84,1.03,1.08,617,780,163,182,,,,55.45,46.37,57.44,1,61.63,,,,4.1,1.7,98,99,,,,,,117,84,14.55,14.39,14.74,-6.6,5.8,338,338,,1,346,346,,,,,,,,,"2,10,13,12,18,12,13,20,0","0,2,23,75,0","0,1,19,72,8",,,,,134,,,,,,,,,,,,,,,21,,,,,,,,,,,,,,,,,,,,,73.7,12,7,334,56,,1024,3,351,0,3,3,Balve,1,0,I1.000|4:33-I1.000|5:16-I1.000|5:49-I1.000|5:08-I1.000|5:16-I1.000|5:27-I1.000|4:10-I1.000|3:37-I1.000|3:30-I1.000|3:32-I1.000|3:18-I0.789|2:52,,,,,3113,,250,0,,0,168070,250480,30378,,3771119,,,,,,,,,,,,,,,,,,,,,,,,,,,,,,,,,,,,,,,,"4,4",
14890446,acc15e92-d952-4ead-a062-aa5ffc0db5a6,1589706773,120,1589707570,,0,0,23.33,7009,7945,682,652,,,0,5.9,0.76,1.02,1,720,1305,148,174,,,,55.14,42.66,57.22,1,61.39,,,,3.8,0.3,103,98,,,,,,180,83,12.93,12.47,13.36,-3.3,-10.4,299,299,,1,321,321,,,,,,,,,"15,9,8,14,24,24,7,0,0","1,25,60,14,0","0,7,45,42,6",,,,,120,,,,,,,,,,,,,,,17,,,,,,,,,,,,,,,,,,,,,56.5,10,6,290,68,,1024,2,343,0,5,3,Balve,1,0,I1.000|4:57-I1.000|4:50-I1.000|5:17-I1.000|4:39-I1.000|5:13-I1.000|4:23-I1.000|5:03-I1.000|5:44-I1.000|6:48-I1.000|6:18-I1.000|5:57-I0.769|4:17-I1.000|4:40-I1.000|4:28-I1.000|4:52-I1.000|6:19-I1.000|5:08-I1.000|4:57-I1.000|4:27-I1.000|4:00-I1.000|3:58-I1.000|4:05-I1.000|4:06-I0.557|2:24,,,,,3113,,250,0,,0,168070,250480,30378,,3788183,,,,,,,,,,,,,,,,,,,,,,,,,,,,,,,,,,,,,,,,"1,4,5",
14898808,175e6e29-72a6-433c-a5b1-c756288c72ee,1589717731,120,1589723610,,0,0,13.1,10617,12855,356,333,,,0,4.4,0.74,,,203,979,106,122,95,,,,,,1,,,,,2,0,,86,,,,,,78,56,,7.74,,17.1,,,,,,,,,,,,,,,,"82,17,1,0,0,1","21,79,0,0,0",,,,,,,,,,,,,,,,,,,,,19,,,,,,,,,,,,,,,,,,,,,5.7,15,8,304,42,,1024,5,343,0,5,3,Balve,1,0,,,,,,3113,,250,0,,0,168075,,30378,,3794317,,,,,,,,,,,,,,,,,,,,,,,,,,,,,,,,,,,,,,,,"3,5",
14926640,1e0cb8a5-c9eb-4533-bd00-11c66cfd64d1,1589826848,120,1589822988,,0,0,12.44,3151,3267,138,141,,,0,1.3,0.46,1.03,1.08,421,704,156,180,,,,63.18,49.51,64.03,1,61.97,,,,3.8,2,104,100,,,,,,100,84,14.43,14.68,14.8,8.9,3.8,348,348,,1,362,362,,,,,,,,,"2,0,2,7,29,25,20,14,1","0,10,52,38,0","1,1,19,56,22",,,,,141,,,,,,,,,,,,,,,18,,,,,,,,,,,,,,,,,,,,,82.7,21,11,255,47,,1022,1,334,0,3,3,Balve,1,0,I1.000|4:44-I1.000|4:31-I0.488|2:10-I0.305|1:01-I0.217|0:59-I0.270|1:00-I0.203|1:00-I0.309|1:00-I0.236|1:00-I0.263|0:59-I0.232|1:01-I0.303|1:00-I0.221|1:01-I0.302|1:00-I0.189|1:02-I0.309|1:00-I0.233|1:00-I0.308|1:01-I0.233|1:01-I0.274|1:01-I0.248|1:01-I0.334|1:01-I0.230|1:00-I0.320|1:00-I0.240|1:01-I0.330|1:00-I1.000|5:21-I1.000|4:37-I1.000|4:36-I0.847|3:25,,,,,3113,,250,0,,0,168070,250480,30378,,3817975,,,,,,,,,,,,,,,,,,,,,,,,,,,,,,,,,,,,,,,,5,
14935404,,1589844582,120,1589837409,,0,0,1.5,480,0,,,,,0,,,,,,100,,,,,,,32.11,,1,,,,,,,,,,,,,,10,,,,,,,,,,,,,,,,,,,,,,,,,,,,,,,,,,,,,,,,,,,,,,,,,,,,,,,,,,,,,,,,,,,,,,,,,,1,,,0,0,,,,,,connect,,,0,,0,168070,250480,30378,,3825513,,,,,,,,,,,,,,,,,,,,,,,,,,,,,,,,,,,,,,,,,
15015288,d99cde36-0a4f-4793-9638-ab15cd4bf8b6,1589911519,120,1589909420,,0,0,15.29,4470,4893,285,284,,,0,3.3,0.58,1.03,1.08,601,783,135,163,,,,64.36,42.59,65.85,1,62.52,,,,2.9,0,,101,,,,,,84,81,12.84,12.94,13.39,-7.9,0.5,299,299,,1,318,318,,,,,,,,,"22,4,4,8,18,30,13,1,0","2,60,37,2,0","0,14,27,55,4",,,,,127,,,,,,,,,,,,,,,14,,,,,,,,,,,,,,,,,,,,,30.3,19,11,337,55,,1021,2,324,0,5,3,Balve,1,0,I1.000|7:14-I1.000|7:09-I1.000|4:06-I1.000|5:01-I1.000|4:13-I1.000|4:56-I1.000|4:32-I1.000|5:20-I1.000|4:10-I1.000|4:41-I1.000|4:24-I1.000|4:27-I1.000|4:15-I1.000|4:09-I1.000|4:47-I0.286|1:05,,,,,3113,,250,0,,0,168070,250480,30378,,3895270,,,,,,,,,,,,,,,,,,,,,,,,,,,,,,,,,,,,,,,,"4,4,5",
15079407,68acd719-6f0d-4533-a389-0582a7e6f08b,1589995638,120,1589993406,,0,0,15.38,4571,4908,332,331,,,0,3.7,0.72,1.08,1.1,535,786,142,182,,,,59.08,41.8,60.67,1,62.59,,,,3.5,1.2,100,100,,,,,,107,82,12.64,12.51,13.31,-5.6,1.1,296,296,,1,327,327,,,,,,,,,"13,8,7,16,24,23,8,1,0","0,54,22,24,0","1,11,42,31,15",,,,,123,,,,,,,,,,,,,,,19,,,,,,,,,,,,,,,,,,,,,78.9,20,12,12,55,,1022,2,332,0,5,3,Balve,1,0,I1.000|6:27-I1.000|6:32-I1.000|5:17-I1.000|4:58-I1.000|4:50-I0.212|1:18-I0.125|0:31-I0.088|0:31-I0.118|0:31-I0.097|0:31-I0.122|0:30-I0.089|0:30-I0.137|0:30-I0.098|0:31-I0.130|0:30-I0.089|0:32-I0.132|0:30-I0.098|0:31-I0.131|0:30-I0.085|0:32-I0.143|0:31-I0.098|0:32-I0.140|0:31-I0.085|0:32-I0.140|0:32-I0.068|0:32-I0.131|0:31-I0.069|0:32-I0.130|0:31-I0.071|0:31-I0.125|0:31-I0.068|0:30-I0.140|0:30-I0.086|0:31-I0.158|0:30-I0.099|0:30-I0.160|0:31-I0.048|0:31-I0.113|0:31-I0.077|0:30-I0.116|0:31-I0.066|0:31-I0.123|0:31-I0.049|0:30-I0.065|0:16-I1.000|4:54-I1.000|4:26-I1.000|4:04-I1.000|4:23-I1.000|4:36-I0.691|3:02-I0.370|1:35,,,,,3113,,250,0,,0,168070,250480,30378,,3949068,,,,,,,,,,,,,,,,,,,,,,,,,,,,,,,,,,,,,,,,"3,5",
15112570,8ebd1af8-ad29-4e62-a688-7d0f9471f9c5,1590047107,120,1590044035,,0,0,13.03,3846,3941,353,340,,,0,4.3,0.76,1,1.11,509,809,152,169,,,,54.29,41.59,56.18,1,61.92,,,,3.6,0,98,97,,,,,,108,82,13.16,12.85,13.28,-8.8,4.4,301,301,,1,308,308,,,,,,,,,"13,7,15,16,14,15,20,0,0","0,14,64,22,0","0,0,47,52,1",,,,,124,,,,,,,,,,,,,,,21,,,,,,,,,,,,,,,,,,,,,53.6,13,4,132,78,,1023,1,329,0,3,3,Balve,1,0,I1.000|5:01-I1.000|4:51-I1.000|5:16-I1.000|5:39-I1.000|6:23-I1.000|5:28-I1.000|6:11-I1.000|5:21-I1.000|3:58-I1.000|4:04-I1.000|3:51-I1.000|3:49-I1.000|4:07-I0.026|0:07,,,,,3113,,250,0,,0,168070,250480,30378,,3978870,,,,,,,,,,,,,,,,,,,,,,,,,,,,,,,,,,,,,,,,"4,4,4",
15135948,99085031-df7c-4f60-bd28-ed9de7ea8834,1590065683,120,1590064824,,0,0,6.39,6018,6102,277,262,,,0,4.4,0.82,,,331,522,104,124,104,,,,,,1,,,,,1,0,,83,,,,,,42,55,,4.42,,-23.2,,,,,,,,,,,,,,,,"77,23,0,0,0,0","28,72,0,0,0",,,,,,,,,,,,,,,,,,,,,18,,,,,,,,,,,,,,,,,,,,,5.6,21,4,59,54,,1022,7,335,0,3,3,Hemer,1,0,,,,,,3113,,250,0,,0,168075,,30378,,3996427,,,,,,,,,,,,,,,,,,,,,,,,,,,,,,,,,,,,,,,,3,
15224488,b3c4a910-7193-48cb-8e81-7166c88d009b,1590167123,120,1590164040,,0,0,15.4,3949,3965,356,350,,,0,4.2,0.76,0.97,1.08,615,902,157,175,,,,61.65,49.61,63.45,1,61.65,,,,3.9,0.3,104,100,,,,,,127,83,14.88,14.76,15.02,-10.1,-0.5,351,351,,1,358,358,,,,,,,,,"3,4,5,12,20,19,15,21,0","0,3,61,36,0","0,0,14,74,12",,,,,141,,,,,,,,,,,,,,,18,,,,,,,,,,,,,,,,,,,,,69.1,22,14,226,51,,1018,2,320,0,4,3,Balve,1,0,I1.000|4:26-I1.000|4:47-I1.000|4:35-I1.000|5:01-I1.000|5:30-I1.000|4:43-I1.000|5:14-I1.000|4:43-I1.000|4:10-I1.000|3:46-I1.000|3:49-I1.000|3:23-I1.000|3:20-I1.000|3:19-I1.000|3:25-I0.403|1:36,,,,,3113,,250,0,,0,168070,250480,30378,,4071692,,,,,,,,,,,,,,,,,,,,,,,,,,,,,,,,,,,,,,,,"4,4,5",
15277546,72eb6233-7dea-49b7-a409-1d2d463c734e,1590255780,120,1590252663,,0,0,12.67,3427,3427,298,296,,,0,3.7,0.7,0.96,1.04,546,741,151,169,,,,61.04,45.94,62.83,1,61.73,,,,3.5,0.6,103,100,,,,,,94,82,14.11,13.99,14.33,-12.5,-2.7,330,330,,1,340,340,,,,,,,,,"1,9,14,15,17,11,27,6,0","0,12,73,14,0","0,1,29,58,12",,,,,135,,,,,,,,,,,,,,,19,,,,,,,,,,,,,,,,,,,,,44.7,16,18,258,51,,1023,2,370,0,4,3,Balve,1,0,I1.000|4:44-I1.000|5:13-I1.000|5:40-I1.000|5:19-I1.000|5:31-I1.000|5:12-I1.000|4:08-I1.000|4:22-I1.000|3:38-I1.000|3:40-I1.000|3:37-I1.000|3:30-I0.669|2:34,,,,,3113,,250,0,,0,168070,250480,30378,,4117328,,,,,,,,,,,,,,,,,,,,,,,,,,,,,,,,,,,,,,,,3,
15301347,95992033-3e76-4f84-a0a4-8d670a1668e3,1590311557,120,1590309729,,0,0,18.23,5054,5288,245,218,,,0,2,0.46,1.03,0.98,419,963,142,162,,,,64.39,45.94,65.58,1,62.32,,,,3.1,0.1,103,101,,,,,,110,81,13.27,13.11,13.44,-1.4,-2.4,313,313,,1,321,321,,,,,,,,,"1,1,4,17,36,37,4,0,0","0,38,61,0,0","0,2,37,57,4",,,,,134,,,,,,,,,,,,,,,22,,,,,,,,,,,,,,,,,,,,,31.8,11,19,255,75,,1028,2,377,0,5,3,Balve,1,0,I1.000|5:21-I1.000|4:45-I1.000|4:44-I1.000|5:14-I1.000|4:47-I1.000|4:38-I1.000|4:41-I1.000|4:35-I1.000|4:51-I1.000|4:45-I1.000|4:22-I1.000|4:26-I1.000|4:21-I1.000|4:11-I1.000|4:15-I1.000|4:13-I1.000|4:30-I1.000|4:34-I0.225|1:00,,,,,3113,,250,0,,0,168070,250480,30378,,4136635,,,,,,,,,,,,,,,,,,,,,,,,,,,,,,,,,,,,,,,,"5,5",
15324044,ac4cbbc5-9588-4ed5-a581-c95d42597ed8,1590338481,120,1590334183,,0,0,6.72,2843,2844,92,97,,,0,1.4,0.55,1.01,0.86,187,447,127,161,,,,43.94,25.83,44.64,1,62.32,,,,2.1,0,,100,,,,,,41,80,8.67,8.73,8.98,12.1,13.2,185,185,,1,197,197,,,,,,,,,"63,25,10,1,1,0,0,0,0","0,93,6,0,0","8,51,40,0,0",,,,,89,,,,,,,,,,,,,,,16,,,,,,,,,,,,,,,,,,,,,14.4,12,17,309,81,,1028,2,366,0,4,3,Balve,1,0,I1.000|6:32-I1.000|7:10-I1.000|6:55-I1.000|7:54-I1.000|6:22-I1.000|6:58-I0.723|5:32,,,,,3113,,250,0,,0,168070,250480,30378,,4156055,,,,,,,,,,,,,,,,,,,,,,,,,,,,,,,,,,,,,,,,5,
15370484,24a975de-5f10-4045-8e33-dc18268cd38c,1590429683,120,1590428476,,0,0,16.74,4825,5599,431,417,,,0,4.2,0.8,1.06,1.04,451,845,143,181,91,,,60.79,43.61,62.8,1,62.5,,,,3.4,2.1,102,101,,,,,,116,81,13.13,12.92,13.93,9.1,3.9,307,307,,1,335,335,,,,,,,,,"7,2,6,19,26,31,9,0,0","1,43,37,19,0","2,7,39,40,13",,,,,128,,,,,,,,,,,,,,,14,,,,,,,,,,,,,,,,,,,,,75.3,17,17,342,60,,1032,2,342,0,3,3,Balve,1,0,I1.000|5:10-I1.000|5:03-I1.000|4:26-I1.000|4:28-I1.000|4:32-I1.000|4:53-I1.000|4:42-I0.222|1:14-I0.259|1:03-I0.179|0:58-I0.257|1:02-I0.190|1:01-I0.268|1:01-I0.181|1:00-I0.264|1:01-I0.194|1:01-I0.255|1:01-I0.169|1:00-I0.244|1:00-I0.149|1:00-I0.244|1:01-I0.365|1:51-I0.273|1:00-I0.120|1:00-I0.204|1:01-I0.111|1:00-I0.142|0:36-I1.000|7:02-I1.000|4:14-I1.000|4:06-I1.000|4:12-I1.000|4:31-I0.448|2:18,,,,,3113,,250,0,,0,168070,250480,30378,,4192604,,,,,,,,,,,,,,,,,,,,,,,,,,,,,,,,,,,,,,,,"3,5,5",
15417923,ab6b92df-d2e1-43fe-8f58-babd3f166a71,1590518662,120,1590515832,,0,0,14.86,4118,4262,406,407,,,0,4.6,0.86,0.98,1.01,656,842,149,170,,,,60.35,45.21,62.39,1,62.19,,,,3.5,0.1,103,98,,,,,,107,82,13.9,13.48,14.13,-0.5,9.3,323,323,,1,333,333,,,,,,,,,"6,6,7,18,17,23,20,2,0","0,20,70,11,0","0,3,31,59,7",,,,,132,,,,,,,,,,,,,,,20,,,,,,,,,,,,,,,,,,,,,43,19,9,13,49,,1035,1,334,0,3,3,Balve,1,0,I1.000|4:56-I1.000|4:43-I1.000|4:58-I1.000|5:16-I1.000|5:41-I1.000|4:41-I1.000|5:17-I1.000|4:43-I1.000|3:51-I1.000|3:49-I1.000|3:42-I1.000|3:55-I1.000|3:58-I1.000|5:07-I0.859|4:03,,,,,3113,,250,0,,0,168070,250480,30378,,4231783,,,,,,,,,,,,,,,,,,,,,,,,,,,,,,,,,,,,,,,,"4,4,5,5",
15418759,47a435de-be22-48ab-a08a-75daf4a8d787,1590524078,120,1590517217,,0,0,1.15,305,305,0,35,,,0,1.1,0.83,,0.94,,63,137,150,,,,71.27,38.51,68.59,1,62.21,,,,1,0,,100,,,,,,5,80,12.61,13.97,12.97,20.2,22.4,277,277,,1,288,288,,,,,,,,,"0,0,5,10,42,27,9,8,0","2,41,57,0,0","0,0,83,11,6",,,,,141,,,,,,,,,,,,,,,16,,,,,,,,,,,,,,,,,,,,,11.3,17,8,26,50,,1034,0,335,0,3,3,Balve,1,0,I0.194|0:54-I0.958|4:11,,,,,3113,,250,0,,0,168070,250480,30378,,4232336,,,,,,,,,,,,,,,,,,,,,,,,,,,,,,,,,,,,,,,,,
15457336,68c8ba23-b83d-4fcd-9893-c426aa8ee894,1590603001,120,1590600211,,0,0,13.09,3810,4348,170,159,,,0,1.3,0.51,1,1.02,421,727,145,181,,,,58.96,42.29,59.97,1,62.75,,,,3.3,2.7,100,101,,,,,,95,81,12.65,13.34,13.51,7.9,-5.1,295,295,,1,330,330,,,,,,,,,"15,7,12,29,8,6,8,14,1","1,49,27,23,0","0,15,44,23,18",,,,,127,,,,,,,,,,,,,,,18,,,,,,,,,,,,,,,,,,,,,61.8,20,9,340,45,,1031,1,343,0,5,3,Balve,1,0,I1.000|5:38-I1.000|5:16-I1.000|5:05-I1.000|4:44-I0.078|0:26-I0.285|1:01-I0.226|1:01-I0.539|2:01-I0.395|2:01-I0.842|3:01-I0.547|3:00-I0.896|3:02-I0.516|3:01-I0.898|3:00-I0.526|3:02-I0.634|2:02-I0.316|2:01-I0.360|1:03-I1.000|7:14-I1.000|5:41-I0.032|0:10,,,,,3113,,250,0,,0,168070,250480,30378,,4264623,,,,,,,,,,,,,,,,,,,,,,,,,,,,,,,,,,,,,,,,5,
15488020,a4945828-1706-4f77-978d-0c42e8ad18b5,1590677686,120,1590678399,1590697909,0,0,19.92,6478,6912,804,805,,,4,6.5,0.83,1.16,1.11,828,1125,142,176,106,,,52.87,38.42,55.51,1,62.04,,,,3.6,1.4,99,97,,,,,,158,82,12.42,11.51,13.94,6,2.2,288,287,,1,343,343,,,,,,,,,"11,5,18,26,32,8,0,0,0","1,52,14,33,0","4,26,29,19,22",,,,,113,,,,,,,,,,,,,,,15,,,,,,,,,,,,,,,,,,,,,62.8,18,16,17,35,,1032,6,361,0,3,3,Balve,1,0,I1.000|5:00-I0.733|3:50-I1.612|8:31-I1.622|8:31-I1.609|8:35-I1.624|8:30-I1.602|8:35-I1.626|8:33-I1.612|8:50-I1.633|10:38-I1.608|8:44-I1.677|9:35-I1.000|5:23-I0.960|4:43,,,,,3113,,250,0,,0,168070,250480,30378,,4285773,,,,,,,,,,,,,,,,,,,,,,,,,,,,,,,,,,,,,,,,"3,4,4,4,4",
15541936,622ccca3-9f00-41ca-9bc9-adf89735c3e7,1590774322,120,1590771574,,0,0,12.3,3684,4410,359,269,,,0,4.7,0.71,1.03,1.1,751,642,139,171,,,,60.18,40.71,62.91,1,62.12,,,,3.1,0,104,99,,,,,,77,81,13.07,12.59,13.4,-11.4,5.5,306,306,,1,331,331,,,,,,,,,"16,7,8,14,22,26,7,0,0","1,55,34,10,0","0,5,46,43,5",,,,,124,,,,,,,,,,,,,,,13,,,,,,,,,,,,,,,,,,,,,47.6,19,14,50,36,,1026,2,361,0,3,3,Balve,1,0,I1.000|4:53-I1.000|4:51-I1.000|5:00-I1.000|6:46-I1.000|6:29-I1.000|5:22-I1.000|5:43-I1.000|4:39-I1.000|4:01-I1.000|4:08-I1.000|3:57-I1.000|4:15-I0.300|1:20,,,,,3113,,250,0,,0,168070,250480,30378,,4329383,,,,,,,,,,,,,,,,,,,,,,,,,,,,,,,,,,,,,,,,"3,5",
15563717,e3434a5b-6cd0-46a0-a991-9f370bf8c727,1590836394,120,1590835531,,0,0,20.22,5781,6293,582,511,,,0,5,0.79,1.06,1.01,632,1233,154,175,,,,55.43,44.69,57.65,1,61.82,,,,4.1,0.2,100,99,,,,,,172,83,13.56,12.93,13.83,1.2,6.5,313,313,,1,327,327,,,,,,,,,"3,6,10,20,25,23,12,0,0","0,5,71,23,0","0,4,38,49,9",,,,,126,,,,,,,,,,,,,,,23,,,,,,,,,,,,,,,,,,,,,58,18,16,69,36,,1024,5,352,0,3,3,Balve,1,0,I1.000|5:01-I1.000|4:48-I1.000|4:55-I1.000|5:07-I1.000|5:45-I1.000|4:58-I1.000|5:16-I1.000|4:46-I1.000|4:15-I1.000|4:45-I1.000|4:03-I1.000|5:21-I1.000|5:12-I1.000|5:15-I1.000|5:03-I1.000|4:16-I1.000|3:57-I1.000|3:57-I1.000|4:12-I1.000|4:22-I0.215|1:07,,,,,3113,,250,0,,0,168070,250480,30378,,4346966,,,,,,,,,,,,,,,,,,,,,,,,,,,,,,,,,,,,,,,,"4,4,4,5",
15602480,cc0360ca-f12e-4818-aa78-e3c6b2690771,1590918600,120,1590919041,1590927673,0,0,10.38,2380,2380,232,237,,,0,3,0.81,1.04,1,599,663,177,198,123,,,58.76,54.92,60.35,1,61.57,,,,5,4.3,103,96,,,,,,125,86,16.48,16.2,16.52,3,13.2,398,398,,1,403,403,,,,,,,,,"0,0,0,3,17,28,13,37,2","0,2,9,41,48","0,0,2,48,49",,,,,152,,,,,,,,,,,,,,,17,,,,,,,,,,,,,,,,,,,,,153.8,14,14,55,50,,1023,3,340,0,5,3,Balve,1,0,I1.000|4:08-I1.000|4:39-I1.000|4:23-I1.000|4:29-I1.000|4:13-I1.000|3:19-I1.000|3:17-I1.000|3:21-I1.000|3:15-I1.000|3:19-I0.381|1:18,,,,,3113,,250,0,,0,168070,250484,30378,,4380091,,,,,,,,,,,,,,,,,,,,,,10.38,2380,,,0,,,,,,,,0,0,30378,15602480,,,4,
15651759,fb3350a2-a633-4ca9-a19e-f12bc0284994,1590998884,120,1591000581,,0,0,3.74,1159,1196,69,63,,,0,1.5,0.73,1.06,1.05,304,230,139,160,105,,,57.7,36.21,59.13,1,61.41,,,,2.2,0,99,98,,,,,,23,80,11.98,11.7,12.21,5.2,14.1,272,272,,1,282,282,,,,,,,,,"1,3,18,44,33,1,0,0,0","1,59,40,0,0","0,9,64,27,0",,,,,121,,,,,,,,,,,,,,,15,,,,,,,,,,,,,,,,,,,,,25.4,13,4,70,69,,1024,1,335,0,3,3,Balve,1,0,I1.000|5:35-I1.000|5:13-I1.000|4:57-I0.743|3:34,,,,,3113,,250,0,,0,168070,250480,30378,,4417440,,,,,,,,,,,,,,,,,,,,,,,,,,,,,,,,,,,,,,,,5,
15651762,00436e00-e6e1-48f4-9867-83d55a02db4f,1591000401,120,1591000586,,0,0,6.96,1638,1638,133,132,,,0,2.2,0.68,1.05,0.99,528,409,164,179,,,,64.22,51.99,65.76,1,61.35,,,,3.5,1.4,103,94,,,,,,64,86,15.95,15.68,16.07,1.8,10.4,385,385,,1,396,396,,,,,,,,,"0,0,0,16,6,21,30,27,0","1,4,23,72,0","0,0,7,62,30",,,,,148,,,,,,,,,,,,,,,17,,,,,,,,,,,,,,,,,,,,,78.1,15,4,65,65,,1024,2,336,0,3,3,Balve,1,0,I1.000|3:46-I1.000|4:17-I1.000|4:38-I1.000|4:22-I1.000|3:31-I1.000|3:23-I0.961|3:22,,,,,3113,,250,0,,0,168070,250480,30378,,4417443,,,,,,,,,,,,,,,,,,,,,,,,,,,,,,,,,,,,,,,,4,
15651780,f54cba72-bd35-4e14-afd4-227bfba1365a,1591002810,120,1591000616,,0,0,10.43,2857,2857,247,236,,,0,3.1,0.87,0.97,1.02,538,674,160,176,124,,,55.27,44.63,56.96,1,61.23,,,,3.7,0.6,99,98,,,,,,99,83,13.85,13.55,14,-6.7,6,323,323,,1,332,332,,,,,,,,,"0,2,14,20,18,23,22,1,0","0,1,40,59,0","0,1,29,62,7",,,,,132,,,,,,,,,,,,,,,22,,,,,,,,,,,,,,,,,,,,,66.9,16,8,46,59,,1024,3,334,0,5,3,Balve,1,0,I1.000|4:34-I1.000|5:20-I1.000|5:18-I1.000|5:30-I1.000|5:07-I1.000|4:03-I1.000|3:56-I1.000|4:06-I1.000|4:00-I1.000|3:57-I0.434|1:47,,,,,3113,,250,0,,0,168070,250480,30378,,4417459,,,,,,,,,,,,,,,,,,,,,,,,,,,,,,,,,,,,,,,,4,
15651781,d600f38a-e256-4c4f-81ab-024da428f4f0,1591007300,120,1591000617,,0,0,1.01,335,335,4,2,,,0,0,0,1,,,65,133,140,,,,56.1,29.47,56.52,1,61.18,,,,0.9,0,,99,,,,,,5,83,10.95,10.94,11.06,5.7,6.4,249,249,,1,252,252,,,,,,,,,"0,16,27,57,0,0,0,0,0","3,97,0,0,0","0,2,98,0,0",,,,,109,,,,,,,,,,,,,,,17,,,,,,,,,,,,,,,,,,,,,9.4,19,7,34,51,,1023,4,333,0,3,3,Balve,1,0,I1.000|5:31-I0.010|0:04,,,,,3113,,250,0,,0,168070,250480,30378,,4417460,,,,,,,,,,,,,,,,,,,,,,,,,,,,,,,,,,,,,,,,,
15680343,30e31cd5-1d89-4cb8-a5fb-ac2f08d24336,1557435396,120,1591036457,,0,0,5.6,1545,1550,52,44,,,4,0,0.18,3.17,0.02,,70,79,115,,,,,,,1,,,,,,,,,,,,,,3,,,15.72,,42.3,-9.3,55,32,,1,74,59,,,,,,,,,"36,61,2,0,0,0,0","98,2,0,0,0","91,8,1,0,0",,,,,,,,,,,,,,,,,,,,,,,,,,,,,,,,,,,,,,,,,1.1,12,18,245,79,,1006,0,389,1,5,3,Karlsruhe,1,0,I5.590|24:42-I0.013|1:02-I0.000|0:07,,Cycling,,,,"Polar M430",43,0,,0,168072,,30378,,,,,,,,,,,,,,,,,,,,,,,,,,,,,,,,,,,,,,,,,,,
15680364,ca178707-4f3b-4189-9c91-129618817ef1,1557388213,120,1591036463,,0,0,11.82,4372,4387,52,61,,,4,0,0.1,,0.07,,245,89,127,,,,,,,1,,,,,,,,,,,,,,11,,,16,,69.8,24.6,48,22,,1,69,54,,,,,,,,,"57,22,21,0,0,0,0","79,21,0,0,0","92,8,0,0,0",,,,,,,,,,,,,,,,,,,,,,,,,,,,,,,,,,,,,,,,,3.9,9,6,227,89,,1001,1,411,0,5,3,Karlsruhe,1,0,,,Cycling,,,,"Polar M430",43,0,,0,168072,,30378,,,,,,,,,,,,,,,,,,,,,,,,,,,,,,,,,,,,,,,,,,,
15680368,7b7420c2-68de-4ba0-a5ad-8eb58b802603,1557736369,120,1591036464,,0,0,11.08,2113,2207,63,70,,,4,0,0.13,2.94,,,386,128,165,,,,,,,1,,,,,,,,,,,,,,38,,,19.72,,21.5,11.1,63,45,,1,76,67,,,,,,,,,"12,30,59,0,0,0,0","26,24,49,2,0","88,12,0,0,0",,,,,,,,,,,,,,,,,,,,,,,,,,,,,,,,,,,,,,,,,34.7,7,19,19,75,,1036,1,388,0,5,3,Karlsruhe,1,0,,,Cycling,,,,"Polar M430",43,0,,0,168072,,30378,,,,,,,,,,,,,,,,,,,,,,,,,,,,,,,,,,,,,,,,,,,
15680392,7ca41f4d-b74c-4460-8578-d05ed76458bf,1557771074,120,1591036468,,0,0,10.25,1789,1806,70,67,,,4,0,0.08,,,,354,133,156,,,,,,,1,,,,,,,,,,,,,,34,,,21.06,,20.5,18.2,64,53,,1,78,72,,,,,,,,,"5,22,72,1,0,0,0","14,30,56,0,0","84,16,0,0,0",,,,,,,,,,,,,,,,,,,,,,,,,,,,,,,,,,,,,,,,,29.3,16,25,39,29,,1033,2,350,0,3,3,Eggenstein-Leopoldshafen,1,0,,,Cycling,,,,"Polar M430",43,0,,0,168072,,30378,,,,,,,,,,,,,,,,,,,,,,,,,,,,,,,,,,,,,,,,,,,
15680408,218fb166-90ea-4917-af54-718b39a898a0,1557820659,120,1591036471,,0,0,11.31,2033,2034,59,68,,,4,0,0.07,,,,509,153,169,,,,,,,1,,,,,,,,,,,,,,63,,,20.5,,4.6,-6.6,57,44,,1,67,59,,,,,,,,,"6,23,71,0,0,0,0","9,4,34,53,0","91,9,0,0,0",,,,,,,,,,,,,,,,,,,,,,,,,,,,,,,,,,,,,,,,,57.9,7,15,34,75,,1032,1,353,0,3,3,Karlsruhe,1,0,,,Cycling,,,,"Polar M430",43,0,,0,168072,,30378,,,,,,,,,,,,,,,,,,,,,,,,,,,,,,,,,,,,,,,,,,,
15680425,1cb7a4af-b085-4804-8a54-f6f2c0f2eec8,1557165406,120,1591036475,,0,0,4.91,983,1105,32,32,,,4,0,0.12,,,,167,125,166,,,,,,,1,,,,,,,,,,,,,,16,,,20.17,,40.7,1.6,65,49,,1,79,71,,,,,,,,,"20,22,50,8,0,0,0","27,35,28,10,0","84,16,0,0,0",,,,,,,,,,,,,,,,,,,,,,,,,,,,,,,,,,,,,,,,,27.1,13,3,31,44,,1021,1,405,0,5,3,Karlsruhe,1,0,I4.912|17:47-I0.000|0:05-I0.000|0:01-I0.000|0:01-I0.000|0:01-I0.000|0:01-I0.000|0:01-I0.000|0:01-I0.000|0:03-I0.000|0:07-I0.000|0:18,,Cycling,,,,"Polar M430",43,0,,0,168072,,30378,,,,,,,,,,,,,,,,,,,,,,,,,,,,,,,,,,,,,,,,,,,
15680723,d64fa550-7ec3-4090-8dee-b21708b95f1a,1558029556,120,1591036568,,0,0,7.31,1385,1652,59,58,,,4,0,0.14,2.65,,,282,138,162,,,,,,,1,,,,,,,,,,,,,,29,,,20.21,,27.7,15,67,50,,1,87,78,,,,,,,,,"10,27,61,2,0,0,0","9,18,72,1,0","84,16,0,0,0",,,,,,,,,,,,,,,,,,,,,,,,,,,,,,,,,,,,,,,,,26.6,16,9,30,49,,1013,1,371,0,3,3,Eggenstein-Leopoldshafen,1,0,I7.312|23:11-I0.000|0:09,,Cycling,,,,"Polar M430",43,0,,0,168072,,30378,,,,,,,,,,,,,,,,,,,,,,,,,,,,,,,,,,,,,,,,,,,
15680748,6b423587-ef76-43de-b13f-f8291324eaee,1558634374,120,1591036574,,0,0,6.9,1502,1521,47,48,,,4,0,0.15,2.61,0.03,,245,125,167,,,,,,,1,,,,,,,,,,,,,,24,,,19.71,,34,-4.2,68,43,,1,84,71,,,,,,,,,"25,15,57,2,0,0,0","20,48,29,3,0","83,17,0,0,0",,,,,,,,,,,,,,,,,,,,,,,,,,,,,,,,,,,,,,,,,24.5,22,7,68,40,,1018,2,337,0,3,3,Eggenstein-Leopoldshafen,1,0,I6.904|25:04-I0.000|0:02,,Cycling,,,,"Polar M430",43,0,,0,168072,,30378,,,,,,,,,,,,,,,,,,,,,,,,,,,,,,,,,,,,,,,,,,,
15680750,476e0484-0815-412d-b9e1-774fda2c6dad,1558654625,120,1591036574,,0,0,5.21,940,941,43,35,,,4,0,0.16,2.24,,,57,80,107,,,,,,,1,,,,,,,,,,,,,,2,,,21.06,,33.6,10.1,70,53,,1,83,73,,,,,,,,,"16,18,53,14,0,0,0","89,11,0,0,0","82,18,0,0,0",,,,,,,,,,,,,,,,,,,,,,,,,,,,,,,,,,,,,,,,,1.5,13,5,90,72,,1017,0,341,1,3,3,Karlsruhe,1,0,,,Cycling,,,,"Polar M430",43,0,,0,168072,,30378,,,,,,,,,,,,,,,,,,,,,,,,,,,,,,,,,,,,,,,,,,,
15680757,de6597b4-ab41-40d5-81d7-4ceadc7b8acb,1559029942,120,1591036577,,0,0,11.02,1905,1906,66,75,,,4,0,0.09,,,,414,139,164,,,,,,,1,,,,,,,,,,,,,,47,,,21.66,,19.8,-15.2,67,50,,1,79,71,,,,,,,,,"9,8,81,3,0,0,0","17,7,61,15,0","84,16,0,0,0",,,,,,,,,,,,,,,,,,,,,,,,,,,,,,,,,,,,,,,,,43.2,13,18,194,93,,1007,1,349,0,6,3,Karlsruhe,1,0,,,Cycling,,,,"Polar M430",43,0,,0,168072,,30378,,,,,,,,,,,,,,,,,,,,,,,,,,,,,,,,,,,,,,,,,,,
15680771,1d8794a4-86a9-4574-843b-050cfa7ce5c4,1558599103,120,1591036580,,0,0,11.55,1768,1769,78,83,,,4,0,0.18,,,,362,136,160,,,,,,,1,,,,,,,,,,,,,,35,,,26.62,,42.8,64,91,77,,1,152,146,,,,,,,,,"4,27,39,9,10,8,2","13,26,61,0,0","71,21,4,4,0",,,,,,,,,,,,,,,,,,,,,,,,,,,,,,,,,,,,,,,,,29.4,10,2,180,85,,1020,1,341,0,3,3,Karlsruhe,1,0,I11.553|30:28-I0.000|0:07-I0.000|0:02,,Cycling,,,,"Polar M430",43,0,,0,168072,,30378,,,,,,,,,,,,,,,,,,,,,,,,,,,,,,,,,,,,,,,,,,,
15680796,ef0bacf8-156f-484b-89d2-44c940edfced,1558039947,120,1591036585,,0,0,5.95,1405,1592,56,49,,,4,0,0.1,2.5,,,197,114,157,,,,,,,1,,,,,,,,,,,,,,17,,,17.14,,49.9,-25.9,62,43,,1,95,84,,,,,,,,,"28,66,6,0,0,0,0","33,48,19,0,0","86,11,3,0,0",,,,,,,,,,,,,,,,,,,,,,,,,,,,,,,,,,,,,,,,,16.2,14,9,39,64,,1012,0,376,0,3,3,Eggenstein-Leopoldshafen,1,0,I5.950|23:53-I0.027|0:07,,Cycling,,,,"Polar M430",43,0,,0,168072,,30378,,,,,,,,,,,,,,,,,,,,,,,,,,,,,,,,,,,,,,,,,,,
15680838,963de536-35e3-41f3-94ea-3a395a84d094,1559064019,120,1591036597,,0,0,10.98,1770,1773,80,73,,,4,0,0.15,,,,440,151,169,,,,,,,1,,,,,,,,,,,,,,52,,,22.57,,15.1,23.1,70,61,,1,86,81,,,,,,,,,"1,9,86,4,0,0,0","9,5,40,46,0","79,21,0,0,0",,,,,,,,,,,,,,,,,,,,,,,,,,,,,,,,,,,,,,,,,57.6,17,18,258,53,,1011,2,360,0,4,3,Eggenstein-Leopoldshafen,1,0,,,Cycling,,,,"Polar M430",43,0,,0,168072,,30378,,,,,,,,,,,,,,,,,,,,,,,,,,,,,,,,,,,,,,,,,,,
15680846,74ec7f59-faf5-40f7-8da5-9386837afea8,1559117732,120,1591036598,,0,0,11.09,2020,2096,76,85,,,4,0,0.11,2.5,0.21,,72,91,120,,,,,,,1,,,,,,,,,,,,,,2,,,21.44,,,,67,50,,1,82,73,,,,,,,,,"13,17,63,7,0,0,0","23,77,0,0,0","82,18,0,0,0",,,,,,,,,,,,,,,,,,,,,,,,,,,,,,,,,,,,,,,,,2.5,12,4,207,93,,1019,1,373,0,5,3,Karlsruhe,1,0,,,Cycling,,,,"Polar M430",43,0,,0,168072,,30378,,,,,,,,,,,,,,,,,,,,,,,,,,,,,,,,,,,,,,,,,,,
15680885,75d284d8-9abc-4419-82e9-e442851ef71f,1557914087,120,1591036608,,0,0,10.88,2211,2218,67,76,,,4,0,0.15,2.14,0.49,,225,100,149,,,,,,,1,,,,,,,,,,,,,,16,,,18.83,,24.9,8.3,59,42,,1,74,63,,,,,,,,,"15,55,29,2,0,0,0","54,40,6,0,0","88,12,0,0,0",,,,,,,,,,,,,,,,,,,,,,,,,,,,,,,,,,,,,,,,,12.7,10,14,51,60,,1025,3,364,0,3,3,Karlsruhe,1,0,,,Cycling,,,,"Polar M430",43,0,,0,168072,,30378,,,,,,,,,,,,,,,,,,,,,,,,,,,,,,,,,,,,,,,,,,,
15680893,afff680a-e862-45ad-b8a7-51982947f0c2,1558168996,120,1591036610,,0,0,3.47,803,822,18,19,,,4,0,0.06,1.43,0.15,,122,120,171,,,,,,,1,,,,,,,,,,,,,,13,,,19.07,,61.1,40.1,59,46,,1,78,69,,,,,,,,,"44,16,34,4,2,0,0","44,13,27,16,0","90,9,1,0,0",,,,,,,,,,,,,,,,,,,,,,,,,,,,,,,,,,,,,,,,,29.2,15,6,116,73,,1006,2,349,0,5,3,Karlsruhe,1,0,I2.323|9:01-I0.021|0:03-I1.125|4:37,,Cycling,,,,"Polar M430",43,0,,0,168072,,30378,,,,,,,,,,,,,,,,,,,,,,,,,,,,,,,,,,,,,,,,,,,
15680898,cf062d3a-a3fc-4d5f-bc4d-af77fafa6a2b,1558374754,120,1591036611,,0,0,11.14,2034,2040,87,78,,,4,0,0.13,2.26,,,458,143,165,,,,,,,1,,,,,,,,,,,,,,49,,,20.44,,8,15.4,61,50,,1,75,69,,,,,,,,,"7,28,64,1,0,0,0","9,13,63,15,0","85,15,0,0,0",,,,,,,,,,,,,,,,,,,,,,,,,,,,,,,,,,,,,,,,,44.9,17,13,312,72,,1006,1,342,0,6,3,Eggenstein-Leopoldshafen,1,0,,,Cycling,,,,"Polar M430",43,0,,0,168072,,30378,,,,,,,,,,,,,,,,,,,,,,,,,,,,,,,,,,,,,,,,,,,
15680900,247b655a-bfb4-4fd6-ad0a-ad9b5cb1872b,1558339166,120,1591036611,,0,0,11.02,1885,3023,72,79,,,4,0,0.22,,,,483,155,174,,,,,,,1,,,,,,,,,,,,,,61,,,21.45,,7.6,-25.8,65,52,,1,78,70,,,,,,,,,"5,16,76,3,0,0,0","7,6,29,58,0","85,15,0,0,0",,,,,,,,,,,,,,,,,,,,,,,,,,,,,,,,,,,,,,,,,61.9,15,16,213,90,,1004,1,351,0,4,3,Karlsruhe,1,0,,,Cycling,,,,"Polar M430",43,0,,0,168072,,30378,,,,,,,,,,,,,,,,,,,,,,,,,,,,,,,,,,,,,,,,,,,
15680913,fbf0fafe-5c0c-43d4-90ab-22bb2e6e7d79,1558982014,120,1591036615,,0,0,10.45,2029,2030,67,61,,,4,0,0.12,3.33,2.7,,407,135,155,,,,,,,1,,,,,,,,,,,,,,39,,,19.76,,18.4,-25.8,72,56,,1,100,90,,,,,,,,,"13,22,64,1,0,0,0","11,25,64,0,0","82,15,2,1,0",,,,,,,,,,,,,,,,,,,,,,,,,,,,,,,,,,,,,,,,,27.6,18,9,263,67,,1009,1,330,0,4,3,Eggenstein-Leopoldshafen,1,0,,,Cycling,,,,"Polar M430",43,0,,0,168072,,30378,,,,,,,,,,,,,,,,,,,,,,,,,,,,,,,,,,,,,,,,,,,
15681251,3166ceec-c498-4e48-8b7e-f4df8a8c3119,1559149664,120,1591036701,,0,0,10.62,2109,2141,79,75,,,4,0,0.15,3.66,,,228,131,155,,,,,,,1,,,,,,,,,,,,,,39,,,19.34,,35.3,74.6,75,55,,1,193,178,,,,,,,,,"17,31,52,1,0,0,0","17,21,62,0,0","87,11,0,0,1",,,,,,,,,,,,,,,,,,,,,,,,,,,,,,,,,,,,,,,,,26.8,19,4,31,50,,1021,3,362,0,5,3,Eggenstein-Leopoldshafen,1,0,,,Cycling,,,,"Polar M430",43,0,,0,168072,,30378,,,,,,,,,,,,,,,,,,,,,,,,,,,,,,,,,,,,,,,,,,,
15681298,14dcc5db-110a-4354-9c3c-8a652f786530,1566099889,120,1591036711,,0,0,4.27,25274,25286,19,36,,,4,0,0.29,,,,1045,118,146,,,,,,,1,,,,,,,,,,,,,,34,,,3.25,,92.8,,,,,,,,,,,,,,,,"93,7,0,0,0,0","89,10,0,0,0",,,,,,,,,,,,,,,,,,,,,,,,,,,,,,,,,,,,,,,,,,13.4,16,6,164,91,,1012,0,283,0,4,3,Möglingen,1,0,I0.000|0:05-I4.268|7:01:23,,Hiking,,,,"Polar M430",43,0,,0,168075,,30378,,,,,,,,,,,,,,,,,,,,,,,,,,,,,,,,,,,,,,,,,,,
15681307,3eaace9b-c3de-4f0b-af49-d6302629d1ca,1559633929,120,1591036713,,0,0,11.39,2419,2423,77,86,,,4,0,0.21,2.4,2.21,,272,135,162,,,,,,,1,,,,,,,,,,,,,,50,,,19.09,,14.5,16.6,67,46,,1,96,84,,,,,,,,,"24,24,52,1,0,0,0","14,25,60,1,0","86,12,1,1,0",,,,,,,,,,,,,,,,,,,,,,,,,,,,,,,,,,,,,,,,,37,19,8,85,82,,1013,1,340,0,3,3,Karlsruhe,1,0,I11.393|40:46-I0.000|0:03,,Cycling,,,,"Polar M430",43,0,,0,168072,,30378,,,,,,,,,,,,,,,,,,,,,,,,,,,,,,,,,,,,,,,,,,,
15681352,1cc1751d-5cb3-4be1-bc7e-a824d4db1446,1560168402,120,1591036725,,0,0,4.5,1887,1955,42,32,,,4,0,0.09,1.16,0.94,,280,163,180,,,,31.71,25.45,32.17,1,,,,,,,,,,,,,,70,86,8.7,8.63,8.83,-0.1,-6.3,187,187,,1,191,191,,,,,,,,,"89,5,4,1,1,0,0,0,0","1,3,16,80,0","0,72,26,2,0",,,,,83,,,,,,,,,,,,,,,,,,,,,,,,,,,,,,,,,,,,74.7,19,3,252,76,,1013,5,333,0,5,3,Karlsruhe,1,0,I1.000|6:52-I1.000|7:14-I1.000|7:16-I1.000|7:12-I0.497|2:59,,Running,,,,"Polar M430",43,0,,0,168070,250480,30378,,,,,,,,,,,,,,,,,,,,,,,,,,,,,,,,,,,,,,,,,,,
15715643,4b2945dd-38ed-4371-bb2a-219421f11c66,1591121730,120,1591118267,,0,0,11.15,3550,3654,319,311,,,0,4.5,0.67,0.99,1.08,715,612,140,169,,,,55.29,37.62,57.3,1,61.02,,,,3.1,0,100,100,,,,,,76,80,12.3,11.83,12.56,-8.4,5,278,278,,1,287,287,,,,,,,,,"23,5,7,21,27,16,2,0,0","0,55,35,10,0","0,7,55,38,0",,,,,118,,,,,,,,,,,,,,,20,,,,,,,,,,,,,,,,,,,,,46.3,25,5,199,34,,1014,1,340,0,5,3,Balve,1,0,I1.000|5:08-I1.000|4:57-I1.000|5:06-I1.000|7:30-I1.000|6:24-I1.000|5:51-I1.000|5:42-I1.000|4:39-I1.000|4:26-I1.000|4:28-I1.000|4:16-I0.149|0:42,,,,,3113,,250,0,,0,168070,250480,30378,,4469568,,,,,,,,,,,,,,,,,,,,,,,,,,,,,,,,,,,,,,,,2,
15762758,aeb886e7-d659-44df-a6f7-cfa38892fabb,1591212772,120,1591206297,,0,0,1,370,379,20,17,,,0,1.3,0.6,1.34,0.93,,63,124,132,,,,53.31,25.98,54.82,1,61.65,,,,0.6,0,,100,,,,,,4,80,9.98,9.84,11.17,19.1,37.6,225,225,,1,256,256,,,,,,,,,"22,40,38,0,0,0,0,0,0","1,99,0,0,0","0,49,41,4,6",,,,,101,,,,,,,,,,,,,,,19,,,,,,,,,,,,,,,,,,,,,6,21,10,315,50,,1002,0,343,0,4,3,Balve,1,0,I1.000|6:09-I0.004|0:02,,,,,3113,,250,0,,0,168070,250480,30378,,4509601,,,,,,,,,,,,,,,,,,,,,,,,,,,,,,,,,,,,,,,,,
15762764,da860865-d696-4a50-967f-3ca621d70d80,1591208678,120,1591206304,,0,0,1.03,348,348,11,0,,,0,0,0.02,1.04,,,66,131,140,,,,55.87,28.92,57.35,1,61.05,,,,0.9,0,,100,,,,,,5,79,11.04,10.73,11.1,-1.7,-3.6,255,255,,1,256,256,,,,,,,,,"5,3,50,42,0,0,0,0,0","3,97,0,0,0","0,4,96,0,0",,,,,112,,,,,,,,,,,,,,,19,,,,,,,,,,,,,,,,,,,,,8.8,23,10,256,42,,1002,1,345,0,4,3,Balve,1,0,I1.000|5:37-I0.031|0:11,,,,,3113,,250,0,,0,168070,250480,30378,,4509606,,,,,,,,,,,,,,,,,,,,,,,,,,,,,,,,,,,,,,,,,
15762771,2e735173-ad55-45df-8b3b-40b2d48a1af2,1591209265,120,1591206314,,0,0,11.66,2834,3026,76,75,,,0,0,0.19,1.04,1,,679,161,180,,,,63.46,51.71,63.98,1,61.65,,,,3.8,0.8,101,99,,,,,,99,83,14.9,14.88,14.97,-2.2,-3.5,363,363,,1,366,366,,,,,,,,,"0,0,0,0,9,51,38,2,0","0,2,35,63,0","0,0,1,87,12",,,,,149,,,,,,,,,,,,,,,19,,,,,,,,,,,,,,,,,,,,,72.1,22,10,256,42,,1002,1,345,0,4,3,Balve,1,0,I1.000|4:20-I1.000|4:08-I1.000|4:07-I1.000|4:09-I1.000|4:11-I1.000|4:14-I1.000|4:02-I1.000|4:09-I1.000|3:57-I1.000|3:56-I1.000|3:38-I0.664|2:23,,,,,3113,,250,0,,0,168070,250480,30378,,4509613,,,,,,,,,,,,,,,,,,,,,,,,,,,,,,,,,,,,,,,,,
15795837,b0c56a28-324d-414d-aef4-fb26adb7cd34,1591295231,120,1591293405,,0,0,16.01,4699,5326,387,374,,,0,4.4,0.71,1.05,0.99,475,945,148,170,,,,56.75,42.55,58.5,1,61.56,,,,3.6,0,100,100,,,,,,120,82,12.99,12.56,13.3,3.2,18.9,305,305,,1,329,329,,,,,,,,,"6,4,12,27,21,27,4,0,0","0,18,71,10,0","0,9,39,45,7",,,,,125,,,,,,,,,,,,,,,17,,,,,,,,,,,,,,,,,,,,,49.7,12,12,295,93,,996,1,379,0,6,3,Balve,1,0,I1.000|5:20-I1.000|5:14-I1.000|4:47-I1.000|4:45-I1.000|5:10-I1.000|5:28-I1.000|5:48-I1.000|4:44-I1.000|5:41-I1.000|5:15-I1.000|4:19-I1.000|4:19-I1.000|4:21-I1.000|4:42-I1.000|3:57-I1.000|4:27-I0.005|0:02,,,,,3113,,250,0,,0,168070,250480,30378,,4535833,,,,,,,,,,,,,,,,,,,,,,,,,,,,,,,,,,,,,,,,3,
15819884,50ce2d30-566f-4f12-98cf-3e0883e1155f,1591369718,120,1591365295,,0,0,7.83,2269,2750,234,219,,,0,3.9,0.77,1.06,0.94,941,484,146,169,,,,58.73,41,61.04,1,61.81,,,,3,0.1,103,100,,,,,,55,82,13.51,12.92,13.97,14.3,26.3,310,310,,1,330,330,,,,,,,,,"17,6,6,6,15,45,6,0,0","1,19,77,3,0","0,2,45,40,12",,,,,126,,,,,,,,,,,,,,,16,,,,,,,,,,,,,,,,,,,,,34.5,9,21,218,100,,993,3,389,0,6,3,Balve,1,0,I1.000|4:36-I1.000|4:18-I1.000|4:39-I1.000|6:07-I1.000|6:19-I1.000|4:07-I1.000|4:11-I0.831|3:32,,,,,3113,,250,0,,0,168070,250480,30378,,4556390,,,,,,,,,,,,,,,,,,,,,,,,,,,,,,,,,,,,,,,,"3,5",
15859480,509d6d42-54da-426a-9fed-a01dfac9e75c,1591466598,120,1591460942,,0,0,4.89,1465,1465,80,76,,,0,1.4,0.59,0.98,0.96,320,294,139,158,,,,60.16,38.32,61.44,1,61.58,,,,2.3,0,100,100,,,,,,29,81,12.32,12.15,12.38,-1.6,3.8,283,283,,1,287,287,,,,,,,,,"2,3,12,38,23,20,1,0,0","1,52,47,0,0","0,3,63,34,0",,,,,124,,,,,,,,,,,,,,,14,,,,,,,,,,,,,,,,,,,,,21,15,19,234,59,,1001,2,366,0,5,3,Balve,1,0,I1.000|5:15-I1.000|5:16-I1.000|5:25-I1.000|4:30-I0.888|3:59,,,,,3113,,250,0,,0,168070,250480,30378,,4585900,,,,,,,,,,,,,,,,,,,,,,,,,,,,,,,,,,,,,,,,5,
15879836,3743599e-3b32-4bda-a81f-d3b66fa60aa9,1591517214,120,1591519764,,0,0,31.01,8865,9621,682,656,,,0,4.6,0.69,1.02,1.04,439,1663,149,175,,,,58.08,46.14,59.72,1,61.18,,,,4.1,0.1,97,99,,,,,,234,83,13.23,12.88,13.41,0.7,3,305,305,,1,315,315,,,,,,,,,"3,5,9,23,23,30,8,0,0","0,17,71,12,0","0,3,38,55,3",,,,,126,,,,,,,,,,,,,,,21,,,,,,,,,,,,,,,,,,,,,56,10,19,221,78,,1005,1,370,0,5,3,Balve,1,0,I1.000|5:11-I1.000|5:14-I1.000|5:28-I1.000|5:53-I1.000|4:25-I1.000|4:15-I1.000|4:07-I1.000|4:17-I1.000|4:27-I1.000|4:23-I1.000|4:57-I1.000|5:01-I1.000|5:16-I1.000|5:22-I1.000|5:40-I1.000|5:04-I1.000|5:27-I1.000|5:08-I1.000|4:36-I1.000|4:35-I1.000|4:31-I1.000|4:01-I1.000|3:56-I1.000|4:03-I1.000|4:08-I1.000|4:28-I1.000|5:04-I1.000|5:14-I1.000|4:20-I1.000|4:44-I1.000|4:26-I0.009|0:02,,,,,3113,,250,0,,0,168070,250480,30378,,4603634,,,,,,,,,,,,,,,,,,,,,,,,,,,,,,,,,,,,,,,,"3,4,4,5,5",
15970333,f4cd3bbb-722b-4c36-9ab0-2d341c22790c,1591726077,120,1591723932,,0,0,1.01,296,296,10,0,,,0,0,0,1.02,,,62,139,148,103,,,61.82,33.91,63.33,1,61.3,,,,1.1,0,,102,,,,,,6,80,12.64,12.25,12.72,5.2,5.4,302,302,,1,304,304,,,,,,,,,"0,0,0,36,61,3,0,0,0","3,22,75,0,0","0,0,51,49,0",,,,,128,,,,,,,,,,,,,,,17,,,,,,,,,,,,,,,,,,,,,11.6,16,8,23,72,,1016,2,338,0,6,3,Balve,1,0,I1.000|4:53-I0.009|0:02,,,,,3113,,250,0,,0,168070,250480,30378,,4679292,,,,,,,,,,,,,,,,,,,,,,,,,,,,,,,,,,,,,,,,,
15970340,7ca52556-348a-4c3c-8353-19bfeb7fe2ca,1591730398,120,1591723941,,0,0,1.11,364,397,11,5,,,0,0,0.18,1.03,,,70,132,140,,,,57.43,30.18,58.52,1,61.14,,,,1,0,101,101,,,,,,6,80,11.26,11.09,11.34,-5.6,-6.3,256,256,,1,259,259,,,,,,,,,"12,14,20,34,16,3,0,0,0","2,98,0,0,0","0,9,79,12,0",,,,,114,,,,,,,,,,,,,,,24,,,,,,,,,,,,,,,,,,,,,9.5,15,8,11,77,,1016,1,337,0,6,3,Balve,1,0,I1.000|5:33-I0.105|0:30,,,,,3113,,250,0,,0,168070,250480,30378,,4679296,,,,,,,,,,,,,,,,,,,,,,,,,,,,,,,,,,,,,,,,,
15970341,378414bc-4f23-4ce3-9e0a-fd54d799e935,1591726725,120,1591723942,,0,0,13.04,3142,3208,127,122,,,0,0.6,0.31,1.03,1,456,767,161,187,,,,64.15,52.65,64.95,1,61.11,,,,4.3,2,103,100,,,,,,113,83,15.15,15.11,15.28,1.9,1.1,366,366,,1,373,373,,,,,,,,,"0,0,0,1,17,31,42,8,0","0,6,37,53,3","0,0,10,64,26",,,,,150,,,,,,,,,,,,,,,20,,,,,,,,,,,,,,,,,,,,,98.5,16,8,23,72,,1016,2,338,0,6,3,Balve,1,0,I1.000|4:34-I1.000|4:24-I1.000|4:15-I1.000|4:24-I1.000|4:09-I1.000|4:01-I1.000|3:53-I1.000|4:10-I1.000|3:54-I1.000|3:53-I1.000|3:38-I1.000|3:26-I1.000|3:33-I0.037|0:07,,,,,3113,,250,0,,0,168070,250480,30378,,4679297,,,,,,,,,,,,,,,,,,,,,,,,,,,,,,,,,,,,,,,,5,
16008162,f2e484d5-e92f-4a77-819b-dfb011880842,1591814327,120,1591808389,,0,0,3.96,1061,1137,8,12,,,0,0,0.03,,,,235,146,167,,,,64.7,43.11,64.79,1,61.88,,,,2.5,0.3,103,103,,,,,,26,81,13.42,13.53,13.51,-3.3,-6.9,318,318,,1,321,321,,,,,,,,,"0,0,0,10,41,43,6,0,0","1,19,75,5,0","0,1,38,61,0",,,,,138,,,,,,,,,,,,,,,19,,,,,,,,,,,,,,,,,,,,,35.5,17,6,6,77,,1013,1,345,0,6,3,Menden,1,0,I1.000|4:50-I1.000|4:39-I1.000|4:09-I0.962|4:03,,,,,3113,,250,0,,0,168070,250480,30378,,4709331,,,,,,,,,,,,,,,,,,,,,,,,,,,,,,,,,,,,,,,,,
16011312,fd80cae8-ec8a-41d7-a7ad-06b66ea1c88a,1591820376,120,1591813474,,0,0,0.64,214,214,6,4,,,0,0,0,,,,47,139,146,,,,52.53,27.81,53.34,1,62.71,,,,0.7,0,,100,,,,,,4,83,10.8,10.71,10.83,0.7,2.3,246,246,,1,247,247,,,,,,,,,"3,7,61,29,0,0,0,0,0","0,75,25,0,0","0,0,100,0,0",,,,,108,,,,,,,,,,,,,,,27,,,,,,,,,,,,,,,,,,,,,8.5,16,5,33,79,,1013,0,344,0,6,3,Menden,1,0,,,,,,3113,,250,0,,0,168070,250480,30378,,4711894,,,,,,,,,,,,,,,,,,,,,,,,,,,,,,,,,,,,,,,,,
16011316,9b9bd688-539d-4b2a-9fcf-0580f93456a8,1591816185,120,1591813487,,0,0,14.2,3983,3983,77,74,,,0,0,0.11,0.77,0.71,,914,160,188,117,,,53.67,44.43,54.05,1,62.71,,,,4.2,3.3,104,101,,,,,,142,83,12.97,14.32,14.37,-1.5,-24.1,317,317,,1,371,371,,,,,,,,,"27,4,3,5,7,8,26,21,1","0,15,25,57,2","8,15,17,24,36",,,,,129,,,,,,,,,,,,,,,21,,,,,,,,,,,,,,,,,,,,,96.9,17,5,14,80,,1013,1,344,0,6,3,Menden,1,0,I0.400|1:28-I0.224|1:42-I0.412|1:30-I0.200|1:30-I0.412|1:25-I0.203|1:26-I0.401|1:25-I0.202|1:28-I0.405|1:24-I0.210|1:28-I0.403|1:23-I0.199|1:33-I0.405|1:16-I0.210|1:29-I0.404|1:17-I0.423|4:05-I0.393|1:29-I0.211|1:17-I0.414|1:30-I0.202|1:17-I0.410|1:26-I0.213|1:17-I0.412|1:21-I0.209|1:11-I0.404|1:21-I0.211|1:18-I0.410|1:18-I0.206|1:11-I0.406|1:16-I0.221|3:57-I0.402|1:29-I0.207|0:54-I0.404|1:29-I0.201|0:59-I0.414|1:25-I0.209|0:58-I0.404|1:25-I0.196|1:04-I0.405|1:23-I0.211|0:57-I0.404|1:23-I0.196|1:00-I0.398|1:17-I0.211|0:56-I0.412|1:15-I0.095|1:30,,,,,3113,,250,0,,0,168070,250480,30378,,4711898,,,,,,,,,,,,,,,,,,,,,,,,,,,,,,,,,,,,,,,,,
16035824,e201d688-f57f-4462-ba6d-0ea2ff459ceb,1591873269,120,1591869331,,0,0,7.4,2366,2412,98,106,,,0,1.3,0.46,0.99,1.01,310,493,142,160,,,,53.99,36.37,54.8,1,62.46,,,,2.8,0,99,96,,,,,,50,79,11.49,11.41,11.57,-3.2,-6.4,262,262,,1,267,267,,,,,,,,,"9,5,18,38,29,1,0,0,0","0,39,61,0,0","0,3,82,15,0",,,,,119,,,,,,,,,,,,,,,21,,,,,,,,,,,,,,,,,,,,,27.1,16,6,47,77,,1011,3,346,0,5,3,Balve,1,0,I1.000|5:38-I1.000|5:24-I1.000|5:43-I1.000|4:52-I1.000|5:00-I1.000|5:37-I1.000|5:10-I0.396|2:02,,,,,3113,,250,0,,0,168070,250480,30378,,4733532,,,,,,,,,,,,,,,,,,,,,,,,,,,,,,,,,,,,,,,,5,
16081623,7776995e-0956-49f5-8c2c-80e5c574986e,1591982206,120,1591978712,,0,0,10.45,3043,3455,171,164,,,0,1.7,0.56,1.12,1,343,584,147,183,108,,,57.84,41.56,59.06,1,62,,,,3.5,2.4,98,99,,,,,,81,81,12.7,13.08,13.57,14.4,3.2,297,295,,1,328,328,,,,,,,,,"9,4,12,27,17,12,17,3,0","0,45,29,24,1","2,7,47,33,11",,,,,127,,,,,,,,,,,,,,,14,,,,,,,,,,,,,,,,,,,,,78.6,26,12,123,45,,1007,3,330,0,5,3,Balve,1,0,I1.000|5:05-I1.000|4:41-I1.000|4:53-I1.000|3:33-I1.000|4:03-I1.000|3:45-I1.000|5:35-I0.436|3:15-I1.000|5:21-I1.000|5:13-I0.543|2:49-I0.466|2:30,,,,,3113,,250,0,,0,168070,250480,30378,,4771617,,,,,,,,,,,,,,,,,,,,,,,,,,,,,,,,,,,,,,,,"5,5",
16092185,73fa033d-abc6-49c8-9eba-3bab64544666,1592037019,120,1592034148,,0,0,13.3,3939,4200,377,353,,,0,4.1,0.82,1.03,1.04,551,783,151,180,,,,54.57,41.49,56.61,1,61.38,,,,3.7,2.1,96,98,,,,,,111,83,13.02,12.42,13.37,-3.3,-31.4,314,314,,1,372,372,,,,,,,,,"3,11,11,24,24,24,3,0,0","0,23,54,23,0","0,14,32,44,10",,,,,122,,,,,,,,,,,,,,,21,,,,,,,,,,,,,,,,,,,,,71.1,17,4,240,88,,1011,1,324,0,5,3,Balve,1,0,I1.000|5:57-I1.000|5:48-I1.000|5:06-I1.000|4:58-I1.000|5:09-I1.000|5:24-I1.000|5:00-I1.000|5:12-I1.000|4:19-I1.000|4:17-I1.000|4:17-I1.000|4:45-I1.000|4:13-I0.303|1:15,,,,,3113,,250,0,,0,168070,250480,30378,,4780738,,,,,,,,,,,,,,,,,,,,,,,,,,,,,,,,,,,,,,,,"3,5",
16134505,156e448a-758b-4aaf-8c2e-ccec237b898c,1592138089,120,1592136743,,0,0,19.46,5531,5784,554,580,,,0,5.4,0.87,0.99,1.07,683,1061,148,171,,,,59.04,44.86,61.03,1,61.27,,,,3.6,0,100,100,,,,,,142,83,13.65,13.42,13.86,0.1,6.3,313,313,,1,327,327,,,,,,,,,"10,7,13,17,14,18,16,6,0","0,26,64,9,0","0,6,30,60,5",,,,,127,,,,,,,,,,,,,,,19,,,,,,,,,,,,,,,,,,,,,48.3,19,12,285,87,,1013,4,316,0,6,3,Balve,1,0,I1.000|5:39-I1.000|5:01-I1.000|5:19-I1.000|4:16-I1.000|3:59-I1.000|6:28-I1.000|5:52-I1.000|4:24-I1.000|4:04-I1.000|5:13-I1.000|5:22-I1.000|5:03-I1.000|5:13-I1.000|5:42-I1.000|4:17-I1.000|3:29-I1.000|3:43-I1.000|3:49-I1.000|3:26-I0.461|1:52,,,,,3113,,250,0,,0,168070,250480,30378,,4815878,,,,,,,,,,,,,,,,,,,,,,,,,,,,,,,,,,,,,,,,"3,4,4,4",
16134513,77bda0a9-798d-4819-b7be-f7ae82c6c2aa,1592136996,120,1592136763,,0,0,1.8,795,834,50,8,,,0,0.4,0.33,1.03,0.86,,123,119,132,,,,44.89,22.46,47.73,1,61.38,,,,0.8,0,,100,,,,,,8,79,8.91,8.29,9.07,1.7,1.4,194,194,,1,201,201,,,,,,,,,"94,4,3,0,0,0,0,0,0","1,99,0,0,0","4,56,40,0,0",,,,,86,,,,,,,,,,,,,,,16,,,,,,,,,,,,,,,,,,,,,6.4,19,11,285,87,,1013,4,316,0,6,3,Balve,1,0,I1.000|7:02-I0.801|6:13,,,,,3113,,250,0,,0,168070,250480,30378,,4815884,,,,,,,,,,,,,,,,,,,,,,,,,,,,,,,,,,,,,,,,,
16174990,1a337ac5-1dec-4d60-902e-3afbcdd3b287,1592244597,120,1592243194,,0,0,16.11,4573,4661,408,407,,,0,4.2,0.84,0.98,1.08,564,868,147,167,104,,,59.69,44.25,61.56,1,61.2,,,,3.5,0,102,98,,,,,,114,81,13.51,13.12,13.58,-5.6,3,311,311,,1,317,317,,,,,,,,,"3,8,14,19,17,21,18,1,0","0,24,66,10,0","0,0,34,65,0",,,,,130,,,,,,,,,,,,,,,16,,,,,,,,,,,,,,,,,,,,,42.6,19,3,342,74,,1017,1,316,0,6,3,Balve,1,0,I1.000|4:54-I1.000|5:24-I1.000|5:32-I1.000|5:04-I1.000|5:12-I1.000|5:39-I1.000|4:14-I1.000|4:45-I1.000|4:27-I1.000|4:05-I1.000|5:43-I1.000|4:41-I1.000|4:07-I1.000|3:54-I1.000|4:01-I1.000|4:02-I0.112|0:28,,,,,3113,,250,0,,0,168070,250480,30378,,4848773,,,,,,,,,,,,,,,,,,,,,,,,,,,,,,,,,,,,,,,,"4,4",
16206291,ad562577-ec7a-4bb1-b9ca-d4b73653acc8,1592331380,120,1592327593,,0,0,4.68,1475,1961,88,68,,,0,2.1,0.74,1,1.01,351,272,134,158,93,,,59.2,35.99,60.89,1,61.22,,,,2.3,0,102,100,,,,,,26,79,11.86,11.56,12.02,-8.8,-17,273,273,,1,286,286,,,,,,,,,"7,6,15,36,34,1,0,0,0","2,68,30,0,0","0,10,64,24,2",,,,,120,,,,,,,,,,,,,,,18,,,,,,,,,,,,,,,,,,,,,23.2,17,5,337,87,,1015,1,340,0,6,3,Balve,1,0,I1.000|5:22-I1.000|5:29-I1.000|5:35-I1.000|4:49-I0.684|3:19,,,,,3113,,250,0,,0,168070,250480,30378,,4874509,,,,,,,,,,,,,,,,,,,,,,,,,,,,,,,,,,,,,,,,4,
16243404,d0d0eca7-0ca7-4384-86ed-8dadb6cf3435,1592419422,120,1592416532,,0,0,16.21,4183,4237,428,412,,,0,4.2,0.84,0.99,1.1,621,873,154,173,,,,62.91,49.44,65.05,1,61.17,,,,3.8,0.7,103,99,,,,,,127,84,14.89,14.45,14.94,-7.6,1.4,349,349,,1,355,355,,,,,,,,,"1,3,5,17,19,18,28,10,0","0,8,57,35,0","0,0,16,75,9",,,,,138,,,,,,,,,,,,,,,17,,,,,,,,,,,,,,,,,,,,,61,21,6,74,68,,1011,1,338,0,6,3,Balve,1,0,I1.000|4:30-I1.000|4:48-I1.000|4:49-I1.000|4:31-I1.000|5:07-I1.000|5:13-I1.000|3:52-I1.000|4:26-I1.000|4:01-I1.000|3:47-I1.000|5:23-I1.000|4:21-I1.000|3:44-I1.000|3:29-I1.000|3:30-I1.000|3:26-I0.207|0:45,,,,,3113,,250,0,,0,168070,250480,30378,,4906255,,,,,,,,,,,,,,,,,,,,,,,,,,,,,,,,,,,,,,,,"3,4",
16278587,9b9fc05b-6b98-4642-91cf-f433af21556a,1592504769,120,1592503524,,0,0,16.86,4927,5601,431,403,,,0,4.1,0.75,0.98,1.06,535,874,144,167,,,,59.21,42.94,61.21,1,60.66,,,,3.5,0,99,98,,,,,,116,82,13.14,12.66,13.27,-8.2,-1.6,301,301,,1,309,309,,,,,,,,,"4,7,18,20,17,28,7,0,0","1,37,55,7,0","0,3,41,55,1",,,,,125,,,,,,,,,,,,,,,21,,,,,,,,,,,,,,,,,,,,,40.4,19,5,75,73,,1013,1,340,0,4,3,Balve,1,0,I1.000|5:14-I1.000|5:25-I1.000|5:36-I1.000|5:07-I1.000|5:45-I1.000|5:38-I1.000|4:24-I1.000|4:44-I1.000|4:22-I1.000|4:08-I1.000|5:43-I1.000|4:59-I1.000|4:10-I1.000|4:10-I1.000|4:29-I1.000|4:17-I0.859|3:55,,,,,3113,,250,0,,0,168070,250480,30378,,4935727,,,,,,,,,,,,,,,,,,,,,,,,,,,,,,,,,,,,,,,,"3,4",
16303766,7ae98194-663c-4f85-9d5f-12fe8c53f668,1592582175,120,1592579797,,0,0,14.94,4480,4748,403,367,,,0,4.2,0.84,1.01,1.08,489,857,148,170,,,,55.26,41.27,57.27,1,60.07,,,,3.6,0,98,98,,,,,,114,81,12.87,12.41,13.03,-4.5,4,292,292,,1,301,301,,,,,,,,,"4,11,18,27,11,22,7,0,0","0,23,67,10,0","0,4,49,46,2",,,,,124,,,,,,,,,,,,,,,19,,,,,,,,,,,,,,,,,,,,,46.6,20,11,295,64,,1015,3,345,0,4,3,Balve,1,0,I1.000|5:30-I1.000|5:41-I1.000|5:33-I1.000|5:13-I1.000|5:28-I1.000|5:44-I1.000|4:27-I1.000|4:49-I1.000|5:51-I1.000|5:21-I1.000|5:01-I1.000|3:57-I1.000|3:59-I1.000|4:12-I0.942|3:54,,,,,3113,,250,0,,0,168070,250480,30378,,4957696,,,,,,,,,,,,,,,,,,,,,,,,,,,,,,,,,,,,,,,,"3,4",
16333556,f7255672-2cc1-4603-9499-86fb34531aec,1592680807,120,1592675828,,0,0,7.55,2021,2106,22,26,,,0,0,0,0.88,0.87,,421,145,161,,,,65.39,44.91,65.58,1,60.84,,,,3,0.1,103,103,,,,,,48,81,13.47,13.7,13.72,5.8,6.8,320,320,,1,329,329,,,,,,,,,"1,2,5,16,18,39,19,0,0","1,25,74,0,0","0,3,29,66,2",,,,,138,,,,,,,,,,,,,,,20,,,,,,,,,,,,,,,,,,,,,35.5,22,9,294,56,,1021,1,350,0,3,3,"Porz am Rhein",1,0,I1.000|5:08-I1.000|4:20-I1.000|3:51-I1.000|4:06-I1.000|4:11-I1.000|4:23-I1.000|4:53-I0.550|2:48,,,,,3113,,250,0,,0,168070,250480,30378,,4983242,,,,,,,,,,,,,,,,,,,,,,,,,,,,,,,,,,,,,,,,,
16365840,1a0e4ab0-33b9-438d-a14e-7b5e17be50eb,1592759389,120,1592754766,,0,0,7.61,2109,2453,51,25,,,0,0,0.16,1.14,0.92,,416,139,152,,,,66.24,43.13,67.07,1,61.41,,,,2.6,0,102,101,,,,,,43,81,13.17,13.08,13.29,2,2.1,305,305,,1,311,311,,,,,,,,,"0,1,4,12,45,35,3,0,0","1,41,58,0,0","0,5,34,60,1",,,,,134,,,,,,,,,,,,,,,19,,,,,,,,,,,,,,,,,,,,,23.4,22,7,234,62,,1019,3,325,0,5,3,"Porz am Rhein",1,0,I1.000|4:55-I1.000|4:16-I1.000|4:42-I1.000|4:39-I1.000|4:26-I1.000|4:52-I1.000|4:32-I0.605|2:48,,,,,3113,,250,0,,0,168070,250480,30378,,5011068,,,,,,,,,,,,,,,,,,,,,,,,,,,,,,,,,,,,,,,,,
16426373,f84da24a-be07-4b47-8b4d-161b352721c6,1592917412,120,1592911420,,0,0,4.18,1089,1148,24,14,,,0,0,0,1.11,,,247,149,160,,,,65.14,44.71,65.79,1,62.08,,,,2.6,0,100,103,,,,,,28,82,13.95,13.83,14,-4.3,-5.9,332,332,,1,334,334,,,,,,,,,"0,0,0,2,21,73,4,0,0","0,8,92,0,0","0,0,15,80,5",,,,,140,,,,,,,,,,,,,,,18,,,,,,,,,,,,,,,,,,,,,31.9,26,3,25,52,,1026,8,317,0,3,3,"Porz am Rhein",1,0,I1.000|4:28-I1.000|4:19-I1.000|4:17-I1.000|4:22-I0.179|0:43,,,,,3113,,250,0,,0,168070,250480,30378,,5063491,,,,,,,,,,,,,,,,,,,,,,,,,,,,,,,,,,,,,,,,,
16501134,c36415ac-1020-4465-907d-afe585712f62,1593111282,120,1593121820,,0,0,14.69,4014,4543,416,354,,,0,4.3,0.85,0.98,1.02,605,907,159,183,,,,55.95,45.92,58.21,1,60.93,,,,4.2,1.8,102,96,,,,,,139,82,14.18,13.52,14.36,-7.5,1.4,329,329,,1,339,339,,,,,,,,,"1,4,11,15,27,18,25,0,0","0,4,49,46,1","0,1,27,65,6",,,,,134,,,,,,,,,,,,,,,18,,,,,,,,,,,,,,,,,,,,,85.9,27,14,85,52,,1017,1,321,0,3,3,Balve,1,0,I1.000|4:40-I1.000|4:51-I1.000|4:58-I1.000|4:47-I1.000|5:13-I1.000|5:27-I1.000|4:15-I1.000|4:17-I1.000|5:12-I1.000|4:56-I1.000|4:04-I1.000|3:52-I1.000|3:51-I1.000|3:48-I0.686|2:43,,,,,3113,,250,0,,0,168070,250480,30378,,5125892,,,,,,,,,,,,,,,,,,,,,,,,,,,,,,,,,,,,,,,,"3,4",
16519114,106d2725-e113-49b5-acde-3fce17c67f6d,1593198254,120,1593194726,,0,0,14.1,3496,3519,86,86,,,0,0,0.13,1.02,0.98,,864,169,187,,,,57.48,51.23,57.91,1,60.38,,,,5,1.1,103,97,,,,,,154,83,14.59,14.92,14.99,9.7,8.4,353,353,,1,367,367,,,,,,,,,"5,6,2,1,2,24,60,0,0","0,2,17,62,19","0,4,10,67,18",,,,,146,,,,,,,,,,,,,,,17,,,,,,,,,,,,,,,,,,,,,126.7,27,9,165,42,,1011,1,302,0,3,3,Balve,1,0,I1.000|4:35-I1.000|3:56-I1.000|3:52-I1.000|4:03-I1.000|3:54-I1.000|4:03-I1.000|4:03-I1.000|3:46-I1.000|3:47-I1.000|3:53-I1.000|3:50-I1.000|3:48-I1.000|3:41-I1.000|6:29-I0.102|0:36,,,,,3113,,250,0,,0,168070,250480,30378,,5141575,,,,,,,,,,,,,,,,,,,,,,,,,,,,,,,,,,,,,,,,,
16569329,12049dc5-ff37-4bdb-957a-a62fd63746f5,1593285522,120,1593337145,,0,0,13.37,4194,4661,348,320,,,0,3.5,0.81,0.98,1.11,526,697,139,160,,,,56.84,38.82,58.82,1,60.25,,,,3.2,0,100,98,,,,,,87,80,12.29,11.87,12.42,-4.6,6.5,271,271,,1,284,284,,,,,,,,,"8,14,15,20,25,16,1,0,0","0,49,51,0,0","2,10,49,38,0",,,,,120,,,,,,,,,,,,,,,20,,,,,,,,,,,,,,,,,,,,,35.8,24,16,225,64,,1011,1,314,0,3,3,Balve,1,0,I1.000|5:23-I1.000|5:33-I1.000|5:31-I1.000|5:28-I1.000|5:42-I1.000|4:48-I1.000|6:11-I1.000|5:35-I1.000|5:44-I1.000|4:41-I1.000|4:25-I1.000|4:33-I1.000|4:35-I0.374|1:44,,,,,3113,,250,0,,0,168070,250480,30378,,5186374,,,,,,,,,,,,,,,,,,,,,,,,,,,,,,,,,,,,,,,,"4,4",
16578672,0b4ceeda-7b40-459c-b573-f52928924362,1593351121,120,1593352869,,0,0,25.04,7677,8758,711,713,,,0,5.4,0.82,0.98,1.01,634,1325,146,177,,,,54.78,41.88,56.7,1,60.19,,,,4,0.3,102,98,,,,,,191,82,12.7,12.27,12.96,6.6,4.4,290,290,,1,309,309,,,,,,,,,"16,11,10,13,23,21,6,0,0","0,31,58,11,0","1,7,47,42,3",,,,,119,,,,,,,,,,,,,,,19,,,,,,,,,,,,,,,,,,,,,50.9,18,18,254,67,,1015,4,314,0,4,3,Balve,1,0,I1.000|4:59-I1.000|5:04-I1.000|5:16-I1.000|4:59-I1.000|5:23-I1.000|4:20-I1.000|4:06-I1.000|3:52-I1.000|4:01-I1.000|4:36-I1.000|6:13-I1.000|5:33-I1.000|4:32-I1.000|6:00-I1.000|5:53-I1.000|6:59-I1.000|6:32-I1.000|5:04-I1.000|4:29-I1.000|6:37-I1.000|5:18-I1.000|4:30-I1.000|4:25-I1.000|4:26-I1.000|4:39-I0.041|0:11,,,,,3113,,250,0,,0,168070,250480,30378,,5193525,,,,,,,,,,,,,,,,,,,,,,,,,,,,,,,,,,,,,,,,"4,4,4,4",
16609089,4e3dbece-3bd0-4199-94c5-3deba3659822,1593459128,120,1593453327,,0,0,4.83,1315,1328,54,72,,,0,0.7,0.54,1.06,1.14,,276,146,166,,,,63.43,42.87,64.02,1,60.34,,,,2.6,0.9,99,101,,,,,,33,83,13.39,13.89,13.79,-1.5,20.5,327,327,,1,374,374,,,,,,,,,"5,4,14,23,14,11,16,11,2","1,34,50,15,0","0,5,44,32,19",,,,,133,,,,,,,,,,,,,,,21,,,,,,,,,,,,,,,,,,,,,34.2,18,19,251,51,,1012,1,327,0,3,3,Balve,1,0,I1.000|5:24-I0.265|1:01-I0.197|1:00-I0.265|1:00-I0.170|1:00-I0.257|1:01-I0.184|1:01-I0.214|1:01-I0.142|1:01-I0.304|1:00-I0.219|0:59-I0.334|1:01-I0.203|1:01-I0.300|1:00-I0.215|1:01-I0.311|1:01-I0.246|1:22,,,,,3113,,250,0,,0,168070,250480,30378,,5219519,,,,,,,,,,,,,,,,,,,,,,,,,,,,,,,,,,,,,,,,,
16632921,e3710be0-7a7f-4be7-a8ab-25aca0570161,1593531266,120,1593528252,,0,0,14.17,3959,4140,392,366,,,0,4,0.77,0.98,1.07,545,799,154,171,,,,57.03,44.62,59.11,1,59.98,,,,3.8,0.2,100,98,,,,,,118,82,13.8,13.24,13.89,-3.9,4.3,321,321,,1,329,329,,,,,,,,,"2,6,10,22,19,21,20,0,0","0,14,49,37,0","0,1,30,66,3",,,,,131,,,,,,,,,,,,,,,23,,,,,,,,,,,,,,,,,,,,,58.1,21,21,242,47,,1010,5,318,0,5,3,Balve,1,0,I1.000|4:54-I1.000|5:06-I1.000|5:15-I1.000|4:53-I1.000|5:05-I1.000|5:19-I1.000|4:04-I1.000|5:08-I1.000|5:14-I1.000|4:22-I1.000|4:10-I1.000|3:59-I1.000|4:00-I1.000|3:50-I0.172|0:39,,,,,3113,,250,0,,0,168070,250480,30378,,5240074,,,,,,,,,,,,,,,,,,,,,,,,,,,,,,,,,,,,,,,,"4,4",
16670857,864900aa-a04b-4f0a-a365-24c4db65f3ea,1593630239,120,1593627152,,0,0,14.71,3999,4060,389,390,,,0,4,0.78,1.01,1.16,552,822,155,173,,,,58.44,46.19,60.35,1,59.5,,,,3.8,0,100,98,,,,,,123,81,14.15,13.81,14.21,-10.5,-1.3,328,328,,1,333,333,,,,,,,,,"1,4,15,19,20,12,23,6,0","0,10,49,41,0","0,0,26,73,1",,,,,136,,,,,,,,,,,,,,,22,,,,,,,,,,,,,,,,,,,,,60.5,18,12,240,98,,1008,1,325,0,4,3,Balve,1,0,I1.000|5:01-I1.000|5:14-I1.000|5:15-I1.000|4:58-I1.000|5:11-I1.000|5:13-I1.000|3:56-I1.000|4:16-I1.000|5:23-I1.000|4:50-I1.000|3:54-I1.000|3:39-I1.000|3:35-I1.000|3:37-I0.710|2:36,,,,,3113,,250,0,,0,168070,250480,30378,,5272915,,,,,,,,,,,,,,,,,,,,,,,,,,,,,,,,,,,,,,,,"4,4",
16710257,35d05a36-c532-49e8-8728-41266ff9cca1,1593717219,120,1593714522,,0,0,14.73,4204,4431,384,385,,,0,4,0.82,0.99,1.06,519,829,148,163,,,,58.74,43.67,60.63,1,59.47,,,,3.5,0,104,98,,,,,,107,82,13.47,13.14,13.54,-5.2,-47.3,316,316,,1,358,358,,,,,,,,,"4,8,15,21,16,13,22,1,0","0,13,85,2,0","0,3,32,62,3",,,,,128,,,,,,,,,,,,,,,18,,,,,,,,,,,,,,,,,,,,,41.6,18,13,279,80,,1012,1,343,0,6,3,Balve,1,0,I1.000|5:11-I1.000|5:30-I1.000|5:31-I1.000|5:03-I1.000|5:17-I1.000|5:32-I1.000|4:08-I1.000|4:22-I1.000|5:41-I1.000|5:10-I1.000|4:07-I1.000|3:49-I1.000|3:52-I1.000|3:52-I0.727|2:59,,,,,3113,,250,0,,0,168070,250480,30378,,5305637,,,,,,,,,,,,,,,,,,,,,,,,,,,,,,,,,,,,,,,,"4,4",
16753444,2aa50748-26ee-42c3-a171-1d839fe67149,1593808200,120,1593802551,,0,0,4.85,1496,1499,68,80,,,0,1.4,0.63,0.99,1.02,272,274,136,157,,,,59.68,37,60.53,1,59.79,,,,2.3,0,102,101,,,,,,28,79,11.79,11.74,11.89,-1.8,5.6,268,268,,1,273,273,,,,,,,,,"2,3,15,45,32,3,0,0,0","1,64,35,0,0","0,3,80,18,0",,,,,123,,,,,,,,,,,,,,,16,,,,,,,,,,,,,,,,,,,,,24.5,19,10,237,66,,1018,0,324,0,3,3,Balve,1,0,I1.000|5:25-I1.000|5:14-I1.000|5:20-I1.000|4:46-I0.853|4:11,,,,,3113,,250,0,,0,168070,250480,30378,,5342706,,,,,,,,,,,,,,,,,,,,,,,,,,,,,,,,,,,,,,,,5,
16765750,1dfba22a-58f9-4079-af33-982a2776c3d0,1593861081,120,1593855602,,0,0,3.04,934,1028,31,41,,,0,0.4,0.4,1.01,1.02,,187,138,150,98,,,58.86,36.04,59.36,1,59.81,,,,2.1,0,98,100,,,,,,18,80,11.75,11.78,11.8,-1,6.9,270,270,,1,273,273,,,,,,,,,"0,1,31,26,40,3,0,0,0","3,46,51,0,0","0,0,89,11,0",,,,,122,,,,,,,,,,,,,,,15,,,,,,,,,,,,,,,,,,,,,18.9,19,21,222,72,,1016,3,329,0,4,3,Balve,1,0,I1.000|5:30-I1.000|5:07-I1.000|4:45-I0.036|0:12,,,,,3113,,250,0,,0,168070,250480,30378,,5353667,,,,,,,,,,,,,,,,,,,,,,,,,,,,,,,,,,,,,,,,,
16792831,9f8eafa8-f848-4067-8076-3c70f08c6b70,1593943286,120,1593949329,,0,0,15.49,3834,4391,60,54,,,0,0,0.14,,0.93,,889,160,177,,,,62.63,51.7,62.96,1,60.19,,,,4.3,2,105,98,,,,,,134,83,14.63,14.62,14.72,7.3,1.2,353,353,,1,361,361,,,,,,,,,"1,0,1,4,3,54,38,0,0","0,6,39,55,0","0,1,10,82,8",,,,,146,,,,,,,,,,,,,,,20,,,,,,,,,,,,,,,,,,,,,83.1,20,21,240,80,,1013,3,305,0,4,3,"Porz am Rhein",1,0,I1.000|4:30-I1.000|4:04-I1.000|4:04-I1.000|4:00-I1.000|3:59-I1.000|4:09-I1.000|4:05-I1.000|4:06-I1.000|4:03-I1.000|4:03-I1.000|4:16-I1.000|3:56-I1.000|4:02-I1.000|4:03-I1.000|4:03-I0.494|2:33,,,,,3113,,250,0,,0,168070,250480,30378,,5375849,,,,,,,,,,,,,,,,,,,,,,,,,,,,,,,,,,,,,,,,,
16972096,9dd58977-a6d9-4917-802a-f9299931ed6e,1594060780,120,1594450962,,0,0,12.06,2989,3191,60,91,,,0,0,0.1,1.02,0.93,,657,151,165,,,,68.01,50.67,68.21,1,61.35,,,,3.4,0.3,106,100,,,,,,83,83,14.55,14.6,14.63,2.2,0,350,350,,1,355,355,,,,,,,,,"1,0,0,0,4,64,31,0,0","0,9,85,5,0","0,2,6,83,9",,,,,146,,,,,,,,,,,,,,,24,,,,,,,,,,,,,,,,,,,,,44,17,19,285,52,,1019,1,361,0,2,3,"Porz am Rhein",1,0,I1.000|4:18-I1.000|3:57-I1.000|3:59-I1.000|4:03-I1.000|4:07-I1.000|4:05-I1.000|4:08-I1.000|4:08-I1.000|3:54-I1.000|4:26-I1.000|4:07-I1.000|4:20-I0.058|0:17,,,,,3113,,250,0,,0,168070,250480,30378,,5527479,,,,,,,,,,,,,,,,,,,,,,,,,,,,,,,,,,,,,,,,,
16972106,592a6d9d-4ac3-48ea-ac34-95aa41687460,1594320569,120,1594450993,,0,0,14.17,3438,3507,26,39,,,0,0,0.03,,,,815,162,181,115,,,63.01,52.55,63.08,1,61.14,,,,4.6,1.4,105,99,,,,,,127,82,14.8,15.03,15.04,8.1,5.3,359,359,,1,368,368,,,,,,,,,"0,1,3,7,5,12,72,0,0","0,3,28,68,0","0,1,11,71,16",,,,,151,,,,,,,,,,,,,,,16,,,,,,,,,,,,,,,,,,,,,93.4,22,10,289,66,,1013,1,324,0,3,3,"Porz am Rhein",1,0,I1.000|4:31-I1.000|3:58-I1.000|3:54-I1.000|3:56-I1.000|3:56-I1.000|3:56-I1.000|3:54-I1.000|3:51-I1.000|3:53-I1.000|3:50-I1.000|3:48-I1.000|3:47-I1.000|3:47-I1.000|5:28-I0.165|0:50,,,,,3113,,250,0,,0,168070,250480,30378,,5527489,,,,,,,,,,,,,,,,,,,,,,,,,,,,,,,,,,,,,,,,,
16972114,cc5f3a09-3d1d-4b9c-8f6d-7a25c582cd7c,1594411126,120,1594451022,,0,0,13.01,3218,3399,44,24,,,0,0,0.05,1.09,,,721,153,173,,,,66.92,51.07,67.32,1,61.41,,,,3.6,0.5,102,101,,,,,,93,82,14.65,14.72,14.84,0.1,0.5,353,353,,1,360,360,,,,,,,,,"0,0,0,1,15,48,32,4,0","0,7,79,14,0","0,0,12,69,19",,,,,148,,,,,,,,,,,,,,,21,,,,,,,,,,,,,,,,,,,,,49.6,18,12,328,67,,1016,0,334,0,3,3,"Porz am Rhein",1,0,I1.000|4:38-I1.000|4:11-I1.000|4:21-I1.000|4:02-I1.000|3:59-I1.000|3:36-I1.000|3:37-I1.000|4:00-I1.000|4:26-I1.000|4:13-I1.000|4:19-I1.000|4:04-I1.000|4:08-I0.011|0:03,,,,,3113,,250,0,,0,168070,250480,30378,,5527497,,,,,,,,,,,,,,,,,,,,,,,,,,,,,,,,,,,,,,,,,
17025970,cbdd50bf-8ebd-4f86-b37a-622a2dc9da14,1594494996,120,1594575628,,0,0,12.8,3111,3124,27,36,,,0,0,0.05,,,,752,160,177,,,,64.06,52.06,64.17,1,61.48,,,,4.2,0.1,104,100,,,,,,107,83,14.8,14.93,14.91,1.6,0.1,359,359,,1,364,364,,,,,,,,,"0,0,0,2,10,38,50,1,0","0,2,47,51,0","0,0,4,83,12",,,,,149,,,,,,,,,,,,,,,18,,,,,,,,,,,,,,,,,,,,,72.9,20,10,321,50,,1025,1,360,0,3,3,"Porz am Rhein",1,0,I1.000|4:32-I1.000|4:07-I1.000|4:17-I1.000|4:11-I1.000|4:07-I1.000|3:51-I1.000|3:53-I1.000|3:53-I1.000|3:50-I1.000|3:50-I1.000|3:55-I1.000|3:44-I0.797|3:41,,,,,3113,,250,0,,0,168070,250480,30378,,5574063,,,,,,,,,,,,,,,,,,,,,,,,,,,,,,,,,,,,,,,,,
17025975,a8e5348b-b716-41dd-a2c5-90d805a1dabc,1594577969,120,1594575642,,0,0,17.64,4783,4786,469,470,,,0,5,0.79,0.97,1.07,663,986,154,178,,,,59.18,47.01,61.12,1,61.3,,,,3.9,0.7,103,98,,,,,,143,82,14.24,13.99,14.43,0.3,5,332,332,,1,341,341,,,,,,,,,"8,4,8,18,16,15,24,9,0","0,8,61,31,0","0,1,25,67,8",,,,,135,,,,,,,,,,,,,,,19,,,,,,,,,,,,,,,,,,,,,62.7,19,10,21,49,,1027,2,334,0,3,3,Balve,1,0,I1.000|4:33-I1.000|4:49-I1.000|5:12-I1.000|4:55-I1.000|5:09-I1.000|4:07-I1.000|3:45-I1.000|3:40-I1.000|5:29-I1.000|5:42-I1.000|5:36-I1.000|5:05-I1.000|4:09-I1.000|3:41-I1.000|3:43-I1.000|3:35-I1.000|3:35-I0.638|3:00,,,,,3113,,250,0,,0,168070,250480,30378,,5574067,,,,,,,,,,,,,,,,,,,,,,,,,,,,,,,,,,,,,,,,"3,4,4",
17055170,a8684f79-a8cb-45a0-9310-1e8bae20a9c6,1594665048,120,1594661818,,0,0,15.01,3613,3813,59,60,,,0,0,0.04,,,,915,166,184,,,,61.31,53.27,61.6,1,60.94,,,,4.8,1.8,103,99,,,,,,146,83,14.98,15.04,15.12,3.3,1,365,365,,1,370,370,,,,,,,,,"0,0,0,1,6,36,54,2,0","0,1,19,77,3","0,0,5,76,18",,,,,150,,,,,,,,,,,,,,,14,,,,,,,,,,,,,,,,,,,,,108.8,22,6,13,48,,1020,1,325,0,3,3,Sundern,1,0,I1.000|4:19-I1.000|4:06-I1.000|4:05-I1.000|4:00-I1.000|4:01-I1.000|4:08-I1.000|4:06-I1.000|3:49-I1.000|3:52-I1.000|3:45-I1.000|3:52-I1.000|3:52-I1.000|3:54-I1.000|3:50-I1.000|4:30-I0.007|0:02,,,,,3113,,250,0,,0,168070,250480,30378,,5599957,,,,,,,,,,,,,,,,,,,,,,,,,,,,,,,,,,,,,,,,,
17088544,822b4e11-39d2-472d-a120-c6503d3b0e4c,1594754408,120,1594766582,,0,0,14.6,4333,4786,396,384,,,0,4,0.87,0.97,1.04,514,816,147,169,,,,56.5,41.7,58.45,1,60.65,,,,3.5,0,103,95,,,,,,108,80,12.96,12.47,13.07,-4.3,4.5,294,294,,1,302,302,,,,,,,,,"3,12,14,22,21,21,7,0,0","0,31,57,12,0","0,2,43,55,0",,,,,126,,,,,,,,,,,,,,,15,,,,,,,,,,,,,,,,,,,,,48.8,17,5,63,69,,1014,1,334,0,4,3,Balve,1,0,I1.000|4:51-I1.000|5:19-I1.000|5:36-I1.000|5:14-I1.000|5:34-I1.000|5:42-I1.000|4:20-I1.000|4:40-I1.000|5:57-I1.000|5:21-I1.000|4:32-I1.000|4:11-I1.000|4:16-I1.000|4:08-I0.599|2:33,,,,,3113,,250,0,,0,168070,250480,30378,,5628189,,,,,,,,,,,,,,,,,,,,,,,,,,,,,,,,,,,,,,,,"4,4",
17113454,cc8b7a74-5ee1-490a-996e-f58728b00386,1594838177,120,1594837610,,0,0,4.87,1437,1437,52,57,,,0,0.7,0.5,0.99,1.03,224,286,140,160,92,,,60.73,39.01,61.46,1,60.74,,,,2.4,0,100,100,,,,,,29,78,12.35,12.3,12.42,-4.2,0.9,285,285,,1,289,289,,,,,,,,,"1,2,4,39,42,12,0,0,0","0,47,53,0,0","0,0,67,33,0",,,,,130,,,,,,,,,,,,,,,19,,,,,,,,,,,,,,,,,,,,,26.5,20,11,310,52,,1015,2,345,0,3,3,Balve,1,0,I1.000|5:04-I1.000|5:06-I1.000|5:11-I1.000|4:33-I0.866|4:03,,,,,3113,,250,0,,0,168070,250480,30378,,5650917,,,,,,,,,,,,,,,,,,,,,,,,,,,,,,,,,,,,,,,,5,
17113463,07c1ffe7-38b6-44d7-9894-d74b5b4036a9,1594841105,120,1594837627,,0,0,7.43,3149,3149,69,72,,,0,0,0.18,1.14,0.43,,489,133,167,,,,41.46,25.96,41.91,1,60.74,,,,2.6,2.1,,100,,,,,,56,77,8.51,11.26,11.52,27.8,30,196,196,,1,290,290,,,,,,,,,"59,10,5,3,6,9,1,8,0","0,69,25,7,0","33,22,21,12,11",,,,,92,,,,,,,,,,,,,,,17,,,,,,,,,,,,,,,,,,,,,31.4,18,9,296,57,,1015,1,340,0,3,3,Balve,1,0,I1.019|3:15-I0.204|3:02-I0.519|1:42-I2.056|14:03-I1.369|8:38-I2.260|21:49,,,,,3113,,250,0,,0,168070,250480,30378,,5650926,,,,,,,,,,,,,,,,,,,,,,,,,,,,,,,,,,,,,,,,,
17113475,2d1d8d8d-b45c-4663-8490-641d46181d79,1594840584,120,1594837666,,0,0,0.73,442,444,13,10,,,0,0,0,1.25,0.07,,72,122,142,,,,29.48,,30.29,1,60.74,,,,0.6,0.1,,100,,,,,,5,72,6.37,7.53,7.8,-16.9,-16.9,147,139,,1,184,181,,,,,,,,,"71,16,4,7,2,0,0,0,0","1,96,3,0,0","41,21,35,2,1",,,,,69,,,,,,,,,,,,,,,22,,,,,,,,,,,,,,,,,,,,,6.7,18,8,296,57,,1015,1,340,0,3,3,Balve,1,0,,,,,,3113,,250,0,,0,168070,250480,30378,,5650938,,,,,,,,,,,,,,,,,,,,,,,,,,,,,,,,,,,,,,,,,
17138288,7e71f255-7884-47d0-9304-e66f6fbf0937,1594926676,120,1594925199,,0,0,15.65,5102,5455,463,428,,,0,5.1,0.85,1.03,1.1,563,829,138,166,106,,,54.71,37.58,56.86,1,60.32,,,,3.3,0,100,97,,,,,,104,79,11.91,11.44,12.25,-0.3,2.9,266,266,,1,280,280,,,,,,,,,"19,8,15,22,29,7,0,0,0","0,51,47,1,0","0,13,56,30,1",,,,,116,,,,,,,,,,,,,,,14,,,,,,,,,,,,,,,,,,,,,35.7,14,4,266,86,,1017,1,343,0,6,3,Balve,1,0,I2.264|12:16-I0.004|0:01-I1.000|5:34-I1.000|5:32-I1.000|5:50-I1.000|4:51-I1.000|4:37-I1.000|4:42-I1.000|7:31-I1.000|6:35-I1.000|6:27-I1.000|4:57-I1.000|4:38-I1.000|4:47-I1.000|4:41-I0.383|2:04,,,,,3113,,250,0,,0,168070,250480,30378,,5673080,,,,,,,,,,,,,,,,,,,,,,,,,,,,,,,,,,,,,,,,"3,4",
17160852,54a0126c-0b59-4865-9634-fd2360ea61fa,1595008328,120,1595006227,,0,0,14.61,4439,4807,390,371,,,0,4,0.84,1,1.09,504,762,141,164,107,,,58.03,40.57,60.05,1,60.21,,,,3.3,0,103,99,,,,,,95,80,12.65,12.2,12.78,-3.4,7.4,286,286,,1,294,294,,,,,,,,,"7,11,15,27,14,21,4,0,0","0,48,48,3,0","0,4,53,42,1",,,,,123,,,,,,,,,,,,,,,15,,,,,,,,,,,,,,,,,,,,,38.7,20,8,328,60,,1020,2,311,0,3,3,Balve,1,0,I1.000|5:15-I1.000|5:35-I1.000|5:30-I1.000|5:18-I1.000|5:22-I1.000|5:50-I1.000|4:35-I1.000|4:59-I1.000|6:10-I1.000|5:29-I1.000|4:40-I1.000|4:12-I1.000|4:17-I1.000|4:18-I0.612|2:30,,,,,3113,,250,0,,0,168070,250480,30378,,5693144,,,,,,,,,,,,,,,,,,,,,,,,,,,,,,,,,,,,,,,,"4,4",
17176487,83c99c35-9768-429d-99de-b4f0f85dfe9f,1595079668,120,1595074019,,0,0,2.23,1424,1504,23,23,,,0,0,0.09,0.71,0.28,,217,122,149,,,,27.56,,27.92,1,60.27,,,,1.8,0.1,,102,,,,,,18,75,6.45,8.75,8.78,,-23.7,148,138,,1,218,215,,,,,,,,,"70,7,1,6,16,2,0,0,0","7,80,13,0,0","49,17,24,8,2",,,,,63,,,,,,,,,,,,,,,24,,,,,,,,,,,,,,,,,,,,,15.4,22,5,233,52,,1019,4,308,0,4,3,Balve,1,0,I1.000|16:50-I0.203|1:55-I1.000|4:51-I0.027|0:08,,,,,3113,,250,0,,0,168070,250480,30378,,5707167,,,,,,,,,,,,,,,,,,,,,,,,,,,,,,,,,,,,,,,,,
17176492,10a6b7d4-ed87-44bc-bfce-d5ab2f6c0aaa,1595076382,120,1595074037,,0,0,9.34,2754,3150,173,147,,,0,2.3,0.71,0.99,1.02,276,544,144,165,,,,58.56,40.64,60.11,1,60.1,,,,3,0,101,99,,,,,,63,80,12.67,12.32,12.79,-2.7,-1.6,291,291,,1,298,298,,,,,,,,,"1,1,8,32,43,13,1,0,0","0,33,66,0,0","0,3,47,50,0",,,,,127,,,,,,,,,,,,,,,16,,,,,,,,,,,,,,,,,,,,,32.7,22,5,234,53,,1020,4,307,0,4,3,Balve,1,0,I1.000|5:18-I1.000|5:11-I1.000|4:51-I1.000|4:51-I1.000|4:58-I1.000|4:40-I1.000|4:52-I1.000|5:10-I1.000|4:28-I0.336|1:35,,,,,3113,,250,0,,0,168070,250480,30378,,5707172,,,,,,,,,,,,,,,,,,,,,,,,,,,,,,,,,,,,,,,,5,
17207409,b069b499-6ee4-403c-b9dc-043cddb5da5d,1595166009,120,1595160341,,0,0,0.83,272,272,14,4,,,0,0,0.27,0.89,0.97,,65,156,173,,,,45.98,29.24,47.62,1,60.2,,,,1.4,0,,95,,,,,,8,82,11.47,11.02,11.47,-4.6,-3,265,265,,1,266,266,,,,,,,,,"10,3,18,58,11,0,0,0,0","0,0,87,13,0","0,0,99,1,0",,,,,112,,,,,,,,,,,,,,,36,,,,,,,,,,,,,,,,,,,,,21.7,24,11,254,49,,1016,4,318,0,4,3,Sundern,1,0,,,,,,3113,,250,0,,0,168070,250480,30378,,5734523,,,,,,,,,,,,,,,,,,,,,,,,,,,,,,,,,,,,,,,,,
17207410,5ef1f5e3-3ebf-44c6-9926-36f4e8a153d5,1595158935,120,1595160345,,0,0,26.02,6225,7050,87,75,,,0,0,0.07,,,,1547,168,183,,,,60.63,56.04,60.92,1,60.37,,,,5,2.4,105,99,,,,,,260,84,15.09,15.07,15.14,2.1,1.3,368,368,,1,370,370,,,,,,,,,"0,0,0,0,2,42,56,0,0","0,1,14,82,2","0,0,2,84,15",,,,,149,,,,,,,,,,,,,,,22,,,,,,,,,,,,,,,,,,,,,108,22,8,255,59,,1017,4,317,0,4,3,Sundern,1,0,I1.000|4:13-I1.000|4:06-I1.000|4:12-I1.000|3:56-I1.000|3:57-I1.000|4:00-I1.000|3:59-I1.000|3:56-I1.000|4:06-I1.000|3:53-I1.000|3:59-I1.000|4:03-I1.000|4:03-I1.000|4:04-I1.000|3:56-I1.000|4:04-I1.000|3:57-I1.000|4:03-I1.000|3:56-I1.000|3:58-I1.000|3:47-I1.000|3:57-I1.000|3:56-I1.000|3:56-I1.000|3:54-I1.000|3:50-I0.019|0:04,,,,,3113,,250,0,,0,168070,250480,30378,,5734524,,,,,,,,,,,,,,,,,,,,,,,,,,,,,,,,,,,,,,,,,
17239341,92f3e721-1698-4839-a556-7954187064e3,1595258820,120,1595256429,,0,0,14.93,4671,4770,390,406,,,0,4.1,0.84,1.02,0.93,522,840,140,160,,,,56.5,39.28,58.25,1,60.25,,,,3.3,0,104,99,,,,,,102,80,12.2,12.61,13.07,9.6,7.4,282,279,,1,304,303,,,,,,,,,"14,9,10,21,13,16,15,0,0","6,22,72,0,0","9,1,40,50,1",,,,,120,,,,,,,,,,,,,,,18,,,,,,,,,,,,,,,,,,,,,32.5,19,9,1,54,,1020,4,332,0,3,3,Balve,1,0,I1.000|4:53-I1.000|5:30-I1.000|5:31-I1.000|5:01-I1.000|5:29-I1.000|5:39-I1.000|4:20-I1.000|4:36-I1.000|5:53-I1.000|5:17-I1.000|4:14-I1.000|4:02-I1.000|3:59-I1.000|3:55-I0.931|9:33,,,,,3113,,250,0,,0,168070,250480,30378,,5762065,,,,,,,,,,,,,,,,,,,,,,,,,,,,,,,,,,,,,,,,"3,4",
17275806,702c908d-2b74-4569-af4a-e722c41b84a4,1595357657,120,1595353084,,0,0,5.02,2066,2372,50,47,,,0,0,0.2,0.82,0.54,,362,143,176,107,,,39.16,26.22,39.67,1,60.38,,,,2.9,2.5,,100,,,,,,49,75,9.23,11.73,11.98,21.3,-1.4,225,210,,1,305,299,,,,,,,,,"53,2,6,12,4,3,5,15,0","0,50,29,21,0","37,14,22,7,19",,,,,97,,,,,,,,,,,,,,,,,,,,,,,,,,,,,,,,,,,,44.5,20,10,351,46,,1023,1,314,0,2,3,Balve,1,0,I0.126|0:56-I0.305|0:59-I0.158|1:26-I0.307|1:00-I0.164|1:34-I0.313|0:59-I0.161|1:31-I0.309|0:59-I0.177|1:33-I0.302|0:58-I0.166|1:43-I0.314|1:02-I0.209|1:59-I0.311|1:00-I0.158|1:29-I0.310|1:00-I0.020|0:08-I1.000|13:00-I0.211|1:09,,,,,3113,,250,0,,0,168070,250480,30378,,5794475,,,,,,,,,,,,,,,,,,,,,,,,,,,,,,,,,,,,,,,,,
17275818,4a9c7177-4aa5-4471-937c-f480fbc4ecf5,1595356920,120,1595353096,,0,0,2.06,469,469,5,4,,,0,0,0,,,,108,155,173,112,,,72.79,48.83,73.05,1,60.34,,,,2.1,0,103,103,,,,,,14,84,15.84,15.94,16,0.9,-0.6,391,391,,1,398,398,,,,,,,,,"0,0,0,0,8,34,22,36,0","0,11,56,33,0","0,0,4,47,49",,,,,157,,,,,,,,,,,,,,,21,,,,,,,,,,,,,,,,,,,,,34.8,19,10,351,46,,1023,1,314,0,2,3,Balve,1,0,I0.404|1:43-I0.406|1:24-I0.410|1:49-I0.822|2:50-I0.017|0:03,,,,,3113,,250,0,,0,168070,250480,30378,,5794485,,,,,,,,,,,,,,,,,,,,,,,,,,,,,,,,,,,,,,,,,
17275857,aaa455ee-f9e4-4315-9b6c-55d7d8bcf9f9,1595355394,120,1595353164,,0,0,3.64,1044,1168,59,46,,,0,1.3,0.66,0.96,1,,226,148,168,111,,,58.38,39.58,59.81,1,60.12,,,,2.5,0,100,99,,,,,,27,78,12.95,12.63,13.04,-1.3,6.8,299,299,,1,305,305,,,,,,,,,"0,1,7,19,45,28,0,0,0","1,22,65,13,0","0,6,36,58,0",,,,,134,,,,,,,,,,,,,,,17,,,,,,,,,,,,,,,,,,,,,38,20,11,342,46,,1023,2,314,0,2,3,Balve,1,0,I1.000|4:48-I1.000|5:12-I1.000|4:34-I0.642|2:50,,,,,3113,,250,0,,0,168070,250480,30378,,5794521,,,,,,,,,,,,,,,,,,,,,,,,,,,,,,,,,,,,,,,,,
17312719,6e5fd4fc-5707-4531-887d-850c0c2837b0,1595441033,120,1595441610,,0,0,14.03,4292,4329,377,365,,,0,4.1,0.79,0.96,1.05,549,823,150,173,106,,,52.92,40.12,54.74,1,59.88,,,,3.7,0,100,96,,,,,,119,81,12.59,12.1,12.72,-5.5,5.9,285,285,,1,294,294,,,,,,,,,"9,12,13,20,24,20,2,0,0","0,25,46,29,0","0,5,51,44,0",,,,,121,,,,,,,,,,,,,,,19,,,,,,,,,,,,,,,,,,,,,60.7,20,10,349,46,,1021,1,311,0,3,3,Balve,1,0,I1.000|5:09-I1.000|5:39-I1.000|5:24-I1.000|5:21-I1.000|5:36-I1.000|5:58-I1.000|4:34-I1.000|5:28-I1.000|5:57-I1.000|4:34-I1.000|4:17-I1.000|4:19-I1.000|4:32-I1.000|4:35-I0.034|0:09,,,,,3113,,250,0,,0,168070,250480,30378,,5826567,,,,,,,,,,,,,,,,,,,,,,,,,,,,,,,,,,,,,,,,"3,4",
17312727,43d8da02-61b5-44ed-a3a5-a9961b66f6c6,1595445949,120,1595441623,,0,0,3.25,2114,2727,24,43,,,0,0,0.12,0.83,0.43,,345,129,164,,,,25.18,,25.23,1,59.73,,,,2.2,0.4,,96,,,,,,33,74,6.02,8.12,8.16,34.5,-66.8,137,133,,1,232,230,,,,,,,,,"72,2,6,13,6,1,0,0,0","0,79,20,1,0","52,17,23,6,2",,,,,62,,,,,,,,,,,,,,,21,,,,,,,,,,,,,,,,,,,,,23.8,19,11,0,50,,1021,1,311,0,4,3,Balve,1,0,I1.000|7:37-I1.000|19:03-I1.000|7:14-I0.248|1:20,,,,,3113,,250,0,,0,168070,250480,30378,,5826575,,,,,,,,,,,,,,,,,,,,,,,,,,,,,,,,,,,,,,,,,
17414623,62a1adf9-bdc0-4162-8d21-0da683b2a9d2,1595537354,120,1595861537,,0,0,0.96,435,482,54,0,,,0,1.8,0.63,0.9,0.26,456,79,130,149,,,,39.25,20.41,44.78,1,59.84,,,,1.1,0,,100,,,,,,7,81,10.22,9.61,11.79,-20.2,8.1,280,280,,1,321,321,,,,,,,,,"55,11,14,7,2,8,4,0,0","3,65,32,0,0","15,9,32,26,17",,,,,82,,,,,,,,,,,,,,,20,,,,,,,,,,,,,,,,,,,,,10.8,21,4,29,50,,1015,0,310,0,3,3,Balve,1,0,,,,,,3113,,250,0,,0,168070,250480,30378,,5894327,,,,,,,,,,,,,,,,,,,,,,,,,,,,,,,,,,,,,,,,4,
17414624,cb236e74-4bb7-4cbe-be5a-095cfd4d7afe,1595616166,120,1595861539,,0,0,2.64,864,1262,20,9,,,0,0,0.24,0.86,,,152,128,143,93,,,59.76,33.1,60.62,1,59.94,,,,1.4,0,103,102,,,,,,13,79,11.24,11.23,11.45,1.2,-1.7,253,253,,1,262,262,,,,,,,,,"7,6,28,26,33,0,0,0,0","5,92,4,0,0","5,8,77,10,0",,,,,116,,,,,,,,,,,,,,,19,,,,,,,,,,,,,,,,,,,,,11.9,21,12,274,61,,1012,1,317,0,3,3,Balve,1,0,I1.000|5:27-I1.000|5:46-I0.643|3:11,,,,,3113,,250,0,,0,168070,250480,30378,,5894329,,,,,,,,,,,,,,,,,,,,,,,,,,,,,,,,,,,,,,,,,
17414626,8cd5f110-a262-4fc2-809d-403ee8ee1ab0,1595530381,120,1595861539,,0,0,14.85,4242,5556,392,345,,,0,3.8,0.73,1.08,0.98,528,854,149,174,,,,58.13,43.65,60.26,1,59.84,,,,3.7,1.2,105,99,,,,,,113,80,13.34,12.98,13.79,7,13.1,303,303,,1,320,320,,,,,,,,,"3,4,12,17,22,33,9,0,0","1,18,66,16,0","1,7,36,51,5",,,,,131,,,,,,,,,,,,,,,18,,,,,,,,,,,,,,,,,,,,,54.7,23,4,314,41,,1015,1,312,0,2,3,Balve,1,0,I1.000|4:07-I1.000|4:24-I1.000|4:42-I1.000|5:36-I1.000|4:49-I1.000|5:05-I1.000|5:42-I1.000|4:54-I1.000|5:34-I1.000|4:40-I1.000|4:07-I1.000|4:09-I1.000|4:54-I1.000|4:12-I0.853|3:46,,,,,3113,,250,0,,0,168070,250480,30378,,5894330,,,,,,,,,,,,,,,,,,,,,,,,,,,,,,,,,,,,,,,,"4,5",
17414631,87829ef3-cac0-4749-b6d8-f52443ccc9fb,1595692472,120,1595861545,,0,0,2,610,639,40,9,,,0,0.8,0.39,1.02,1,313,128,142,156,,,,57.22,34.99,59.74,1,60.17,,,,2,0,102,100,,,,,,13,80,12.73,11.95,12.93,5.5,4.3,302,302,,1,312,312,,,,,,,,,"6,5,9,27,46,8,0,0,0","2,39,59,0,0","0,3,40,56,0",,,,,123,,,,,,,,,,,,,,,17,,,,,,,,,,,,,,,,,,,,,21.1,25,14,239,46,,1012,3,322,0,4,3,Balve,1,0,I1.000|5:01-I1.001|5:09,,,,,3113,,250,0,,0,168070,250480,30378,,5894334,,,,,,,,,,,,,,,,,,,,,,,,,,,,,,,,,,,,,,,,5,
17414632,dad1c702-dac0-407b-82a9-f96d8a52c6b8,1595693138,120,1595861546,,0,0,14.24,4608,4904,598,614,,,0,5.8,0.98,,,958,826,148,183,,,,50.31,37.62,52.86,1,59.05,,,,3.6,2.4,98,96,,,,,,131,81,12.2,11.55,13.53,6.6,10.5,277,277,,1,327,327,,,,,,,,,"13,10,21,18,26,12,0,0,0","0,49,5,44,1","3,31,22,25,18",,,,,114,,,,,,,,,,,,,,,27,,,,,,,,,,,,,,,,,,,,,86.6,24,13,239,46,,1012,3,322,0,4,3,Balve,1,0,I1.000|5:17-I0.594|3:24-I1.615|7:57-I1.590|8:49-I1.625|8:28-I1.603|8:32-I1.573|10:09-I1.583|10:01-I0.409|2:21-I1.000|4:25-I1.000|4:23-I0.646|3:02,,,,,3113,,250,0,,0,168070,250480,30378,,5894336,,,,,,,,,,,,,,,,,,,,,,,,,,,,,,,,,,,,,,,,"4,4,4,4",
17414642,c7b552eb-caa2-4d3f-abf4-f638505bf1c5,1595782839,120,1595861558,,0,0,13.5,4053,4723,370,342,,,0,4.1,0.88,0.98,1.02,543,748,142,163,,,,58.35,40.89,60.48,1,59.22,,,,3.2,0,104,100,,,,,,89,81,12.88,12.4,13.01,-4.1,5.5,291,291,,1,300,300,,,,,,,,,"7,11,19,21,10,26,7,0,0","0,37,63,0,0","0,4,48,46,1",,,,,123,,,,,,,,,,,,,,,20,,,,,,,,,,,,,,,,,,,,,32.2,20,16,261,58,,1013,2,332,0,4,3,Balve,1,0,I1.000|5:24-I1.000|5:51-I1.000|5:46-I1.000|5:20-I1.000|5:31-I1.000|5:45-I1.000|4:23-I1.000|5:17-I1.000|5:19-I1.000|4:17-I1.000|3:59-I1.000|4:18-I1.000|4:12-I0.496|2:12,,,,,3113,,250,0,,0,168070,250480,30378,,5894342,,,,,,,,,,,,,,,,,,,,,,,,,,,,,,,,,,,,,,,,"3,4",
17414645,c3a76e56-c868-41a0-a85c-8f528eb74b98,1595755824,120,1595861561,,0,0,22.41,18969,19928,615,648,,,0,5.3,0.7,,,205,1624,107,133,109,,,,,,1,59.06,,,,2.3,0,,81,,,,,,148,57,,4.63,,4.9,,,,,,,,,,,,,,,,"70,30,0,0,0,0","22,78,0,0,0",,,,,,,,,,,,,,,,,,,,,17,,,,,,,,,,,,,,,,,,,,,6.8,15,13,256,87,,1010,2,338,0,6,3,Brilon,1,0,I8.179|1:57:57-I5.648|1:25:00-I8.587|1:53:12,,,,,3113,,250,0,,0,168075,,30378,,5894345,,,,,,,,,,,,,,,,,,,,,,,,,,,,,,,,,,,,,,,,"4,4,4,4,5,5",
17424253,81b47b47-df14-417a-b08a-094ff3cf63ff,1595877301,120,1595875007,,0,0,10.25,4305,4556,245,250,,,0,3.2,0.61,1.33,0.59,485,642,132,176,,,,42.32,26.9,43.54,1,60.02,,,,3,2.3,104,102,,,,,,77,76,8.81,10.02,11.44,28.9,1.2,202,201,,1,284,284,,,,,,,,,"61,5,4,6,13,6,4,0,0","1,64,28,7,0","29,35,10,17,9",,,,,94,,,,,,,,,,,,,,,13,,,,,,,,,,,,,,,,,,,,,31.3,24,11,181,55,,1010,1,306,0,3,3,Balve,1,0,I1.000|4:46-I1.000|4:39-I1.000|5:32-I0.243|1:23-I0.208|0:47-I0.256|2:13-I0.221|0:48-I0.258|2:06-I0.218|0:50-I0.248|2:38-I0.217|0:49-I0.246|2:43-I0.213|0:49-I0.246|3:00-I0.212|0:50-I0.243|3:07-I0.214|0:52-I0.248|2:45-I0.217|0:51-I0.253|3:44-I0.215|0:50-I0.258|3:25-I0.218|0:54-I1.000|9:11-I1.000|6:59-I0.403|3:30-I0.199|1:45,,,,,3113,,250,0,,0,168070,250480,30378,,5901170,,,,,,,,,,,,,,,,,,,,,,,,,,,,,,,,,,,,,,,,"5,5,5,5",
17456721,a1eee98c-936b-499a-a748-b476b885c92d,1595960308,120,1595957502,,0,0,13.79,3477,4048,130,151,,,0,0.9,0.38,1.01,1,,767,158,183,,,,62.37,50.16,62.98,1,60.37,,,,4,2.3,104,100,,,,,,115,83,14.42,14.36,14.5,1.9,-3.6,353,353,,1,362,362,,,,,,,,,"0,0,0,2,15,62,22,0,0","0,9,45,45,0","0,0,11,78,10",,,,,143,,,,,,,,,,,,,,,13,,,,,,,,,,,,,,,,,,,,,66.3,20,16,265,65,,1014,1,330,0,3,3,Balve,1,0,I1.000|4:37-I1.000|4:19-I1.000|4:08-I1.000|4:14-I1.000|4:02-I1.000|4:11-I1.000|4:10-I1.000|3:53-I1.000|3:58-I1.000|4:07-I1.000|4:15-I1.000|4:35-I1.000|4:22-I0.790|3:05,,,,,3113,,250,0,,0,168070,250480,30378,,5928335,,,,,,,,,,,,,,,,,,,,,,,,,,,,,,,,,,,,,,,,,
17483488,f54a2bc1-6f4e-4465-8d98-5a05c0574501,1596054319,120,1596047931,,0,0,0.6,279,279,4,1,,,0,0,0,1.16,0.97,,36,111,120,,,,45.38,18.77,46.03,1,60.43,,,,0.2,0,,100,,,,,,2,79,7.94,7.75,7.94,-17.3,-12.9,168,168,,1,170,170,,,,,,,,,"85,13,2,0,0,0,0,0,0","7,93,0,0,0","0,77,23,0,0",,,,,82,,,,,,,,,,,,,,,19,,,,,,,,,,,,,,,,,,,,,2.6,18,7,313,65,,1021,0,307,0,3,3,Balve,1,0,,,,,,3113,,250,0,,0,168070,250480,30378,,5950082,,,,,,,,,,,,,,,,,,,,,,,,,,,,,,,,,,,,,,,,,
17483489,9ee9fda7-aaca-4b6d-992c-821ffaf47372,1596052119,120,1596047932,,0,0,4.64,1849,2175,68,53,,,0,1.4,0.61,1.07,1.05,404,260,121,156,,,,50.02,27.14,51.13,1,60.43,,,,2,0,100,100,,,,,,23,78,9.31,10.4,10.71,22.1,10.1,205,205,,1,240,240,,,,,,,,,"28,12,26,20,10,3,0,0,0","19,73,8,0,0","21,5,68,6,0",,,,,97,,,,,,,,,,,,,,,,,,,,,,,,,,,,,,,,,,,,14.8,19,8,313,63,,1021,0,307,0,3,3,Balve,1,0,I1.000|5:51-I1.000|5:27-I1.000|4:54-I1.000|5:44-I0.644|8:54,,,,,3113,,250,0,,0,168070,250480,30378,,5950083,,,,,,,,,,,,,,,,,,,,,,,,,,,,,,,,,,,,,,,,5,
17509697,fbff019f-b1dd-479f-9f16-cb5902bdebde,1596137421,120,1596134281,,0,0,13.97,3625,4020,277,267,,,0,3.1,0.7,0.97,1.03,525,801,155,176,,,,61.9,48.56,63.48,1,60.57,,,,3.7,2.1,102,100,,,,,,112,81,14.45,14.25,14.62,-6.2,-5.4,340,340,,1,348,348,,,,,,,,,"0,2,6,13,22,15,41,1,0","0,9,55,36,0","0,0,18,73,9",,,,,143,,,,,,,,,,,,,,,16,,,,,,,,,,,,,,,,,,,,,60.5,24,8,25,45,,1019,0,307,0,3,3,Balve,1,0,I1.000|4:52-I1.000|5:05-I1.000|5:07-I1.000|4:54-I1.000|5:19-I1.000|4:12-I1.000|3:50-I1.000|3:50-I1.000|3:43-I1.000|3:40-I1.000|4:08-I1.000|3:57-I1.000|3:57-I0.970|3:52,,,,,3113,,250,0,,0,168070,250480,30378,,5971439,,,,,,,,,,,,,,,,,,,,,,,,,,,,,,,,,,,,,,,,"4,5",
17588885,4fabcbeb-c7df-4976-9461-f745fda0d3c6,1596225048,120,1596610687,,0,0,11.25,3058,3700,222,210,,,0,2.4,0.64,1.02,1.05,423,669,153,176,,,,59.55,45.28,61.08,1,60.72,,,,3.6,2,100,100,,,,,,89,81,13.82,13.51,13.99,3.9,-4.3,327,327,,1,340,340,,,,,,,,,"2,2,8,12,18,40,16,1,0","0,9,64,27,0","0,0,33,59,7",,,,,136,,,,,,,,,,,,,,,21,,,,,,,,,,,,,,,,,,,,,56.4,29,7,51,46,,1015,0,288,0,2,3,Balve,1,0,I1.000|5:19-I1.000|4:39-I1.000|4:16-I1.000|4:23-I1.000|4:22-I1.000|4:34-I1.000|4:32-I1.000|4:31-I1.000|4:10-I1.000|4:17-I1.000|4:54-I0.250|1:01,,,,,3113,,250,0,,0,168070,250480,30378,,6024427,,,,,,,,,,,,,,,,,,,,,,,,,,,,,,,,,,,,,,,,"4,5,5,5",
17589327,8aa5bb54-b569-4af8-9739-9ad36264f892,1596301549,120,1596610774,,0,0,10.19,2982,3209,235,223,,,0,3.1,0.81,1,1.14,557,632,147,166,,,,57.48,41.25,59.21,1,60.43,,,,3.3,0.1,100,99,,,,,,75,80,13.06,13.03,13.12,-15.5,-2.2,299,299,,1,303,303,,,,,,,,,"9,13,16,21,6,8,26,1,0","1,17,81,1,0","0,1,47,52,0",,,,,128,,,,,,,,,,,,,,,14,,,,,,,,,,,,,,,,,,,,,36.2,28,6,262,56,,1015,3,284,0,3,3,Balve,1,0,I1.000|5:16-I1.000|5:29-I1.000|6:10-I1.000|5:39-I1.000|6:18-I1.000|4:29-I1.000|3:55-I1.000|3:54-I1.000|3:57-I1.000|3:43-I0.193|0:52,,,,,3113,,250,0,,0,168070,250480,30378,,6024865,,,,,,,,,,,,,,,,,,,,,,,,,,,,,,,,,,,,,,,,4,
17599412,b51d0f7a-638a-4c5d-b291-81dfd5460d17,1596371700,120,1596612669,,0,0,22.42,6362,6848,551,537,,,0,4.7,0.77,0.97,1.05,600,1235,153,177,,,,56.47,45.46,58.23,1,60.03,,,,4.1,0.1,100,98,,,,,,185,81,13.46,13.14,13.57,8.5,8.3,309,309,,1,316,316,,,,,,,,,"6,6,12,20,15,24,18,0,0","0,11,59,30,0","0,1,39,58,1",,,,,131,,,,,,,,,,,,,,,20,,,,,,,,,,,,,,,,,,,,,63.8,23,12,285,55,,1015,4,308,0,4,3,Balve,1,0,I1.000|5:01-I1.000|5:15-I1.000|5:02-I1.000|4:56-I1.000|5:11-I1.000|4:21-I1.000|3:53-I1.000|3:55-I1.000|3:58-I1.000|4:07-I1.000|4:24-I1.000|5:57-I1.000|6:24-I1.000|5:02-I1.000|4:10-I1.000|5:11-I1.000|6:02-I1.000|5:08-I1.000|4:16-I1.000|3:54-I1.000|4:04-I1.000|4:01-I0.424|1:49,,,,,3113,,250,0,,0,168070,250480,30378,,6034660,,,,,,,,,,,,,,,,,,,,,,,,,,,,,,,,,,,,,,,,"4,4,4",
17614777,1b56a083-ec90-4856-b411-bcd93428bf92,1596481047,120,1596615543,,0,0,14.8,4155,4182,334,334,,,0,3.7,0.76,0.98,1.08,446,738,140,164,,,,64.59,44.52,66.39,1,60.56,,,,3.2,0,104,101,,,,,,87,81,13.43,13.15,13.53,-10.7,-1,311,311,,1,317,317,,,,,,,,,"1,5,12,22,22,24,15,0,0","0,46,53,1,0","0,0,37,61,2",,,,,132,,,,,,,,,,,,,,,18,,,,,,,,,,,,,,,,,,,,,29.9,20,9,17,48,,1012,1,334,0,4,3,Balve,1,0,I1.000|4:59-I1.000|5:34-I1.000|5:41-I1.000|4:51-I1.000|4:59-I1.000|5:03-I1.000|4:31-I1.000|3:55-I1.000|4:01-I1.000|4:14-I1.000|4:33-I1.000|4:13-I1.000|4:56-I1.000|4:28-I0.796|3:16,,,,,3113,,250,0,,0,168070,250480,30378,,6049380,,,,,,,,,,,,,,,,,,,,,,,,,,,,,,,,,,,,,,,,"4,4",
17627190,c971fa7c-573b-49ca-8319-8ed1c8af477a,1596570351,120,1596617850,,0,0,3.83,1585,1648,21,28,,,0,0,0.11,1.13,0.4,,285,136,171,,,,41.52,25.62,41.71,1,60.68,,,,2.3,1.8,,96,,,,,,30,74,8.72,11.21,11.42,4.7,-7.7,204,204,,1,298,298,,,,,,,,,"53,10,12,5,6,2,2,3,8","0,74,19,7,0","33,20,27,7,12",,,,,98,,,,,,,,,,,,,,,29,,,,,,,,,,,,,,,,,,,,,26.6,20,5,288,51,,1017,0,308,0,3,3,,1,0,I0.770|5:14-I0.003|0:01-I0.306|0:49-I0.228|2:58-I0.303|0:52-I0.231|2:58-I0.303|0:52-I0.208|3:05-I0.306|0:53-I0.167|2:52-I1.000|5:48-I0.005|0:02,,,,,3113,,250,0,,0,168070,250480,30378,,6061491,,,,,,,,,,,,,,,,,,,,,,,,,,,,,,,,,,,,,,,,,
17627682,6b240b09-6fbc-48ac-a223-55d7d7bf88d2,1596567132,120,1596617925,,0,0,8.43,2290,2451,209,213,,,0,3.1,0.86,1.01,1.17,558,488,152,176,,,,60.15,44.44,61.96,1,60.83,,,,3.3,0.5,101,100,,,,,,67,83,14,13.94,14.29,0.4,9.9,332,332,,1,345,345,,,,,,,,,"6,5,16,15,9,14,29,6,0","1,19,42,38,0","0,2,34,46,18",,,,,133,,,,,,,,,,,,,,,13,,,,,,,,,,,,,,,,,,,,,70.3,21,6,290,48,,1017,1,313,0,3,3,Balve,1,0,I1.000|5:25-I0.357|2:06-I0.112|0:31-I0.076|0:31-I0.120|0:31-I0.088|0:31-I0.130|0:32-I0.078|0:31-I0.125|0:30-I0.087|0:33-I0.137|0:31-I0.091|0:32-I0.138|0:32-I0.081|0:32-I0.143|0:32-I0.088|0:32-I0.138|0:33-I0.091|0:32-I0.140|0:33-I0.090|0:32-I0.140|0:32-I0.083|0:31-I0.140|0:32-I0.066|0:31-I0.134|0:32-I0.064|0:32-I0.123|0:32-I0.066|0:32-I0.123|0:31-I0.066|0:32-I0.128|0:33-I1.000|4:20-I1.000|3:42-I1.000|3:35-I0.993|3:42,,,,,3113,,250,0,,0,168070,250480,30378,,6061980,,,,,,,,,,,,,,,,,,,,,,,,,,,,,,,,,,,,,,,,4,
17645088,5fc1c426-f95f-4077-808d-d9d646ff99d5,1596654843,120,1596651461,,0,0,10.31,3239,3485,292,287,,,0,3.7,0.86,0.97,1.15,524,587,140,159,,,,56.21,37.99,58.21,1,59.94,,,,3,0,97,97,,,,,,67,80,12.39,12.1,12.46,-12.6,1.9,277,277,,1,282,282,,,,,,,,,"18,14,19,15,7,19,8,1,0","1,46,53,0,0","0,2,74,23,0",,,,,119,,,,,,,,,,,,,,,11,,,,,,,,,,,,,,,,,,,,,29.1,27,6,206,35,,1017,1,303,0,2,3,Balve,1,0,I1.000|5:20-I1.000|5:47-I1.000|6:15-I1.000|5:37-I1.000|6:30-I1.000|6:08-I1.000|4:50-I1.000|3:53-I1.000|4:07-I1.000|4:11-I0.309|1:21,,,,,3113,,250,0,,0,168070,250480,30378,,6076307,,,,,,,,,,,,,,,,,,,,,,,,,,,,,,,,,,,,,,,,3,
17667795,003cb25d-55a7-45b6-9353-13961d5f1289,1596742886,120,1596739733,,0,0,10.02,3177,3722,275,236,,,0,3.3,0.82,1.04,1.03,491,568,138,159,,,,56.62,37.5,58.82,1,59.29,,,,2.8,0,97,99,,,,,,63,80,12.19,11.76,12.41,-2.9,12.7,270,270,,1,277,277,,,,,,,,,"16,15,18,12,15,24,0,0,0","0,52,48,0,0","0,4,76,18,2",,,,,118,,,,,,,,,,,,,,,17,,,,,,,,,,,,,,,,,,,,,22.4,28,6,72,40,,1020,0,308,0,2,3,Balve,1,0,I1.000|5:27-I1.000|6:08-I1.000|6:01-I1.000|6:15-I1.000|6:08-I1.000|5:02-I1.000|4:36-I1.000|4:32-I1.000|4:22-I1.000|4:20-I0.019|0:06,,,,,3113,,250,0,,0,168070,250480,30378,,6094758,,,,,,,,,,,,,,,,,,,,,,,,,,,,,,,,,,,,,,,,4,
17691669,566fb908-396e-41dc-a148-2d8953a89bae,1596825826,120,1596825475,,0,0,21.36,6228,6766,560,502,,,0,4.8,0.78,0.95,1.03,629,1219,155,178,,,,53.6,43.88,55.52,1,59.09,,,,4.3,1.5,102,99,,,,,,189,81,13.24,12.87,13.32,7.3,12.2,312,312,,1,337,337,,,,,,,,,"12,9,10,12,14,31,12,0,0","0,4,66,29,0","0,5,38,48,8",,,,,127,,,,,,,,,,,,,,,19,,,,,,,,,,,,,,,,,,,,,74.4,31,7,34,32,,1019,1,302,0,2,3,Balve,1,0,I1.000|4:47-I1.000|5:18-I1.000|5:21-I1.000|5:06-I1.000|5:49-I1.000|4:24-I1.000|4:08-I1.000|4:00-I1.000|4:01-I1.000|4:14-I1.000|4:25-I1.000|6:11-I1.000|6:26-I1.000|5:22-I1.000|4:20-I1.000|5:57-I1.000|5:49-I1.000|4:13-I1.000|3:58-I1.000|4:10-I1.000|4:14-I0.363|1:36,,,,,3113,,250,0,,0,168070,250480,30378,,6114760,,,,,,,,,,,,,,,,,,,,,,,,,,,,,,,,,,,,,,,,"4,4,4",
17720585,7389b261-f8e3-4362-9afc-7658f90cfa8c,1596912887,120,1596908885,,0,0,9.64,2794,2868,204,193,,,0,2.9,0.64,1.01,1.06,485,593,150,171,,,,56.57,41.55,58.13,1,59.19,,,,3.3,0.2,101,100,,,,,,75,81,13.05,12.73,13.15,-6,1.3,300,300,,1,306,306,,,,,,,,,"4,10,8,23,18,31,6,0,0","0,11,78,10,0","0,1,44,55,0",,,,,128,,,,,,,,,,,,,,,19,,,,,,,,,,,,,,,,,,,,,40.4,32,8,5,34,,1019,1,289,0,2,3,Balve,1,0,I1.000|5:06-I1.000|4:56-I1.000|5:21-I1.000|5:50-I1.000|4:20-I1.000|4:38-I1.000|4:13-I1.000|4:34-I1.000|4:59-I0.635|2:37,,,,,3113,,250,0,,0,168070,250480,30378,,6139985,,,,,,,,,,,,,,,,,,,,,,,,,,,,,,,,,,,,,,,,"4,5",
17734569,863d57fe-bfc4-4a72-bf37-fb01d1c36096,1596972790,120,1596970413,,0,0,14.23,4037,4632,301,274,,,0,3.1,0.72,0.96,1.02,447,913,160,181,135,,,52.93,43.85,54.43,1,58.62,,,,4.2,2.5,100,97,,,,,,140,82,13.32,13.16,13.42,-8.8,0.1,304,304,,1,310,310,,,,,,,,,"4,10,13,17,15,21,20,0,0","0,2,46,51,0","0,2,41,55,2",,,,,129,,,,,,,,,,,,,,,18,,,,,,,,,,,,,,,,,,,,,77.4,28,4,175,68,,1019,4,290,0,4,3,Balve,1,0,I1.000|5:03-I1.000|5:35-I1.000|5:40-I1.000|5:35-I1.000|6:09-I1.000|4:13-I1.000|4:59-I1.000|4:04-I1.000|3:57-I1.000|3:59-I1.000|4:05-I1.000|3:59-I1.000|4:06-I1.000|4:47-I0.225|1:05,,,,,3113,,250,0,,0,168070,250480,30378,,6150352,,,,,,,,,,,,,,,,,,,,,,,,,,,,,,,,,,,,,,,,4,
17767170,44401af2-065a-4129-99cd-8b300b6cb4d6,1597088437,120,1597084844,,0,0,12.96,3485,3569,147,147,,,0,1.2,0.4,0.98,1.02,237,746,151,174,,,,61.48,46.33,62.34,1,59.38,,,,3.6,1.5,104,101,,,,,,97,82,13.69,13.7,13.82,-1.9,-4.1,324,324,,1,330,330,,,,,,,,,"2,2,6,13,30,23,23,3,0","0,9,76,15,0","1,0,24,71,4",,,,,136,,,,,,,,,,,,,,,20,,,,,,,,,,,,,,,,,,,,,58.8,29,10,93,57,,1016,0,292,0,3,3,Balve,1,0,I1.000|4:57-I1.000|4:23-I1.000|4:43-I1.000|4:51-I1.000|5:00-I1.000|4:32-I1.000|4:58-I1.000|4:05-I1.000|4:10-I1.000|4:01-I1.000|3:52-I0.652|2:46-I0.139|0:46-I0.048|0:50-I1.000|3:46-I0.117|0:25,,,,,3113,,250,0,,0,168070,250480,30378,,6175210,,,,,,,,,,,,,,,,,,,,,,,,,,,,,,,,,,,,,,,,"5,5",
17792777,c8127f8f-0f16-4834-bda8-31f1c8c577ad,1597175197,120,1597171724,,0,0,10.76,3146,3672,237,228,,,0,3.1,0.77,0.99,1.09,522,576,139,156,,,,62,41.45,63.76,1,59.54,,,,2.9,0,103,100,,,,,,63,80,12.96,12.77,13.08,-5.2,25.6,308,308,,1,370,370,,,,,,,,,"4,8,21,21,7,29,10,0,0","1,49,50,0,0","0,1,52,44,3",,,,,128,,,,,,,,,,,,,,,16,,,,,,,,,,,,,,,,,,,,,24.6,25,5,120,71,,1016,0,283,0,3,3,Balve,1,0,I1.000|5:20-I1.000|5:33-I1.000|5:41-I1.000|5:30-I1.000|5:55-I1.000|4:33-I1.000|4:13-I1.000|4:10-I1.000|3:56-I1.000|4:06-I0.758|3:29,,,,,3113,,250,0,,0,168070,250480,30378,,6194863,,,,,,,,,,,,,,,,,,,,,,,,,,,,,,,,,,,,,,,,4,
17833920,5673afd8-7886-4f3c-9119-06c1dc9d4ec6,1597259459,120,1597257259,,0,0,15.5,4469,4955,448,432,,,0,4.8,0.83,0.91,1.03,583,856,146,172,,,,59.1,43.33,61.29,1,59.84,,,,3.4,0.3,103,100,,,,,,110,82,13.62,13.38,13.64,-6.5,5.6,306,306,,1,311,311,,,,,,,,,"15,10,11,11,9,13,28,2,0","0,24,70,6,0","0,2,37,60,1",,,,,127,,,,,,,,,,,,,,,17,,,,,,,,,,,,,,,,,,,,,45.5,28,9,129,61,,1015,0,285,0,2,3,Balve,1,0,I1.000|5:04-I1.000|5:14-I1.000|5:38-I1.000|5:23-I1.000|5:40-I1.000|4:08-I1.000|3:56-I1.000|4:00-I1.000|6:42-I1.000|6:03-I1.000|5:50-I1.000|3:52-I1.000|3:31-I1.000|3:43-I1.000|3:44-I0.502|2:00,,,,,3113,,250,0,,0,168070,250480,30378,,6232694,,,,,,,,,,,,,,,,,,,,,,,,,,,,,,,,,,,,,,,,"3,4",
17854903,80738db8-109c-4b16-8700-42ff81b3971a,1597347491,120,1597345063,,0,0,15.53,4554,4712,447,429,,,0,4.9,0.88,0.97,1.1,585,821,144,170,,,,58.96,42.49,61.15,1,59.97,,,,3.3,0,104,100,,,,,,105,81,13.33,13.02,13.39,-5.9,5.1,301,301,,1,307,307,,,,,,,,,"13,8,15,15,9,20,19,2,0","0,34,62,3,0","0,1,41,57,0",,,,,126,,,,,,,,,,,,,,,13,,,,,,,,,,,,,,,,,,,,,43,26,8,191,73,,1013,0,280,0,6,3,Balve,1,0,I1.000|5:02-I1.000|5:30-I1.000|5:36-I1.000|5:19-I1.000|5:27-I1.000|4:23-I1.000|4:04-I1.000|3:59-I0.397|1:37-I1.000|7:36-I0.224|0:51-I1.000|6:22-I1.000|4:45-I1.000|3:47-I1.000|3:54-I1.000|3:56-I0.908|3:44,,,,,3113,,250,0,,0,168070,250480,30378,,6249964,,,,,,,,,,,,,,,,,,,,,,,,,,,,,,,,,,,,,,,,"3,4",
17877569,89a2456c-ef54-4e7c-96fd-b9f215968917,1597432717,120,1597428538,,0,0,10.14,2763,2880,281,287,,,0,3.7,0.84,0.96,1.08,518,591,156,181,118,,,57.73,44.82,59.67,1,59.87,,,,3.7,1.5,100,100,,,,,,90,82,14.21,13.86,14.4,-3.7,1.5,329,329,,1,342,342,,,,,,,,,"6,6,6,16,21,20,15,9,1","0,15,36,48,0","0,1,34,49,16",,,,,134,,,,,,,,,,,,,,,14,,,,,,,,,,,,,,,,,,,,,75,24,7,263,72,,1014,0,292,0,6,3,Balve,1,0,I1.000|5:03-I0.719|3:26-I0.174|1:01-I0.218|1:01-I0.164|1:01-I0.233|1:02-I0.192|1:01-I0.228|1:00-I0.186|1:01-I0.232|1:01-I0.169|1:01-I0.257|1:02-I0.168|1:01-I0.228|1:02-I0.157|1:01-I0.219|1:01-I0.159|1:02-I0.282|1:02-I0.205|1:01-I0.227|1:01-I0.121|1:00-I0.185|1:00-I0.120|1:01-I0.274|1:02-I1.000|3:59-I1.000|4:04-I1.000|3:50-I1.000|3:12-I0.022|0:06,,,,,3113,,250,0,,0,168070,250480,30378,,6266800,,,,,,,,,,,,,,,,,,,,,,,,,,,,,,,,,,,,,,,,3,
17900474,e0b00997-3d93-4b8e-8679-224d3ee4b929,1597521877,120,1597518630,,0,0,4.37,1679,1728,163,152,,,0,2.4,0.81,1.92,0.95,313,321,143,176,,,,42.64,28.27,44.75,1,60.41,,,,2.6,2.4,,100,,,,,,41,79,9.79,10.57,13.12,8.5,8.5,239,236,,1,340,339,,,,,,,,,"49,8,8,6,8,11,8,1,0","0,51,20,29,0","30,29,9,8,24",,,,,99,,,,,,,,,,,,,,,19,,,,,,,,,,,,,,,,,,,,,43.4,22,5,80,77,,1014,0,304,0,4,3,Balve,1,0,I0.217|0:50-I0.239|2:12-I0.216|0:52-I0.244|1:36-I0.216|0:52-I0.251|2:18-I0.219|0:50-I0.240|2:07-I0.214|0:54-I0.248|2:02-I0.216|0:52-I0.242|2:08-I0.212|0:52-I0.244|1:50-I0.215|0:50-I0.245|2:01-I0.216|0:53-I0.247|2:18-I0.213|0:52-I0.008|0:50,,,,,3113,,250,0,,0,168070,250480,30378,,6286494,,,,,,,,,,,,,,,,,,,,,,,,,,,,,,,,,,,,,,,,"4,5,5",
17900689,7bfb0ca0-db30-47e8-89fe-891da3441233,1597519530,120,1597519617,,0,0,6.51,2025,2183,168,118,,,0,2.7,0.78,1.02,0.97,458,368,138,161,,,,57.97,37.27,60.38,1,60.34,,,,2.7,0,103,101,,,,,,40,81,12.4,11.9,12.79,13.4,5.9,287,287,,1,303,303,,,,,,,,,"8,8,6,35,34,8,1,0,0","1,46,52,1,0","2,11,31,55,2",,,,,119,,,,,,,,,,,,,,,15,,,,,,,,,,,,,,,,,,,,,34.1,23,5,70,75,,1014,0,303,0,4,3,Balve,1,0,I1.000|4:54-I1.000|5:12-I1.000|4:56-I1.000|5:30-I1.000|4:31-I1.000|5:08-I0.077|0:25-I0.207|1:20-I0.016|0:41-I0.205|1:04-I0.006|0:03,,,,,3113,,250,0,,0,168070,250480,30378,,6286669,,,,,,,,,,,,,,,,,,,,,,,,,,,,,,,,,,,,,,,,"4,5",
17908369,8516863c-d50b-4c6f-9c29-35a1b1329bfa,1597569982,120,1597567524,,0,0,10.03,3250,3488,246,218,,,0,3.1,0.8,0.97,1.08,427,588,140,158,,,,54.1,36.56,55.93,1,59.78,,,,3,0,100,96,,,,,,68,81,11.8,11.46,11.84,-7.3,3.8,261,261,,1,265,265,,,,,,,,,"19,16,12,16,27,10,0,0,0","0,47,53,0,0","0,4,86,9,0",,,,,114,,,,,,,,,,,,,,,19,,,,,,,,,,,,,,,,,,,,,27,21,5,130,81,,1013,2,303,0,2,3,Balve,1,0,I1.000|5:21-I1.000|6:07-I1.000|6:23-I1.000|6:09-I1.000|6:24-I1.000|5:05-I1.000|4:48-I1.000|4:48-I1.000|4:32-I1.000|4:25-I0.025|0:07,,,,,3113,,250,0,,0,168070,250480,30378,,6293296,,,,,,,,,,,,,,,,,,,,,,,,,,,,,,,,,,,,,,,,4,
17915880,85dfea48-22ae-40ac-a58a-6b0a8515ea59,1597580311,120,1597585490,,0,0,10.42,9617,9617,353,370,,,0,4.5,0.83,,,224,790,102,142,,,,,,,1,59.83,,,,1.2,0,,83,,,,,,64,56,,4.42,,-29.2,,,,,,,,,,,,,,,,"89,11,0,0,0,0","41,59,0,0,0",,,,,,,,,,,,,,,,,,,,,19,,,,,,,,,,,,,,,,,,,,,9.1,27,5,126,60,,1012,5,303,0,3,3,Balve,1,0,,,,,,3113,,250,0,,0,168075,,30378,,6299788,,,,,,,,,,,,,,,,,,,,,,,,,,,,,,,,,,,,,,,,3,
17965024,57a23a49-e275-4f44-8575-87a0c7fa73a9,1597687704,120,1597685501,,0,0,15.76,4337,4363,448,446,,,0,4.9,0.83,0.96,1.09,612,877,150,170,,,,60.31,45.79,62.44,1,60.01,,,,3.5,0.4,103,99,,,,,,115,82,14.22,14.01,14.28,-15.9,0.7,326,326,,1,331,331,,,,,,,,,"11,6,9,17,13,12,20,12,0","0,12,76,12,0","0,0,20,77,2",,,,,133,,,,,,,,,,,,,,,14,,,,,,,,,,,,,,,,,,,,,53.7,20,5,243,78,,1011,1,308,0,6,3,Balve,1,0,I1.000|4:42-I1.000|5:14-I1.000|5:22-I1.000|5:00-I1.000|5:25-I1.000|4:12-I1.000|3:53-I1.000|3:49-I1.000|5:35-I1.000|6:10-I1.000|5:49-I1.000|4:03-I1.000|3:49-I1.000|3:29-I1.000|3:20-I0.763|2:26,,,,,3113,,250,0,,0,168070,250480,30378,,6343877,,,,,,,,,,,,,,,,,,,,,,,,,,,,,,,,,,,,,,,,"3,4",
18008494,173dacd2-36af-47f5-8b2e-23482ee1fcef,1597781753,120,1597777886,,0,0,8.88,2542,3206,199,208,,,0,3.4,0.73,0.95,1.11,508,508,142,162,,,,61.89,41.93,63.53,1,60.4,,,,3,0.1,104,100,,,,,,62,81,13.46,13.64,13.57,-19.8,-6.8,306,306,,1,311,311,,,,,,,,,"17,3,13,22,7,4,28,6,0","1,35,64,0,0","0,0,46,51,3",,,,,129,,,,,,,,,,,,,,,16,,,,,,,,,,,,,,,,,,,,,34.4,20,5,298,70,,1012,0,309,0,6,3,Balve,1,0,I1.000|5:35-I1.000|5:24-I1.000|5:10-I1.000|7:09-I1.000|4:11-I1.000|3:39-I1.000|3:31-I1.000|3:55-I0.882|3:47,,,,,3113,,250,0,,0,168070,250480,30378,,6381133,,,,,,,,,,,,,,,,,,,,,,,,,,,,,,,,,,,,,,,,"4,5",
18038363,42723b81-93dc-492c-a6a8-de34af00e79a,1597855365,120,1597853478,,0,0,12.13,3720,3901,320,308,,,0,3.7,0.7,1.05,1.03,535,670,140,158,,,,57.91,39.56,59.87,1,60.17,,,,3.1,0,102,100,,,,,,81,80,12.46,11.93,12.86,3.2,18.1,282,282,,1,299,299,,,,,,,,,"4,8,18,24,35,11,0,0,0","1,48,51,0,0","0,9,51,36,4",,,,,122,,,,,,,,,,,,,,,18,,,,,,,,,,,,,,,,,,,,,30.5,24,10,200,56,,1010,3,298,0,3,3,Balve,1,0,I1.000|5:14-I1.000|5:31-I1.000|5:33-I1.000|5:27-I1.000|5:59-I1.000|5:31-I1.000|4:47-I1.000|4:34-I1.000|4:31-I1.000|4:37-I1.000|4:49-I1.000|4:45-I0.131|0:40,,,,,3113,,250,0,,0,168070,250480,30378,,6407227,,,,,,,,,,,,,,,,,,,,,,,,,,,,,,,,,,,,,,,,3,
18076901,2b254c5c-4c5b-438e-b69a-6630207d7760,1597950370,120,1597946338,,0,0,8.66,2795,3114,207,194,,,0,3.5,0.7,1.06,1.07,539,493,139,169,,,,54.88,36.35,56.6,1,59.74,,,,3.1,0,101,99,,,,,,61,80,11.75,11.81,12.35,4.9,11.9,267,267,,1,285,285,,,,,,,,,"29,5,8,20,14,21,4,0,0","1,55,36,9,0","2,15,48,34,1",,,,,116,,,,,,,,,,,,,,,15,,,,,,,,,,,,,,,,,,,,,45.1,27,9,155,66,,1010,0,283,0,4,3,Balve,1,0,I1.000|5:06-I1.000|5:19-I1.000|5:04-I1.000|7:15-I1.000|4:32-I1.000|4:20-I1.000|4:13-I1.000|6:45-I0.656|4:02,,,,,3113,,250,0,,0,168070,250480,30378,,6441613,,,,,,,,,,,,,,,,,,,,,,,,,,,,,,,,,,,,,,,,"4,5",
18107638,21d3fcca-2f6e-4e37-a962-8b71e63f208d,1598036021,120,1598030483,,0,0,4.87,1454,1603,71,68,,,0,1.1,0.54,0.96,1.03,,264,133,154,,,,63.89,38.47,65.09,1,59.84,,,,2.2,0,103,100,,,,,,21,79,12.29,12.18,12.3,-19.9,-1.6,281,281,,1,285,285,,,,,,,,,"2,4,15,30,34,12,3,0,0","3,73,24,0,0","0,2,73,25,0",,,,,127,,,,,,,,,,,,,,,15,,,,,,,,,,,,,,,,,,,,,17.5,26,15,219,65,,1011,1,279,0,4,3,Balve,1,0,I1.000|5:15-I1.000|5:34-I1.000|5:04-I1.000|4:37-I0.866|3:44,,,,,3113,,250,0,,0,168070,250480,30378,,6468592,,,,,,,,,,,,,,,,,,,,,,,,,,,,,,,,,,,,,,,,,
18122614,5e7f8a81-462a-4098-8409-7c4323fafe44,1598089417,120,1598087747,,0,0,17.57,5139,5494,361,351,,,0,3.4,0.64,0.94,0.97,460,1079,154,175,,,,53.9,43.04,55.3,1,59.36,,,,4.1,0.5,99,97,,,,,,159,82,12.94,12.93,13.18,-8.5,-21.4,312,312,,1,343,343,,,,,,,,,"6,11,14,18,17,14,18,1,0","0,7,62,31,0","1,7,38,48,6",,,,,125,,,,,,,,,,,,,,,16,,,,,,,,,,,,,,,,,,,,,65.6,20,15,224,66,,1016,2,302,0,4,3,Balve,1,0,I1.000|5:10-I1.000|5:34-I1.000|5:53-I1.000|5:30-I1.000|6:06-I1.000|4:55-I1.000|5:09-I1.000|5:05-I1.000|4:28-I1.000|4:53-I1.000|4:37-I1.000|6:06-I1.000|3:50-I1.000|3:47-I1.000|3:43-I1.000|3:51-I1.000|4:16-I0.573|2:45,,,,,3113,,250,0,,0,168070,250480,30378,,6481985,,,,,,,,,,,,,,,,,,,,,,,,,,,,,,,,,,,,,,,,"4,5",
18167572,54bd0e73-6b2a-433e-a465-7bcf3dfadade,1598208581,120,1598204713,,0,0,11.52,3270,3270,300,313,,,0,3.6,0.84,1,1.11,468,615,148,169,,,,59.14,43.12,60.96,1,59.3,,,,3.4,0,103,98,,,,,,93,80,13.45,13.06,13.56,2,8.6,320,320,,1,330,330,,,,,,,,,"2,8,11,22,19,22,16,0,0","1,28,48,23,0","0,0,33,65,2",,,,,132,,,,,,,,,,,,,,,15,,,,,,,,,,,,,,,,,,,,,55.9,19,14,283,71,,1016,0,300,0,3,3,Balve,1,0,I1.000|5:00-I1.000|5:14-I1.000|5:18-I1.000|4:58-I1.000|5:17-I1.000|5:27-I1.000|4:54-I1.000|4:06-I1.000|3:53-I1.000|4:06-I1.000|4:02-I0.522|2:14,,,,,3113,,250,0,,0,168070,250480,30378,,6520740,,,,,,,,,,,,,,,,,,,,,,,,,,,,,,,,,,,,,,,,3,
18192222,e5c87a36-e5c4-408e-88e7-f7725c551fe9,1598288347,120,1598284961,,0,0,13.1,3694,3770,315,322,,,0,3.6,0.75,0.94,1.07,471,700,145,170,,,,61.31,43.88,63.1,1,59.52,,,,3.2,0.9,103,100,,,,,,95,81,13.58,13.42,13.66,-6.4,-1.8,321,321,,1,328,328,,,,,,,,,"8,11,10,15,13,17,23,3,0","0,27,70,4,0","0,0,26,69,4",,,,,131,,,,,,,,,,,,,,,22,,,,,,,,,,,,,,,,,,,,,39.3,18,15,254,63,,1016,2,313,0,4,3,Balve,1,0,I1.000|4:41-I1.000|5:28-I1.000|5:37-I1.000|5:20-I1.000|5:43-I1.000|5:51-I1.000|4:59-I1.000|3:55-I1.000|3:41-I1.000|3:50-I1.000|3:52-I1.000|4:11-I1.000|3:52-I0.099|0:34,,,,,3113,,250,0,,0,168070,250480,30378,,6541892,,,,,,,,,,,,,,,,,,,,,,,,,,,,,,,,,,,,,,,,3,
18208791,c82386c5-5859-4262-9911-f580e1eaf215,1598346649,120,1598344044,,0,0,14.51,4168,4535,317,332,,,0,3.7,0.68,0.93,1.02,559,863,150,176,,,,57.2,43.29,58.67,1,59.67,,,,3.6,0.8,103,100,,,,,,121,82,13.27,13.16,13.33,-6.3,-2.1,311,311,,1,317,317,,,,,,,,,"12,12,7,12,9,26,21,0,0","0,12,75,13,0","0,2,35,62,1",,,,,127,,,,,,,,,,,,,,,19,,,,,,,,,,,,,,,,,,,,,51.4,14,10,175,85,,1014,1,292,0,3,3,Balve,1,0,I1.000|5:09-I1.000|5:31-I1.000|6:05-I1.000|6:38-I1.000|6:03-I1.000|4:31-I1.000|5:00-I1.000|4:29-I1.000|3:58-I1.000|4:01-I1.000|3:53-I1.000|3:59-I1.000|3:59-I1.000|4:02-I0.508|2:10,,,,,3113,,250,0,,0,168070,250480,30378,,6555777,,,,,,,,,,,,,,,,,,,,,,,,,,,,,,,,,,,,,,,,3,
18218798,c27c9355-4200-4349-b061-f4cf2cefd214,1598377260,120,1598378905,,0,0,19.01,5463,8673,59,24,,,0,0,0.05,,,,1124,149,171,,,,57.7,44.21,58.06,1,59.61,,,,3.5,0.2,103,100,,,,,,155,81,12.61,12.64,12.76,2.7,1.7,303,303,,1,308,308,,,,,,,,,"0,1,7,30,35,26,1,0,0","0,15,78,7,0","0,1,46,53,1",,,,,129,,,,,,,,,,,,,,,20,,,,,,,,,,,,,,,,,,,,,51.8,23,11,210,48,,1011,2,289,0,4,3,Karlsruhe,1,0,I1.000|4:26-I1.000|4:55-I1.000|5:15-I1.000|5:12-I0.387|2:02-I1.000|4:59-I1.000|4:28-I1.000|4:30-I1.000|4:54-I1.000|4:31-I1.000|4:31-I1.000|4:58-I0.094|0:29-I1.000|4:23-I1.000|4:26-I1.000|4:58-I0.048|0:15-I1.000|4:24-I1.000|4:23-I1.000|5:20-I1.000|5:13-I0.464|2:27-I0.016|0:03,,,,,3113,,250,0,,0,168070,250480,30378,,6563682,,,,,,,,,,,,,,,,,,,,,,,,,,,,,,,,,,,,,,,,,
18244997,727462c5-ab66-4f06-8616-45fae6ee9517,1598467736,120,1598464285,,0,0,10.7,2935,3622,33,36,,,0,0,0.07,,,,600,144,157,,,,64.03,44.64,64.26,1,60.22,,,,3,0,104,103,,,,,,74,80,13.13,13.15,13.19,0.8,-0.9,317,317,,1,320,320,,,,,,,,,"0,0,1,5,56,35,2,0,0","0,11,89,0,0","0,2,22,74,2",,,,,137,,,,,,,,,,,,,,,22,,,,,,,,,,,,,,,,,,,,,32.4,23,22,265,47,,1016,1,294,0,2,3,Karlsruhe,1,0,I1.000|4:38-I1.000|4:36-I1.000|4:32-I1.000|4:30-I1.000|4:29-I1.000|4:34-I1.000|4:45-I1.000|4:34-I1.000|4:33-I1.000|4:35-I0.702|3:09,,,,,3113,,250,0,,0,168070,250480,30378,,6586139,,,,,,,,,,,,,,,,,,,,,,,,,,,,,,,,,,,,,,,,,
18276817,9c804ec5-b094-47cd-b7da-5ab99a2a986f,1598548643,120,1598545498,,0,0,14.83,3780,3863,24,36,,,0,0,0,,,,863,156,173,,,,62.7,49.81,62.76,1,60.22,,,,4,0.3,102,100,,,,,,126,82,14.11,14.21,14.21,2.5,1.9,349,349,,1,352,352,,,,,,,,,"0,0,1,3,14,62,19,0,0","0,3,67,30,0","0,0,9,87,4",,,,,144,,,,,,,,,,,,,,,23,,,,,,,,,,,,,,,,,,,,,60.6,25,7,229,45,,1015,2,290,0,3,3,Karlsruhe,1,0,I1.000|4:34-I1.000|4:11-I1.000|4:08-I1.000|4:10-I1.000|4:09-I1.000|4:12-I1.000|4:18-I1.000|4:22-I1.000|4:07-I1.000|4:14-I1.000|4:05-I1.000|4:08-I1.000|4:06-I1.000|4:07-I0.829|4:09,,,,,3113,,250,0,,0,168070,250480,30378,,6612939,,,,,,,,,,,,,,,,,,,,,,,,,,,,,,,,,,,,,,,,,
18301763,0a9e1a4e-3752-40d4-9faa-65c7608302ea,1598629017,120,1598624219,,0,0,8.39,2137,2274,21,21,,,0,0,0.05,,,,434,152,176,,,,65.14,47.91,65.34,1,60.91,,,,3.3,1,105,100,,,,,,67,83,14.17,14.43,14.42,11.4,0.9,353,353,,1,364,364,,,,,,,,,"0,0,1,19,17,29,26,7,0","1,26,29,44,0","0,0,21,57,22",,,,,142,,,,,,,,,,,,,,,18,,,,,,,,,,,,,,,,,,,,,70.3,19,16,213,78,,1005,3,304,0,6,3,Karlsruhe,1,0,I1.000|4:31-I0.722|3:10-I0.131|0:32-I0.141|0:31-I0.117|0:31-I0.148|0:31-I0.124|0:31-I0.136|0:30-I0.125|0:30-I0.149|0:31-I0.129|0:31-I0.147|0:31-I0.122|0:30-I0.144|0:31-I0.114|0:31-I0.141|0:31-I0.133|0:35-I0.157|0:32-I0.098|0:30-I0.149|0:31-I0.125|0:31-I0.154|0:32-I0.104|0:30-I0.154|0:31-I0.114|0:31-I0.145|0:31-I0.111|0:30-I0.172|0:36-I0.110|0:31-I0.152|0:32-I0.121|0:30-I0.153|0:31-I0.112|0:30-I0.151|0:32-I0.117|0:31-I0.147|0:31-I0.123|0:31-I0.247|0:49-I1.000|5:12-I0.746|3:47,,,,,3113,,250,0,,0,168070,250480,30378,,6633630,,,,,,,,,,,,,,,,,,,,,,,,,,,,,,,,,,,,,,,,,
18363952,f1cfc00c-c761-41ef-be5a-35090d8624ba,1598805602,120,1598817895,,0,0,15.65,4433,4646,444,430,,,0,4.8,0.84,0.97,1.11,623,810,145,172,92,,,60.97,44.26,63.18,1,60.97,,,,3.4,0,103,99,,,,,,110,81,13.76,13.34,13.83,-5.9,3.1,324,324,,1,331,331,,,,,,,,,"11,5,11,14,16,14,29,0,0","0,32,61,6,0","0,1,25,73,1",,,,,131,,,,,,,,,,,,,,,,,,,,,,,,,,,,,,,,,,,,45.8,20,8,311,60,,1009,2,320,0,3,3,Balve,1,0,I1.000|4:55-I1.000|5:16-I1.000|5:14-I1.000|4:55-I1.000|5:18-I1.000|4:10-I1.000|3:55-I1.000|3:52-I1.000|5:56-I1.000|6:04-I1.000|5:48-I1.000|4:05-I1.000|3:53-I1.000|3:58-I1.000|3:55-I0.652|2:40,,,,,3113,,250,0,,0,168070,250480,30378,,6687145,,,,,,,,,,,,,,,,,,,,,,,,,,,,,,,,,,,,,,,,"3,4",
18393481,c57ecc03-d14e-4f31-992c-ba9dfa5994ad,1598898513,120,1598896029,,0,0,17.01,4077,4077,39,48,,,0,0,0.06,,,,986,161,176,,,,64.57,54.05,64.71,1,61.72,,,,4.5,0,105,97,,,,,,146,83,15.02,15.05,15.06,4,3.9,376,376,,1,378,378,,,,,,,,,"0,0,0,0,4,39,57,0,0","0,5,21,73,0","0,0,1,77,21",,,,,151,,,,,,,,,,,,,,,18,,,,,,,,,,,,,,,,,,,,,70,16,8,354,75,,1018,0,322,0,3,3,Sundern,1,0,I1.000|4:15-I1.000|4:04-I1.000|3:53-I1.000|3:55-I1.000|4:00-I1.000|4:04-I1.000|3:55-I1.000|4:05-I1.000|3:55-I1.000|4:06-I1.000|4:07-I1.000|3:59-I1.000|3:52-I1.000|3:56-I1.000|3:58-I1.000|3:57-I1.000|3:55-I0.005|0:01,,,,,3113,,250,0,,0,168070,250480,30378,,6713517,,,,,,,,,,,,,,,,,,,,,,,,,,,,,,,,,,,,,,,,,
18393825,16ae4cda-dd7f-4ec2-be29-8040e3946b8a,1598902683,120,1598896631,,0,0,1.62,489,489,14,0,,,0,0,0.12,1.07,,,102,137,145,104,,,60.72,34.61,62.02,1,61.8,,,,1.5,0,100,101,,,,,,9,80,12.26,11.99,12.33,2,2.3,296,296,,1,299,299,,,,,,,,,"0,1,16,45,34,4,0,0,0","0,88,12,0,0","0,0,64,36,0",,,,,124,,,,,,,,,,,,,,,31,,,,,,,,,,,,,,,,,,,,,14.5,16,7,1,73,,1018,0,325,0,3,3,Sundern,1,0,I1.000|5:06-I0.617|3:03,,,,,3113,,250,0,,0,168070,250480,30378,,6713811,,,,,,,,,,,,,,,,,,,,,,,,,,,,,,,,,,,,,,,,,
18428782,3b960349-852a-4374-b877-a525474cddc8,1598987851,120,1598984586,,0,0,12.41,3681,3775,158,150,,,0,1.3,0.55,1.02,1.05,294,647,138,157,,,,61.48,41.2,62.49,1,61.62,,,,3,0,100,99,,,,,,48,81,12.4,12.25,12.51,0.3,-1.5,296,296,,1,301,301,,,,,,,,,"2,4,9,27,43,13,1,0,0","0,58,42,0,0","0,1,55,44,0",,,,,125,,,,,,,,,,,,,,,20,,,,,,,,,,,,,,,,,,,,,27.9,16,8,3,73,,1018,0,330,0,2,3,Balve,1,0,I1.000|5:22-I1.000|4:45-I1.000|4:47-I1.000|4:54-I1.000|5:00-I1.000|4:50-I1.000|5:26-I1.000|4:45-I1.000|4:50-I1.000|4:30-I1.000|5:06-I1.000|5:07-I0.405|2:00,,,,,3113,,250,0,,0,168070,250480,30378,,6744311,,,,,,,,,,,,,,,,,,,,,,,,,,,,,,,,,,,,,,,,"5,5",
18456469,364a0c4b-d2eb-449c-a876-8f097132644e,1599073544,120,1599070200,,0,0,12.71,3723,3786,267,283,,,0,3.1,0.7,0.96,1.08,417,716,143,159,,,,59.59,41.88,61.05,1,61.07,,,,3.2,0,97,98,,,,,,80,80,12.87,12.68,12.91,-7.2,0.8,302,302,,1,307,307,,,,,,,,,"5,8,14,24,14,28,7,0,0","0,33,67,0,0","0,1,39,60,0",,,,,128,,,,,,,,,,,,,,,15,,,,,,,,,,,,,,,,,,,,,37.8,16,5,356,61,,1019,0,316,0,2,3,Balve,1,0,I1.000|5:18-I1.000|5:44-I1.000|5:44-I1.000|5:17-I1.000|5:52-I1.000|4:37-I1.000|4:10-I1.000|4:02-I1.000|4:07-I1.000|4:10-I1.000|5:00-I1.000|4:53-I0.710|3:11,,,,,3113,,250,0,,0,168070,250480,30378,,6767719,,,,,,,,,,,,,,,,,,,,,,,,,,,,,,,,,,,,,,,,"4,5",
18490723,1cc6008c-2df8-4822-b934-00a7cd562839,1599155996,120,1599153691,,0,0,15.22,4429,4607,452,444,,,0,5.3,0.8,1.01,1.11,843,796,148,177,,,,57.35,42.8,59.5,1,60.59,,,,3.6,0.4,99,98,,,,,,86,81,13.38,12.87,13.72,-3.8,5.9,316,316,,1,331,331,,,,,,,,,"12,7,9,8,22,31,11,0,0","0,33,46,21,0","0,2,37,53,9",,,,,127,,,,,,,,,,,,,,,19,,,,,,,,,,,,,,,,,,,,,64.9,15,17,206,85,,1019,1,289,0,6,3,Balve,1,0,I1.000|5:06-I1.000|4:55-I1.000|4:40-I1.000|5:53-I1.000|5:08-I1.000|4:14-I1.000|4:00-I1.000|4:09-I1.000|6:59-I1.000|5:42-I1.000|5:04-I1.000|4:24-I1.000|4:08-I1.000|4:19-I1.000|4:06-I0.218|1:04,,,,,3113,,250,0,,0,168070,250480,30378,,6798298,,,,,,,,,,,,,,,,,,,,,,,,,,,,,,,,,,,,,,,,"3,4",
18514033,b837d764-508f-4117-974c-629c5f43092d,1599234856,120,1599229926,,0,0,6.99,1916,2128,24,29,,,0,0,0.08,0.92,,,408,148,178,,,,61.74,43.47,61.95,1,61.05,,,,3,2,100,101,,,,,,43,82,13.17,13.85,13.77,-33.1,-16.4,320,320,,1,342,342,,,,,,,,,"2,6,10,21,33,6,8,15,0","1,21,54,24,0","0,3,43,34,21",,,,,133,,,,,,,,,,,,,,,22,,,,,,,,,,,,,,,,,,,,,65.7,20,14,246,82,,1021,3,289,0,3,3,Balve,1,0,I1.000|5:07-I1.000|4:57-I1.000|4:41-I0.799|3:59-I1.000|3:27-I0.398|1:45-I1.000|3:22-I0.791|4:38,,,,,3113,,250,0,,0,168070,250480,30378,,6818274,,,,,,,,,,,,,,,,,,,,,,,,,,,,,,,,,,,,,,,,,
18585448,2bb97edd-5d23-4112-8ff8-1789e99148c5,1599411671,120,1599413633,,0,0,47.99,7566,8946,867,849,,,0,4.2,0.63,1.37,0.7,807,1034,130,161,,,,,,,1,61.05,,,,3.1,1,,100,,,,,,144,,,31.26,,-23.4,1.2,155,122,,1,177,164,,,,,,,,,"35,16,9,9,8,9,13","2,71,27,0,0","40,39,19,2,0",,,,,,,,,,,,,,,,,,,,26,,,,,,,,,,,,,,,,,,,,,36.7,17,11,300,55,,1019,2,311,0,2,3,Balve,1,0,I2.130|5:45-I5.000|22:53-I0.330|0:58-I2.974|11:23-I5.000|8:43-I1.641|3:04-I5.000|11:33-I5.000|16:17-I5.000|9:06-I5.000|14:06-I5.000|7:48-I5.000|12:15-I0.910|2:14,,,,,3113,,250,0,,0,168072,,30378,,6881145,,,,,,,,,,,,,,,,,,,,,,,,,,,,,,,,,,,,,,,,"4,4,5,5,5",
18610402,ca2e9c68-0545-4314-b1d1-5bd4384bd5f3,1599482040,120,1599483938,,0,0,61.68,7993,8857,609,584,,,0,2,0.36,,,709,2116,,,95,,,,,,1,61.05,,,,,,,100,,,,,,106,,,32,,,,144,132,,1,170,166,,,,,,,,,"10,17,15,11,24,13,10",,"29,58,11,1,1",,,,,,,,,,,,,,,,,,,,,,,,,,,,,,,,,,,,,,,,,,18,7,265,62,,1025,4,287,0,3,3,Balve,1,0,I5.000|13:01-I5.000|10:48-I5.000|10:39-I5.000|15:51-I5.000|6:58-I5.000|8:29-I5.000|8:50-I5.000|9:31-I5.000|8:55-I5.000|14:57-I5.000|11:33-I5.000|8:14-I1.683|5:26,,,,,3113,,250,0,,0,168072,,30378,,6902214,,,,,,,,,,,,,,,,,,,,,,,,,,,,,,,,,,,,,,,,"4,4,5,5,5",
18620700,0fa9214f-6465-4620-9eb3-6e8f75b54ba4,1599500922,120,1599502003,,0,0,50.66,7036,8159,619,605,,,0,2.6,0.46,,,705,1703,,,,,,,,,1,61.05,,,,,,,100,,,,,,94,,,32.14,,,,143,127,,1,162,157,,,,,,,,,"16,17,13,20,16,6,12",,"32,55,12,0,0",,,,,,,,,,,,,,,,,,,,,,,,,,,,,,,,,,,,,,,,,,20,8,318,53,,1024,1,280,0,3,3,Balve,1,0,I5.000|14:26-I5.000|11:32-I5.000|13:05-I5.000|9:20-I5.000|11:04-I5.000|14:48-I5.000|13:55-I5.000|5:48-I5.000|10:27-I5.000|9:48-I0.659|3:04,,,,,3113,,250,0,,0,168072,,30378,,6910140,,,,,,,,,,,,,,,,,,,,,,,,,,,,,,,,,,,,,,,,"4,5,5,5",
18645189,8322ba26-5d33-479e-a259-b4e85d0e8f0c,1599574837,120,1599570421,,0,0,15.64,2708,2708,265,266,,,0,2.7,0.6,1.37,0.75,735,395,122,149,,,,,,,1,61.05,,,,2.1,0.1,,100,,,,,,30,,,29.84,,-88,-5.8,121,101,,1,141,134,,,,,,,,,"44,24,7,4,5,4,11","5,84,10,0,0","45,49,6,0,0",,,,,,,,,,,,,,,,,,,,13,,,,,,,,,,,,,,,,,,,,,16.7,21,14,244,61,,1026,4,263,0,3,3,Balve,1,0,I5.000|16:43-I5.000|18:04-I5.000|8:10-I0.636|2:12,,,,,3113,,250,0,,0,168072,,30378,,6930699,,,,,,,,,,,,,,,,,,,,,,,,,,,,,,,,,,,,,,,,4,
18655571,11edb850-3120-4c2e-b7b5-ff6eef38f11a,1599592254,120,1599588185,,0,0,15.33,3047,3047,274,273,,,0,2.9,0.58,2.91,1.25,597,404,119,145,,,,,,,1,61.05,,,,2,0,,100,,,,,,37,,,20.9,,-2.3,-17,117,80,,1,172,155,,,,,,,,,"37,33,18,5,3,3,1","4,94,2,0,0","66,24,5,3,1",,,,,,,,,,,,,,,,,,,,18,,,,,,,,,,,,,,,,,,,,,11.4,19,7,275,73,,1026,0,262,0,3,3,Balve,1,0,I5.000|18:32-I5.000|13:18-I5.000|17:42-I0.325|1:14,,,,,3113,,250,0,,0,168072,,30378,,6939305,,,,,,,,,,,,,,,,,,,,,,,,,,,,,,,,,,,,,,,,"5,5,5,5",
18680531,ef7625cd-2d68-47b9-9077-3e6fb6685739,1599663465,120,1599670693,,0,0,88.7,13423,14162,1257,1248,,,0,3.9,0.52,1.59,0.71,674,1685,130,163,,,,,,,1,61.05,,,,3.3,2,,100,,,,,,211,,,29.68,,8.5,-9,129,108,,1,154,145,,,,,,,,,"24,17,18,13,11,6,11","0,80,19,0,0","46,43,11,0,0",,,,,,,,,,,,,,,,,,,,16,,,,,,,,,,,,,,,,,,,,,29.2,21,15,258,72,,1021,4,266,0,3,3,Balve,1,0,I5.000|12:36-I5.000|10:41-I5.000|11:37-I5.000|15:10-I5.000|13:32-I5.000|6:40-I5.000|11:59-I5.000|12:29-I5.000|15:22-I5.000|18:03-I5.000|11:21-I5.000|13:58-I5.000|8:41-I5.000|10:44-I5.000|17:56-I5.000|10:21-I5.000|14:30-I3.696|8:04,,,,,3113,,250,0,,0,168072,,30378,,6959913,,,,,,,,,,,,,,,,,,,,,,,,,,,,,,,,,,,,,,,,"4,4,4,4,5,5,5,5",
18711478,f25de99c-f933-4045-b53e-7ca43e03119b,1599755260,120,1599757623,,0,0,35.28,6929,8273,829,812,,,0,4.7,0.75,2.36,1,833,870,124,165,100,,,,,,1,61.05,,,,3,1.8,,100,,,,,,85,,,29.34,,16.6,2.9,145,100,,1,179,161,,,,,,,,,"39,35,6,4,3,2,10","9,63,27,1,0","51,33,15,1,0",,,,,,,,,,,,,,,,,,,,18,,,,,,,,,,,,,,,,,,,,,34,19,6,12,49,,1022,2,294,0,2,3,Balve,1,0,I5.000|16:05-I0.075|0:23-I3.149|10:55-I3.220|5:15-I3.148|11:33-I3.229|5:38-I3.149|11:42-I3.221|12:19-I3.137|13:01-I5.000|15:17-I2.947|13:20,,,,,3113,,250,0,,0,168072,,30378,,6983846,,,,,,,,,,,,,,,,,,,,,,,,,,,,,,,,,,,,,,,,"4,4,4,4,5",
18739109,da3118d4-d913-46b2-a99f-96a033c6442d,1599830475,120,1599833059,,0,0,60.79,9404,9404,976,984,,,0,3.8,0.62,1.41,1,648,1271,131,162,102,,,,,,1,61.05,,,,3.1,1.2,,100,,,,,,169,,,30.49,,-5.5,25.3,154,119,,1,217,197,,,,,,,,,"24,20,20,10,7,6,14","1,73,25,0,0","39,47,14,1,0",,,,,,,,,,,,,,,,,,,,15,,,,,,,,,,,,,,,,,,,,,37.5,21,5,240,47,,1018,5,283,0,2,3,Balve,1,0,I5.000|14:12-I5.000|17:20-I5.000|6:28-I5.000|8:46-I5.000|13:09-I5.000|18:26-I5.000|11:47-I5.000|13:08-I5.000|13:20-I5.000|13:49-I5.000|10:38-I5.000|9:31-I0.791|6:11,,,,,3113,,250,0,,0,168072,,30378,,7006847,,,,,,,,,,,,,,,,,,,,,,,,,,,,,,,,,,,,,,,,"4,4,4,5,5,5",
18768289,a0e25214-1b05-4796-9a24-8b395ce227b4,1599921758,120,1599928870,,0,0,94.74,14151,14151,1531,1520,,,0,4.3,0.64,1.29,0.62,671,1905,136,171,,,,,,,1,61.05,,,,4,2.4,,100,,,,,,307,,,31.73,,11.9,4.2,150,123,,1,176,166,,,,,,,,,"22,22,15,10,8,9,15","1,54,35,10,0","36,46,17,1,0",,,,,,,,,,,,,,,,,,,,17,,,,,,,,,,,,,,,,,,,,,54.5,23,16,175,50,,1020,4,280,0,3,3,Balve,1,0,I5.000|11:05-I5.000|9:05-I5.000|9:36-I5.000|13:27-I5.000|7:38-I5.000|15:25-I5.000|13:00-I5.000|10:59-I5.000|10:06-I5.000|16:12-I5.000|22:08-I5.000|9:56-I5.000|16:18-I5.000|9:14-I5.000|13:20-I5.000|16:54-I5.000|7:29-I5.000|10:52-I4.735|13:06,,,,,3113,,250,0,,0,168072,,30378,,7032102,,,,,,,,,,,,,,,,,,,,,,,,,,,,,,,,,,,,,,,,"4,4,4,4,4,4,5",
18787789,79b3afc3-6206-486a-aebb-89b3f3d67da6,1600002181,120,1599996476,,0,0,4.83,1457,1457,48,56,,,0,0.5,0.37,0.95,1,,321,147,159,,,,55.37,37.98,55.94,1,60.54,,,,2.7,0,98,98,,,,,,38,80,12.05,11.99,12.08,-9.1,0.8,284,284,,1,287,287,,,,,,,,,"0,1,16,35,44,4,0,0,0","0,12,88,0,0","0,3,74,23,0",,,,,124,,,,,,,,,,,,,,,23,,,,,,,,,,,,,,,,,,,,,33,21,10,228,57,,1026,3,274,0,4,3,Balve,1,0,I1.000|5:12-I1.000|5:27-I1.000|4:58-I1.000|4:41-I0.827|3:58,,,,,3113,,250,0,,0,168070,250480,30378,,7047272,,,,,,,,,,,,,,,,,,,,,,,,,,,,,,,,,,,,,,,,,
18823312,e4ae68a1-fdb7-4dfa-934f-f9f3e81189d6,1600104590,120,1600098954,,0,0,4.91,1407,1466,6,13,,,0,0,0,,,,291,143,175,,,,61.23,40.4,61.22,1,60.56,,,,2.6,0.4,101,103,,,,,,35,79,12.53,12.73,12.69,15.8,55.5,344,344,,1,638,638,,,,,,,,,"1,1,2,30,48,14,1,3,0","1,25,69,4,0","0,1,65,30,4",,,,,133,,,,,,,,,,,,,,,18,,,,,,,,,,,,,,,,,,,,,34.8,28,12,131,53,,1023,1,275,0,4,3,"Porz am Rhein",1,0,I1.000|4:46-I1.000|4:34-I0.157|0:44-I0.303|1:02-I1.000|5:12-I1.000|4:56-I0.452|2:14,,,,,3113,,250,0,,0,168070,250480,30378,,7076535,,,,,,,,,,,,,,,,,,,,,,,,,,,,,,,,,,,,,,,,,
18858518,7448133d-ddbf-4d3e-a5b3-e6b17c903f12,1600198612,120,1600194826,,0,0,12.01,3097,3219,34,36,,,0,0,0.07,,,,698,153,174,,,,63.55,48.37,63.76,1,61.06,,,,3.7,0.1,102,104,,,,,,87,80,13.98,14.02,14.06,2.7,2.2,344,344,,1,347,347,,,,,,,,,"0,1,2,2,12,75,9,0,0","1,9,73,17,0","0,0,9,86,4",,,,,145,,,,,,,,,,,,,,,13,,,,,,,,,,,,,,,,,,,,,62.5,28,3,89,48,,1018,0,273,1,2,3,"Porz am Rhein",1,0,I1.000|4:45-I1.000|4:14-I1.000|4:11-I1.000|4:16-I1.000|4:17-I1.000|4:20-I1.000|4:16-I1.000|4:13-I1.000|4:17-I1.000|4:10-I1.000|4:02-I1.000|4:36-I0.005|0:01,,,,,3113,,250,0,,0,168070,250480,30378,,7108125,,,,,,,,,,,,,,,,,,,,,,,,,,,,,,,,,,,,,,,,,
18885077,e84b057c-8e37-4e28-aa60-e32ffb306901,1600277748,120,1600272728,,0,0,6.95,1898,1932,16,20,,,0,0,0.12,,,,427,150,169,,,,60.88,43.64,61.01,1,60.99,,,,3.1,0,100,101,,,,,,56,80,13.09,13.2,13.23,7.7,5.7,318,318,,1,323,323,,,,,,,,,"2,0,1,7,49,40,1,0,0","1,10,84,5,0","0,3,22,75,1",,,,,137,,,,,,,,,,,,,,,17,,,,,,,,,,,,,,,,,,,,,42.1,26,14,339,54,,1019,1,267,0,2,3,"Porz am Rhein",1,0,I1.000|4:49-I1.000|4:14-I1.000|4:19-I1.000|4:34-I1.000|4:37-I1.000|4:38-I0.949|4:27,,,,,3113,,250,0,,0,168070,250480,30378,,7131379,,,,,,,,,,,,,,,,,,,,,,,,,,,,,,,,,,,,,,,,,
18989764,a12efccb-bac0-4806-8697-db8d016b84d7,1600596695,120,1600604592,,0,0,105.7,14704,14705,1540,1527,,,0,4.4,0.53,1.13,0.76,814,2230,139,177,110,,,,,,1,60.99,,,,4.5,2.8,,100,,,,,,296,,,34.12,,6,7.8,175,144,,1,203,193,,,,,,,,,"20,20,10,9,11,9,20","1,50,36,14,0","32,36,29,3,0",,,,,,,,,,,,,,,,,,,,15,,,,,,,,,,,,,,,,,,,,,65.2,15,6,78,60,,1018,2,272,0,2,3,Möhnesee,1,0,I5.000|8:19-I5.000|8:09-I5.000|12:00-I5.000|10:40-I5.000|11:59-I5.000|10:45-I5.000|12:27-I5.000|8:45-I5.000|9:04-I5.000|14:24-I5.000|9:48-I5.000|7:11-I5.000|15:44-I5.000|27:10-I5.000|7:54-I5.000|11:18-I5.000|12:23-I5.000|10:26-I5.000|10:14-I5.000|11:28-I5.000|12:07-I0.702|2:50,,,,,3113,,250,0,,0,168072,,30378,,7223115,,,,,,,,,,,,,,,,,,,,,,,,,,,,,,,,,,,,,,,,"4,4,4,4,4,4,4,4,5,5,5",
19023719,6e71ac10-1c5a-415b-815c-3eae9de41948,1600697310,120,1600699042,,0,0,56.57,8674,8674,1062,1068,,,0,4.4,0.65,1.48,0.75,801,1376,138,169,,,,,,,1,60.99,,,,3.6,2.2,,100,,,,,,184,,,31.06,,-4.5,2.2,152,126,,1,182,170,,,,,,,,,"21,28,16,10,8,4,13","1,51,44,5,0","38,40,19,2,1",,,,,,,,,,,,,,,,,,,,19,,,,,,,,,,,,,,,,,,,,,46.2,24,4,147,40,,1016,4,265,0,2,3,Balve,1,0,I5.000|14:16-I5.000|14:34-I5.000|9:07-I5.000|19:04-I5.000|8:39-I5.000|11:28-I5.000|16:29-I5.000|7:27-I5.000|20:13-I5.000|9:50-I5.000|9:19-I1.569|4:07,,,,,3113,,250,0,,0,168072,,30378,,7253206,,,,,,,,,,,,,,,,,,,,,,,,,,,,,,,,,,,,,,,,"4,4,4,4,5,5",
19050324,fe752f67-9fb1-4fbd-915a-368ef613cd3c,1600776481,120,1600779479,,0,0,67.31,8953,10074,708,694,,,0,2.2,0.39,1.46,0.97,608,2179,147,170,,,,,,,1,60.99,,,,3.2,1.3,100,100,,,,,,63,,,31.33,,,,147,129,,1,206,200,,,,,,,,,"12,17,10,16,24,7,14","0,77,20,3,0","31,55,13,0,0",,,,,,,,,,,,,,,,,,,,14,,,,,,,,,,,,,,,,,,,,,41,22,5,232,49,,1011,4,271,0,2,3,Balve,1,0,I5.000|8:03-I5.000|7:34-I5.000|11:38-I5.000|12:26-I5.000|13:00-I5.000|12:21-I5.000|9:12-I5.000|9:45-I5.000|9:26-I5.000|11:14-I5.000|14:47-I5.000|12:03-I5.000|12:00-I2.305|5:44,,,,,3113,,250,0,,0,168072,,30378,,7275874,,,,,,,,,,,,,,,,,,,,,,,,,,,,,,,,,,,,,,,,"4,4,5,5,5,5",
19081798,e481c8a8-f666-4e65-bc95-8e71104a9608,1600871931,120,1600869644,,0,0,30.41,4694,4797,638,685,,,0,4.2,0.77,1.25,0.79,834,734,132,163,,,,,,,1,62.16,1194,,,,,,,,,,,,69,,,33.25,,-49.5,-12,146,129,,1,164,158,,,,,,,,,"31,34,10,2,3,3,17","1,64,34,1,0","29,57,14,0,0",,,,,,,,,,,,,,,,,,,,,,,,,,,,,,,,,,,,,,,,,29,23,15,217,43,,1005,4,281,0,2,3,Balve,1,0,I5.000|15:04-I3.112|12:39-I3.108|3:50-I3.074|11:47-I3.093|3:59-I3.052|13:04-I5.000|8:06-I4.975|9:46,,,,,Edge_130,,336,0,,0,168072,,30378,,7301985,,,,,,,,,,,,,,,,,,,,,,,,,,,,,,,,,,,,,,,,"4,4,4",
19090757,b1df935c-82c4-40f5-9ae6-8e90c7242a6e,1600882589,120,1600881682,,0,0,33.69,5593,6132,540,537,,,0,3.5,0.57,1.51,0.73,786,813,131,178,,,,,,,1,62.16,1048,,,,,,,,,,,,83,,,27.2,,-20.4,-8.3,140,103,,1,172,158,,,,,,,,,"25,30,18,11,7,2,8","1,72,16,10,0","51,31,17,1,0",,,,,,,,,,,,,,,,,,,,,,,,,,,,,,,,,,,,,,,,,56.6,22,15,215,55,,1004,1,278,0,2,3,Balve,1,0,I5.000|17:52-I5.000|13:17-I0.181|0:38-I3.051|10:44-I5.000|10:46-I5.000|16:50-I5.000|11:30-I1.346|2:09-I2.435|4:06-I1.673|5:21,,,,,Edge_130,,336,0,,0,168072,,30378,,7309467,,,,,,,,,,,,,,,,,,,,,,,,,,,,,,,,,,,,,,,,"4,5,5,5,5",
19114302,80abdd51-6304-4d4a-b09a-3a658e7749c7,1600957593,120,1600957009,,0,0,41.65,6022,6501,667,664,,,0,3.5,0.65,1.65,1.22,647,845,128,157,,,,,,,1,62.16,700,,,,,,,,,,,,81,,,31.74,,8.7,4.8,141,126,,1,167,162,,,,,,,,,"17,29,21,7,4,4,18","1,82,17,0,0","32,56,10,1,0",,,,,,,,,,,,,,,,,,,,,,,,,,,,,,,,,,,,,,,,,21.5,18,19,208,51,,1005,3,280,0,3,3,Balve,1,0,I5.000|15:03-I5.000|17:23-I5.000|6:52-I5.000|9:51-I5.000|8:42-I5.000|14:18-I5.000|12:23-I5.000|10:31-I1.645|5:19,,,,,Edge_130,,336,0,,0,168072,,30378,,7330268,,,,,,,,,,,,,,,,,,,,,,,,,,,,,,,,,,,,,,,,"4,4,5,5,5",
19154352,3662d26d-351b-4d20-9275-a249488a6001,1601050155,120,1601049810,,0,0,45.18,6292,6673,685,686,,,0,3.3,0.54,1.24,0.94,606,898,129,159,,,,,,,1,62.16,758,,,,,,,,,,,,105,,,33.15,,-5.1,-14.5,143,132,,1,169,164,,,,,,,,,"16,29,19,5,6,5,20","1,83,16,0,0","26,59,14,1,0",,,,,,,,,,,,,,,,,,,,,,,,,,,,,,,,,,,,,,,,,22.4,14,19,208,62,,997,1,315,0,3,3,Balve,1,0,I5.000|14:36-I4.867|15:10-I5.000|10:39-I5.000|6:53-I5.000|13:20-I5.000|16:02-I5.000|7:53-I5.000|12:22-I2.853|3:45-I2.457|4:13,,,,,Edge_130,,336,0,,0,168072,,30378,,7362155,,,,,,,,,,,,,,,,,,,,,,,,,,,,,,,,,,,,,,,,"4,4,5,5",
19173709,5c07ceea-d562-42d3-9169-ee2c23858c49,1601128862,120,1601125999,,0,0,12.84,3924,3994,371,363,,,0,4.1,0.85,0.97,0.98,603,858,153,173,,,,51.53,39.89,53.42,1,59.94,,,,3.8,0,100,94,,,,,,123,80,12.7,12.19,12.81,2.5,10.3,293,293,,1,302,302,,,,,,,,,"12,11,14,13,22,26,1,0,0","0,5,69,25,0","0,3,49,47,1",,,,,123,,,,,,,,,,,,,,,15,,,,,,,,,,,,,,,,,,,,,54.2,13,10,1,70,,999,2,308,0,4,3,Balve,1,0,I1.000|4:53-I1.000|5:35-I1.000|5:50-I1.000|5:33-I1.000|5:54-I1.000|4:31-I1.000|4:20-I1.000|5:54-I1.000|6:09-I1.000|4:26-I1.000|4:21-I1.000|4:27-I0.842|3:33,,,,,3113,,250,0,,0,168070,250480,30378,,7379643,,,,,,,,,,,,,,,,,,,,,,,,,,,,,,,,,,,,,,,,"4,4",
19197025,65b752d1-9060-42aa-a8e6-dbc83be63385,1601215085,120,1601210957,,0,0,10.14,2970,3014,240,230,,,0,3.4,0.82,1.02,1.12,467,596,146,162,,,,57.96,41.19,59.73,1,59.62,,,,3.2,0,99,97,,,,,,78,81,12.99,12.76,13.18,-11.2,5.2,303,303,,1,311,311,,,,,,,,,"3,14,16,20,12,23,13,0,0","0,23,76,1,0","0,1,42,55,2",,,,,126,,,,,,,,,,,,,,,22,,,,,,,,,,,,,,,,,,,,,39.2,13,8,142,72,,1004,3,293,0,4,3,Balve,1,0,I1.000|5:00-I1.000|5:38-I1.000|5:53-I1.000|5:29-I1.000|5:52-I1.000|4:41-I1.000|4:12-I1.000|4:02-I1.000|4:06-I1.000|4:02-I0.135|0:37,,,,,3113,,250,0,,0,168070,250480,30378,,7399820,,,,,,,,,,,,,,,,,,,,,,,,,,,,,,,,,,,,,,,,4,
19235725,c6e0a286-51a8-40b3-9fe0-3a6d8741c51d,1601317845,120,1601313863,,0,0,10.08,2770,3028,34,44,,,0,0,0.08,1.05,0.97,,579,151,179,,,,59.86,44.36,60.03,1,59.58,,,,3.4,0.6,101,99,,,,,,86,81,13.12,13.33,13.33,9.8,5.3,316,316,,1,324,324,,,,,,,,,"1,2,3,16,42,23,13,0,0","1,11,59,29,0","0,0,41,57,2",,,,,135,,,,,,,,,,,,,,,23,,,,,,,,,,,,,,,,,,,,,73.2,13,10,179,74,,1011,0,277,0,4,3,"Porz am Rhein",1,0,I1.000|4:43-I1.000|4:11-I1.000|3:52-I1.000|4:21-I1.000|4:02-I1.000|5:18-I1.000|4:43-I1.000|4:47-I1.000|4:48-I1.000|4:55-I0.083|0:30,,,,,3113,,250,0,,0,168070,250480,30378,,7430998,,,,,,,,,,,,,,,,,,,,,,,,,,,,,,,,,,,,,,,,,
19305497,b5e782b6-4c88-4575-bc5d-f5ea278058a8,1601492140,120,1601488162,,0,0,6.94,2021,2677,24,22,,,0,0,0.09,,0.86,,392,142,168,,,,60.59,40.46,60.87,1,60.23,,,,2.9,0.5,103,100,,,,,,51,80,12.38,12.85,12.9,4.3,-4.3,292,292,,1,310,310,,,,,,,,,"13,3,4,10,28,34,5,3,0","0,41,51,7,0","6,9,26,54,5",,,,,129,,,,,,,,,,,,,,,17,,,,,,,,,,,,,,,,,,,,,33.5,15,9,147,84,,1013,0,286,0,3,3,"Porz am Rhein",1,0,I1.000|5:34-I1.000|4:16-I1.000|4:41-I0.772|3:48-I0.529|2:29-I1.000|5:42-I1.000|4:19-I0.640|2:52,,,,,3113,,250,0,,0,168070,250480,30378,,7486951,,,,,,,,,,,,,,,,,,,,,,,,,,,,,,,,,,,,,,,,,
19338693,4dced5a3-591b-4ae1-9bcb-516d3518d943,1601570774,120,1601569508,,0,0,21.1,5447,5689,121,122,,,0,0,0.18,0.96,0.99,,1331,166,181,,,,56.23,50.48,56.63,1,59.52,,,,5,1.4,102,95,,,,,,226,83,14.05,14.02,14.11,3.8,-17.7,348,348,,1,365,365,,,,,,,,,"0,0,2,4,15,66,13,0,0","0,1,14,84,0","0,0,10,86,4",,,,,140,,,,,,,,,,,,,,,23,,,,,,,,,,,,,,,,,,,,,94.2,14,15,185,79,,1001,1,302,0,6,3,"Porz am Rhein",1,0,I1.000|4:20-I1.000|4:10-I1.000|4:26-I1.000|4:16-I1.000|4:20-I1.000|4:11-I1.000|4:18-I1.000|4:12-I1.000|4:09-I1.000|4:13-I1.000|4:45-I1.000|4:29-I1.000|4:25-I1.000|4:20-I1.000|4:13-I1.000|4:06-I1.000|4:16-I1.000|4:12-I1.000|4:12-I1.000|4:15-I1.000|4:29-I0.098|0:30,,,,,3113,,250,0,,0,168070,250480,30378,,7515565,,,,,,,,,,,,,,,,,,,,,,,,,,,,,,,,,,,,,,,,,
19367824,da346640-6908-4c7e-96c8-51c0a4436181,1601659398,120,1601656247,,0,0,13.13,3490,3779,39,44,,,0,0,0,,,,806,158,169,,,,58.43,47.01,58.62,1,59.37,,,,4,0.6,102,95,,,,,,119,81,13.56,13.6,13.61,-2.3,4.8,329,329,,1,331,331,,,,,,,,,"0,0,1,5,27,61,5,0,0","1,5,42,53,0","0,0,12,87,1",,,,,139,,,,,,,,,,,,,,,18,,,,,,,,,,,,,,,,,,,,,58,19,15,99,59,,991,1,297,0,4,3,Eil,1,0,I1.000|4:21-I1.000|4:21-I1.000|4:26-I1.000|4:34-I1.000|4:35-I1.000|4:25-I1.000|4:27-I1.000|4:26-I1.000|4:19-I1.000|4:30-I1.000|4:16-I1.000|4:25-I1.000|4:29-I0.125|0:37,,,,,3113,,250,0,,0,168070,250480,30378,,7541186,,,,,,,,,,,,,,,,,,,,,,,,,,,,,,,,,,,,,,,,,
19385477,5b64b84f-222b-4e95-81bb-0465fbfc9604,1601718864,120,1601714161,,0,0,8.01,2227,2234,35,41,,,0,0,0.05,0.93,0.95,,489,155,176,,,,56.84,43.1,57.1,1,59.33,,,,3.5,0.1,102,99,,,,,,73,83,13,13.22,13.17,7.7,1,312,312,,1,318,318,,,,,,,,,"2,5,9,17,14,47,7,0,0","1,9,45,44,0","0,1,36,62,2",,,,,130,,,,,,,,,,,,,,,20,,,,,,,,,,,,,,,,,,,,,67.6,13,7,270,82,,989,1,297,0,4,3,"Porz am Rhein",1,0,I1.000|4:57-I1.000|4:19-I1.000|4:16-I1.000|4:17-I1.000|4:08-I0.102|0:33-I0.102|0:21-I0.099|0:31-I0.108|0:22-I0.101|0:31-I0.119|0:26-I0.100|0:32-I0.097|0:23-I0.095|0:29-I0.100|0:23-I0.101|0:27-I0.117|0:25-I1.000|5:31-I0.767|4:15,,,,,3113,,250,0,,0,168070,250480,30378,,7556966,,,,,,,,,,,,,,,,,,,,,,,,,,,,,,,,,,,,,,,,,
19423025,c42e5137-eda7-477f-8bf0-bf1fa4bc7d51,1601814376,120,1601813369,,0,0,20,5206,5637,179,151,,,0,0.3,0.26,1.06,0.97,393,1080,153,173,,,,62.82,49.78,63.63,1,59.56,,,,4,1.4,104,99,,,,,,161,84,14.03,13.93,14.17,5.1,5.7,342,342,,1,348,348,,,,,,,,,"0,0,2,5,22,58,12,1,0","0,7,80,13,0","0,1,18,69,13",,,,,137,,,,,,,,,,,,,,,15,,,,,,,,,,,,,,,,,,,,,56.5,12,27,203,73,,995,2,319,0,4,3,"Porz am Rhein",1,0,I1.000|4:32-I1.000|4:15-I1.000|4:24-I1.000|4:16-I1.000|4:21-I1.000|4:12-I1.000|4:16-I1.000|4:12-I1.000|4:20-I1.000|4:17-I1.000|4:36-I1.000|4:24-I1.000|4:33-I1.000|4:00-I1.000|4:11-I1.000|4:19-I1.000|4:16-I1.000|4:14-I1.000|4:24-I1.000|4:42-I0.003|0:01,,,,,3113,,250,0,,0,168070,250480,30378,,7589692,,,,,,,,,,,,,,,,,,,,,,,,,,,,,,,,,,,,,,,,5,
19465636,e289202a-8030-461f-b90b-7b9ff4ab2c95,1601921476,120,1601915562,,0,0,3.12,870,1059,14,13,,,0,0,0,0.97,0.94,,176,140,150,,,,65.13,40.42,65.52,1,59.84,,,,2.2,0,102,101,,,,,,18,81,12.96,12.95,13.02,8.7,7.9,308,308,,1,311,311,,,,,,,,,"0,0,3,13,50,33,0,0,0","1,23,75,0,0","0,0,45,55,0",,,,,133,,,,,,,,,,,,,,,21,,,,,,,,,,,,,,,,,,,,,22.5,13,13,191,79,,1002,0,324,0,4,3,"Porz am Rhein",1,0,I1.000|4:39-I1.000|4:45-I1.000|4:35-I0.117|0:31,,,,,3113,,250,0,,0,168070,250480,30378,,7626495,,,,,,,,,,,,,,,,,,,,,,,,,,,,,,,,,,,,,,,,,
19499111,f8c8b89b-d6aa-4a62-abad-87e5a22071f5,1602008686,120,1602004865,,0,0,10.17,2834,3177,18,41,,,0,0,0.06,,,,560,144,179,,,,62.8,43.67,62.76,1,60.18,,,,3.2,1.1,104,100,,,,,,68,82,12.85,13.3,13.27,-1,-6.8,308,308,,1,324,324,,,,,,,,,"2,3,8,20,35,13,17,2,0","0,38,49,13,0","0,2,50,40,7",,,,,131,,,,,,,,,,,,,,,15,,,,,,,,,,,,,,,,,,,,,65.4,14,19,242,80,,1001,0,303,0,6,3,"Porz am Rhein",1,0,I1.000|4:51-I1.000|4:40-I1.000|4:42-I1.000|4:48-I0.957|4:26-I1.000|3:45-I1.000|3:45-I0.518|1:55-I1.000|5:45-I1.000|5:02-I0.699|3:33,,,,,3113,,250,0,,0,168070,250480,30378,,7655937,,,,,,,,,,,,,,,,,,,,,,,,,,,,,,,,,,,,,,,,,
19530143,c73e6818-99f5-46bb-befa-e36d9b4716eb,1602089567,120,1602086872,,0,0,16.06,4166,4318,35,53,,,0,0,0.04,,,,904,152,160,,,,63.68,49.11,63.76,1,60.73,,,,3.8,0.1,102,98,,,,,,128,83,13.87,13.91,13.91,0.7,2.5,337,337,,1,340,340,,,,,,,,,"0,0,0,2,18,73,8,0,0","0,3,97,0,0","0,0,10,89,2",,,,,139,,,,,,,,,,,,,,,19,,,,,,,,,,,,,,,,,,,,,47.5,14,25,280,72,,1014,,,0,5,1,Eil,1,0,I1.000|4:18-I1.000|4:20-I1.000|4:24-I1.000|4:22-I1.000|4:17-I1.000|4:12-I1.000|4:20-I1.000|4:23-I1.000|4:10-I1.000|4:14-I1.000|4:13-I1.000|4:18-I1.000|4:18-I1.000|4:25-I1.000|4:26-I1.000|4:28-I0.064|0:19,,,,,3113,,250,0,,0,168070,250480,30378,,7682597,,,,,,,,,,,,,,,,,,,,,,,,,,,,,,,,,,,,,,,,,
19556868,432c3ff8-f54a-4498-a028-22869e8d75a5,1602173903,120,1602171103,,0,0,10.48,3029,4239,52,11,,,0,0,0.06,,,,576,139,161,,,,62.89,41.93,63.58,1,61.05,,,,2.9,0.5,104,100,,,,,,70,81,12.62,12.65,12.83,3,6.2,302,302,,1,311,311,,,,,,,,,"2,0,6,29,39,16,6,1,0","1,42,57,0,0","1,4,41,51,4",,,,,128,,,,,,,,,,,,,,,15,,,,,,,,,,,,,,,,,,,,,32.5,17,26,220,72,,1014,,,0,4,1,"Porz am Rhein",1,0,I1.000|4:46-I1.000|4:27-I1.000|4:39-I0.366|1:53-I0.574|2:05-I0.089|0:57-I0.607|2:21-I1.000|4:58-I1.000|4:50-I1.000|4:52-I1.000|5:08-I1.000|5:08-I0.848|4:24,,,,,3113,,250,0,,0,168070,250480,30378,,7704665,,,,,,,,,,,,,,,,,,,,,,,,,,,,,,,,,,,,,,,,,
19584228,81ca404e-97f3-4ab0-9ca6-1e72e90127e4,1602257224,120,1602254217,,0,0,13.72,3703,4022,15,30,,,0,0,0,,,,862,155,174,,,,58.96,46.33,58.96,1,60.34,,,,3.9,0,102,96,,,,,,101,81,13.31,13.37,13.34,2.2,2.7,323,323,,1,325,325,,,,,,,,,"0,0,0,5,46,48,1,0,0","0,6,74,20,0","0,0,14,86,0",,,,,137,,,,,,,,,,,,,,,20,,,,,,,,,,,,,,,,,,,,,51.4,13,4,210,85,,1017,2,268,0,4,3,"Porz am Rhein",1,0,I1.000|4:29-I1.000|4:30-I1.000|4:36-I1.000|4:29-I1.000|4:33-I1.000|4:27-I1.000|4:37-I1.000|4:21-I1.000|4:12-I1.000|4:22-I1.000|4:28-I1.000|4:42-I1.000|4:34-I0.715|3:24,,,,,3113,,250,0,,0,168070,250480,30378,,7727743,,,,,,,,,,,,,,,,,,,,,,,,,,,,,,,,,,,,,,,,,
19602641,dadbac8f-033c-473f-badc-59fad06c505f,1602328547,120,1602325581,,0,0,12.3,3360,4076,54,46,,,0,0,0.12,1.07,,,739,154,179,,,,58.64,45.31,59,1,59.62,,,,3.7,0.3,103,94,,,,,,108,81,13.22,13.21,13.3,-1.2,-1.3,323,323,,1,326,326,,,,,,,,,"0,0,1,8,47,44,1,0,0","0,9,56,35,0","0,0,18,80,2",,,,,136,,,,,,,,,,,,,,,15,,,,,,,,,,,,,,,,,,,,,74.3,11,9,281,88,,1023,2,282,0,6,3,Karlsruhe,1,0,I1.000|4:27-I1.000|4:27-I1.000|4:20-I1.000|4:23-I1.000|4:26-I1.000|4:39-I1.000|4:38-I1.000|4:37-I1.000|4:27-I1.000|4:39-I1.000|4:50-I1.000|4:45-I0.295|1:22,,,,,3113,,250,0,,0,168070,250480,30378,,7743637,,,,,,,,,,,,,,,,,,,,,,,,,,,,,,,,,,,,,,,,,
19631530,7a856153-ca1f-4efe-aeb0-780f63a7a58b,1602412614,120,1602409783,,0,0,14.48,3867,4182,54,33,,,0,0,0.07,1.1,,,918,160,177,,,,57.02,47.1,57.39,1,58.94,,,,4.3,0.5,102,95,,,,,,144,82,13.58,13.54,13.64,4.6,4.2,331,331,,1,335,335,,,,,,,,,"0,0,1,4,37,55,3,0,0","0,4,32,64,0","0,1,10,86,2",,,,,137,,,,,,,,,,,,,,,21,,,,,,,,,,,,,,,,,,,,,71.3,9,11,242,80,,1022,1,317,0,4,3,Karlsruhe,1,0,I1.000|4:26-I1.000|4:19-I1.000|4:19-I1.000|4:17-I1.000|4:15-I1.000|4:34-I1.000|4:24-I1.000|4:18-I1.000|4:31-I1.000|4:22-I1.000|4:32-I1.000|4:40-I1.000|4:35-I1.000|4:28-I0.481|2:28,,,,,3113,,250,0,,0,168070,250480,30378,,7769373,,,,,,,,,,,,,,,,,,,,,,,,,,,,,,,,,,,,,,,,,
19641595,5c005613-07d4-40b0-bb76-990889b37c58,1602436794,120,1602433834,,0,0,12.28,3677,4080,44,30,,,0,0,0.08,1.1,,,756,146,165,,,,56.4,40.71,56.73,1,58.83,,,,3.2,0.2,99,98,,,,,,98,81,12.09,12.06,12.18,-1,-4.8,288,288,,1,292,292,,,,,,,,,"0,1,10,41,41,7,0,0,0","0,8,91,0,0","0,1,65,33,1",,,,,124,,,,,,,,,,,,,,,17,,,,,,,,,,,,,,,,,,,,,35.5,11,4,54,73,,1020,0,315,0,3,3,Karlsruhe,1,0,I1.000|5:02-I1.000|4:52-I1.000|5:04-I1.000|5:06-I1.000|4:58-I1.000|4:54-I1.000|5:02-I1.000|5:09-I1.000|5:12-I1.000|5:08-I1.000|4:57-I1.000|4:34-I0.280|1:19,,,,,3113,,250,0,,0,168070,250480,30378,,7777970,,,,,,,,,,,,,,,,,,,,,,,,,,,,,,,,,,,,,,,,,
19692012,850d2c68-fa74-485c-9716-8f64cf162399,1602598101,120,1602594907,,0,0,15,3790,3831,24,23,,,0,0,0.03,,,,854,155,172,,,,63.97,50.36,64.1,1,59.69,,,,3.9,0.9,104,101,,,,,,125,82,14.27,14.33,14.35,1.6,0.6,354,354,,1,358,358,,,,,,,,,"0,0,1,3,13,59,25,0,0","0,3,79,18,0","0,0,5,90,5",,,,,145,,,,,,,,,,,,,,,21,,,,,,,,,,,,,,,,,,,,,58,12,5,59,62,,1013,2,303,0,4,3,Karlsruhe,1,0,I1.000|4:22-I1.000|4:20-I1.000|4:11-I1.000|4:06-I1.000|4:07-I1.000|4:08-I1.000|4:09-I1.000|4:11-I1.000|4:12-I1.000|4:10-I1.000|4:05-I1.000|4:01-I1.000|4:05-I1.000|4:04-I1.000|4:56-I0.003|0:02,,,,,3113,,250,0,,0,168070,250480,30378,,7820698,,,,,,,,,,,,,,,,,,,,,,,,,,,,,,,,,,,,,,,,,
19732011,319fcc96-ce44-4e13-8370-f0b0811d50c5,1602696323,120,1602692153,,0,0,10.48,2734,2903,35,36,,,0,0,0.08,,,,603,153,174,,,,62.65,47.27,62.9,1,59.94,,,,3.4,0,104,100,,,,,,84,82,13.83,13.96,13.95,2.5,3.2,338,338,,1,343,343,,,,,,,,,"0,0,1,9,30,38,20,1,0","0,6,73,21,0","0,0,17,77,6",,,,,140,,,,,,,,,,,,,,,27,,,,,,,,,,,,,,,,,,,,,67.4,10,12,25,72,,1015,0,299,0,4,3,Karlsruhe,1,0,I1.000|4:29-I1.000|4:06-I1.000|4:00-I1.000|4:02-I1.000|3:52-I1.000|4:25-I1.000|4:32-I1.000|4:22-I1.000|4:41-I1.000|4:47-I0.479|2:18,,,,,3113,,250,0,,0,168070,250480,30378,,7855404,,,,,,,,,,,,,,,,,,,,,,,,,,,,,,,,,,,,,,,,,
19773667,cb20c0f1-bbfe-482d-9427-fde050cd01a1,1602786633,120,1602784109,,0,0,13.31,4197,4516,34,41,,,0,0,0.09,,,,720,135,160,,,,58.62,38.57,58.76,1,60.55,,,,2.7,0,101,102,,,,,,87,80,11.42,11.65,11.7,-2.1,-7.1,269,269,,1,280,280,,,,,,,,,"1,10,38,21,15,15,0,0,0","0,75,25,0,0","0,1,74,24,0",,,,,119,,,,,,,,,,,,,,,17,,,,,,,,,,,,,,,,,,,,,33.1,9,14,13,96,,1016,0,298,1,6,3,Karlsruhe,1,0,I1.000|4:32-I1.000|5:05-I1.000|5:29-I1.000|5:27-I1.000|5:36-I1.000|5:39-I1.000|5:40-I1.000|5:52-I1.000|5:44-I1.000|5:54-I1.000|4:35-I1.000|4:20-I1.000|4:33-I0.314|1:32,,,,,3113,,250,0,,0,168070,250480,30378,,7891044,,,,,,,,,,,,,,,,,,,,,,,,,,,,,,,,,,,,,,,,,
19815391,,1602869400,120,1602924871,,0,0,15,4200,4200,,,,,0,,,,,,1055,,,,,,,44.71,,1,,,,,,,,,,,,,,101,,,,,,,,,,,,,,,,,,,,,,,,,,,,,,,,,,,,,,,,,,,,,,,,,,,,,,,,,,,,,,,,,,,,,,,,,,1,,,0,0,,,,,,connect,,,0,,0,168070,250480,30378,,7924233,,,,,,,,,,,,,,,,,,,,,,,,,,,,,,,,,,,,,,,,,
19824560,01679db9-e3ff-45de-9f54-a1a30d1e912b,1602945345,120,1602942351,,0,0,14.01,3797,4126,76,62,,,0,0,0.14,1.18,,,869,153,165,,,,59.77,46.18,60.24,1,60.48,,,,3.7,0,100,100,,,,,,118,82,13.36,13.32,13.46,-3.8,-6.1,323,323,,1,328,328,,,,,,,,,"0,0,1,5,47,45,2,0,0","0,5,89,6,0","0,1,20,75,4",,,,,135,,,,,,,,,,,,,,,20,,,,,,,,,,,,,,,,,,,,,48.3,11,7,23,77,,1020,2,291,0,3,3,Karlsruhe,1,0,I1.000|4:39-I1.000|4:26-I1.000|4:27-I1.000|4:25-I1.000|4:31-I1.000|4:52-I1.000|4:38-I1.000|4:36-I1.000|4:25-I1.000|4:36-I1.000|4:31-I1.000|4:33-I1.000|4:20-I1.000|4:17-I0.009|0:02,,,,,3113,,250,0,,0,168070,250480,30378,,7932293,,,,,,,,,,,,,,,,,,,,,,,,,,,,,,,,,,,,,,,,,
19850085,eaa8ae11-af3c-4b55-9b73-afcbf09b6983,1603015824,120,1603015413,,0,0,20.64,6264,6578,73,59,,,0,0,0.08,1.06,,,1208,146,172,,,,55.47,41.77,55.76,1,59.68,,,,3.6,0,98,96,,,,,,123,83,11.91,11.89,11.97,0,0.8,283,283,,1,286,286,,,,,,,,,"0,0,7,54,37,2,0,0,0","0,12,88,1,0","0,1,78,21,0",,,,,119,,,,,,,,,,,,,,,,,,,,,,,,,,,,,,,,,,,,38.6,8,6,248,84,,1024,1,277,0,3,3,Karlsruhe,1,0,I1.000|5:17-I1.000|5:04-I1.000|5:00-I1.000|4:58-I1.000|4:55-I1.000|5:00-I1.000|4:48-I1.000|4:44-I1.000|4:52-I1.000|5:06-I1.000|5:17-I1.000|5:02-I1.000|5:07-I1.000|5:10-I1.000|5:13-I1.000|5:10-I1.000|5:08-I1.000|5:08-I1.000|5:12-I1.000|5:01-I0.642|3:12,,,,,3113,,250,0,,0,168070,250480,30378,,7952941,,,,,,,,,,,,,,,,,,,,,,,,,,,,,,,,,,,,,,,,,
19919408,32398c55-2343-4911-9a21-0109636bdb5d,1603131089,120,1603126358,,0,0,8.51,2307,2316,16,33,,,0,0,0.03,,,,503,149,165,,,,62.01,44.57,62,1,60.12,,,,3.2,0,100,101,,,,,,66,82,13.23,13.46,13.41,1.5,-1.4,322,322,,1,329,329,,,,,,,,,"1,1,2,16,33,40,9,0,0","0,17,73,9,0","0,0,32,66,2",,,,,135,,,,,,,,,,,,,,,15,,,,,,,,,,,,,,,,,,,,,49.6,11,6,85,64,,1021,0,287,1,2,3,Karlsruhe,1,0,I1.000|4:42-I1.000|4:38-I1.000|4:31-I1.000|4:13-I1.000|4:01-I1.000|4:08-I1.000|4:36-I1.000|5:04-I0.514|2:32,,,,,3113,,250,0,,0,168070,250480,30378,,8013094,,,,,,,,,,,,,,,,,,,,,,,,,,,,,,,,,,,,,,,,,
19963107,9d85d81b-26a9-47b2-94cd-83f4fcfe63be,1603217309,120,1603214896,,0,0,15.19,3726,3735,53,58,,,0,0,0.11,1.07,0.92,,948,165,182,,,,60.45,52.17,60.69,1,59.86,,,,4.8,2.1,100,99,,,,,,151,84,14.69,14.73,14.8,3.1,2.6,367,367,,1,371,371,,,,,,,,,"0,0,0,0,5,59,36,0,0","0,1,21,77,1","0,0,3,84,13",,,,,146,,,,,,,,,,,,,,,21,,,,,,,,,,,,,,,,,,,,,90.7,14,2,83,62,,1010,,,1,4,1,Karlsruhe,1,0,I1.000|4:22-I1.000|4:17-I1.000|4:18-I1.000|4:08-I1.000|3:56-I1.000|4:06-I1.000|4:11-I1.000|3:59-I1.000|4:02-I1.000|3:54-I1.000|3:54-I1.000|4:03-I1.000|4:00-I1.000|4:00-I1.000|4:02-I0.188|0:54,,,,,3113,,250,0,,0,168070,250480,30378,,8051384,,,,,,,,,,,,,,,,,,,,,,,,,,,,,,,,,,,,,,,,,
20009406,82971272-6520-4f27-b9e5-1afaf51a758d,1603303496,120,1603299340,,0,0,8.82,2842,2914,40,36,,,0,0,0.11,1.12,0.93,,506,134,156,,,,57.61,36.46,57.96,1,59.71,,,,2.4,0,100,99,,,,,,53,80,11.22,11.19,11.3,-1,-2.4,263,263,,1,267,267,,,,,,,,,"0,2,30,64,5,0,0,0,0","0,97,3,0,0","0,0,91,8,0",,,,,116,,,,,,,,,,,,,,,15,,,,,,,,,,,,,,,,,,,,,18.3,16,11,197,56,,1005,,,1,5,1,Karlsruhe,1,0,I1.000|5:36-I1.000|5:26-I1.000|5:22-I1.000|5:18-I1.000|5:23-I1.000|5:15-I1.000|5:19-I1.000|5:17-I0.823|4:27,,,,,3113,,250,0,,0,168070,250480,30378,,8092633,,,,,,,,,,,,,,,,,,,,,,,,,,,,,,,,,,,,,,,,,
20043141,c011b5fa-1807-4e54-8e64-5f3fd2a19744,1603389961,120,1603388048,,0,0,13.99,3480,3790,34,19,,,0,0,0.04,,,,810,161,179,,,,61.67,51.01,61.94,1,59.68,,,,4.2,0.9,102,100,,,,,,130,84,14.53,14.61,14.68,3.4,-0.6,361,361,,1,367,367,,,,,,,,,"1,0,0,2,16,46,31,4,0","0,4,36,60,0","0,2,6,77,15",,,,,144,,,,,,,,,,,,,,,,,,,,,,,,,,,,,,,,,,,,82,18,13,209,71,,1015,0,275,1,4,3,Karlsruhe,1,0,I1.000|4:16-I1.000|4:10-I1.000|4:05-I1.000|4:07-I1.000|3:56-I1.000|4:04-I1.000|4:02-I1.000|4:07-I1.000|4:05-I1.000|4:01-I0.910|3:53-I0.207|0:38-I0.202|0:55-I0.207|0:40-I0.210|0:55-I0.212|0:41-I0.201|0:58-I0.210|0:40-I0.206|0:56-I0.206|0:42-I0.019|0:17-I1.000|4:49-I0.206|1:04,,,,,3113,,250,0,,0,168070,250480,30378,,8123584,,,,,,,,,,,,,,,,,,,,,,,,,,,,,,,,,,,,,,,,,
20073944,ef3a0f56-f9b3-4edb-a032-e93c5099e7d2,1603474299,120,1603469944,,0,0,7.83,2302,2659,45,29,,,0,0,0.15,1.07,,,461,141,155,,,,60.44,40.3,61.02,1,59.67,,,,2.7,0,100,100,,,,,,53,81,12.36,12.29,12.44,3.1,3.6,295,295,,1,299,299,,,,,,,,,"0,2,6,26,58,8,0,0,0","0,32,68,0,0","0,3,53,42,2",,,,,126,,,,,,,,,,,,,,,26,,,,,,,,,,,,,,,,,,,,,27.1,15,14,229,96,,1013,0,285,0,6,3,Karlsruhe,1,0,I1.000|4:47-I1.000|5:02-I1.000|4:41-I1.000|4:50-I1.000|4:51-I1.000|4:54-I1.000|5:12-I0.828|4:05,,,,,3113,,250,0,,0,168070,250480,30378,,8150853,,,,,,,,,,,,,,,,,,,,,,,,,,,,,,,,,,,,,,,,,
20098847,e0c4e15a-4c40-4ebc-9a38-bbf50f679d99,1603554732,120,1603552256,,0,0,15.48,4126,4494,51,24,,,0,0,0.05,,,,929,153,167,,,,61.01,47.45,61.39,1,59.95,,,,3.7,0.1,102,100,,,,,,128,82,13.6,13.55,13.67,-1.4,-3.4,333,333,,1,336,336,,,,,,,,,"0,0,0,8,33,52,6,0,0","0,5,88,7,0","0,0,18,78,3",,,,,137,,,,,,,,,,,,,,,25,,,,,,,,,,,,,,,,,,,,,52.1,16,13,226,70,,1017,1,286,0,2,3,Karlsruhe,1,0,I1.000|4:33-I1.000|4:24-I1.000|4:39-I1.000|4:33-I1.000|4:26-I1.000|4:28-I1.000|4:35-I1.000|4:26-I1.000|4:27-I1.000|4:35-I1.000|4:24-I1.000|4:05-I1.000|4:16-I1.000|4:30-I1.000|4:20-I0.480|2:05,,,,,3113,,250,0,,0,168070,250480,30378,,8172752,,,,,,,,,,,,,,,,,,,,,,,,,,,,,,,,,,,,,,,,,
20128119,9bbc1042-11d4-4e40-9421-6dab1430b792,1603640379,60,1603641417,,0,0,0.49,122,122,0,0,,,0,0,0,,,,25,135,145,,,,78.55,38.23,78.55,1,59.95,,,,0.4,0,,100,,,,,,2,81,14.33,14.12,14.13,12,8.8,351,351,,1,350,350,,,,,,,,,"0,0,0,7,24,44,21,4,0","0,68,32,0,0","0,0,12,83,6",,,,,149,,,,,,,,,,,,,,,22,,,,,,,,,,,,,,,,,,,,,5.6,13,13,185,87,,1004,0,293,0,6,3,Eil,1,0,,,,,,3113,,250,0,,0,168070,250480,30378,,8198298,,,,,,,,,,,,,,,,,,,,,,,,,,,,,,,,,,,,,,,,,
20128141,ed5c3ca3-f836-44a2-8ea4-70ff3c8d5ec2,1603640607,60,1603641464,,0,0,15.33,4045,4271,50,49,,,0,0,0.05,,,,893,152,178,,,,62.35,47.98,62.61,1,60.22,,,,3.7,0.9,104,100,,,,,,124,82,13.68,13.72,13.74,-3.8,-3.5,335,335,,1,338,338,,,,,,,,,"0,0,2,4,30,54,8,1,0","0,3,89,8,0","0,0,13,85,2",,,,,139,,,,,,,,,,,,,,,18,,,,,,,,,,,,,,,,,,,,,49.5,13,13,185,87,,1004,0,293,0,6,3,Eil,1,0,I1.000|4:22-I1.000|4:28-I1.000|4:40-I1.000|4:31-I1.000|4:24-I1.000|4:34-I1.000|4:27-I1.000|4:19-I1.000|4:11-I0.608|2:56-I1.000|4:19-I1.000|4:18-I1.000|4:15-I1.000|4:12-I1.000|4:15-I0.721|3:13,,,,,3113,,250,0,,0,168070,250480,30378,,8198319,,,,,,,,,,,,,,,,,,,,,,,,,,,,,,,,,,,,,,,,,
20178486,3995703d-58b0-4944-9192-e8850969dbbe,1603817620,60,1603817778,,0,0,14.01,3422,3446,44,44,,,0,0,0.05,,0.89,,812,160,182,,,,63.67,52.1,63.92,1,61.12,,,,4.3,1,103,102,,,,,,128,84,14.79,15,15.05,4.4,0,369,369,,1,379,379,,,,,,,,,"0,1,6,3,5,29,55,1,0","0,9,35,56,0","0,1,8,58,33",,,,,146,,,,,,,,,,,,,,,17,,,,,,,,,,,,,,,,,,,,,93,12,20,194,67,,1007,0,279,1,3,3,"Porz am Rhein",1,0,I1.000|4:34-I1.000|4:10-I1.000|4:08-I1.000|4:05-I1.000|4:02-I1.000|3:56-I1.000|3:54-I1.000|3:51-I1.000|3:51-I1.000|3:42-I1.000|3:42-I1.000|3:43-I1.000|3:41-I1.000|5:41-I0.005|0:03,,,,,3113,,250,0,,0,168070,250480,30378,,8239215,,,,,,,,,,,,,,,,,,,,,,,,,,,,,,,,,,,,,,,,,
20210867,c866b80d-7ffb-4656-9944-7f04efaf411a,1603906211,60,1603905616,,0,0,8.33,2402,2731,39,31,,,0,0,0.12,1.12,0.94,,455,136,157,,,,64.86,41.4,65.31,1,61.55,,,,2.4,0,99,103,,,,,,50,81,12.58,12.61,12.75,-6.3,-9.4,299,299,,1,305,305,,,,,,,,,"0,0,5,30,46,17,2,0,0","1,67,32,0,0","0,1,54,42,3",,,,,128,,,,,,,,,,,,,,,,,,,,,,,,,,,,,,,,,,,,26.8,11,17,213,77,,1010,0,301,1,4,3,"Porz am Rhein",1,0,I1.000|4:57-I1.000|4:58-I1.000|5:09-I1.000|5:04-I1.000|4:43-I1.000|4:47-I1.000|4:30-I1.000|4:18-I0.331|1:35,,,,,3113,,250,0,,0,168070,250480,30378,,8268314,,,,,,,,,,,,,,,,,,,,,,,,,,,,,,,,,,,,,,,,,
20236962,96f515ce-5976-4b06-8679-f93ddbab37b4,1603990252,60,1603990803,,0,0,15.61,3935,3970,44,42,,,0,0,0.05,,,,916,156,175,,,,63.56,50.65,63.79,1,62.05,,,,4.1,0,100,102,,,,,,135,82,14.32,14.41,14.47,1.5,-0.3,355,355,,1,361,361,,,,,,,,,"0,0,0,3,21,37,39,0,0","0,5,45,50,0","0,0,10,81,10",,,,,145,,,,,,,,,,,,,,,20,,,,,,,,,,,,,,,,,,,,,74.4,12,11,249,91,,1019,0,296,1,6,3,"Porz am Rhein",1,0,I1.000|4:45-I1.000|4:29-I1.000|4:21-I1.000|4:24-I1.000|4:03-I1.000|3:58-I1.000|3:54-I1.000|3:51-I1.000|3:54-I1.000|3:59-I1.000|3:54-I1.000|4:00-I1.000|4:05-I1.000|4:37-I1.000|4:30-I0.608|2:51,,,,,3113,,250,0,,0,168070,250480,30378,,8291982,,,,,,,,,,,,,,,,,,,,,,,,,,,,,,,,,,,,,,,,,
20251262,361f7a74-db1a-4e57-ade2-75a7e7e84bde,1603732535,60,1604049642,,0,0,10,2836,2978,31,32,,,0,0,0.04,,,,559,143,166,100,,,62.02,42.73,62.25,1,60.56,,,,3.1,0.2,103,102,,,,,,71,81,12.72,12.9,12.94,2.5,0.2,308,308,,1,317,317,,,,,,,,,"2,1,6,16,46,21,8,0,0","1,42,50,8,0","0,3,41,52,4",,,,,131,,,,,,,,,,,,,,,15,,,,,,,,,,,,,,,,,,,,,43.9,12,16,210,73,,1004,0,329,1,3,3,"Porz am Rhein",1,0,I1.000|5:03-I1.000|4:32-I1.000|4:34-I1.000|4:32-I1.000|4:07-I1.000|4:50-I1.000|4:51-I1.000|4:00-I1.000|5:45-I1.000|5:00-I0.004|0:02,,,,,3113,,250,0,,0,168070,250480,30378,,8303934,,,,,,,,,,,,,,,,,,,,,,,,,,,,,,,,,,,,,,,,,
20265022,d3a186de-3310-48c6-967e-421c9968fe37,1604076092,60,1604077415,,0,0,16.1,4551,4763,66,59,,,0,0,0.14,1.1,0.97,,949,146,163,,,,60.56,44.47,60.9,1,61.7,,,,3.4,0,101,98,,,,,,121,81,12.79,12.78,12.89,0.8,1.6,307,307,,1,312,312,,,,,,,,,"0,0,2,13,65,19,0,0,0","1,13,86,0,0","0,2,36,61,1",,,,,131,,,,,,,,,,,,,,,16,,,,,,,,,,,,,,,,,,,,,38.7,14,14,247,89,,1022,0,273,1,4,3,"Porz am Rhein",1,0,I1.000|4:42-I1.000|4:23-I1.000|4:38-I1.000|4:42-I1.000|4:47-I1.000|4:44-I1.000|4:47-I1.000|4:49-I1.000|4:54-I1.000|4:46-I1.000|4:56-I1.000|4:43-I1.000|4:45-I1.000|4:28-I1.000|4:31-I1.000|4:43-I0.100|0:34,,,,,3113,,250,0,,0,168070,250480,30378,,8316619,,,,,,,,,,,,,,,,,,,,,,,,,,,,,,,,,,,,,,,,,
20292144,ac129702-5ea5-472c-9d75-dc3d8ffaaa3d,1604151496,60,1604151746,,0,0,10.41,3057,3401,54,28,,,0,0,0.1,1.05,0.93,,772,162,181,120,,,49.79,41.14,50.26,1,61.7,,,,4.1,0.9,,100,,,,,,117,80,12.41,12.33,12.48,-0.4,-1.6,296,296,,1,300,300,,,,,,,,,"1,3,7,20,60,9,0,0,0","0,3,35,61,0","0,1,50,49,0",,,,,128,,,,,,,,,,,,,,,22,,,,,,,,,,,,,,,,,,,,,81.1,15,16,163,75,,1019,1,294,0,2,3,"Porz am Rhein",1,0,I1.000|5:07-I1.000|4:43-I1.000|5:06-I1.000|5:05-I1.000|5:15-I1.000|4:55-I1.000|4:40-I1.000|4:46-I1.000|4:37-I1.000|4:44-I0.413|2:00,,,,,3113,,250,0,,0,168070,250480,30378,,8340897,,,,,,,,,,,,,,,,,,,,,,,,,,,,,,,,,,,,,,,,,
20314930,a4b8bf41-4a05-429d-b9dc-52604e44441b,1604226929,60,1604232935,,0,0,30,7987,8243,268,265,,,0,0.6,0.28,1.02,1.01,286,1685,154,170,,,,60.53,50.03,61.21,1,61.35,,,,4.5,0,101,98,,,,,,259,82,13.71,13.63,13.81,1.4,3.6,335,335,,1,340,340,,,,,,,,,"0,1,3,7,27,51,10,0,0","0,5,79,17,0","0,1,17,76,6",,,,,137,,,,,,,,,,,,,,,19,,,,,,,,,,,,,,,,,,,,,56.9,12,13,184,97,,1015,1,282,0,6,3,Eil,1,0,I1.000|4:29-I1.000|4:26-I1.000|4:22-I1.000|4:26-I1.000|4:17-I1.000|4:19-I1.000|4:21-I1.000|4:27-I1.000|4:22-I1.000|4:17-I1.000|4:33-I1.000|4:30-I1.000|4:40-I1.000|4:30-I1.000|4:45-I1.000|4:55-I1.000|4:15-I1.000|5:10-I1.000|4:19-I1.000|4:11-I1.000|4:13-I1.000|4:18-I1.000|4:39-I1.000|4:25-I1.000|4:28-I1.000|4:03-I1.000|4:17-I1.000|4:21-I1.000|4:16-I1.000|4:34-I0.002|0:02,,,,,3113,,250,0,,0,168070,250480,30378,,8360251,,,,,,,,,,,,,,,,,,,,,,,,,,,,,,,,,,,,,,,,"5,5",
20360425,98b51514-77df-453b-9c4a-9b4fd29f0dcb,1604337613,60,1604336015,,0,0,4.37,1419,1830,16,11,,,0,0,0.12,,,,243,127,139,,,,60.9,34.59,61.26,1,61.34,,,,2,0,100,100,,,,,,23,79,11.13,11.12,11.18,4.1,6.4,259,259,,1,262,262,,,,,,,,,"0,3,41,48,8,0,0,0,0","3,97,0,0,0","0,2,96,2,0",,,,,117,,,,,,,,,,,,,,,15,,,,,,,,,,,,,,,,,,,,,15.8,19,24,115,78,,1011,0,268,1,4,3,"Porz am Rhein",1,0,I1.000|5:18-I1.000|5:09-I1.000|5:29-I1.000|5:42-I0.369|2:01,,,,,3113,,250,0,,0,168070,250480,30378,,8396181,,,,,,,,,,,,,,,,,,,,,,,,,,,,,,,,,,,,,,,,,
20408758,edbd3cb2-7b31-4c91-83e8-bc7ce061abd6,1604422288,60,1604423759,,0,0,16.01,4262,4299,68,69,,,0,0,0.11,1.05,0.91,,935,149,170,104,,,63.42,47.65,63.75,1,61.81,,,,3.7,0.1,101,102,,,,,,125,82,13.55,13.71,13.8,-1.2,7.6,341,341,,1,368,368,,,,,,,,,"0,2,4,4,38,37,15,0,0","0,13,70,17,0","0,2,18,69,11",,,,,137,,,,,,,,,,,,,,,15,,,,,,,,,,,,,,,,,,,,,64.6,10,12,230,70,,1023,0,281,1,3,3,"Porz am Rhein",1,0,I1.000|4:42-I1.000|4:27-I1.000|4:27-I1.000|4:39-I1.000|4:51-I1.000|4:34-I1.000|4:31-I1.000|4:28-I1.000|4:28-I1.000|4:23-I1.000|4:07-I1.000|3:55-I1.000|3:57-I1.000|3:58-I1.000|3:51-I1.000|5:43-I0.008|0:02,,,,,3113,,250,0,,0,168070,250480,30378,,8438942,,,,,,,,,,,,,,,,,,,,,,,,,,,,,,,,,,,,,,,,,
20446536,1b926822-7f30-41ee-8e9b-5b697e7dfe8c,1604510219,60,1604510753,,0,0,13.87,3807,3991,90,92,,,0,0,0.17,1.12,0.92,,771,147,175,,,,62.22,45.48,62.71,1,61.56,,,,3.5,2,96,101,,,,,,104,82,13.18,13.45,13.58,3.3,3.4,319,319,,1,334,334,,,,,,,,,"0,1,3,25,39,11,21,0,0","0,34,46,20,0","0,1,47,38,14",,,,,133,,,,,,,,,,,,,,,15,,,,,,,,,,,,,,,,,,,,,76.8,7,3,332,77,,1034,0,310,1,2,3,"Porz am Rhein",1,0,I1.000|5:16-I1.000|4:46-I1.000|4:43-I1.000|4:46-I0.250|1:11-I3.558|13:16-I1.000|5:15-I1.000|5:05-I1.000|4:52-I1.000|4:44-I1.000|4:25-I1.000|4:49-I0.056|0:20,,,,,3113,,250,0,,0,168070,250480,30378,,8468207,,,,,,,,,,,,,,,,,,,,,,,,,,,,,,,,,,,,,,,,,
20479613,78591501-3d38-4c0d-a2e6-c02456beb57a,1604600039,60,1604598299,,0,0,5.27,1664,1705,11,21,,,0,0,0.08,,1.01,,303,132,155,,,,60.18,36.16,60.19,1,61.44,,,,2.1,0,100,99,,,,,,31,80,11.35,11.43,11.38,-4,-3.7,266,266,,1,267,267,,,,,,,,,"0,5,23,51,20,0,0,0,0","1,87,12,0,0","0,0,93,7,0",,,,,119,,,,,,,,,,,,,,,,,,,,,,,,,,,,,,,,,,,,18.7,6,2,51,83,,1038,0,291,1,2,3,"Porz am Rhein",1,0,I1.000|5:34-I1.000|5:03-I1.000|5:14-I1.000|5:06-I1.000|5:22-I0.266|1:25,,,,,3113,,250,0,,0,168070,250480,30378,,8493190,,,,,,,,,,,,,,,,,,,,,,,,,,,,,,,,,,,,,,,,,
20508395,e402472f-8375-4ad2-b827-0681e25b53d9,1604678715,60,1604679068,,0,0,10.52,3380,3799,57,35,,,0,0,0.1,1.07,,,574,134,158,,,,57.81,37.06,58.35,1,61.39,,,,2.9,0,103,98,,,,,,70,84,11.32,11.6,11.73,14.6,18.9,265,265,,1,281,281,,,,,,,,,"12,22,22,7,20,18,0,0,0","1,57,41,0,0","1,9,59,32,0",,,,,111,,,,,,,,,,,,,,,17,,,,,,,,,,,,,,,,,,,,,36.2,11,8,116,63,,1031,0,280,0,2,3,"Porz am Rhein",1,0,I1.000|4:36-I1.000|4:30-I1.000|4:41-I1.000|4:33-I1.000|4:32-I1.000|6:17-I1.000|6:09-I1.000|6:05-I1.000|5:54-I1.000|6:02-I0.516|3:00,,,,,3113,,250,0,,0,168070,250480,30378,,8512669,,,,,,,,,,,,,,,,,,,,,,,,,,,,,,,,,,,,,,,,,
20540420,16b239b6-1e02-4772-9801-4cb61060047a,1604757116,60,1604755762,,0,0,5.94,1628,1870,47,27,,,0,0,0.24,1.03,0.82,,352,143,158,100,,,64.7,43.06,65.6,1,61.83,,,,2.8,0,103,101,,,,,,41,83,13.35,13.25,13.47,6.5,2.6,321,321,,1,327,327,,,,,,,,,"0,2,5,8,36,48,1,0,0","1,27,72,0,0","0,2,22,74,3",,,,,132,,,,,,,,,,,,,,,19,,,,,,,,,,,,,,,,,,,,,36.5,13,13,126,66,,1024,1,270,0,2,3,"Porz am Rhein",1,0,I1.000|4:58-I1.000|4:27-I1.000|4:21-I1.000|4:20-I1.000|4:33-I0.943|4:28,,,,,3113,,250,0,,0,168070,250480,30378,,8535020,,,,,,,,,,,,,,,,,,,,,,,,,,,,,,,,,,,,,,,,,
20581537,cfedb4da-cb19-4d2f-8340-f992bdf040e9,1604834020,60,1604840254,,0,0,29.56,8031,8738,303,262,,,0,0.9,0.33,1.04,0.95,330,2261,178,193,,,,47.22,48.81,47.9,1,61.83,,,,5,4.6,,100,,,,,,400,83,13.49,13.34,13.58,1.3,4,327,327,,1,332,332,,,,,,,,,"1,1,2,8,37,47,5,0,0","0,1,6,40,52","0,1,23,74,3",,,,,133,,,,,,,,,,,,,,,24,,,,,,,,,,,,,,,,,,,,,161.5,10,9,129,75,,1024,1,283,0,4,3,Eil,1,0,I1.000|4:41-I1.000|4:36-I1.000|4:20-I1.000|4:25-I1.000|4:22-I1.000|4:18-I1.000|4:17-I1.000|4:32-I1.000|4:22-I1.000|4:33-I1.000|4:36-I1.000|4:37-I1.000|4:33-I1.000|4:44-I1.000|4:38-I1.000|4:55-I1.000|4:20-I1.000|5:09-I1.000|4:19-I1.000|4:35-I1.000|4:21-I1.000|4:22-I1.000|4:23-I1.000|4:42-I1.000|4:18-I1.000|4:25-I1.000|4:28-I0.497|2:23-I1.000|4:39-I1.000|4:39-I0.067|0:20,,,,,3113,,250,0,,0,168070,250480,30378,,8567273,,,,,,,,,,,,,,,,,,,,,,,,,,,,,,,,,,,,,,,,"5,5,5",
20588861,0a08cefa-155a-43b4-b51c-73a752e16f7e,1604848730,60,1604849861,,0,0,15.24,4561,4561,45,16,,,0,0,0.07,2.94,0.17,,780,133,136,,,,,,,1,61.83,,,,2.5,0,,100,,,,,,78,,,13.02,,-3.4,37.1,29,25,,1,69,65,,,,,,,,,"83,16,0,0,0,0,0","0,100,0,0,0","98,2,0,0,0",,,,,,,,,,,,,,,,,,,,23,,,,,,,,,,,,,,,,,,,,,16.9,14,9,120,68,,1023,0,288,0,4,3,"Porz am Rhein",1,0,I5.000|23:44-I5.000|27:52-I5.000|23:07-I0.235|1:19,,,,,3113,,250,0,,0,168072,,30378,,8573090,,,,,,,,,,,,,,,,,,,,,,,,,,,,,,,,,,,,,,,,,
20632743,bc6d072d-5d9a-470b-84a8-2062e8f5fddd,1604943296,60,1604943189,,0,0,10.58,3009,3262,39,37,,,0,0,0.11,1,0.87,,588,144,193,120,,,61.23,42.76,61.53,1,61.65,,,,4,3.2,,85,,,,,,82,81,12.69,12.71,12.79,21.9,19.6,305,305,,1,309,309,,,,,,,,,"0,0,3,15,65,16,0,0,0","0,66,8,2,24","0,0,43,56,0",,,,,130,,,,,,,,,,,,,,,14,,,,,,,,,,,,,,,,,,,,,167.9,13,6,124,80,,1024,0,287,1,3,3,"Porz am Rhein",1,0,I1.000|5:07-I1.000|4:43-I1.000|4:45-I1.000|4:46-I1.000|4:47-I1.000|4:42-I1.000|4:53-I1.000|4:37-I1.000|4:30-I1.000|4:34-I0.580|2:46,,,,,3113,,250,0,,0,168070,250480,30378,,8606296,,,,,,,,,,,,,,,,,,,,,,,,,,,,,,,,,,,,,,,,,
20700260,9fc1f5f6-cdb3-4f5d-a039-bee5a32eda83,1605111865,60,1605112690,,0,0,16.39,4036,4140,40,52,,,0,0,0.06,,0.99,,964,160,177,,,,63.03,52.24,63.17,1,61.78,,,,4.4,1.2,99,101,,,,,,124,83,14.62,14.76,14.75,4.4,1.9,364,364,,1,369,369,,,,,,,,,"0,0,1,3,13,43,34,5,0","0,6,35,59,0","0,0,6,78,16",,,,,147,,,,,,,,,,,,,,,18,,,,,,,,,,,,,,,,,,,,,82.3,11,9,137,88,,1023,0,283,1,2,3,"Porz am Rhein",1,0,I1.000|4:34-I1.000|4:12-I1.000|3:57-I1.000|4:02-I1.000|3:56-I1.000|3:58-I1.000|4:05-I0.148|0:37-I0.295|1:01-I0.245|1:02-I0.298|1:02-I0.237|1:01-I0.300|1:02-I0.229|1:03-I0.301|1:03-I0.235|1:02-I0.291|1:01-I0.229|1:04-I0.300|1:02-I0.209|1:00-I0.285|1:01-I0.200|1:00-I0.293|1:01-I1.000|4:15-I1.000|3:57-I1.000|4:11-I1.000|4:00-I1.000|4:41-I0.291|1:27,,,,,3113,,250,0,,0,168070,250480,30378,,8658121,,,,,,,,,,,,,,,,,,,,,,,,,,,,,,,,,,,,,,,,,
20790946,e6268500-d9e3-4684-8b43-38f9eb2c5ba5,1605290872,60,1605291277,,0,0,13.06,3630,3793,51,43,,,0,0,0.15,1.1,,,787,146,157,,,,61.83,44.61,62.18,1,61.9,,,,3.3,0,100,100,,,,,,93,80,13,12.98,13.09,2.9,3.4,314,314,,1,317,317,,,,,,,,,"0,0,1,7,71,22,0,0,0","1,12,87,0,0","0,0,29,69,1",,,,,135,,,,,,,,,,,,,,,18,,,,,,,,,,,,,,,,,,,,,34.7,12,9,189,87,,1017,0,287,1,4,3,"Porz am Rhein",1,0,I1.000|4:58-I1.000|4:30-I1.000|4:31-I1.000|4:37-I1.000|4:32-I1.000|4:35-I1.000|4:39-I1.000|4:33-I1.000|4:31-I1.000|4:34-I1.000|4:44-I1.000|4:39-I1.000|4:51-I0.056|0:17,,,,,3113,,250,0,,0,168070,250480,30378,,8726555,,,,,,,,,,,,,,,,,,,,,,,,,,,,,,,,,,,,,,,,,
20825842,185b620f-8c9a-436d-b660-3efa7314387a,1605385812,60,1605383897,,0,0,4.69,1311,1457,16,10,,,0,0,0.09,1.01,0.95,,281,141,168,,,,64.33,41.48,64.7,1,62.41,,,,2.5,0.2,102,102,,,,,,31,80,12.97,13.01,13.11,0.9,2.3,313,313,,1,319,319,,,,,,,,,"0,0,5,15,49,26,3,1,0","2,34,61,3,0","0,0,37,59,3",,,,,134,,,,,,,,,,,,,,,15,,,,,,,,,,,,,,,,,,,,,27.2,12,13,154,88,,1015,0,287,1,3,3,"Porz am Rhein",1,0,I1.000|5:02-I0.151|0:51-I1.000|4:05-I1.000|4:38-I1.000|4:41-I0.540|2:35,,,,,3113,,250,0,,0,168070,250480,30378,,8756641,,,,,,,,,,,,,,,,,,,,,,,,,,,,,,,,,,,,,,,,,
20848570,281dda43-e297-4eca-92b8-52988314259c,1605440849,60,1605442384,,0,0,17.11,4522,4854,49,40,,,0,0,0.08,,,,1012,151,166,,,,62.81,48.3,63.07,1,62.27,,,,3.6,0,100,100,,,,,,135,81,13.66,13.64,13.7,1.6,1.3,334,334,,1,335,335,,,,,,,,,"0,0,0,1,28,70,1,0,0","0,6,89,5,0","0,0,7,92,1",,,,,140,,,,,,,,,,,,,,,15,,,,,,,,,,,,,,,,,,,,,49.7,15,22,169,73,,1009,1,275,0,3,3,"Porz am Rhein",1,0,I1.000|4:36-I1.000|4:18-I1.000|4:14-I1.000|4:23-I1.000|4:21-I1.000|4:23-I1.000|4:21-I1.000|4:19-I1.000|4:18-I1.000|4:24-I1.000|4:17-I1.000|4:21-I1.000|4:35-I1.000|4:27-I1.000|4:31-I1.000|4:31-I1.000|4:33-I0.108|0:31,,,,,3113,,250,0,,0,168070,250480,30378,,8776303,,,,,,,,,,,,,,,,,,,,,,,,,,,,,,,,,,,,,,,,,
20879315,7345ee06-5698-44af-a8f9-222524f11060,1605202714,60,1605524702,,0,0,14.32,3873,3913,38,38,,,4,0,0.01,,,,946,148,161,,,,62.77,46.37,62.98,1,,,,,,,,,,,,,,110,81,13.33,13.36,13.39,2.2,2.4,325,325,,1,328,328,,,,,,,,,"0,0,0,7,37,56,0,0,0","0,9,90,0,0","0,0,18,82,0",,,,,137,,,,,,,,,,,,,,,,,,,,,,,,,,,,,,,,,,,,42.3,10,9,224,83,,1021,0,289,1,3,3,"Porz am Rhein",1,0,,,"Afternoon Run",,,StravaGPX,,133,0,,0,168070,250480,30378,,,,,,,,,,,,,,,,,,,,,,,,,,,,,,,,,,,,,,,,,,,
20900933,1bb547c6-8cc7-48a4-8407-44f162adf9a5,1605553067,60,1605553740,,0,0,14.59,3983,4030,48,47,,,0,0,0.1,1.03,0.98,,896,149,165,95,,,61.48,45.94,61.73,1,62.06,,,,3.5,0,100,100,,,,,,116,81,13.24,13.22,13.28,-1.6,-2.9,322,322,,1,324,324,,,,,,,,,"0,0,0,5,51,44,0,0,0","0,6,92,2,0","0,0,15,84,0",,,,,136,,,,,,,,,,,,,,,15,,,,,,,,,,,,,,,,,,,,,44,11,17,255,86,,1021,0,277,1,4,3,"Porz am Rhein",1,0,I1.000|4:56-I1.000|4:29-I1.000|4:37-I1.000|4:31-I1.000|4:32-I1.000|4:35-I1.000|4:26-I1.000|4:27-I1.000|4:32-I1.000|4:31-I1.000|4:22-I1.000|4:28-I1.000|4:33-I1.000|4:35-I0.592|2:48,,,,,3113,,250,0,,0,168070,250480,30378,,8815961,,,,,,,,,,,,,,,,,,,,,,,,,,,,,,,,,,,,,,,,,
20931740,98429449-d99e-4b15-8df0-3d884f2387c0,1605638389,60,1605639192,,0,0,14.55,3949,4204,51,52,,,0,0,0.06,1.06,1,,864,150,173,,,,61.35,46.24,61.61,1,61.91,,,,3.7,1.2,100,100,,,,,,118,81,13.31,13.47,13.51,0.1,-0.2,323,323,,1,331,331,,,,,,,,,"1,5,2,6,38,37,8,2,0","0,12,70,18,0","0,1,24,69,6",,,,,136,,,,,,,,,,,,,,,15,,,,,,,,,,,,,,,,,,,,,61.5,10,10,226,93,,1027,0,226,1,4,3,"Porz am Rhein",1,0,I1.000|6:05-I1.000|4:30-I1.000|4:26-I1.000|4:22-I1.000|4:26-I1.000|4:19-I0.583|2:24-I0.145|0:30-I0.228|1:01-I0.151|0:33-I0.241|1:00-I0.146|0:31-I0.219|0:58-I0.155|0:32-I0.225|1:01-I0.193|0:40-I1.000|4:38-I0.184|0:40-I0.205|0:59-I0.153|0:32-I0.215|1:01-I0.173|0:37-I0.205|0:59-I0.149|0:30-I0.210|1:02-I0.158|0:31-I1.000|4:39-I1.000|4:48-I1.000|4:41-I0.611|2:55,,,,,3113,,250,0,,0,168070,250480,30378,,8842238,,,,,,,,,,,,,,,,,,,,,,,,,,,,,,,,,,,,,,,,,
20966292,125e2c62-4b7c-4038-9427-2a15f7633bcb,1605727414,60,1605727417,,0,0,3.45,1430,1781,47,7,,,0,0,0.29,1.11,,,214,116,136,93,,,49.92,25.42,51.48,1,61.91,,,,1,0,,100,,,,,,18,79,9.06,8.79,9.22,1.1,-3.1,202,202,,1,207,207,,,,,,,,,"86,6,4,4,0,0,0,0,0","9,91,0,0,0","0,54,46,0,0",,,,,92,,,,,,,,,,,,,,,15,,,,,,,,,,,,,,,,,,,,,10.4,11,14,162,74,,1019,0,226,1,2,3,"Porz am Rhein",1,0,I1.000|6:59-I1.000|7:09-I1.000|6:23-I0.446|3:18,,,,,3113,,250,0,,0,168070,250480,30378,,8869353,,,,,,,,,,,,,,,,,,,,,,,,,,,,,,,,,,,,,,,,,
20966297,f0de1beb-986b-4202-822f-4dbbfc0888a0,1605729431,60,1605727440,,0,0,4.85,1368,1408,19,17,,,0,0,0.04,,0.97,,355,163,194,,,,51.84,41.13,52.11,1,61.43,,,,3.3,3,98,96,,,,,,55,81,12.82,12.83,12.89,2.4,0.5,309,309,,1,312,312,,,,,,,,,"0,0,1,17,57,24,0,0,0","1,5,33,51,10","0,0,44,56,0",,,,,131,,,,,,,,,,,,,,,15,,,,,,,,,,,,,,,,,,,,,92.9,11,14,163,75,,1019,0,226,1,2,3,"Porz am Rhein",1,0,I1.000|5:02-I1.000|4:47-I1.000|4:40-I1.000|4:23-I0.850|3:55,,,,,3113,,250,0,,0,168070,250480,30378,,8869357,,,,,,,,,,,,,,,,,,,,,,,,,,,,,,,,,,,,,,,,,
21003159,b24b0fbc-b448-4e2d-95cf-8d2f2b30dded,1605812252,60,1605813427,,0,0,13.54,4123,4563,37,42,,,0,0,0.09,,0.97,,692,133,151,,,,62.35,40.23,62.53,1,61.28,,,,2.5,0,96,100,,,,,,81,80,11.84,11.84,11.87,-3.1,-5,280,280,,1,282,282,,,,,,,,,"0,0,10,54,36,0,0,0,0","1,92,6,0,0","0,0,88,12,0",,,,,123,,,,,,,,,,,,,,,17,,,,,,,,,,,,,,,,,,,,,22,7,12,322,82,,1027,0,303,1,6,3,"Porz am Rhein",1,0,I1.000|5:25-I1.000|4:57-I1.000|5:15-I1.000|5:17-I1.000|5:04-I1.000|5:01-I1.000|4:53-I1.000|4:52-I1.000|4:58-I1.000|5:00-I1.000|4:59-I1.000|5:05-I1.000|5:09-I0.535|2:47,,,,,3113,,250,0,,0,168070,250480,30378,,8898428,,,,,,,,,,,,,,,,,,,,,,,,,,,,,,,,,,,,,,,,,
21074054,ecb2b1f9-732a-4616-b235-d7259e2b2b8f,1605977828,60,1605978171,,0,0,14.66,3682,3726,65,89,,,0,0,0.14,1.17,0.96,398,921,162,173,,,,60.38,50.62,60.59,1,60.83,,,,4.3,0,96,99,,,,,,140,82,14.31,14.39,14.52,-0.6,0.5,354,354,,1,362,362,,,,,,,,,"0,0,0,1,8,76,15,0,0","0,1,26,73,0","0,0,4,86,10",,,,,146,,,,,,,,,,,,,,,20,,,,,,,,,,,,,,,,,,,,,71.7,7,10,201,83,,1030,0,267,1,4,3,"Porz am Rhein",1,0,I1.000|4:30-I1.000|4:10-I1.000|4:15-I1.000|4:19-I1.000|4:15-I1.000|4:09-I1.000|4:11-I1.000|4:10-I1.000|4:06-I1.000|4:05-I1.000|4:03-I1.000|4:06-I1.000|3:59-I1.000|3:59-I0.655|3:05,,,,,3113,,250,0,,0,168070,250480,30378,,8950100,,,,,,,,,,,,,,,,,,,,,,,,,,,,,,,,,,,,,,,,5,
21105896,c91a4da6-2591-4524-bd2c-a79346c14f49,1606050737,60,1606054572,,0,0,26.51,6790,7206,63,63,,,0,0,0.07,,,,1576,157,177,,,,61.74,51.86,61.92,1,60.95,,,,4.7,0.9,100,100,,,,,,213,82,14.08,14.09,14.15,1.6,1.8,347,347,,1,350,350,,,,,,,,,"0,0,1,1,10,80,8,0,0","0,2,76,22,0","0,0,6,89,4",,,,,143,,,,,,,,,,,,,,,15,,,,,,,,,,,,,,,,,,,,,70.3,11,8,230,83,,1027,1,278,0,4,3,"Porz am Rhein",1,0,I1.000|4:31-I1.000|4:12-I1.000|4:09-I1.000|4:15-I1.000|4:12-I1.000|4:13-I1.000|4:17-I1.000|4:18-I1.000|4:19-I1.000|4:21-I1.000|4:15-I1.000|4:25-I1.000|4:01-I1.000|4:15-I1.000|4:24-I1.000|4:14-I1.000|4:15-I1.000|4:04-I1.000|4:14-I1.000|4:22-I1.000|4:21-I1.000|4:12-I1.000|4:22-I1.000|4:12-I1.000|4:13-I1.000|4:17-I0.512|2:18,,,,,3113,,250,0,,0,168070,250480,30378,,8977716,,,,,,,,,,,,,,,,,,,,,,,,,,,,,,,,,,,,,,,,,
21154282,5f413f2e-5c70-40b2-a403-89324191bfb0,1606159756,60,1606159279,,0,0,9.39,2655,2664,15,37,,,0,0,0.09,,0.96,,595,147,161,106,,,59.98,42.7,59.92,1,60.92,,,,3.2,0,100,100,,,,,,72,80,12.67,12.78,12.73,-1,-3.5,304,304,,1,307,307,,,,,,,,,"0,0,3,15,66,16,0,0,0","1,9,90,0,0","0,0,40,60,0",,,,,133,,,,,,,,,,,,,,,16,,,,,,,,,,,,,,,,,,,,,39.3,6,7,142,79,,1030,0,285,1,3,3,"Porz am Rhein",1,0,I1.000|5:13-I1.000|4:45-I1.000|4:35-I1.000|4:40-I1.000|4:39-I1.000|4:34-I1.000|4:40-I1.000|4:47-I1.000|4:33-I0.387|1:49,,,,,3113,,250,0,,0,168070,250480,30378,,9016136,,,,,,,,,,,,,,,,,,,,,,,,,,,,,,,,,,,,,,,,,
21191786,c3bcad84-d5db-4825-8d72-e9d4630d5bac,1606243554,60,1606244808,,0,0,14.57,4204,4426,40,64,,,0,0,0.07,,0.96,,757,137,153,100,,,64.21,43.08,64.29,1,61.32,,,,2.9,0,100,102,,,,,,91,80,12.45,12.51,12.49,1.1,0.6,298,298,,1,300,300,,,,,,,,,"0,0,1,19,74,6,0,0,0","0,70,30,0,0","0,0,53,47,0",,,,,130,,,,,,,,,,,,,,,15,,,,,,,,,,,,,,,,,,,,,25,3,12,137,91,,1022,0,271,1,3,3,"Porz am Rhein",1,0,I1.000|5:04-I1.000|4:45-I1.000|4:39-I1.000|4:42-I1.000|4:45-I1.000|4:55-I1.000|4:56-I1.000|4:44-I1.000|4:36-I1.000|4:45-I1.000|4:44-I1.000|4:50-I1.000|4:55-I1.000|4:51-I0.567|2:53,,,,,3113,,250,0,,0,168070,250480,30378,,9047782,,,,,,,,,,,,,,,,,,,,,,,,,,,,,,,,,,,,,,,,,
21253212,3d5f84be-12e8-41da-baa9-a775851531b6,1606407960,60,1606409608,,0,0,17.13,4651,5025,56,62,,,0,0,0.06,,,,1020,147,165,,,,63.06,46.82,63.29,1,61.26,,,,3.5,0,99,100,,,,,,126,81,13.28,13.3,13.34,0.7,-0.7,331,331,,1,334,334,,,,,,,,,"0,0,0,4,51,45,0,0,0","1,8,91,1,0","0,0,10,88,2",,,,,136,,,,,,,,,,,,,,,16,,,,,,,,,,,,,,,,,,,,,37.5,6,6,127,88,,1021,0,288,1,2,3,"Porz am Rhein",1,0,I1.000|4:57-I1.000|4:20-I1.000|4:20-I1.000|4:24-I1.000|4:36-I1.000|4:28-I1.000|4:28-I1.000|4:28-I1.000|4:28-I1.000|4:26-I1.000|4:39-I1.000|4:31-I1.000|4:32-I1.000|4:33-I1.000|4:36-I1.000|4:27-I1.000|4:40-I0.130|0:39,,,,,3113,,250,0,,0,168070,250480,30378,,9097410,,,,,,,,,,,,,,,,,,,,,,,,,,,,,,,,,,,,,,,,,
21292306,79e73178-d51c-4061-acfb-b30b58889130,1606502737,60,1606502904,,0,0,12.21,3224,3504,63,64,,,0,0,0.15,1.05,,,787,154,171,108,,,61.15,47.11,61.53,1,61.1,,,,3.7,0.3,100,99,,,,,,102,82,13.68,13.72,13.78,5.4,4.7,342,342,,1,347,347,,,,,,,,,"0,1,2,5,25,61,7,0,0","0,5,78,16,0","0,0,10,82,7",,,,,139,,,,,,,,,,,,,,,16,,,,,,,,,,,,,,,,,,,,,56.4,3,9,127,84,,1020,0,287,1,2,3,"Porz am Rhein",1,0,I1.000|4:59-I1.000|4:27-I1.000|4:15-I1.000|4:14-I1.000|4:13-I1.000|4:22-I1.000|4:23-I1.000|4:24-I1.000|4:06-I1.000|4:32-I1.000|4:18-I1.000|4:34-I0.205|0:57,,,,,3113,,250,0,,0,168070,250480,30378,,9129654,,,,,,,,,,,,,,,,,,,,,,,,,,,,,,,,,,,,,,,,,
21320173,56ab0119-7b5a-4ed8-a3b1-62fa4b960dda,1606581230,60,1606581920,,0,0,13.63,3901,4089,61,77,,,0,0,0.15,1.13,0.96,,826,145,160,,,,60.19,43.26,60.44,1,60.64,,,,3.2,0,100,99,,,,,,100,81,12.58,12.6,12.68,-1,-3.1,311,311,,1,315,315,,,,,,,,,"0,0,0,12,82,6,0,0,0","0,17,83,0,0","0,0,35,63,2",,,,,129,,,,,,,,,,,,,,,19,,,,,,,,,,,,,,,,,,,,,33,6,5,108,76,,1021,0,268,1,3,3,"Porz am Rhein",1,0,I1.000|4:59-I1.000|4:36-I1.000|4:40-I1.000|4:41-I1.000|4:44-I1.000|4:48-I1.000|4:43-I1.000|4:45-I1.000|4:45-I1.000|4:45-I1.000|4:56-I1.000|4:51-I1.000|4:44-I0.632|3:05,,,,,3113,,250,0,,0,168070,250480,30378,,9152118,,,,,,,,,,,,,,,,,,,,,,,,,,,,,,,,,,,,,,,,,
21362152,7b8d3426-92ab-45f0-a93b-e9e25e3186bf,1606674348,60,1606674891,,0,0,13.65,3895,3962,36,46,,,0,0,0.06,,0.95,,1015,168,191,,,,48.78,43.42,48.9,1,60.22,,,,5,3.8,94,95,,,,,,170,81,12.62,12.64,12.66,-7.4,-9.7,312,312,,1,314,314,,,,,,,,,"0,0,0,15,73,12,0,0,0","0,3,19,63,15","0,0,29,71,0",,,,,130,,,,,,,,,,,,,,,19,,,,,,,,,,,,,,,,,,,,,108.5,-1,5,111,80,,1027,0,271,1,2,3,"Porz am Rhein",1,0,I1.000|5:02-I1.000|4:46-I1.000|4:45-I1.000|4:46-I1.000|4:52-I1.000|4:58-I1.000|4:52-I1.000|4:50-I1.000|4:44-I1.000|4:39-I1.000|4:32-I1.000|4:36-I1.000|4:35-I0.649|3:00,,,,,3113,,250,0,,0,168070,250480,30378,,9188000,,,,,,,,,,,,,,,,,,,,,,,,,,,,,,,,,,,,,,,,,
21412357,af23af52-66be-4506-bd26-77474b551fa4,1606837729,60,1606838288,,0,0,13.64,3836,3911,30,46,,,0,0,0.07,,0.94,,887,156,182,,,,55.53,44.15,55.6,1,59.64,,,,3.9,2.2,97,99,,,,,,108,81,12.79,12.83,12.82,-2.6,-4.1,317,317,,1,318,318,,,,,,,,,"0,0,1,9,78,12,0,0,0","0,6,59,34,0","0,0,18,82,0",,,,,132,,,,,,,,,,,,,,,18,,,,,,,,,,,,,,,,,,,,,65,6,7,87,100,,1015,0,328,0,6,3,"Porz am Rhein",1,0,I1.000|4:55-I1.000|4:38-I1.000|4:39-I1.000|4:43-I1.000|4:39-I1.000|4:41-I1.000|4:37-I1.000|4:42-I1.000|4:37-I1.000|4:34-I1.000|4:40-I1.000|4:52-I1.000|4:41-I0.642|3:00,,,,,3113,,250,0,,0,168070,250480,30378,,9229068,,,,,,,,,,,,,,,,,,,,,,,,,,,,,,,,,,,,,,,,,
21458355,914a9e5b-92e1-42b0-a8d6-5f26bf62cfbd,1606932124,60,1606931373,,0,0,9.28,2520,2539,23,48,,,0,0,0.11,1.03,0.94,,579,148,161,111,,,62.46,44.73,62.45,1,60,,,,3.2,0,104,100,,,,,,57,82,13.2,13.29,13.23,1.3,0.1,329,329,,1,331,331,,,,,,,,,"0,0,0,4,46,49,0,0,0","1,6,93,0,0","0,0,10,90,0",,,,,135,,,,,,,,,,,,,,,14,,,,,,,,,,,,,,,,,,,,,40.9,3,6,144,86,,1014,0,330,1,4,3,"Porz am Rhein",1,0,I1.000|4:50-I1.000|4:36-I1.000|4:28-I1.000|4:26-I1.000|4:31-I1.000|4:28-I1.000|4:28-I1.000|4:25-I1.000|4:30-I0.283|1:17,,,,,3113,,250,0,,0,168070,250480,30378,,9268860,,,,,,,,,,,,,,,,,,,,,,,,,,,,,,,,,,,,,,,,,
21492644,97b80a27-93d7-4906-847f-545b2ce57c83,1607011571,60,1607012425,,0,0,15.04,3973,4284,52,73,,,0,0,0.11,,0.95,,934,158,175,,,,58.88,47.84,59.03,1,59.54,,,,4,0,97,99,,,,,,115,82,13.61,13.65,13.67,-1.9,-0.9,343,343,,1,346,346,,,,,,,,,"0,0,0,3,25,71,1,0,0","0,4,51,45,0","0,0,6,91,2",,,,,138,,,,,,,,,,,,,,,16,,,,,,,,,,,,,,,,,,,,,66.9,4,20,157,84,,996,0,320,1,4,3,"Porz am Rhein",1,0,I1.000|4:33-I1.000|4:21-I1.000|4:20-I1.000|4:17-I1.000|4:14-I1.000|4:16-I1.000|4:23-I1.000|4:22-I1.000|4:34-I1.000|4:22-I1.000|4:25-I1.000|4:30-I1.000|4:34-I1.000|4:24-I1.000|4:26-I0.037|0:11,,,,,3113,,250,0,,0,168070,250480,30378,,9296739,,,,,,,,,,,,,,,,,,,,,,,,,,,,,,,,,,,,,,,,,
21533507,925f9a24-b38f-4b89-8ec6-7af669dd741c,1607107259,60,1607106981,,0,0,9.28,2591,2657,67,68,,,0,0,0.2,1.14,0.93,416,598,150,166,111,,,59.24,43.3,59.76,1,59.53,,,,3.3,0,101,100,,,,,,61,81,12.99,12.94,13.23,-4.3,-11.8,324,324,,1,333,333,,,,,,,,,"0,0,0,8,66,25,0,0,0","1,5,92,2,0","0,0,23,74,4",,,,,133,,,,,,,,,,,,,,,17,,,,,,,,,,,,,,,,,,,,,42,6,12,144,82,,990,0,326,1,4,3,"Porz am Rhein",1,0,I1.000|5:02-I1.000|4:36-I1.000|4:39-I1.000|4:37-I1.000|4:37-I1.000|4:36-I1.000|4:34-I1.000|4:41-I1.000|4:30-I0.284|1:20,,,,,3113,,250,0,,0,168070,250480,30378,,9329304,,,,,,,,,,,,,,,,,,,,,,,,,,,,,,,,,,,,,,,,5,
21563970,83cf3e21-8198-4042-aa63-61b190df8dc8,1607185158,60,1607185539,,0,0,14.01,3847,3861,63,85,,,0,0,0.19,1.09,0.91,,889,151,165,,,,59.91,45.49,60.13,1,59.53,,,,3.7,0.2,100,100,,,,,,94,82,13.09,13.14,13.21,2.3,3,326,326,,1,331,331,,,,,,,,,"1,0,1,3,65,30,0,0,0","1,9,88,2,0","0,0,17,78,5",,,,,133,,,,,,,,,,,,,,,19,,,,,,,,,,,,,,,,,,,,,46,4,12,145,77,,1000,0,356,1,3,3,"Porz am Rhein",1,0,I1.000|4:55-I1.000|4:40-I1.000|4:35-I1.000|4:28-I1.000|4:28-I1.000|4:31-I1.000|4:33-I1.000|4:35-I1.000|4:26-I1.000|4:26-I1.000|4:35-I1.000|4:31-I1.000|4:38-I1.000|4:42-I0.006|0:03,,,,,3113,,250,0,,0,168070,250480,30378,,9356635,,,,,,,,,,,,,,,,,,,,,,,,,,,,,,,,,,,,,,,,,
21590646,7d78868e-f206-44f6-9dbf-ad55ca736c6d,1607256025,60,1607260088,,0,0,25.02,6516,6840,81,73,,,0,0,0.07,,,,1503,157,168,,,,60.49,50.64,60.75,1,59.69,,,,4.6,0.2,103,100,,,,,,200,83,13.87,13.84,13.91,0.5,0.5,350,350,,1,353,353,,,,,,,,,"0,0,0,1,13,83,2,0,0","0,3,70,27,0","0,0,5,93,2",,,,,139,,,,,,,,,,,,,,,18,,,,,,,,,,,,,,,,,,,,,57.8,3,7,294,95,,1000,0,360,0,4,3,"Porz am Rhein",1,0,I1.000|4:36-I1.000|4:17-I1.000|4:16-I1.000|4:15-I1.000|4:16-I1.000|4:12-I1.000|4:17-I1.000|4:19-I1.000|4:16-I1.000|4:20-I1.000|4:19-I1.000|4:19-I1.000|4:20-I1.000|4:22-I1.000|4:23-I1.000|4:14-I1.000|4:18-I1.000|4:23-I1.000|4:21-I1.000|4:22-I1.000|4:28-I1.000|4:24-I1.000|4:26-I1.000|4:21-I1.000|4:25-I0.019|0:05,,,,,3113,,250,0,,0,168070,250480,30378,,9379543,,,,,,,,,,,,,,,,,,,,,,,,,,,,,,,,,,,,,,,,,
21590652,8c61873d-114b-4eb1-841e-adc116aedff2,1607262922,60,1607260098,,0,0,1.35,456,458,0,16,,,0,0,0,,0.96,,99,139,146,,,,51.88,29.84,51.12,1,59.52,,,,1.5,0,94,99,,,,,,8,83,10.32,10.72,10.36,-0.2,-2.7,238,238,,1,241,241,,,,,,,,,"3,13,50,32,2,0,0,0,0","0,63,37,0,0","0,2,98,0,0",,,,,107,,,,,,,,,,,,,,,25,,,,,,,,,,,,,,,,,,,,,16,5,9,307,93,,1000,0,356,0,4,3,"Porz am Rhein",1,0,I1.000|5:38-I0.354|1:58,,,,,3113,,250,0,,0,168070,250480,30378,,9379548,,,,,,,,,,,,,,,,,,,,,,,,,,,,,,,,,,,,,,,,,
21650373,c6cc01f4-48ba-4fe8-8dfa-9e66502747c4,1607367953,60,1607367600,,0,0,9.52,2510,2651,57,70,,,0,0,0.17,1.15,0.96,,597,153,166,112,,,61.83,46.39,62.19,1,59.74,,,,3.4,0.3,101,100,,,,,,78,81,13.67,13.69,13.79,0.7,0.8,344,344,,1,350,350,,,,,,,,,"0,0,0,4,26,68,3,0,0","1,6,82,11,0","0,0,8,83,8",,,,,140,,,,,,,,,,,,,,,19,,,,,,,,,,,,,,,,,,,,,50.8,3,10,150,86,,1002,0,274,1,4,3,"Porz am Rhein",1,0,I1.000|4:50-I1.000|4:25-I1.000|4:18-I1.000|4:20-I1.000|4:27-I1.000|4:25-I1.000|4:12-I1.000|4:18-I1.000|4:19-I0.522|2:15,,,,,3113,,250,0,,0,168070,250480,30378,,9428409,,,,,,,,,,,,,,,,,,,,,,,,,,,,,,,,,,,,,,,,,
21678790,8957ee8d-6b90-4041-b720-a9cad50d3b31,1607444105,60,1607445302,,0,0,17.24,4513,4564,79,108,,,0,0,0.15,,0.94,648,1063,155,193,,,,61.23,48.87,61.45,1,60.03,,,,4,2.4,103,97,,,,,,148,81,13.78,13.78,13.96,6.4,9,347,347,,1,354,354,,,,,,,,,"0,0,0,0,15,84,0,0,0","1,3,76,19,1","0,0,5,92,3",,,,,141,,,,,,,,,,,,,,,13,,,,,,,,,,,,,,,,,,,,,80.5,3,2,103,88,,1005,0,297,1,4,3,"Porz am Rhein",1,0,I1.000|4:27-I1.000|4:17-I1.000|4:15-I1.000|4:16-I1.000|4:18-I1.000|4:19-I1.000|4:18-I1.000|4:28-I1.000|4:22-I1.000|4:25-I1.000|4:28-I1.000|4:34-I1.000|4:25-I1.000|4:16-I1.000|4:27-I1.000|4:18-I1.000|4:14-I0.244|1:06,,,,,3113,,250,0,,0,168070,250480,30378,,9453169,,,,,,,,,,,,,,,,,,,,,,,,,,,,,,,,,,,,,,,,5,
21716394,d1b201d4-7cd5-4067-9a6a-494b59059505,1607538972,60,1607540072,,0,0,13,3596,3811,53,91,,,0,0,0.16,1,0.93,,757,144,156,106,,,63.37,44.84,63.46,1,60.4,,,,3.2,0,101,101,,,,,,90,81,12.98,13.06,13.04,-1.9,-3,320,320,,1,324,324,,,,,,,,,"1,0,0,4,70,25,0,0,0","1,13,87,0,0","0,0,19,81,0",,,,,134,,,,,,,,,,,,,,,13,,,,,,,,,,,,,,,,,,,,,31.6,0,5,128,87,,1011,0,299,1,3,3,"Porz am Rhein",1,0,I1.000|4:50-I1.000|4:39-I1.000|4:33-I1.000|4:33-I1.000|4:32-I1.000|4:37-I1.000|4:33-I1.000|4:30-I1.000|4:31-I1.000|4:34-I1.000|4:35-I1.000|4:35-I1.000|4:54-I0.003|0:02,,,,,3113,,250,0,,0,168070,250480,30378,,9485087,,,,,,,,,,,,,,,,,,,,,,,,,,,,,,,,,,,,,,,,,
21741058,2ad07120-0548-4bf5-8113-4bc9a36af0ed,1607621005,60,1607621639,,0,0,13.41,3882,4038,58,81,,,0,0,0.17,1.12,0.94,,840,146,163,,,,58.8,42.64,58.99,1,60.1,1631,,,3.4,0,100,99,,,,,,103,80,12.44,12.47,12.52,-1.1,-2.5,305,305,,1,310,310,,,,,,,,,"0,0,1,20,76,3,0,0,0","1,12,86,1,0","0,1,34,65,0",,,,,130,,,,,,,,,,,,,,,14,,,,,,,,,,,,,,,,,,,,,39.1,1,10,129,87,,1007,0,256,1,4,3,"Porz am Rhein",1,0,I1.000|5:05-I1.000|4:52-I1.000|4:55-I1.000|4:52-I1.000|4:43-I1.000|4:42-I1.000|4:46-I1.000|4:46-I1.000|4:34-I1.000|4:44-I1.000|4:48-I1.000|4:51-I1.000|4:57-I0.406|2:06,,,,,3113,,250,0,,0,168070,250480,30378,,9506793,,,,,,,,,,,,,,,,,,,,,,,,,,,,,,,,,,,,,,,,,
21778899,fe4e82ff-f76a-4a5f-9d8e-c3e73964879f,1607713136,60,1607712781,,0,0,10.28,3034,3093,226,227,,,0,3.3,0.71,1.17,1.05,1078,697,152,169,,,,54.3,40.86,55.77,1,59.39,1822,,,3.4,0.4,97,97,,,,,,92,81,12.62,12.3,13.94,-2.1,13.9,313,313,,1,361,361,,,,,,,,,"1,1,6,38,40,13,1,0,0","0,9,71,21,0","0,2,50,39,9",,,,,125,,,,,,,,,,,,,,,20,,,,,,,,,,,,,,,,,,,,,48,2,17,156,91,,994,0,272,1,4,3,Balve,1,0,I1.000|4:57-I1.000|5:06-I1.000|4:56-I1.000|4:47-I1.000|5:14-I1.000|4:42-I1.000|5:10-I1.000|5:05-I1.000|5:00-I1.000|4:23-I0.282|1:15,,,,,3113,,250,0,,0,168070,250480,30378,,9538213,,,,,,,,,,,,,,,,,,,,,,,,,,,,,,,,,,,,,,,,"4,4",
21795320,cd3d15d4-0417-4662-af4b-122fd60f5f7f,1607782400,60,1607783791,,0,0,15.62,4576,4793,461,473,,,0,5.3,0.81,1,1.12,653,967,155,177,,,,53.29,42.56,55.19,1,58.63,2904,,,3.8,1.2,97,96,,,,,,149,82,13.28,12.97,13.96,1.5,7.4,317,317,,1,337,337,,,,,,,,,"12,5,15,20,10,22,16,1,0","0,10,50,40,0","0,2,39,52,7",,,,,125,,,,,,,,,,,,,,,20,,,,,,,,,,,,,,,,,,,,,70.6,6,6,198,91,,1000,0,316,0,4,3,Balve,1,0,I1.000|5:13-I1.000|5:30-I1.000|5:14-I1.000|5:20-I1.000|4:30-I1.000|4:13-I1.000|4:05-I1.000|6:42-I1.000|5:38-I1.000|6:01-I1.000|5:31-I1.000|4:23-I1.000|3:58-I1.000|4:03-I1.000|3:38-I0.620|2:15,,,,,3113,,250,0,,0,168070,250480,30378,,9552151,,,,,,,,,,,,,,,,,,,,,,,,,,,,,,,,,,,,,,,,"3,4,5",
21828085,775caed8-dd7d-4bcf-8374-79deb0b6ef7a,1607862686,60,1607873376,,0,0,1.89,564,564,28,40,,,0,1.3,0.68,1.23,1.04,,131,151,174,,,,54.07,35.66,54.63,1,58.4,5744,,,2.1,0,98,100,,,,,,16,84,12.15,12.21,12.35,6.2,14.5,292,292,,1,299,299,,,,,,,,,"3,5,22,15,38,10,6,0,0","0,11,77,13,0","0,0,65,30,5",,,,,120,,,,,,,,,,,,,,,23,,,,,,,,,,,,,,,,,,,,,33,6,18,212,88,,1012,1,272,0,3,3,Aachen,1,0,I1.000|5:18-I0.885|4:06,,,,,3113,,250,0,,0,168070,250480,30378,,9579087,,,,,,,,,,,,,,,,,,,,,,,,,,,,,,,,,,,,,,,,,
21828087,9257b3c0-fd88-40bd-8345-d2295f879cd9,1607857868,60,1607873380,,0,0,18.14,4358,4377,215,293,,,0,2.1,0.55,1.06,0.97,384,1131,167,193,,,,60.88,54.18,61.45,1,58.43,5760,,,5,4.1,103,96,,,,,,189,84,15.11,15.1,15.24,5.7,5.4,384,384,,1,390,390,,,,,,,,,"0,0,0,2,7,33,53,4,0","0,2,19,69,9","0,0,3,58,39",,,,,149,,,,,,,,,,,,,,,19,,,,,,,,,,,,,,,,,,,,,105.6,6,18,220,92,,1012,1,274,0,2,3,Breinigerberg,1,0,I1.000|4:23-I1.000|4:39-I1.000|3:57-I1.000|3:48-I1.000|3:52-I1.000|3:52-I1.000|4:09-I1.000|3:51-I1.000|3:49-I1.000|3:56-I1.000|3:50-I1.000|4:08-I1.000|4:01-I1.000|3:51-I1.000|4:22-I1.000|3:54-I1.000|3:57-I1.000|3:43-I0.140|0:36,,,,,3113,,250,0,,0,168070,250480,30378,,9579089,,,,,,,,,,,,,,,,,,,,,,,,,,,,,,,,,,,,,,,,"5,5,5",
21898415,d7b458a0-8da7-41b7-8311-1e35201ff14c,1608042341,60,1608050452,,0,0,22.26,6727,6913,566,593,,,0,5.1,0.78,1.03,1.12,600,1296,151,171,113,,,53.23,42.22,54.83,1,58.2,3019,,,4,0,100,97,,,,,,204,81,12.7,12.56,12.93,-0.4,4,303,303,,1,312,312,,,,,,,,,"14,7,13,19,14,22,11,0,0","0,9,76,14,0","0,3,42,55,0",,,,,123,,,,,,,,,,,,,,,19,,,,,,,,,,,,,,,,,,,,,57.3,9,12,193,100,,1011,0,252,0,6,3,Balve,1,0,I1.000|4:50-I1.000|5:29-I1.000|5:35-I1.000|5:17-I1.000|5:45-I1.000|4:37-I1.000|4:16-I1.000|4:03-I1.000|6:04-I1.000|6:48-I1.000|4:38-I1.000|4:20-I1.000|5:12-I1.000|5:04-I1.000|4:34-I1.000|5:24-I1.000|6:38-I1.000|6:12-I1.000|4:25-I1.000|3:53-I1.000|3:59-I1.000|3:56-I0.263|1:07,,,,,3113,,250,0,,0,168070,250480,30378,,9641832,,,,,,,,,,,,,,,,,,,,,,,,,,,,,,,,,,,,,,,,"3,4,4,5",
21931912,c2f33ac2-49bd-4f1a-9d84-48dbbcc7a06c,1608129966,60,1608132203,,0,0,17.09,5262,5773,452,387,,,0,4.6,0.72,1.01,1.03,583,933,145,169,,,,55,40.46,57.06,1,58.11,2502,,,3.5,0.4,102,99,,,,,,139,81,12.5,12.11,12.89,-5.2,2.3,300,300,,1,316,316,,,,,,,,,"13,11,14,19,19,18,5,0,0","1,36,54,9,0","0,3,48,44,6",,,,,120,,,,,,,,,,,,,,,14,,,,,,,,,,,,,,,,,,,,,52.1,9,12,160,96,,1016,0,258,0,3,3,Balve,1,0,I1.000|4:59-I1.000|5:30-I1.000|5:35-I1.000|5:28-I1.000|5:40-I1.000|5:52-I1.000|4:39-I1.000|5:29-I1.000|5:01-I1.000|4:43-I1.000|6:17-I1.000|6:16-I1.000|4:57-I1.000|4:31-I1.000|4:14-I1.000|4:07-I1.000|4:02-I0.091|0:22,,,,,3113,,250,0,,0,168070,250480,30378,,9672375,,,,,,,,,,,,,,,,,,,,,,,,,,,,,,,,,,,,,,,,"3,5",
21960408,9728db9c-750f-41f5-9e9f-042d5d284163,1608216643,60,1608217925,,0,0,13.12,4100,4390,481,463,,,0,5.7,0.72,1.08,1.08,789,861,152,170,116,,,50.6,38.93,52.99,1,58.01,2221,,,3.7,0.5,98,99,,,,,,125,81,12.86,12.19,13.98,-7.5,5.2,301,301,,1,334,334,,,,,,,,,"22,5,8,20,19,16,9,0,0","0,17,62,21,0","0,8,46,35,11",,,,,119,,,,,,,,,,,,,,,22,,,,,,,,,,,,,,,,,,,,,56.8,8,14,231,89,,1020,0,277,0,3,3,Balve,1,0,I1.000|5:07-I1.000|5:16-I1.000|5:10-I1.000|7:27-I1.000|6:24-I1.000|5:31-I1.000|4:01-I1.000|4:59-I1.000|4:55-I1.000|4:32-I1.000|5:03-I1.000|5:36-I1.000|3:53-I0.116|0:26,,,,,3113,,250,0,,0,168070,250480,30378,,9696393,,,,,,,,,,,,,,,,,,,,,,,,,,,,,,,,,,,,,,,,"3,4,4,5",
21987834,988d6a75-875d-406b-b243-8e619d0099de,1608304268,60,1608303998,,0,0,10.63,3192,3254,240,246,,,0,3.4,0.73,1,1.03,478,657,147,163,,,,55.68,40.14,57.2,1,58.51,1454,,,3.2,0.1,104,101,,,,,,86,80,12.68,12.61,13.09,-14.9,-9.4,304,304,,1,324,324,,,,,,,,,"16,3,4,16,22,36,3,0,0","0,19,78,3,0","0,4,43,45,8",,,,,125,,,,,,,,,,,,,,,19,,,,,,,,,,,,,,,,,,,,,46.8,7,13,177,82,,1021,0,266,0,2,3,Balve,1,0,I1.000|4:59-I1.000|4:51-I1.000|5:10-I1.000|6:34-I1.000|7:13-I1.000|4:33-I1.000|4:12-I1.000|4:13-I1.000|4:25-I1.000|4:11-I0.629|2:51,,,,,3113,,250,0,,0,168070,250480,30378,,9718771,,,,,,,,,,,,,,,,,,,,,,,,,,,,,,,,,,,,,,,,"4,5",
22014580,0bad73f6-9244-4c77-8e57-211b1daea8a9,1608392660,60,1608390063,,0,0,3.14,920,953,40,53,,,0,1.3,0.55,1.1,0.96,400,220,156,172,,,,52.79,38.18,53.35,1,58.14,4320,,,2.7,0,101,100,,,,,,30,83,12.46,12.48,12.64,12.1,19,303,303,,1,309,309,,,,,,,,,"6,1,7,24,41,17,4,0,0","0,6,58,36,0","0,0,53,46,0",,,,,123,,,,,,,,,,,,,,,22,,,,,,,,,,,,,,,,,,,,,48.5,10,21,184,78,,1015,0,262,0,3,3,Balve,1,0,I1.000|4:50-I1.000|5:13-I1.000|4:35-I0.143|0:41,,,,,3113,,250,0,,0,168070,250480,30378,,9742789,,,,,,,,,,,,,,,,,,,,,,,,,,,,,,,,,,,,,,,,5,
22014582,06079510-56d3-4b6d-9b88-aa1c4a8a0b2f,1608382040,60,1608390066,,0,0,26.89,8310,9187,734,718,,,0,5.4,0.74,1.06,1.1,461,1551,152,179,,,,51.3,41.7,53.07,1,58.14,3675,,,4.6,2,100,97,,,,,,258,83,12.49,12.05,12.88,2.4,5.8,298,298,,1,315,315,,,,,,,,,"11,11,13,19,27,17,3,0,0","0,16,54,29,0","0,6,48,39,7",,,,,117,,,,,,,,,,,,,,,18,,,,,,,,,,,,,,,,,,,,,80.9,11,23,187,76,,1015,0,264,0,2,3,Balve,1,0,I1.000|4:52-I1.000|5:00-I1.000|5:10-I1.000|5:02-I1.000|5:35-I1.000|4:36-I1.000|4:52-I1.000|5:25-I1.000|5:32-I1.000|4:59-I1.000|4:43-I1.000|5:14-I1.000|4:37-I1.000|5:09-I1.000|5:52-I1.000|4:50-I1.000|4:33-I1.000|4:20-I1.000|5:53-I1.000|6:44-I1.000|6:37-I1.000|6:22-I1.000|4:23-I1.000|4:16-I1.000|4:30-I1.000|4:58-I0.890|4:26,,,,,3113,,250,0,,0,168070,250480,30378,,9742790,,,,,,,,,,,,,,,,,,,,,,,,,,,,,,,,,,,,,,,,"3,4,4,5",
22038609,e76b7548-f8ef-43ad-b4f8-782dacef4df0,1608461736,60,1608459720,,0,0,4.8,1443,1523,83,87,,,0,2.2,0.5,1.23,0.96,639,299,141,157,,,,58.8,38.12,60,1,58.16,3089,,,2.5,0,100,100,,,,,,32,80,12.16,12.19,13.45,-20.5,-54.8,301,301,,1,344,344,,,,,,,,,"3,2,15,38,22,19,1,0,0","1,45,55,0,0","0,2,65,25,8",,,,,125,,,,,,,,,,,,,,,20,,,,,,,,,,,,,,,,,,,,,29.5,9,14,192,86,,1018,0,300,0,4,3,Balve,1,0,I1.000|5:28-I1.000|5:10-I1.000|5:10-I1.000|4:27-I0.804|3:48,,,,,3113,,250,0,,0,168070,250480,30378,,9761677,,,,,,,,,,,,,,,,,,,,,,,,,,,,,,,,,,,,,,,,4,
22082912,49c8dd23-6bda-4645-98c6-69c883f2f459,1608561826,60,1608563420,,0,0,16.19,4620,4863,441,434,,,0,4.7,0.79,1.05,1.09,669,955,151,168,,,,57.13,44,59.09,1,58.25,2592,,,3.7,0.4,101,100,,,,,,140,82,13.52,13.07,13.81,-6.2,0.7,327,327,,1,338,338,,,,,,,,,"6,7,13,15,20,22,16,0,0","0,9,80,10,0","0,1,32,58,9",,,,,128,,,,,,,,,,,,,,,14,,,,,,,,,,,,,,,,,,,,,54.4,7,20,177,80,,1016,0,268,0,6,3,Balve,1,0,I1.000|4:55-I1.000|5:22-I1.000|5:15-I1.000|4:58-I1.000|5:29-I1.000|5:44-I1.000|4:20-I1.000|4:57-I1.000|4:27-I1.000|4:18-I1.000|5:57-I1.000|4:54-I1.000|4:06-I1.000|3:57-I1.000|3:55-I1.000|3:41-I0.187|0:45,,,,,3113,,250,0,,0,168070,250480,30378,,9801091,,,,,,,,,,,,,,,,,,,,,,,,,,,,,,,,,,,,,,,,"3,4",
22110438,48da5082-73f5-4d20-a487-bf382a019ce4,1608633095,60,1608643508,,0,0,16.92,13723,13723,470,469,,,0,4.7,0.77,,,248,1206,97,135,,,,,,,1,58.25,1313,,,2.1,0,,96,,,,,,55,57,,4.76,,-20.6,,,,,,,,,,,,,,,,"65,35,0,0,0,0","56,44,0,0,0",,,,,,,,,,,,,,,,,,,,,15,,,,,,,,,,,,,,,,,,,,,7.6,12,24,254,95,,1013,1,254,0,6,3,Balve,1,0,,,,,,3113,,250,0,,0,168075,,30378,,9825240,,,,,,,,,,,,,,,,,,,,,,,,,,,,,,,,,,,,,,,,"3,4,4",
22113631,3e31531e-0166-4b27-9937-dd0a98f3b188,1608649581,60,1608649945,,0,0,12.57,3848,3918,345,360,,,0,3.9,0.84,1.1,1.2,458,764,147,164,,,,54.38,39.75,56.14,1,58.23,2605,,,3.4,0,102,98,,,,,,88,82,12.62,12.22,13.03,-4.7,12.9,300,300,,1,319,319,,,,,,,,,"11,10,14,23,15,21,5,0,0","1,23,72,4,0","0,5,49,37,8",,,,,120,,,,,,,,,,,,,,,16,,,,,,,,,,,,,,,,,,,,,41.1,11,16,258,91,,1014,0,258,0,6,3,Balve,1,0,I1.000|5:06-I1.000|5:38-I1.000|5:33-I1.000|5:22-I1.000|5:50-I1.000|6:22-I1.000|5:18-I1.000|5:05-I1.000|5:07-I1.000|4:06-I1.000|4:12-I1.000|4:04-I0.574|2:23,,,,,3113,,250,0,,0,168070,250480,30378,,9827710,,,,,,,,,,,,,,,,,,,,,,,,,,,,,,,,,,,,,,,,3,
22150482,16588285-2b86-4441-9f1f-98a2c8345720,1608736179,60,1608736929,,0,0,12.91,3993,4256,380,391,,,0,5,0.88,1.11,1.23,686,779,145,162,,,,54.7,39.35,56.63,1,58.4,1872,,,3.4,0.1,101,100,,,,,,106,81,12.66,12.62,13.11,-12.1,3.2,298,298,,1,313,313,,,,,,,,,"24,10,10,12,11,11,22,0,0","0,27,71,2,0","0,7,40,49,3",,,,,120,,,,,,,,,,,,,,,18,,,,,,,,,,,,,,,,,,,,,44.9,11,15,219,91,,1007,0,274,0,6,3,Balve,1,0,I1.000|5:40-I1.000|4:51-I1.000|6:14-I1.000|6:44-I1.000|7:37-I1.000|5:54-I1.000|5:07-I1.000|5:02-I1.000|4:08-I1.000|3:53-I1.000|3:56-I1.000|3:46-I0.912|3:40,,,,,3113,,250,0,,0,168070,250480,30378,,9857372,,,,,,,,,,,,,,,,,,,,,,,,,,,,,,,,,,,,,,,,"2,5",
22171592,60c57729-99d4-42fc-a912-a13ddeb5cee8,1608807483,60,1608810366,,0,0,18.17,5615,6424,438,420,,,0,4.1,0.71,1.03,1.05,476,1043,146,174,,,,54.25,40.48,55.93,1,57.99,2119,,,3.6,0.4,103,93,,,,,,153,82,12.36,12.01,12.67,-7.5,-1.3,296,296,,1,312,312,,,,,,,,,"9,14,17,16,23,19,2,0,0","0,35,57,8,0","0,6,50,37,7",,,,,118,,,,,,,,,,,,,,,15,,,,,,,,,,,,,,,,,,,,,49.7,4,15,353,97,,1009,0,315,0,6,3,Balve,1,0,I1.000|4:17-I1.000|5:49-I1.000|6:10-I1.000|5:39-I1.000|5:58-I1.000|5:53-I1.000|4:57-I1.000|5:34-I1.000|4:59-I1.000|4:33-I1.000|6:09-I1.000|5:18-I1.000|4:52-I1.000|4:13-I1.000|4:19-I1.000|4:35-I1.000|5:07-I1.000|4:25-I0.172|0:49,,,,,3113,,250,0,,0,168070,250480,30378,,9875802,,,,,,,,,,,,,,,,,,,,,,,,,,,,,,,,,,,,,,,,"4,4,5",
22200593,2e132a79-f39e-4dd6-a898-9883bf749eca,1608887664,60,1608890114,,0,0,0.49,135,135,8,1,,,0,0.4,0.41,1.07,,,30,146,156,103,,,62.51,33.99,64.88,1,57.99,855,,,0.6,0.1,,100,,,,,,3,82,13.61,12.99,13.77,10.1,13.6,349,349,,1,355,355,,,,,,,,,"0,0,0,4,70,25,0,0,0","0,20,80,0,0","0,0,0,100,0",,,,,133,,,,,,,,,,,,,,,28,,,,,,,,,,,,,,,,,,,,,9.4,1,6,299,100,,1022,0,345,0,3,3,Balve,1,0,,,,,,3113,,250,0,,0,168070,250480,30378,,9902741,,,,,,,,,,,,,,,,,,,,,,,,,,,,,,,,,,,,,,,,,
22200598,074af33b-e3d5-4ba6-a5c3-4284a209ce2c,1608888286,60,1608890121,,0,0,20.19,5376,5390,230,256,,,0,2.2,0.44,1.08,0.98,350,1156,151,166,,,,62.23,48.53,63.01,1,58.66,2592,,,3.9,0,100,103,,,,,,164,83,13.66,13.59,13.88,0.2,3.9,343,343,,1,352,352,,,,,,,,,"0,0,1,9,24,63,3,0,0","0,5,88,6,0","0,0,17,72,11",,,,,136,,,,,,,,,,,,,,,15,,,,,,,,,,,,,,,,,,,,,48.2,1,6,298,100,,1023,0,345,0,3,3,Balve,1,0,I1.000|4:55-I1.000|5:04-I1.000|4:32-I1.000|4:41-I1.000|4:19-I1.000|4:30-I1.000|4:26-I1.000|4:24-I1.000|4:25-I1.000|4:30-I1.000|4:25-I1.000|4:21-I1.000|4:18-I1.000|4:15-I1.000|4:17-I1.000|4:28-I1.000|4:24-I1.000|4:14-I1.000|4:04-I1.000|4:10-I0.187|0:55,,,,,3113,,250,0,,0,168070,250480,30378,,9902744,,,,,,,,,,,,,,,,,,,,,,,,,,,,,,,,,,,,,,,,"5,5,5,5",
22235274,f52584ee-a7d3-4621-9e44-914a99aba0c2,1608975338,60,1608977441,,0,0,15.2,4602,4778,374,396,,,0,4.2,0.81,1.04,1.14,582,879,148,170,,,,54.61,40.87,56.18,1,58.31,2947,,,3.5,0,98,100,,,,,,132,82,12.57,12.34,12.77,-9.1,-1,300,300,,1,310,310,,,,,,,,,"9,16,12,16,14,26,6,0,0","0,29,54,18,0","0,3,42,54,0",,,,,121,,,,,,,,,,,,,,,27,,,,,,,,,,,,,,,,,,,,,55.4,1,15,231,100,,1023,0,309,0,4,3,Balve,1,0,I1.000|6:08-I1.000|6:15-I1.000|6:14-I1.000|5:23-I1.000|4:38-I1.000|4:44-I1.000|5:48-I1.000|5:10-I1.000|5:36-I1.000|4:34-I1.000|4:31-I1.000|4:07-I1.000|4:06-I1.000|4:08-I1.000|4:24-I0.202|0:55,,,,,3113,,250,0,,0,168070,250480,30378,,9934839,,,,,,,,,,,,,,,,,,,,,,,,,,,,,,,,,,,,,,,,"4,4",
22287191,80fc2c4e-e075-40dc-9a4a-dd8e13d9715a,1609067177,60,1609066335,,0,0,8.99,2622,2681,214,248,,,0,3.8,0.72,1.01,1.03,1086,568,148,167,,,,57.19,41.05,58.61,1,58.44,1872,,,3.2,0,104,100,,,,,,74,80,13.13,13.08,13.3,-7.9,5.1,316,316,,1,325,325,,,,,,,,,"15,5,4,13,24,22,16,1,0","0,10,85,4,0","0,0,41,54,5",,,,,129,,,,,,,,,,,,,,,18,,,,,,,,,,,,,,,,,,,,,48.6,3,40,189,78,,990,0,277,0,11,3,Balve,1,0,I1.000|4:55-I1.000|4:55-I1.000|5:08-I1.000|6:29-I1.000|6:03-I1.000|4:09-I1.000|4:04-I1.000|3:52-I0.994|4:07,,,,,3113,,250,0,,0,168070,250480,30378,,9980431,,,,,,,,,,,,,,,,,,,,,,,,,,,,,,,,,,,,,,,,3,
22348041,a831bae7-4e88-4154-9692-691b02644aea,1609177331,60,1609177460,,0,0,12.36,3288,3459,75,71,,,0,0,0.2,1.16,0.94,340,741,151,166,,,,62.31,46.75,62.8,1,59.1,1454,,,3.5,0,102,101,,,,,,100,80,13.61,13.57,13.8,-4.5,-11.2,341,341,,1,349,349,,,,,,,,,"0,0,1,2,21,76,0,0,0","1,5,90,3,0","0,0,8,85,7",,,,,141,,,,,,,,,,,,,,,13,,,,,,,,,,,,,,,,,,,,,47.1,4,10,157,88,,978,0,366,1,6,3,"Porz am Rhein",1,0,I1.000|4:55-I1.000|4:27-I1.000|4:22-I1.000|4:23-I1.000|4:21-I1.000|4:23-I1.000|4:24-I1.000|4:20-I1.000|4:21-I1.000|4:25-I1.000|4:23-I1.000|4:27-I0.361|1:38,,,,,3113,,250,0,,0,168070,250480,30378,,10031030,,,,,,,,,,,,,,,,,,,,,,,,,,,,,,,,,,,,,,,,5,
22401624,2d4c8bc2-0b82-4139-a968-88d1c5941d0c,1609250205,60,1609250801,,0,0,11.07,2982,4045,130,102,,,0,0.9,0.38,1.12,0.91,531,639,147,175,105,,,63.68,45.71,64.8,1,59.37,1338,,,3.2,0.2,103,97,,,,,,84,82,13.59,13.43,13.78,-4.2,-4.4,334,334,,1,342,342,,,,,,,,,"0,1,2,8,32,53,4,0,0","1,17,74,8,0","0,1,25,65,9",,,,,136,,,,,,,,,,,,,,,15,,,,,,,,,,,,,,,,,,,,,47.5,5,27,240,75,,989,,,0,4,1,"Porz am Rhein",1,0,I1.000|4:38-I1.000|4:21-I1.000|4:35-I1.000|4:36-I1.000|4:51-I1.000|4:45-I1.000|4:27-I1.000|4:08-I1.000|4:25-I1.000|4:17-I1.000|4:23-I0.067|0:17,,,,,3113,,250,0,,0,168070,250480,30378,,10066458,,,,,,,,,,,,,,,,,,,,,,,,,,,,,,,,,,,,,,,,5,
22457838,a0fde11e-c86b-43ba-9c21-66d7a72df0d7,1609344009,60,1609342097,,0,0,4.83,1386,1450,20,39,,,0,0.1,0.29,1.12,0.95,,293,139,152,,,,63.45,40.29,63.47,1,59.75,816,,,2.4,0,103,101,,,,,,32,81,12.46,12.61,12.54,0.8,-1.7,304,304,,1,308,308,,,,,,,,,"0,1,2,21,63,13,0,0,0","2,29,69,0,0","0,0,47,53,0",,,,,129,,,,,,,,,,,,,,,16,,,,,,,,,,,,,,,,,,,,,29,5,12,242,81,,1004,0,370,0,6,3,"Porz am Rhein",1,0,I1.000|5:08-I1.000|4:46-I1.000|4:40-I1.000|4:43-I0.829|3:49,,,,,3113,,250,0,,0,168070,250480,30378,,10111117,,,,,,,,,,,,,,,,,,,,,,,,,,,,,,,,,,,,,,,,,
22505202,90c9a5a4-5f0b-41e9-9de3-8a01b94c4eb1,1609417830,60,1609419824,,0,0,4.17,1177,1257,24,31,,,0,0,0.19,1.09,0.93,,257,142,164,,,,62.97,40.71,63.29,1,60.25,816,,,2.4,0,100,102,,,,,,29,81,12.78,12.79,12.84,2.8,4,314,314,,1,317,317,,,,,,,,,"0,0,0,18,61,21,0,0,0","1,27,70,1,0","0,0,25,75,0",,,,,131,,,,,,,,,,,,,,,15,,,,,,,,,,,,,,,,,,,,,30.3,0,13,149,100,,1002,1,318,0,7,3,"Porz am Rhein",1,0,I1.000|5:02-I1.000|4:36-I1.000|4:31-I1.000|4:40-I0.169|0:48,,,,,3113,,250,0,,0,168070,250480,30378,,10148905,,,,,,,,,,,,,,,,,,,,,,,,,,,,,,,,,,,,,,,,,
22505250,a3648bac-2c3f-4445-83df-bd63f8abb736,1609419386,60,1609419858,,0,0,7.58,1713,1713,28,59,,,0,0,0.24,1.11,0.94,,459,169,182,,,,64.45,54.81,64.42,1,59.84,2548,,,3.7,1.7,103,100,,,,,,77,86,15.8,15.96,15.89,8.4,12,409,409,,1,414,414,,,,,,,,,"0,0,0,0,0,2,95,2,0","0,3,3,92,1","0,0,0,44,56",,,,,154,,,,,,,,,,,,,,,18,,,,,,,,,,,,,,,,,,,,,91.2,0,13,149,100,,1002,1,318,0,7,3,"Porz am Rhein",1,0,I1.000|3:44-I1.000|3:44-I1.000|3:42-I1.000|3:47-I1.000|3:46-I1.000|3:48-I1.000|3:48-I0.583|2:14,,,,,3113,,250,0,,0,168070,250480,30378,,10148926,,,,,,,,,,,,,,,,,,,,,,,,,,,,,,,,,,,,,,,,,
22506043,977342b0-4a66-41bc-9ff5-07083271a3b7,1609421410,60,1609420496,,0,0,6.32,1910,2008,25,20,,,0,0,0.1,,,,394,139,158,,,,59.52,38.5,59.86,1,60.35,3456,,,2.5,0,100,101,,,,,,43,81,11.96,11.97,12.05,-1.7,-4.6,293,293,,1,296,296,,,,,,,,,"1,2,6,45,45,1,0,0,0","1,62,37,0,0","0,1,66,33,0",,,,,123,,,,,,,,,,,,,,,18,,,,,,,,,,,,,,,,,,,,,27.8,3,12,141,94,,1002,0,317,0,6,3,"Porz am Rhein",1,0,I1.000|5:13-I1.000|4:59-I1.000|4:58-I1.000|4:48-I1.000|4:51-I1.000|5:14-I0.321|1:47,,,,,3113,,250,0,,0,168070,250480,30378,,10149323,,,,,,,,,,,,,,,,,,,,,,,,,,,,,,,,,,,,,,,,,
22562502,c8b42546-dfff-4a18-a24f-05d3f4b98168,1609510418,60,1609511883,,0,0,17.16,4569,4860,153,122,,,0,0.6,0.22,1.1,0.92,466,1021,152,165,,,,61.66,47.9,62.48,1,60.35,3172,,,3.9,0,100,97,,,,,,141,82,13.72,13.58,13.9,-3.5,-2.7,344,344,,1,352,352,,,,,,,,,"1,0,0,5,32,57,5,0,0","0,5,91,4,0","0,0,16,75,9",,,,,137,,,,,,,,,,,,,,,16,,,,,,,,,,,,,,,,,,,,,52,2,4,217,90,,1010,0,349,0,3,3,"Porz am Rhein",1,0,I1.000|4:26-I1.000|4:24-I1.000|4:28-I1.000|4:33-I1.000|4:25-I1.000|4:29-I1.000|4:26-I1.000|4:39-I1.000|4:27-I1.000|4:21-I1.000|4:19-I1.000|4:18-I1.000|4:36-I1.000|4:28-I1.000|4:12-I1.000|4:20-I1.000|4:33-I0.161|0:45,,,,,3113,,250,0,,0,168070,250480,30378,,10195123,,,,,,,,,,,,,,,,,,,,,,,,,,,,,,,,,,,,,,,,"5,5",
22608026,b96dedca-6bc1-4235-895b-c70a72acd996,1609587926,60,1609590943,,0,0,8.58,6463,6463,60,72,,,0,0,0.21,,,,564,98,152,,,,,,,1,60.34,1549,,,1.3,0.1,,100,,,,,,51,56,,8.44,,-12.3,,,,,,,,,,,,,,,,"79,10,6,5,0,0","69,29,2,0,0",,,,,,,,,,,,,,,,,,,,,20,,,,,,,,,,,,,,,,,,,,,15.2,3,3,217,91,,1014,1,323,0,3,3,Eil,1,0,,,,,,3113,,250,0,,0,168075,,30378,,10230510,,,,,,,,,,,,,,,,,,,,,,,,,,,,,,,,,,,,,,,,,
22620914,f4259829-cf93-4d14-b28e-17833b3b0e96,1609602218,60,1609601838,,0,0,11.01,3127,3174,52,56,,,0,0,0.11,1.06,0.89,1088,709,149,163,,,,58.55,42.95,58.86,1,60.22,2959,,,3.3,0,100,99,,,,,,89,81,12.75,12.77,12.87,-1.1,0.7,316,316,,1,321,321,,,,,,,,,"1,1,2,13,60,22,1,0,0","1,5,93,1,0","0,1,30,67,2",,,,,130,,,,,,,,,,,,,,,14,,,,,,,,,,,,,,,,,,,,,39.2,3,3,66,92,,1014,0,322,0,2,3,"Porz am Rhein",1,0,I1.000|4:36-I1.000|4:48-I1.000|4:34-I1.000|4:39-I1.000|5:04-I1.000|4:57-I1.000|5:13-I1.000|4:39-I1.000|4:26-I1.000|4:31-I1.000|4:37-I0.010|0:03,,,,,3113,,250,0,,0,168070,250480,30378,,10239665,,,,,,,,,,,,,,,,,,,,,,,,,,,,,,,,,,,,,,,,5,
22696725,2c62a93a-7e9d-4092-a98a-a62c728c60e4,1609683962,60,1609686370,,0,0,19.24,5168,5780,84,120,,,0,0,0.09,1,0.88,,1023,149,166,,,,62.72,47.86,62.92,1,61.12,4320,,,3.7,0,105,92,,,,,,145,82,13.41,13.94,14.06,5.3,14.1,337,337,,1,364,364,,,,,,,,,"6,2,4,9,33,25,14,7,1","0,17,76,7,0","1,5,22,51,21",,,,,136,,,,,,,,,,,,,,,23,,,,,,,,,,,,,,,,,,,,,53.6,3,14,24,89,,1014,0,313,0,4,3,Niederkassel,1,0,I1.000|3:50-I1.000|3:27-I1.000|5:35-I1.000|3:55-I1.000|4:15-I1.000|4:14-I1.000|3:50-I1.000|4:06-I0.945|4:58-I1.000|3:52-I1.000|4:36-I1.000|5:11-I1.000|4:43-I1.000|4:30-I1.000|4:39-I1.000|4:36-I1.000|4:42-I1.000|4:42-I1.000|4:53-I0.298|1:34,,,,,3113,,250,0,,0,168070,250480,30378,,10294014,,,,,,,,,,,,,,,,,,,,,,,,,,,,,,,,,,,,,,,,,
22749009,09487142-75ac-463c-bbec-b6aa9d70787d,1609781116,60,1609781854,,0,0,14.6,3910,4144,141,133,,,0,0.9,0.29,1.17,0.93,500,876,147,159,,,,64.14,46.98,64.95,1,61.32,2736,,,3.4,0,104,100,,,,,,107,82,13.59,13.48,13.9,-0.7,-5.9,341,341,,1,352,352,,,,,,,,,"0,0,0,4,28,67,0,0,0","0,10,90,0,0","0,0,16,75,9",,,,,137,,,,,,,,,,,,,,,16,,,,,,,,,,,,,,,,,,,,,38.4,2,9,40,88,,1015,0,309,1,4,3,"Porz am Rhein",1,0,I1.000|4:55-I1.000|4:27-I1.000|4:26-I1.000|4:25-I1.000|4:16-I1.000|4:19-I1.000|4:22-I1.000|4:27-I1.000|4:22-I1.000|4:28-I1.000|4:28-I1.000|4:27-I1.000|4:34-I1.000|4:27-I0.599|2:46,,,,,3113,,250,0,,0,168070,250480,30378,,10336249,,,,,,,,,,,,,,,,,,,,,,,,,,,,,,,,,,,,,,,,"5,5",
22808534,1c0521ed-9bf1-4df1-9107-f29db4a49390,1609865896,60,1609866555,,0,0,13.13,3698,4073,67,74,,,0,0,0.14,1.07,0.95,,717,139,157,,,,64.93,43.95,65.3,1,61.65,1454,,,3,0,102,100,,,,,,82,81,12.83,12.84,12.91,2,-0.3,319,319,,1,322,322,,,,,,,,,"0,0,2,11,61,25,0,0,0","1,48,51,0,0","0,0,19,79,2",,,,,132,,,,,,,,,,,,,,,15,,,,,,,,,,,,,,,,,,,,,28.2,2,6,29,90,,1016,0,306,1,4,3,"Porz am Rhein",1,0,I1.000|4:41-I1.000|4:27-I1.000|4:31-I1.000|4:28-I1.000|4:30-I1.000|4:36-I1.000|4:54-I1.000|5:03-I1.000|4:50-I1.000|4:41-I1.000|4:43-I1.000|4:36-I1.000|4:58-I0.128|0:40,,,,,3113,,250,0,,0,168070,250480,30378,,10383977,,,,,,,,,,,,,,,,,,,,,,,,,,,,,,,,,,,,,,,,,
22855078,fcf437cc-60e6-4486-81d2-34a66b9fb317,1609944897,60,1609947074,,0,0,16.02,4220,4468,48,40,,,0,0,0.05,,,,1019,153,167,114,,,61.9,48.23,62.17,1,61.34,2201,,,3.9,0,103,98,,,,,,135,82,13.71,13.7,13.74,2,3,346,346,,1,348,348,,,,,,,,,"0,0,0,2,29,65,4,0,0","1,5,84,11,0","0,0,4,95,1",,,,,139,,,,,,,,,,,,,,,15,,,,,,,,,,,,,,,,,,,,,53.7,2,10,329,96,,1015,0,300,0,4,3,"Porz am Rhein",1,0,I1.000|4:28-I1.000|4:26-I1.000|4:31-I1.000|4:26-I1.000|4:24-I1.000|4:25-I1.000|4:24-I1.000|4:35-I1.000|4:28-I1.000|4:14-I1.000|4:20-I1.000|4:17-I1.000|4:21-I1.000|4:03-I1.000|4:18-I1.000|4:34-I0.019|0:05,,,,,3113,,250,0,,0,168070,250480,30378,,10424093,,,,,,,,,,,,,,,,,,,,,,,,,,,,,,,,,,,,,,,,,
22896813,0ec62174-7b48-4a15-9636-46a3a187392c,1610038052,60,1610036457,,0,0,5.49,1600,1720,36,45,,,0,0,0.29,1.01,0.97,,354,143,163,,,,59.97,39.86,60.33,1,60.58,1618,,,2.7,0,96,99,,,,,,38,81,12.37,12.4,12.43,6.8,8.8,302,302,,1,305,305,,,,,,,,,"0,0,4,29,58,9,0,0,0","1,26,69,4,0","0,0,45,55,0",,,,,127,,,,,,,,,,,,,,,15,,,,,,,,,,,,,,,,,,,,,31.3,2,12,223,94,,1013,0,290,1,6,3,"Porz am Rhein",1,0,I1.000|5:16-I1.000|4:46-I1.000|4:41-I1.000|4:39-I1.000|4:54-I0.486|2:24,,,,,3113,,250,0,,0,168070,250480,30378,,10459934,,,,,,,,,,,,,,,,,,,,,,,,,,,,,,,,,,,,,,,,,
22939130,38b26929-a146-48ed-a939-b778c01d2f76,1610120399,60,1610121414,,0,0,16.17,4347,4492,111,114,,,0,0.1,0.19,1.17,0.92,1047,959,150,163,,,,62.08,47.15,62.59,1,60.52,1767,,,3.6,0,101,100,,,,,,122,81,13.43,13.41,13.77,-2.6,-10.4,338,338,,1,350,350,,,,,,,,,"0,0,0,5,40,53,1,0,0","1,6,92,1,0","0,0,17,79,4",,,,,138,,,,,,,,,,,,,,,13,,,,,,,,,,,,,,,,,,,,,45.5,1,8,302,100,,1017,0,310,0,4,3,"Porz am Rhein",1,0,I1.000|4:40-I1.000|4:21-I1.000|4:29-I1.000|4:27-I1.000|4:30-I1.000|4:32-I1.000|4:29-I1.000|4:40-I1.000|4:34-I1.000|4:27-I1.000|4:26-I1.000|4:20-I1.000|4:31-I1.000|4:20-I1.000|4:23-I1.000|4:31-I0.169|0:46,,,,,3113,,250,0,,0,168070,250480,30378,,10496189,,,,,,,,,,,,,,,,,,,,,,,,,,,,,,,,,,,,,,,,4,
22980313,1e16d497-765f-40e8-9a52-a20c45e79f5e,1610207895,60,1610207674,,0,0,10.24,2852,2900,87,107,,,0,0.9,0.33,1.17,0.95,472,657,149,161,105,,,59.98,43.72,60.46,1,60.21,1580,,,3.3,0.1,103,99,,,,,,81,80,12.96,12.96,13.22,-0.5,-6.4,321,321,,1,331,331,,,,,,,,,"0,0,1,6,74,19,0,0,0","1,6,93,0,0","0,0,31,64,5",,,,,135,,,,,,,,,,,,,,,12,,,,,,,,,,,,,,,,,,,,,42.1,2,3,288,88,,1024,0,311,0,4,3,"Porz am Rhein",1,0,I1.000|4:46-I1.000|4:32-I1.000|4:37-I1.000|4:36-I1.000|4:33-I1.000|4:35-I1.000|4:39-I1.000|4:38-I1.000|4:35-I1.000|4:47-I0.242|1:13,,,,,3113,,250,0,,0,168070,250480,30378,,10530473,,,,,,,,,,,,,,,,,,,,,,,,,,,,,,,,,,,,,,,,5,
23019886,79551ec0-7eec-4703-8902-137a21832cd8,1610276615,60,1610281502,,0,0,25.49,7528,8211,540,539,,,0,3.9,0.71,1.04,0.99,434,1546,155,177,,,,52.76,43.81,54.15,1,59.42,3353,,,4.4,0.8,98,96,,,,,,253,83,12.66,12.36,12.97,0.9,2.4,309,309,,1,323,323,,,,,,,,,"3,5,10,28,33,19,2,0,0","0,14,48,38,0","0,6,35,55,4",,,,,122,,,,,,,,,,,,,,,20,,,,,,,,,,,,,,,,,,,,,66.3,1,4,266,88,,1026,1,282,0,2,3,Aachen,1,0,I1.000|4:54-I1.000|5:22-I1.000|4:58-I1.000|4:49-I1.000|4:50-I1.000|4:54-I1.000|4:55-I1.000|4:21-I1.000|4:53-I1.000|5:27-I1.000|5:02-I1.000|4:54-I1.000|4:49-I1.000|4:46-I1.000|5:16-I1.000|4:46-I1.000|5:30-I1.000|4:58-I1.000|4:43-I1.000|5:11-I1.000|4:57-I1.000|4:26-I1.000|4:35-I1.000|4:48-I1.000|4:56-I0.489|2:26,,,,,3113,,250,0,,0,168070,250480,30378,,10563830,,,,,,,,,,,,,,,,,,,,,,,,,,,,,,,,,,,,,,,,"4,4,4,5,5",
23062378,a8296124-1974-489f-bd23-430a34a108f5,1610379171,60,1610378351,,0,0,8.99,2552,2592,98,135,,,0,1.3,0.43,1.16,0.94,395,559,145,157,,,,60.81,42.38,61.32,1,59.3,1948,,,3.1,0,99,100,,,,,,66,80,12.75,12.76,13.12,4.5,11,313,313,,1,329,329,,,,,,,,,"1,1,4,15,54,23,1,0,0","1,11,88,0,0","0,1,42,48,8",,,,,132,,,,,,,,,,,,,,,14,,,,,,,,,,,,,,,,,,,,,36.8,0,7,228,66,,1023,0,289,0,3,3,Karlsruhe,1,0,I1.000|5:19-I1.000|4:37-I1.000|4:43-I1.000|4:43-I1.000|4:43-I1.000|4:35-I1.000|4:32-I1.000|4:42-I0.992|4:38,,,,,3113,,250,0,,0,168070,250480,30378,,10598442,,,,,,,,,,,,,,,,,,,,,,,,,,,,,,,,,,,,,,,,5,
23083060,eee388d8-f819-44e4-8999-6ad16aacfa6d,1610439733,60,1610440987,,0,0,14.94,4458,4574,258,257,,,0,3,0.49,1.02,0.96,578,1054,160,192,,,,49.73,41.51,50.79,1,58.82,3741,,,4.4,3.3,98,98,,,,,,158,81,12.75,12.52,12.86,1.7,5.7,306,306,,1,317,317,,,,,,,,,"9,2,2,16,50,18,3,0,0","1,6,39,49,4","0,5,37,55,3",,,,,124,,,,,,,,,,,,,,,22,,,,,,,,,,,,,,,,,,,,,98.7,1,31,224,89,,1014,0,295,0,6,3,Karlsruhe,1,0,I1.000|4:51-I1.000|4:48-I1.000|4:38-I1.000|4:37-I1.000|4:40-I1.000|4:49-I1.000|7:21-I1.000|6:09-I1.000|4:16-I1.000|4:37-I1.000|4:46-I1.000|4:47-I1.000|4:44-I1.000|4:46-I0.935|4:30,,,,,3113,,250,0,,0,168070,250480,30378,,10615245,,,,,,,,,,,,,,,,,,,,,,,,,,,,,,,,,,,,,,,,"4,5",
23120488,94f45c4c-6275-4ae4-b613-46ae7e3807b7,1610526105,60,1610524455,,0,0,5.81,1752,1756,77,88,,,0,1.2,0.42,1.08,0.92,637,398,150,172,,,,53.87,38.41,54.63,1,58.74,2782,,,3,0,97,100,,,,,,51,81,12.17,12.01,12.52,3.9,11.7,296,296,,1,310,310,,,,,,,,,"0,2,11,43,36,7,0,0,0","1,4,85,11,0","0,5,55,36,3",,,,,123,,,,,,,,,,,,,,,17,,,,,,,,,,,,,,,,,,,,,42.4,-1,15,231,90,,1022,0,310,0,3,3,Karlsruhe,1,0,I1.000|4:59-I1.000|4:42-I1.000|5:07-I1.000|5:15-I1.000|5:07-I0.810|4:02,,,,,3113,,250,0,,0,168070,250480,30378,,10648114,,,,,,,,,,,,,,,,,,,,,,,,,,,,,,,,,,,,,,,,4,
23136438,b8dcdb7a-1bde-4b42-975b-9b659b7baa96,1610546585,60,1610549475,,0,0,0.09,6389,6401,27,4,,,0,1.2,1,,,15,441,89,121,,,,,,,1,58.73,2364,,,0.7,0,,100,,,,,,35,52,,0.72,,,,,,,,,,,,,,,,,,"100,0,0,0,0,0","73,27,0,0,0",,,,,,,,,,,,,,,,,,,,,,,,,,,,,,,,,,,,,,,,,,6.3,,,,,,,,,,1,,,1,0,,,,,,3113,,250,0,,0,168075,,30378,,10662513,,,,,,,,,,,,,,,,,,,,,,,,,,,,,,,,,,,,,,,,4,
23179285,5eeb1929-7eb1-4725-9ddc-1b77cbd3b2ef,1610640740,60,1610641853,,0,0,15.85,4441,4603,84,109,,,0,0,0.14,1.14,0.96,,926,148,162,,,,60.09,44.87,60.37,1,58.73,2020,,,3.6,0,102,98,,,,,,109,81,12.88,12.88,13.01,-3.8,-5.7,319,319,,1,325,325,,,,,,,,,"0,0,1,13,62,24,0,0,0","1,5,93,1,0","0,1,25,72,3",,,,,132,,,,,,,,,,,,,,,13,,,,,,,,,,,,,,,,,,,,,44.5,1,10,96,81,,1020,0,292,0,3,3,Eil,1,0,I1.000|4:50-I1.000|4:43-I1.000|4:44-I1.000|4:45-I1.000|4:40-I1.000|4:39-I1.000|4:40-I1.000|4:54-I1.000|4:39-I1.000|4:40-I1.000|4:33-I1.000|4:30-I1.000|4:51-I1.000|4:29-I1.000|4:28-I0.852|3:54,,,,,3113,,250,0,,0,168070,250480,30378,,10700462,,,,,,,,,,,,,,,,,,,,,,,,,,,,,,,,,,,,,,,,,
23213126,7c4c92ed-1501-43c0-9d0a-1d7bce8f5158,1610726052,60,1610727136,,0,0,16.41,4173,4540,57,88,,,0,0,0.12,,0.96,,955,154,167,,,,64.06,50.34,64.19,1,59.45,2160,,,3.9,0.6,104,100,,,,,,134,82,14.12,14.2,14.17,-1.3,-2,357,357,,1,360,360,,,,,,,,,"0,0,0,1,15,65,19,0,0","0,7,83,10,0","0,0,5,90,6",,,,,144,,,,,,,,,,,,,,,13,,,,,,,,,,,,,,,,,,,,,51.9,1,10,347,78,,1028,0,332,0,3,3,"Porz am Rhein",1,0,I1.000|4:27-I1.000|4:09-I1.000|4:18-I1.000|4:12-I1.000|4:14-I1.000|4:18-I1.000|4:22-I1.000|4:28-I1.000|4:15-I1.000|4:06-I1.000|4:03-I1.000|4:21-I1.000|4:22-I1.000|4:01-I1.000|4:10-I1.000|4:06-I0.408|1:41,,,,,3113,,250,0,,0,168070,250480,30378,,10729895,,,,,,,,,,,,,,,,,,,,,,,,,,,,,,,,,,,,,,,,,
23248742,3d45f001-ebfd-4ea4-9abe-ff0c554e032d,1610817174,60,1610815458,,0,0,5.59,1679,1720,64,47,,,0,0.8,0.35,1.19,0.94,476,333,136,148,,,,61.67,38.51,62.78,1,59.75,932,,,2.3,0,103,100,,,,,,35,79,12.19,12.06,12.54,-11.1,-23.2,299,299,,1,312,312,,,,,,,,,"1,2,11,28,55,3,0,0,0","0,77,23,0,0","0,2,59,32,7",,,,,126,,,,,,,,,,,,,,,17,,,,,,,,,,,,,,,,,,,,,22.6,0,11,160,71,,1023,0,337,1,3,3,"Porz am Rhein",1,0,I1.000|5:29-I1.000|4:58-I1.000|4:56-I1.000|4:50-I1.000|4:46-I0.591|3:00,,,,,3113,,250,0,,0,168070,250480,30378,,10760665,,,,,,,,,,,,,,,,,,,,,,,,,,,,,,,,,,,,,,,,5,
23265534,8712dfff-dca9-4be3-8d0e-4f677348bf83,1610875348,60,1610878125,,0,0,20.33,5848,6057,151,163,,,0,0.7,0.25,1.01,0.93,429,1412,158,186,,,,53.01,44.4,53.45,1,59.2,3788,,,4.7,2.5,103,94,,,,,,210,82,12.63,12.64,12.8,9.6,13.3,311,311,,1,319,319,,,,,,,,,"3,2,4,17,54,17,3,0,0","0,3,57,39,1","0,1,36,60,3",,,,,127,,,,,,,,,,,,,,,15,,,,,,,,,,,,,,,,,,,,,90.8,0,5,146,95,,1018,0,357,0,4,3,"Porz am Rhein",1,0,I1.000|4:35-I1.000|4:34-I1.000|4:52-I1.000|4:45-I1.000|4:57-I1.000|4:55-I1.000|4:50-I1.000|5:10-I1.000|5:46-I1.000|4:50-I1.000|4:45-I1.000|4:55-I1.000|4:54-I1.000|4:30-I1.000|4:45-I1.000|4:44-I1.000|4:33-I1.000|4:29-I1.000|4:36-I1.000|4:30-I0.325|1:35,,,,,3113,,250,0,,0,168070,250480,30378,,10774938,,,,,,,,,,,,,,,,,,,,,,,,,,,,,,,,,,,,,,,,4,
23313110,61fd7a74-50e7-4a01-8532-c6a19304cd08,1610989393,60,1610991080,,0,0,2.1,929,929,35,0,,,0,0,0.29,1.03,,,129,109,133,,,,49.16,22.7,51.19,1,59.2,1974,,,0.6,0,,100,,,,,,9,78,8.6,8.2,8.71,-2.6,-8.2,201,201,,1,205,205,,,,,,,,,"86,6,7,2,0,0,0,0,0","2,98,0,0,0","0,59,41,0,0",,,,,87,,,,,,,,,,,,,,,20,,,,,,,,,,,,,,,,,,,,,5.3,4,11,247,91,,1022,0,323,1,6,3,"Porz am Rhein",1,0,I1.000|7:43-I0.293|2:10-I0.100|0:42-I0.126|0:49-I0.150|1:05-I0.432|3:00,,,,,3113,,250,0,,0,168070,250480,30378,,10814790,,,,,,,,,,,,,,,,,,,,,,,,,,,,,,,,,,,,,,,,,
23313136,4d973a9b-83d1-4990-827c-ab7d3e69020b,1610990401,60,1610991114,,0,0,14.61,4007,4070,29,49,,,0,0,0.08,,0.99,,794,142,164,,,,65.25,45.7,65.3,1,60.35,3744,,,3.2,0.3,103,106,,,,,,100,80,13.08,13.27,13.28,-3.1,-8.6,327,327,,1,335,335,,,,,,,,,"0,0,2,15,47,28,9,0,0","0,46,52,2,0","0,0,28,67,5",,,,,137,,,,,,,,,,,,,,,22,,,,,,,,,,,,,,,,,,,,,39.9,4,13,245,92,,1022,0,314,1,4,3,"Porz am Rhein",1,0,I1.000|4:50-I1.000|4:53-I1.000|4:53-I1.000|4:42-I1.000|4:45-I1.000|4:34-I1.000|4:33-I1.000|4:40-I1.000|4:13-I1.000|4:03-I1.000|4:03-I1.000|4:09-I1.000|4:10-I1.000|5:04-I0.609|3:15,,,,,3113,,250,0,,0,168070,250480,30378,,10814815,,,,,,,,,,,,,,,,,,,,,,,,,,,,,,,,,,,,,,,,,
23355121,4eeaa11e-30f4-45a0-a841-fa21823ca120,1611078818,60,1611078327,,0,0,10.02,2843,3001,89,107,,,0,0.7,0.4,1.06,0.94,,602,143,155,,,,61.99,42.72,62.53,1,60.5,2016,,,3,0,102,101,,,,,,66,80,12.74,12.72,12.87,-0.1,-1.1,314,314,,1,320,320,,,,,,,,,"0,1,2,8,77,12,0,0,0","0,17,82,0,0","0,0,39,60,2",,,,,132,,,,,,,,,,,,,,,17,,,,,,,,,,,,,,,,,,,,,28.7,6,17,215,87,,1010,0,292,1,4,3,"Porz am Rhein",1,0,I1.000|4:58-I1.000|4:37-I1.000|4:40-I1.000|4:47-I1.000|4:40-I1.000|4:43-I1.000|4:39-I1.000|4:40-I1.000|4:53-I1.000|4:42-I0.015|0:05,,,,,3113,,250,0,,0,168070,250480,30378,,10849716,,,,,,,,,,,,,,,,,,,,,,,,,,,,,,,,,,,,,,,,,
23393903,e435a313-f477-4e8b-8148-c17e7d5b1c78,1611158803,60,1611160054,,0,0,15.49,4482,4648,110,99,,,0,0.4,0.3,1.1,0.88,,805,144,184,,,,59.94,43.15,60.52,1,60.82,1584,,,3.4,2.4,105,100,,,,,,115,81,12.54,13.12,13.3,1.1,10.4,320,313,,1,341,339,,,,,,,,,"3,2,9,22,41,11,6,6,0","1,50,36,12,0","3,2,37,44,14",,,,,128,,,,,,,,,,,,,,,19,,,,,,,,,,,,,,,,,,,,,84.3,9,18,169,72,,999,0,283,0,4,3,"Porz am Rhein",1,0,I1.000|4:45-I1.000|4:30-I1.000|4:24-I1.000|4:31-I1.000|4:43-I0.014|0:08-I2.540|8:47-I1.000|7:47-I1.000|5:05-I1.000|4:50-I1.000|4:47-I1.000|4:59-I1.000|5:06-I1.000|5:10-I0.932|5:12,,,,,3113,,250,0,,0,168070,250480,30378,,10883240,,,,,,,,,,,,,,,,,,,,,,,,,,,,,,,,,,,,,,,,,
23482335,fb3aa26e-fe70-4626-9045-dd67a5de0ef5,1611337900,60,1611338075,,0,0,11.78,3373,3557,75,66,,,0,0,0.26,1.06,0.98,,692,141,166,,,,62.45,42.76,63,1,60.95,1222,,,3,0,99,100,,,,,,80,80,12.65,12.6,12.72,-3.6,-7.7,312,312,,1,316,316,,,,,,,,,"0,0,2,15,72,10,1,0,0","0,34,65,1,0","0,1,33,66,1",,,,,131,,,,,,,,,,,,,,,18,,,,,,,,,,,,,,,,,,,,,27.4,5,7,295,86,,996,0,326,1,4,3,"Porz am Rhein",1,0,I1.000|5:03-I1.000|4:41-I1.000|4:37-I1.000|4:42-I1.000|4:35-I1.000|4:47-I1.000|4:51-I1.000|4:52-I1.000|4:49-I1.000|4:53-I1.000|4:38-I0.784|3:45,,,,,3113,,250,0,,0,168070,250480,30378,,10966274,,,,,,,,,,,,,,,,,,,,,,,,,,,,,,,,,,,,,,,,,
23505073,ae97afd8-d42f-4cb9-982e-715e4b497231,1611246870,60,1611398143,,0,0,16.48,4553,4755,98,105,,,0,0,0.13,,0.96,351,978,149,169,102,,,60.58,45.75,60.99,1,60.87,1584,,,3.6,0.2,100,100,,,,,,123,80,13.07,13.08,13.39,-1.5,5.4,327,327,,1,338,338,,,,,,,,,"0,0,1,9,57,33,0,0,0","0,6,94,1,0","0,1,22,75,2",,,,,136,,,,,,,,,,,,,,,21,,,,,,,,,,,,,,,,,,,,,39.9,8,18,194,72,,995,0,315,1,4,3,"Porz am Rhein",1,0,I1.000|4:26-I1.000|4:22-I1.000|4:25-I1.000|4:37-I1.000|4:42-I1.000|4:36-I1.000|4:40-I1.000|4:49-I1.000|4:45-I1.000|4:28-I1.000|4:32-I1.000|4:51-I1.000|4:36-I1.000|4:36-I1.000|4:32-I1.000|4:37-I0.478|2:19,,,,,3113,,250,0,,0,168070,250480,30378,,10989451,,,,,,,,,,,,,,,,,,,,,,,,,,,,,,,,,,,,,,,,4,
23519492,052ac8ac-3474-48a5-9bf4-9f39741663d8,1611418627,60,1611418391,,0,0,10.77,2849,3178,44,37,,,0,0,0.15,1,0.9,907,612,151,182,,,,62.74,46.59,63.11,1,61.6,1918,,,3.4,3,101,103,,,,,,90,81,13.7,14.32,14.36,7.8,1.2,349,349,,1,373,373,,,,,,,,,"8,4,5,15,14,18,27,9,0","1,38,23,38,0","1,4,27,35,33",,,,,140,,,,,,,,,,,,,,,24,,,,,,,,,,,,,,,,,,,,,71.4,5,6,143,82,,993,0,352,0,3,3,"Porz am Rhein",1,0,I1.000|4:46-I1.000|4:24-I1.000|4:22-I1.000|3:35-I0.403|2:08-I1.000|3:32-I0.444|2:27-I1.000|3:32-I0.415|2:44-I1.000|3:28-I0.451|2:53-I1.000|3:34-I1.000|5:49-I0.054|0:16,,,,,3113,,250,0,,0,168070,250480,30378,,11002622,,,,,,,,,,,,,,,,,,,,,,,,,,,,,,,,,,,,,,,,,
23559837,6682c3b5-cae7-4bd3-b0a7-d05b2936ac4b,1611497082,60,1611495267,,0,0,5.71,1584,1646,45,34,,,0,0,0.08,1.2,1.02,,358,143,155,,,,63.74,42.35,64.51,1,61.65,1164,,,2.7,0,103,100,,,,,,39,81,13.11,13.04,13.28,0.9,-4.4,328,328,,1,334,334,,,,,,,,,"0,0,3,7,60,30,1,0,0","2,17,81,0,0","0,0,16,80,4",,,,,134,,,,,,,,,,,,,,,14,,,,,,,,,,,,,,,,,,,,,30.7,3,14,317,85,,1000,0,370,0,3,3,"Porz am Rhein",1,0,I1.000|4:44-I1.000|4:34-I1.000|4:30-I1.000|4:34-I1.000|4:42-I0.705|3:20,,,,,3113,,250,0,,0,168070,250480,30378,,11040380,,,,,,,,,,,,,,,,,,,,,,,,,,,,,,,,,,,,,,,,,
23591212,58cedb95-ae43-42a7-8e0c-5c2252b5c9b4,1611563396,60,1611569124,,0,0,25.41,8590,9125,712,673,,,0,5.5,0.8,1.02,0.99,505,2247,167,198,,,,39.93,37.36,41.4,1,60.9,5760,,,5,5,101,91,,,,,,374,82,11.59,11.27,11.75,11.4,17.1,267,267,,1,278,278,,,,,,,,,"28,13,11,13,24,12,0,0,0","0,5,23,57,15","0,10,65,24,1",,,,,108,,,,,,,,,,,,,,,17,,,,,,,,,,,,,,,,,,,,,126.5,-1,4,101,92,,1003,0,398,0,4,3,Balve,1,0,I1.000|4:54-I1.000|6:05-I1.000|6:13-I1.000|6:16-I1.000|6:03-I1.000|4:42-I1.000|4:26-I1.000|4:23-I1.000|9:18-I1.000|6:57-I1.000|5:24-I1.000|4:51-I1.000|6:05-I1.000|5:25-I1.000|5:20-I1.000|4:34-I1.000|5:17-I1.000|7:05-I1.000|7:00-I1.000|7:00-I1.000|5:00-I1.000|4:42-I1.000|4:41-I1.000|4:56-I1.000|4:42-I0.410|1:53,,,,,3113,,250,0,,0,168070,250480,30378,,11070208,,,,,,,,,,,,,,,,,,,,,,,,,,,,,,,,,,,,,,,,"3,4,4,4,5",
23603509,3920b182-9ed8-435e-be38-ca2bdd2e5681,1611592221,60,1611592515,,0,0,11.04,3573,3796,217,214,,,0,3.4,0.57,0.99,1.01,519,719,141,165,,,,53.68,36.87,55.01,1,60.81,5370,,,3,0,99,99,,,,,,85,81,11.76,11.63,11.94,-1.9,-0.9,277,277,,1,285,285,,,,,,,,,"19,3,7,27,35,9,0,0,0","0,48,47,5,0","0,5,65,30,0",,,,,114,,,,,,,,,,,,,,,18,,,,,,,,,,,,,,,,,,,,,40.2,0,8,324,84,,1008,0,409,0,3,3,Balve,1,0,I1.000|5:19-I1.000|4:56-I0.781|3:58-I0.674|6:14-I1.000|5:09-I1.000|4:43-I1.000|4:30-I1.000|7:00-I1.000|5:11-I1.000|4:42-I1.000|5:07-I0.582|2:45,,,,,3113,,250,0,,0,168070,250480,30378,,11081519,,,,,,,,,,,,,,,,,,,,,,,,,,,,,,,,,,,,,,,,"4,4",
23627310,f8b32033-ebfb-4a7b-bcdc-13d5ca8ecae1,1611653048,60,1611657808,,0,0,21.51,7886,8123,492,515,,,0,4.2,0.78,1.02,1.01,398,1906,162,192,,,,37.84,33.53,38.87,1,60.72,5760,,,5,3.4,94,91,,,,,,308,80,10.33,10.22,10.51,11.9,19.2,237,237,,1,247,247,,,,,,,,,"37,16,14,21,10,1,0,0,0","0,5,35,53,7","0,20,73,7,0",,,,,102,,,,,,,,,,,,,,,26,,,,,,,,,,,,,,,,,,,,,100.5,1,17,289,95,,1015,0,366,0,7,3,Balve,1,0,I1.000|5:30-I1.000|6:37-I1.000|7:03-I1.000|6:41-I1.000|6:18-I1.000|6:26-I1.000|4:52-I1.000|6:12-I1.000|6:10-I1.000|5:12-I1.000|6:38-I1.000|6:21-I1.000|6:02-I1.000|7:56-I1.000|7:13-I1.000|6:10-I1.000|6:14-I1.000|5:28-I1.000|5:30-I1.000|5:02-I1.000|5:06-I0.510|2:48,,,,,3113,,250,0,,0,168070,250480,30378,,11102809,,,,,,,,,,,,,,,,,,,,,,,,,,,,,,,,,,,,,,,,"4,4,5,5",
23676180,84860f51-903e-4595-99ca-f1a95e17a336,1611740904,60,1611745990,,0,0,22.39,8112,8603,564,561,,,0,4.8,0.8,1.05,1.02,398,1866,161,196,,,,38.76,34.11,39.98,1,60.46,5760,,,5,3.9,98,92,,,,,,281,79,10.68,10.53,10.95,6,16.5,244,244,,1,260,260,,,,,,,,,"29,16,17,21,15,2,0,0,0","0,8,32,53,7","0,22,59,19,0",,,,,105,,,,,,,,,,,,,,,17,,,,,,,,,,,,,,,,,,,,,110.8,0,20,212,96,,1012,0,383,0,7,3,Balve,1,0,I1.000|5:08-I1.000|5:43-I1.000|5:59-I1.000|5:47-I1.000|6:03-I1.000|7:23-I1.000|5:09-I1.000|6:26-I1.000|6:28-I1.000|5:45-I1.000|6:24-I1.000|5:26-I1.000|5:15-I1.000|9:42-I1.000|6:45-I1.000|8:12-I1.000|6:32-I1.000|5:27-I1.000|4:58-I1.000|5:15-I1.000|5:05-I1.000|4:30-I0.391|1:49,,,,,3113,,250,0,,0,168070,250480,30378,,11148781,,,,,,,,,,,,,,,,,,,,,,,,,,,,,,,,,,,,,,,,"3,4,5",
23685190,e183f155-ed56-4b2f-bd85-5886db741814,1611764740,60,1611764439,,0,0,8.94,3130,3190,218,206,,,0,3.6,0.72,0.94,1.02,562,579,137,155,,,,50.57,33.09,52.18,1,60.26,5455,,,2.8,0,100,96,,,,,,58,79,11.14,10.96,11.21,-12.7,-4.3,256,256,,1,266,266,,,,,,,,,"25,4,14,32,25,1,0,0,0","0,54,45,0,0","0,11,71,18,0",,,,,108,,,,,,,,,,,,,,,22,,,,,,,,,,,,,,,,,,,,,28.9,2,13,252,99,,1011,0,385,0,6,3,Balve,1,0,I1.000|5:29-I1.000|5:23-I1.000|5:51-I1.000|8:18-I1.000|7:33-I1.000|5:05-I1.000|5:01-I1.000|4:47-I0.938|4:42,,,,,3113,,250,0,,0,168070,250480,30378,,11157553,,,,,,,,,,,,,,,,,,,,,,,,,,,,,,,,,,,,,,,,"4,5",
23722988,59199ca4-8207-42ff-be7b-1d5bc66b5def,1611844720,60,1611848527,,0,0,19.45,6254,7173,369,308,,,0,2.9,0.6,0.97,0.95,362,1325,154,184,,,,47.95,38.86,49.26,1,60.47,4704,,,4.2,2.7,103,97,,,,,,205,80,11.76,11.49,12.06,9.1,13.4,278,278,,1,292,292,,,,,,,,,"12,13,13,24,32,6,0,0,0","0,17,50,32,1","1,9,53,35,2",,,,,117,,,,,,,,,,,,,,,21,,,,,,,,,,,,,,,,,,,,,75.2,4,11,310,97,,999,0,347,0,6,3,Balve,1,0,I1.000|4:53-I1.000|4:39-I1.000|5:01-I1.000|5:00-I1.000|5:04-I1.000|5:42-I1.000|5:20-I1.000|5:12-I1.000|4:55-I1.000|4:42-I1.000|5:15-I1.000|5:17-I1.000|6:04-I1.000|6:43-I1.000|5:38-I1.000|5:00-I1.000|5:54-I1.000|5:38-I1.000|6:07-I0.446|2:09,,,,,3113,,250,0,,0,168070,250480,30378,,11194321,,,,,,,,,,,,,,,,,,,,,,,,,,,,,,,,,,,,,,,,"4,4,5",
23768764,247f9dac-0576-45b6-afb8-a5fa8c5fa597,1611935183,60,1611936520,,0,0,14.42,4416,4714,365,364,,,0,4,0.78,0.97,1.07,461,823,141,172,,,,57.47,40.16,59.28,1,60.21,3239,,,3.2,0,97,97,,,,,,66,81,12.54,12.18,12.62,-8.6,1.1,298,298,,1,306,306,,,,,,,,,"10,11,17,17,17,24,3,0,0","0,43,55,2,0","0,1,43,56,0",,,,,121,,,,,,,,,,,,,,,17,,,,,,,,,,,,,,,,,,,,,40.1,6,18,258,94,,995,0,364,0,6,3,Balve,1,0,I1.000|5:08-I1.000|5:44-I1.000|5:41-I1.000|5:48-I1.000|5:40-I1.000|6:33-I1.000|5:30-I1.000|4:25-I1.000|4:11-I1.000|4:26-I1.000|4:25-I1.000|4:39-I1.000|4:57-I1.000|4:47-I0.420|1:43,,,,,3113,,250,0,,0,168070,250480,30378,,11237168,,,,,,,,,,,,,,,,,,,,,,,,,,,,,,,,,,,,,,,,"3,5",
23802920,f2f280ae-5c88-4e96-be8a-ba7f24be9fb9,1612014505,60,1612017770,,0,0,19.02,5825,6402,539,533,,,0,5.4,0.76,1.01,1,577,1249,151,187,104,,,52.36,41.06,54.22,1,59.79,3707,,,4,2.3,100,97,,,,,,178,82,12.66,12.43,13.35,0.3,11.4,302,302,,1,328,328,,,,,,,,,"13,14,13,17,14,19,11,0,0","0,13,67,19,1","0,6,46,40,8",,,,,119,,,,,,,,,,,,,,,18,,,,,,,,,,,,,,,,,,,,,72.7,1,14,77,76,,1002,0,371,0,3,3,Balve,1,0,I1.000|4:57-I1.000|5:21-I1.000|5:50-I1.000|5:26-I1.000|5:41-I1.000|5:52-I1.000|4:41-I1.000|5:18-I1.000|5:51-I1.000|6:37-I1.000|6:30-I1.000|5:37-I1.000|4:53-I1.000|3:52-I1.000|4:10-I1.000|4:13-I1.000|4:15-I1.000|3:47-I1.000|4:07-I0.017|0:06,,,,,3113,,250,0,,0,168070,250480,30378,,11266985,,,,,,,,,,,,,,,,,,,,,,,,,,,,,,,,,,,,,,,,"2,4",
23834519,4b40b187-3faa-4eb2-bbde-2a92d76755f7,1612090760,60,1612095550,,0,0,23.5,7453,8121,747,705,,,0,6.3,0.84,1.13,1.04,742,1661,157,184,105,,,47.43,40.06,49.4,1,59.6,5227,,,4.7,2.2,100,97,,,,,,257,82,12.33,11.85,13.11,11.1,19.4,293,293,,1,319,319,,,,,,,,,"17,12,9,14,28,18,1,0,0","0,7,45,47,0","0,6,54,31,8",,,,,115,,,,,,,,,,,,,,,20,,,,,,,,,,,,,,,,,,,,,73.4,0,8,116,71,,1006,1,399,0,2,3,Balve,1,0,I1.000|5:03-I1.000|5:31-I1.000|7:27-I1.000|5:29-I1.000|6:02-I1.000|5:10-I1.000|4:17-I1.000|4:32-I1.000|4:24-I0.538|2:31-I0.900|6:34-I1.000|5:53-I1.000|6:25-I1.000|5:48-I1.000|5:31-I1.000|4:42-I1.000|4:32-I1.000|4:34-I1.000|4:40-I1.000|4:33-I1.000|4:45-I1.000|5:18-I1.000|5:07-I1.000|5:09-I0.058|0:16,,,,,3113,,250,0,,0,168070,250480,30378,,11294517,,,,,,,,,,,,,,,,,,,,,,,,,,,,,,,,,,,,,,,,"3,3,4,4,4,5",
23891132,1532d1e9-1e30-4d87-a5aa-90c4e8355e83,1612198271,60,1612199306,,0,0,12.81,3987,4268,22,74,,,0,0,0.06,,0.99,,703,135,148,,,,59.57,39.04,59.4,1,59.5,3184,,,2.7,0,97,100,,,,,,81,80,11.46,11.6,11.49,-1.1,-2.5,275,275,,1,277,277,,,,,,,,,"1,1,15,62,22,0,0,0,0","1,85,15,0,0","0,0,93,7,0",,,,,120,,,,,,,,,,,,,,,21,,,,,,,,,,,,,,,,,,,,,22.9,4,5,278,96,,997,0,366,0,4,3,"Porz am Rhein",1,0,I1.000|5:39-I1.000|5:07-I1.000|5:03-I1.000|4:59-I1.000|5:00-I1.000|4:59-I1.000|5:10-I1.000|5:33-I1.000|5:16-I1.000|5:04-I1.000|5:13-I1.000|5:05-I0.811|4:19,,,,,3113,,250,0,,0,168070,250480,30378,,11342741,,,,,,,,,,,,,,,,,,,,,,,,,,,,,,,,,,,,,,,,,
23927284,83e7ba26-10d9-4d85-ad42-b1c08bea98fd,1612284003,60,1612283622,,0,0,7.01,2868,3086,62,52,,,0,0.9,0.4,1.27,0.95,,564,138,169,,,,41.33,26.99,41.86,1,59.32,1977,,,3,0.6,90,91,,,,,,68,79,8.89,9.05,9.38,3.9,-6.2,203,203,,1,220,220,,,,,,,,,"72,9,10,8,2,0,0,0,0","2,41,48,9,0","1,57,36,6,1",,,,,93,,,,,,,,,,,,,,,15,,,,,,,,,,,,,,,,,,,,,45.1,11,12,235,92,,999,0,344,0,4,3,"Porz am Rhein",1,0,I1.000|7:16-I1.000|7:21-I1.000|7:39-I1.000|7:28-I1.000|6:30-I0.337|1:43-I0.076|0:21-I0.161|1:09-I0.088|0:22-I1.000|6:02-I0.347|1:57,,,,,3113,,250,0,,0,168070,250480,30378,,11372245,,,,,,,,,,,,,,,,,,,,,,,,,,,,,,,,,,,,,,,,,
23963431,e926d140-e8e4-4ff7-b12e-3c3afd0cc5ee,1612370458,60,1612370779,,0,0,14.68,3702,3777,54,73,,,0,0,0.15,,0.94,,926,161,178,,,,60.64,50.39,60.82,1,59.37,3168,,,4.4,0.4,105,99,,,,,,139,82,14.27,14.35,14.35,-0.4,-3.3,363,363,,1,367,367,,,,,,,,,"0,0,1,2,9,68,21,0,0","0,3,29,68,0","0,0,2,84,14",,,,,145,,,,,,,,,,,,,,,20,,,,,,,,,,,,,,,,,,,,,74.1,10,15,231,93,,996,0,374,0,6,3,"Porz am Rhein",1,0,I1.000|4:40-I1.000|4:14-I1.000|4:17-I1.000|4:18-I1.000|4:18-I1.000|4:08-I1.000|4:14-I1.000|4:03-I1.000|4:04-I1.000|4:01-I1.000|4:03-I1.000|4:07-I1.000|4:07-I1.000|4:01-I0.681|3:07,,,,,3113,,250,0,,0,168070,250480,30378,,11404419,,,,,,,,,,,,,,,,,,,,,,,,,,,,,,,,,,,,,,,,,
23964453,a744134c-d0cc-43f5-af41-36a2e70df483,1612374438,60,1612372128,,0,0,2.25,1155,1188,64,28,,,0,1.3,0.46,1.24,0.8,410,171,120,148,,,,36.92,18.97,38.96,1,59.37,3146,,,0.9,0,,100,,,,,,15,76,7.54,7.34,8.37,24.9,21,173,173,,1,195,195,,,,,,,,,"98,2,0,0,0,0,0,0,0","0,97,3,0,0","15,63,19,4,0",,,,,77,,,,,,,,,,,,,,,19,,,,,,,,,,,,,,,,,,,,,10.8,10,15,233,91,,996,0,375,1,6,3,"Porz am Rhein",1,0,I1.000|7:55-I0.452|3:15-I0.102|0:38-I0.162|1:57-I0.190|2:04-I0.347|3:25,,,,,3113,,250,0,,0,168070,250480,30378,,11405337,,,,,,,,,,,,,,,,,,,,,,,,,,,,,,,,,,,,,,,,5,
24001592,b1697034-bdc5-403f-8e5f-89ecaca05af8,1612458962,60,1612457046,,0,0,2.67,1319,1392,55,35,,,0,0,0.23,1.33,0.48,,192,118,143,88,,,39.45,20.13,40.82,1,59.37,1732,,,1.1,0.1,,100,,,,,,17,76,7.56,8.05,8.81,36.8,11.8,173,173,,1,206,206,,,,,,,,,"70,15,12,2,0,0,0,0,0","6,93,1,0,0","31,27,36,3,3",,,,,80,,,,,,,,,,,,,,,15,,,,,,,,,,,,,,,,,,,,,9.5,6,4,149,82,,1015,0,350,0,3,3,"Porz am Rhein",1,0,I1.000|6:31-I1.000|8:40-I0.670|6:48,,,,,3113,,250,0,,0,168070,250480,30378,,11435832,,,,,,,,,,,,,,,,,,,,,,,,,,,,,,,,,,,,,,,,,
24025290,8610b32b-105e-4071-a5e2-5f11aeb98e74,1612525337,60,1612526890,,0,0,18.4,4798,4963,91,95,,,0,0,0.18,1.09,0.95,,1130,155,170,,,,61.53,49.35,61.89,1,59.3,2778,,,4.1,0.3,104,97,,,,,,157,82,13.87,13.89,13.99,-2.6,-5.4,351,351,,1,356,356,,,,,,,,,"0,0,0,3,29,55,12,0,0","0,5,74,21,0","0,0,8,81,10",,,,,140,,,,,,,,,,,,,,,20,,,,,,,,,,,,,,,,,,,,,56.1,9,6,158,85,,1013,1,355,0,4,3,"Porz am Rhein",1,0,I1.000|4:38-I1.000|4:27-I1.000|4:45-I1.000|4:30-I1.000|4:32-I1.000|4:28-I1.000|4:26-I1.000|4:25-I1.000|4:20-I1.000|4:25-I1.000|4:04-I1.000|4:10-I1.000|4:03-I1.000|4:10-I1.000|4:10-I1.000|4:05-I1.000|4:14-I1.000|4:19-I0.395|1:47,,,,,3113,,250,0,,0,168070,250480,30378,,11457726,,,,,,,,,,,,,,,,,,,,,,,,,,,,,,,,,,,,,,,,,
24081431,cb28eea1-3320-44fc-b4e7-2866812d5281,1612629512,60,1612628810,,0,0,3.53,1631,1657,33,25,,,0,0.6,0.4,1.06,0.93,,239,120,149,89,,,42.06,22.26,42.66,1,59.3,904,,,1.2,0,,100,,,,,,22,79,7.89,7.82,8.02,6.9,12.9,177,177,,1,182,182,,,,,,,,,"100,0,0,0,0,0,0,0,0","1,96,3,0,0","2,82,16,0,0",,,,,82,,,,,,,,,,,,,,,14,,,,,,,,,,,,,,,,,,,,,9.2,5,15,81,89,,1006,0,338,0,6,3,Eil,1,0,I0.102|0:46-I1.000|7:41-I1.000|7:40-I1.000|7:36-I0.426|3:28,,,,,3113,,250,0,,0,168070,250480,30378,,11508404,,,,,,,,,,,,,,,,,,,,,,,,,,,,,,,,,,,,,,,,,
24081441,81d34b39-5a3b-45ef-8b7c-d191ad0b858f,1612631595,60,1612628826,,0,0,2.89,723,730,0,20,,,0,0,0.14,,0.99,,178,156,178,,,,64.16,45.48,63.61,1,59.72,1280,,,2.4,1.1,101,101,,,,,,24,82,14.13,14.45,14.19,0.1,3.2,356,356,,1,358,358,,,,,,,,,"0,0,0,0,6,78,16,0,0","0,3,62,35,0","0,0,0,97,3",,,,,146,,,,,,,,,,,,,,,20,,,,,,,,,,,,,,,,,,,,,39.6,6,17,80,86,,1006,0,343,0,6,3,Eil,1,0,I1.000|4:06-I1.000|4:07-I0.891|3:50,,,,,3113,,250,0,,0,168070,250480,30378,,11508414,,,,,,,,,,,,,,,,,,,,,,,,,,,,,,,,,,,,,,,,,
24107724,418466a1-553f-46a2-ae51-8b8aad80c81f,1612698572,60,1612701144,,0,0,21.2,5866,5994,181,198,,,0,0.7,0.27,1.07,0.96,550,1185,148,165,,,,61.03,46.6,61.61,1,59.48,1729,,,3.6,0.3,99,99,,,,,,163,82,13.12,13.08,13.28,-4.3,-3.8,327,327,,1,333,333,,,,,,,,,"0,0,2,12,48,38,1,0,0","0,9,89,2,0","0,0,25,69,6",,,,,132,,,,,,,,,,,,,,,23,,,,,,,,,,,,,,,,,,,,,42.1,2,16,110,83,,998,1,362,0,6,3,Eil,1,0,I1.000|4:36-I1.000|4:48-I1.000|4:53-I1.000|4:50-I1.000|4:46-I1.000|4:51-I1.000|4:35-I1.000|4:34-I1.000|4:30-I1.000|4:41-I1.000|5:01-I1.000|4:35-I1.000|4:33-I1.000|4:17-I1.000|4:21-I1.000|4:24-I1.000|4:32-I1.000|4:24-I1.000|4:34-I1.000|4:22-I1.000|4:39-I0.199|0:59,,,,,3113,,250,0,,0,168070,250480,30378,,11531927,,,,,,,,,,,,,,,,,,,,,,,,,,,,,,,,,,,,,,,,4,
24147479,120846dc-9b38-49c4-821a-7bc0ef91cba0,1612802483,60,1612802931,,0,0,14.66,3782,3872,60,73,,,0,0,0.1,1.09,0.93,,875,151,169,,,,64.72,49.07,64.97,1,60.36,1728,,,3.6,0.2,103,103,,,,,,111,83,13.96,14,14.03,-2.5,-5.2,353,353,,1,356,356,,,,,,,,,"0,0,0,1,18,72,8,0,0","0,6,90,4,0","0,0,3,88,9",,,,,140,,,,,,,,,,,,,,,16,,,,,,,,,,,,,,,,,,,,,48,-2,10,73,84,,1000,0,361,0,4,3,"Porz am Rhein",1,0,I1.000|4:55-I1.000|4:23-I1.000|4:20-I1.000|4:19-I1.000|4:17-I1.000|4:16-I1.000|4:20-I1.000|4:32-I1.000|4:08-I1.000|4:11-I1.000|4:11-I1.000|4:13-I1.000|4:07-I1.000|4:02-I0.657|2:46,,,,,3113,,250,0,,0,168070,250480,30378,,11566162,,,,,,,,,,,,,,,,,,,,,,,,,,,,,,,,,,,,,,,,,
24180536,f605b296-5365-4768-a965-55649309f2e2,1612888594,60,1612889616,,0,0,16.55,4296,4406,88,71,,,0,0,0.12,1.15,0.93,683,1185,171,194,,,,53.31,49.19,53.73,1,59.77,5088,,,5,4.3,99,96,,,,,,189,83,13.96,13.91,14.03,-0.3,0.8,353,353,,1,356,356,,,,,,,,,"0,0,0,1,25,62,11,0,0","0,2,12,66,21","0,0,4,90,6",,,,,139,,,,,,,,,,,,,,,16,,,,,,,,,,,,,,,,,,,,,127.9,-4,11,42,70,,1009,0,341,0,3,3,"Porz am Rhein",1,0,I1.000|4:41-I1.000|4:27-I1.000|4:30-I1.000|4:23-I1.000|4:18-I1.000|4:25-I1.000|4:22-I1.000|4:25-I1.000|4:18-I1.000|4:09-I1.000|4:05-I1.000|4:21-I1.000|4:17-I1.000|4:15-I1.000|4:14-I1.000|4:05-I0.548|2:22,,,,,3113,,250,0,,0,168070,250480,30378,,11595133,,,,,,,,,,,,,,,,,,,,,,,,,,,,,,,,,,,,,,,,5,
24213045,1123b6dc-497d-4f2e-8baa-22daf7f58b5b,1612974364,60,1612976333,,0,0,3.15,1270,1270,41,4,,,0,0.1,0.26,1.27,,,283,146,165,104,,,39.06,26.15,40.26,1,59.6,3710,,,2.5,0,95,90,,,,,,31,80,9.28,9.11,9.62,11.8,18.6,220,220,,1,231,231,,,,,,,,,"53,28,17,0,1,0,0,0,0","1,21,73,5,0","2,33,64,1,0",,,,,93,,,,,,,,,,,,,,,20,,,,,,,,,,,,,,,,,,,,,29.6,-3,13,12,74,,1015,0,367,0,3,3,"Porz am Rhein",1,0,I1.000|6:25-I1.000|7:03-I1.000|6:47-I0.147|0:55,,,,,3113,,250,0,,0,168070,250480,30378,,11623204,,,,,,,,,,,,,,,,,,,,,,,,,,,,,,,,,,,,,,,,,
24213070,008c47f9-74dc-4439-ad6e-3278b21196f7,1612975997,60,1612976386,,0,0,13.04,3605,3692,119,131,,,0,1.1,0.36,1.12,0.96,,919,166,192,,,,51.68,44.88,52.2,1,59.32,5760,,,4.6,3.3,98,97,,,,,,146,82,13.11,13.1,13.31,0.4,-2.1,326,326,,1,334,334,,,,,,,,,"1,0,1,11,56,29,2,0,0","0,2,23,63,11","0,0,29,63,8",,,,,132,,,,,,,,,,,,,,,17,,,,,,,,,,,,,,,,,,,,,104.1,-3,12,12,75,,1016,0,370,0,3,3,"Porz am Rhein",1,0,I1.000|4:31-I1.000|4:27-I1.000|4:27-I1.000|4:34-I1.000|4:25-I1.000|4:48-I1.000|4:23-I1.000|4:45-I1.000|4:27-I1.000|4:39-I1.000|4:42-I1.000|4:47-I1.000|4:56-I0.040|0:14,,,,,3113,,250,0,,0,168070,250480,30378,,11623228,,,,,,,,,,,,,,,,,,,,,,,,,,,,,,,,,,,,,,,,,
24247470,e991f3ea-781f-4305-a3a4-e8862cf4a2fa,1613067602,60,1613065770,,0,0,5.43,1599,1599,37,32,,,0,0,0.15,1.1,0.97,,344,140,162,,,,60.88,39.35,61.47,1,59.71,3857,,,2.6,0,103,101,,,,,,23,80,12.33,12.29,12.39,6.8,7.3,304,304,,1,306,306,,,,,,,,,"1,0,3,29,65,2,0,0,0","2,41,57,1,0","0,0,50,50,0",,,,,127,,,,,,,,,,,,,,,13,,,,,,,,,,,,,,,,,,,,,31.5,-3,9,59,73,,1031,0,358,1,2,3,"Porz am Rhein",1,0,I1.000|5:19-I1.000|4:49-I1.000|4:47-I1.000|4:42-I1.000|4:52-I0.429|2:10,,,,,3113,,250,0,,0,168070,250480,30378,,11654409,,,,,,,,,,,,,,,,,,,,,,,,,,,,,,,,,,,,,,,,,
24269998,cc87abd6-76cb-4c69-99ce-7347f4417dcd,1613130150,60,1613132472,,0,0,20.16,5446,5761,168,130,,,0,0.5,0.23,1.08,0.97,261,1244,156,187,,,,58.35,47.72,59.09,1,59.58,4399,,,3.9,2.2,97,99,,,,,,103,83,13.51,13.36,13.62,-0.7,1.7,338,338,,1,343,343,,,,,,,,,"0,0,0,4,44,49,1,0,0","20,11,41,28,1","0,0,13,82,5",,,,,134,,,,,,,,,,,,,,,,,,,,,,,,,,,,,,,,,,,,66.6,-1,17,95,53,,1033,1,370,0,3,3,"Porz am Rhein",1,0,I1.000|4:41-I1.000|4:24-I1.000|4:37-I1.000|4:31-I1.000|4:29-I1.000|4:28-I1.000|4:34-I1.000|4:35-I1.000|4:34-I1.000|4:50-I1.000|4:32-I1.000|4:28-I1.000|4:21-I1.000|4:22-I1.000|4:20-I1.000|4:23-I1.000|4:23-I1.000|4:31-I1.000|4:29-I1.000|4:32-I0.155|0:42,,,,,3113,,250,0,,0,168070,250480,30378,,11674710,,,,,,,,,,,,,,,,,,,,,,,,,,,,,,,,,,,,,,,,4,
24306434,c93b4d30-b5cd-4b48-a8ba-ccf4a4eea313,1613216947,60,1613217855,,0,0,13.63,3607,3894,119,122,,,0,0.5,0.27,1.2,0.95,396,841,154,173,,,,60.98,47.38,61.62,1,59.62,3744,,,3.6,0.3,100,100,,,,,,117,82,13.68,13.68,14,0.4,0.7,343,343,,1,354,354,,,,,,,,,"0,0,0,5,28,62,5,0,0","1,3,72,25,0","0,0,14,75,11",,,,,138,,,,,,,,,,,,,,,19,,,,,,,,,,,,,,,,,,,,,58.8,-1,17,114,51,,1039,1,387,0,2,3,"Porz am Rhein",1,0,I1.000|4:52-I1.000|4:22-I1.000|4:25-I1.000|4:27-I1.000|4:29-I1.000|4:34-I1.000|4:25-I1.000|4:08-I1.000|4:18-I1.000|4:10-I1.000|4:09-I1.000|4:16-I1.000|4:24-I0.633|3:08,,,,,3113,,250,0,,0,168070,250480,30378,,11708512,,,,,,,,,,,,,,,,,,,,,,,,,,,,,,,,,,,,,,,,5,
24345865,8d394d89-d17e-4c09-b47d-d1e260ee993f,1613309640,60,1613310701,,0,0,16.52,4282,4593,170,115,,,0,1,0.21,1.19,0.97,419,1010,158,172,,,,60.28,49.26,61.29,1,59.67,4320,,,4.1,0,103,100,,,,,,148,83,14.11,13.92,14.63,-3.5,-6.2,359,359,,1,375,375,,,,,,,,,"0,0,0,2,23,63,12,0,0","1,3,59,38,0","0,1,8,79,12",,,,,139,,,,,,,,,,,,,,,20,,,,,,,,,,,,,,,,,,,,,68.2,3,20,138,40,,1038,1,357,0,3,3,"Porz am Rhein",1,0,I1.000|4:24-I1.000|4:14-I1.000|4:23-I1.000|4:14-I1.000|4:18-I1.000|4:24-I1.000|4:24-I1.000|4:33-I1.000|4:14-I1.000|4:11-I1.000|4:09-I1.000|4:25-I1.000|4:29-I1.000|4:08-I1.000|4:18-I1.000|4:16-I0.516|2:19,,,,,3113,,250,0,,0,168070,250480,30378,,11742383,,,,,,,,,,,,,,,,,,,,,,,,,,,,,,,,,,,,,,,,"4,4",
24398487,d4575205-1fab-459c-9f88-28c988b609ac,1613406097,60,1613421416,,0,0,10.02,3131,3142,271,220,,,0,3.5,0.86,1.01,1.01,488,691,151,164,,,,51.08,38.15,53.11,1,59.49,2989,,,3.4,0,100,98,,,,,,93,82,12.34,11.85,12.56,-2.1,8.7,299,299,,1,310,310,,,,,,,,,"12,11,14,19,28,15,1,0,0","0,14,80,6,0","0,7,42,48,3",,,,,117,,,,,,,,,,,,,,,18,,,,,,,,,,,,,,,,,,,,,46.6,1,18,186,91,,1025,0,336,0,4,3,Balve,1,0,I1.000|4:56-I1.000|5:46-I1.000|5:50-I1.000|5:47-I1.000|6:19-I1.000|5:05-I1.000|4:46-I1.000|4:33-I1.000|4:34-I1.000|4:26-I0.024|0:08,,,,,3113,,250,0,,0,168070,250480,30378,,11790340,,,,,,,,,,,,,,,,,,,,,,,,,,,,,,,,,,,,,,,,4,
24405280,,1613408400,60,1613462321,,0,0,5,1500,1500,,,,,0,,,,,,359,,,,,,,38.31,,1,,,,,,,,,,,,,,35,,,,,,,,,,,,,,,,,,,,,,,,,,,,,,,,,,,,,,,,,,,,,,,,,,,,,,,,,,,,,,,,,,,,,,,,,,1,,,0,0,,,,,,connect,,,0,,0,168070,250480,30378,,11796645,,,,,,,,,,,,,,,,,,,,,,,,,,,,,,,,,,,,,,,,,
24421948,e954ab2c-5ab2-4db2-a648-5ed02f3abbc6,1613491272,60,1613490349,,0,0,8.75,2567,2645,135,133,,,0,1.7,0.53,1.01,1,816,541,145,162,,,,58.38,40.7,59.52,1,59.24,1879,,,3,0,103,97,,,,,,67,81,12.6,12.4,12.77,0.2,2.2,308,308,,1,316,316,,,,,,,,,"2,3,8,32,36,18,2,0,0","1,32,66,1,0","0,1,43,54,2",,,,,126,,,,,,,,,,,,,,,16,,,,,,,,,,,,,,,,,,,,,37.7,5,17,177,91,,1015,0,323,0,3,3,Balve,1,0,I1.000|4:34-I1.000|5:08-I1.000|5:25-I1.000|4:53-I1.000|4:56-I1.000|4:40-I1.000|5:01-I1.000|4:59-I0.751|3:12,,,,,3113,,250,0,,0,168070,250480,30378,,11809361,,,,,,,,,,,,,,,,,,,,,,,,,,,,,,,,,,,,,,,,5,
24466212,a68cedfc-6e9c-44e1-8d95-87b9d388a222,1613575735,60,1613576831,,0,0,13.49,3967,4646,377,360,,,0,4.4,0.79,1.03,1.07,509,807,150,171,,,,55.57,41.88,57.58,1,58.92,1921,,,3.6,0.1,100,98,,,,,,117,81,13.15,12.58,13.44,-5.6,7.3,315,315,,1,330,330,,,,,,,,,"9,7,9,15,29,25,4,1,0","1,26,43,31,0","0,3,37,50,9",,,,,126,,,,,,,,,,,,,,,15,,,,,,,,,,,,,,,,,,,,,61.2,8,13,217,85,,1018,0,374,0,4,3,Balve,1,0,I1.000|4:39-I1.000|5:06-I1.000|5:24-I1.000|5:06-I1.000|5:38-I1.000|6:02-I1.000|4:31-I1.000|4:28-I1.000|4:14-I1.000|4:20-I1.000|4:28-I1.000|5:31-I1.000|4:41-I0.493|1:58,,,,,3113,,250,0,,0,168070,250480,30378,,11847209,,,,,,,,,,,,,,,,,,,,,,,,,,,,,,,,,,,,,,,,"3,4",
24515958,,1613666136,60,1613684165,,0,0,13,3600,0,,,,,0,,,,,,932,,,,,,,44.79,,1,,,,,,,,,,,,,,87,,,,,,,,,,,,,,,,,,,,,,,,,,,,,,,,,,,,,,,,,,,,,,,,,,,,,,,,,,,,,,,,,,,,,,,,,,1,,,0,0,,,,,,connect,,,0,,0,168070,250480,30378,,11891725,,,,,,,,,,,,,,,,,,,,,,,,,,,,,,,,,,,,,,,,,
24539891,e6560c29-44f2-4fda-be74-cc43eb696bab,1613752160,60,1613751962,,0,0,11.32,3241,3351,299,333,,,0,4,0.73,0.99,1.05,775,685,151,174,,,,56.9,42.64,58.55,1,58.74,1590,,,3.5,0.6,103,98,,,,,,100,81,13.4,13.07,13.77,-4.5,4.7,322,322,,1,338,338,,,,,,,,,"4,12,13,12,17,26,14,1,0","1,26,37,36,0","0,5,27,59,9",,,,,129,,,,,,,,,,,,,,,19,,,,,,,,,,,,,,,,,,,,,69.9,8,14,187,82,,1017,0,343,0,3,3,Balve,1,0,I1.000|4:20-I1.000|5:30-I1.000|5:44-I1.000|5:57-I1.000|5:24-I1.000|4:34-I1.000|4:42-I1.000|4:19-I1.000|4:15-I1.000|3:47-I1.000|3:51-I0.318|1:41,,,,,3113,,250,0,,0,168070,250480,30378,,11911784,,,,,,,,,,,,,,,,,,,,,,,,,,,,,,,,,,,,,,,,3,
24569790,7cbcf5b3-531f-4221-8677-056236747d9b,1613821196,60,1613825253,,0,0,18.34,5787,6405,517,492,,,0,5,0.81,1.05,1.06,466,1273,161,182,117,,,45.99,39.54,47.67,1,58.21,4353,,,4.8,2,100,96,,,,,,221,82,12.24,11.8,12.63,-4.3,4.7,290,290,,1,305,305,,,,,,,,,"13,12,16,22,22,12,3,0,0","0,4,41,52,2","0,9,45,41,5",,,,,116,,,,,,,,,,,,,,,16,,,,,,,,,,,,,,,,,,,,,102.8,11,21,178,74,,1016,2,303,0,3,3,Balve,1,0,I1.000|4:59-I1.000|5:52-I1.000|5:55-I1.000|5:27-I1.000|5:24-I1.000|6:09-I1.000|4:49-I1.000|5:29-I1.000|6:07-I1.000|4:53-I1.000|5:33-I1.000|6:20-I1.000|5:32-I1.000|4:45-I1.000|4:27-I1.000|4:41-I1.000|4:27-I1.000|4:04-I0.338|1:33,,,,,3113,,250,0,,0,168070,250480,30378,,11936838,,,,,,,,,,,,,,,,,,,,,,,,,,,,,,,,,,,,,,,,"3,4",
24617234,1731d0ad-0610-4a9a-99e1-555f170e84dc,1613905421,60,1613913015,,0,0,72.32,10867,10867,1068,1079,,,0,3.9,0.48,1.67,0.85,620,1477,130,169,112,,,,,,1,58.21,3560,,,3.3,2.1,,100,,,,,,201,,,30.64,,5.5,-14.2,139,112,,1,180,169,,,,,,,,,"23,17,16,11,12,9,12","4,66,28,2,0","48,34,14,3,0",,,,,,,,,,,,,,,,,,,,17,,,,,,,,,,,,,,,,,,,,,38.9,13,19,186,60,,1017,2,291,0,2,3,Balve,1,0,I5.000|19:58-I5.000|10:52-I5.000|20:27-I5.000|8:25-I5.000|9:50-I5.000|8:18-I5.000|8:50-I5.000|18:38-I5.000|7:52-I5.000|9:29-I5.000|15:17-I5.000|14:05-I5.000|14:14-I5.000|8:12-I2.320|6:39,,,,,3113,,250,0,,0,168072,,30378,,11977070,,,,,,,,,,,,,,,,,,,,,,,,,,,,,,,,,,,,,,,,"4,4,4,4,5,5,5",
24631525,5842dada-69c6-4a4d-80ce-deacaa7faf09,1613928950,60,1613927032,,0,0,4.87,1411,1411,56,72,,,0,1.2,0.58,0.99,1.02,,330,153,168,129,,,55.04,39.86,55.6,1,58.17,4343,,,3,0,99,100,,,,,,43,79,12.52,12.57,12.58,-1.3,5.5,305,305,,1,308,308,,,,,,,,,"2,2,6,34,29,26,1,0,0","1,2,80,17,0","0,0,45,55,0",,,,,131,,,,,,,,,,,,,,,19,,,,,,,,,,,,,,,,,,,,,47.5,11,12,185,68,,1017,0,293,0,2,3,Balve,1,0,I1.000|5:04-I1.000|5:03-I1.000|5:14-I1.000|4:21-I0.865|3:50,,,,,3113,,250,0,,0,168070,250480,30378,,11988298,,,,,,,,,,,,,,,,,,,,,,,,,,,,,,,,,,,,,,,,,
24665142,de3104e0-f8fa-4d92-b1ba-fdc3e85af5b4,1614006396,60,1614006970,,0,0,13,3776,4026,341,328,,,0,3.8,0.77,1.01,1.03,472,758,148,167,102,,,57.48,42.37,59.42,1,58.23,3168,,,3.4,0.3,100,100,,,,,,104,80,13.06,12.78,13.37,-9.2,-4.4,315,315,,1,325,325,,,,,,,,,"4,8,11,22,17,32,7,0,0","0,25,69,6,0","0,2,39,51,8",,,,,129,,,,,,,,,,,,,,,15,,,,,,,,,,,,,,,,,,,,,50.8,17,12,200,50,,1022,1,291,0,3,3,Balve,1,0,I1.000|5:08-I1.000|5:39-I1.000|5:34-I1.000|5:21-I1.000|5:53-I1.000|4:41-I1.000|4:26-I1.000|4:16-I1.000|4:12-I1.000|4:16-I1.000|4:15-I1.000|4:05-I0.997|5:10,,,,,3113,,250,0,,0,168070,250480,30378,,12017062,,,,,,,,,,,,,,,,,,,,,,,,,,,,,,,,,,,,,,,,"4,4",
24693904,5ea3406e-cb3f-4dd1-9d08-b1b14eacd656,1614087110,60,1614088317,,0,0,19.93,4668,4669,336,331,,,0,3.5,0.47,1.1,1.44,471,604,115,165,,,,,,,1,58.23,1815,,,2.4,1.5,,100,,,,,,61,,,29.24,,-54.7,-95.3,170,89,,1,266,225,,,,,,,,,"51,14,13,5,3,2,12","33,50,14,2,0","68,14,9,5,4",,,,,,,,,,,,,,,,,,,,19,,,,,,,,,,,,,,,,,,,,,32.4,17,16,211,61,,1031,2,317,0,2,3,Balve,1,0,I5.000|38:23-I5.000|12:51-I5.000|11:03-I4.931|15:31,,,,,3113,,250,0,,0,168072,,30378,,12041892,,,,,,,,,,,,,,,,,,,,,,,,,,,,,,,,,,,,,,,,"4,4,5,5",
24698369,2361c7cd-8fa4-40c8-b616-470bc300b65b,1614097741,60,1614098351,,0,0,10.35,2973,3161,297,296,,,0,3.5,0.84,0.97,1.07,496,637,150,172,,,,57.2,42.2,59.24,1,58.21,3752,,,3.4,0,102,100,,,,,,85,80,13.5,13.08,13.66,-8.4,3.8,324,324,,1,334,334,,,,,,,,,"5,11,12,23,15,17,17,2,0","1,18,54,28,0","0,0,36,55,9",,,,,131,,,,,,,,,,,,,,,15,,,,,,,,,,,,,,,,,,,,,52.8,15,14,197,69,,1031,0,307,0,3,3,Balve,1,0,I1.000|5:07-I1.000|5:27-I1.000|5:09-I1.000|4:58-I1.000|5:46-I1.000|5:37-I1.000|4:29-I1.000|3:55-I1.000|3:57-I1.000|3:42-I0.347|1:25,,,,,3113,,250,0,,0,168070,250480,30378,,12045870,,,,,,,,,,,,,,,,,,,,,,,,,,,,,,,,,,,,,,,,4,
24739909,c49a78bb-c4fe-4d99-990f-d3f7bb3f2a4b,1614178379,60,1614186947,,0,0,83.22,11939,12013,1552,1564,,,0,5.2,0.66,1.52,0.72,747,1630,132,167,111,,,,,,1,58.21,2592,,,3.4,1.7,,100,,,,,,223,,,31.59,,-4,-8.8,159,127,,1,184,173,,,,,,,,,"18,22,19,10,8,8,14","2,64,33,1,0","37,40,21,2,0",,,,,,,,,,,,,,,,,,,,13,,,,,,,,,,,,,,,,,,,,,37.9,15,12,189,69,,1029,0,286,0,2,3,Balve,1,0,I5.000|12:19-I5.000|9:52-I5.000|12:31-I5.000|13:32-I5.000|18:25-I5.000|6:42-I5.000|8:02-I5.000|12:03-I5.000|16:02-I5.000|13:18-I5.000|7:03-I5.000|11:55-I5.000|10:34-I5.000|10:12-I5.000|15:57-I5.000|10:36-I3.222|9:56,,,,,3113,,250,0,,0,168072,,30378,,12080646,,,,,,,,,,,,,,,,,,,,,,,,,,,,,,,,,,,,,,,,"3,3,4,4,4,5,5,5,5,5,5",
24765832,b82a3a49-9636-4a76-9095-96353ffe1ec2,1614255626,60,1614255303,,0,0,10.47,3085,3130,236,223,,,0,3.1,0.77,0.94,1.04,440,657,148,161,,,,56.47,41,58.13,1,58.23,1728,,,3.3,0,102,100,,,,,,82,80,12.91,12.66,13,-6.4,4.2,312,312,,1,318,318,,,,,,,,,"5,12,15,20,12,28,8,0,0","0,15,84,0,0","0,1,32,65,2",,,,,127,,,,,,,,,,,,,,,18,,,,,,,,,,,,,,,,,,,,,43.8,16,13,237,67,,1028,2,288,0,2,3,Balve,1,0,I1.000|5:00-I1.000|5:39-I1.000|5:59-I1.000|5:28-I1.000|5:46-I1.000|4:36-I1.000|4:10-I1.000|4:09-I1.000|4:11-I1.000|4:14-I0.474|2:13,,,,,3113,,250,0,,0,168070,250480,30378,,12101783,,,,,,,,,,,,,,,,,,,,,,,,,,,,,,,,,,,,,,,,4,
24805893,051894f5-d5f0-4bc3-a7d4-3e1666ba5f47,1614335617,60,1614335364,,0,0,10.14,3067,3208,331,313,,,0,4.5,0.78,1.02,1.11,664,619,147,172,,,,55.19,39.67,57.54,1,58.16,1440,,,3.3,0.4,101,100,,,,,,74,81,13.15,12.53,13.63,-11.2,2.2,312,312,,1,328,328,,,,,,,,,"17,6,7,21,15,21,11,0,0","1,28,54,17,0","0,3,40,48,9",,,,,122,,,,,,,,,,,,,,,15,,,,,,,,,,,,,,,,,,,,,57.8,6,9,339,88,,1033,1,324,0,6,3,Balve,1,0,I1.000|5:04-I1.000|5:19-I1.000|5:02-I1.000|6:46-I1.000|6:06-I1.000|5:33-I1.000|4:00-I1.000|4:00-I1.000|4:15-I1.000|4:22-I0.136|0:39,,,,,3113,,250,0,,0,168070,250480,30378,,12137797,,,,,,,,,,,,,,,,,,,,,,,,,,,,,,,,,,,,,,,,"3,5",
24859887,3721b1b3-96d3-4f61-bd7e-d867ec7519e5,1614434093,60,1614439071,,0,0,48.1,7192,8154,912,913,,,0,4.3,0.62,,,880,1904,,,,,,,,,1,58.16,0,,,,,,,,,,,,98,,,29.19,,,,141,117,,1,168,160,,,,,,,,,"20,25,15,13,11,7,9",,"41,43,16,1,0",,,,,,,,,,,,,,,,,,,,,,,,,,,,,,,,,,,,,,,,,,7,8,5,78,,1040,1,355,0,4,3,Balve,1,0,I5.000|15:24-I5.000|13:57-I5.000|9:00-I5.000|16:02-I5.000|9:36-I5.000|13:22-I5.000|10:27-I5.000|12:43-I5.000|12:00-I3.104|7:20,,,,,Edge_130,,336,0,,0,168072,,30378,,12186321,,,,,,,,,,,,,,,,,,,,,,,,,,,,,,,,,,,,,,,,"4,4,4,4,5,5,5",
24907106,56d4de57-acca-44c8-a27d-9bc9dd0c275e,1614518055,60,1614525468,,0,0,72.91,10301,10768,1136,1145,,,0,4.3,0.64,,,727,2752,,,,,,,,,1,58.16,0,,,,,,,,,,,,117,,,31.63,,,,136,119,,1,158,152,,,,,,,,,"19,21,16,12,13,8,12",,"35,54,12,0,0",,,,,,,,,,,,,,,,,,,,,,,,,,,,,,,,,,,,,,,,,,8,9,25,65,,1036,1,361,0,3,3,Balve,1,0,I5.000|12:12-I5.000|10:53-I5.000|11:24-I5.000|15:01-I5.000|12:08-I5.000|5:43-I5.000|15:13-I5.000|15:41-I5.000|9:23-I5.000|12:53-I5.000|12:17-I5.000|11:13-I5.000|10:29-I5.000|10:27-I2.909|6:46,,,,,Edge_130,,336,0,,0,168072,,30378,,12228066,,,,,,,,,,,,,,,,,,,,,,,,,,,,,,,,,,,,,,,,"4,4,4,4,5,5,5",
24953991,0ee97630-7346-40f2-a959-ee274c9610e0,1614613969,60,1614614896,,0,0,12.48,4105,4449,286,293,,,0,3.5,0.73,1.09,1,510,772,141,166,,,,52.62,36.52,54.08,1,58.25,1338,,,3.3,0,102,100,,,,,,90,81,11.41,11.22,12.06,10.3,20.8,274,274,,1,299,299,,,,,,,,,"12,14,31,22,13,8,1,0,0","1,39,58,2,0","0,15,48,32,5",,,,,113,,,,,,,,,,,,,,,17,,,,,,,,,,,,,,,,,,,,,36,12,6,78,50,,1032,1,368,0,2,3,Balve,1,0,I1.000|5:02-I1.000|5:41-I1.000|5:25-I1.000|5:21-I1.000|5:45-I1.000|4:43-I1.000|4:22-I1.000|5:53-I1.000|5:57-I1.000|5:36-I1.000|6:15-I1.000|5:43-I0.482|2:42,,,,,3113,,250,0,,0,168070,250480,30378,,12270563,,,,,,,,,,,,,,,,,,,,,,,,,,,,,,,,,,,,,,,,"4,5",
24999222,713d7e7b-52f5-4ce4-b769-9033c6a4b88d,1614702938,60,1614703752,,0,0,13.19,3180,3503,123,125,,,0,0.3,0.26,1.09,0.98,,787,163,176,117,,,62.92,52.66,63.63,1,58.99,2304,,,4.1,1.8,104,102,,,,,,113,83,15.05,15.04,15.18,0.2,-0.2,382,382,,1,386,386,,,,,,,,,"0,0,0,0,8,39,52,1,0","0,2,18,79,0","0,0,3,66,31",,,,,150,,,,,,,,,,,,,,,13,,,,,,,,,,,,,,,,,,,,,75.7,12,9,175,63,,1031,0,346,0,2,3,Balve,1,0,I1.000|4:21-I1.000|4:18-I1.000|4:01-I1.000|4:18-I1.000|4:00-I1.000|4:12-I1.000|3:54-I1.000|3:47-I1.000|3:52-I1.000|3:53-I1.000|3:54-I1.000|3:44-I1.000|3:49-I0.194|0:57,,,,,3113,,250,0,,0,168070,250480,30378,,12309726,,,,,,,,,,,,,,,,,,,,,,,,,,,,,,,,,,,,,,,,,
25040975,cb155e8d-96c0-464c-bbfa-c6bcc6b91d46,1614790779,60,1614790376,,0,0,9.9,2906,3123,308,304,,,0,4.1,0.74,0.98,1.05,507,616,150,175,,,,55.69,41.02,57.87,1,59.06,1728,,,3.4,0.6,103,100,,,,,,86,81,13.48,12.83,13.71,-9.3,-1,321,321,,1,332,332,,,,,,,,,"15,7,6,8,30,21,13,0,0","0,29,44,27,0","0,2,34,56,7",,,,,126,,,,,,,,,,,,,,,17,,,,,,,,,,,,,,,,,,,,,63.1,12,8,242,65,,1026,0,343,0,3,3,Balve,1,0,I1.000|4:51-I1.000|4:45-I1.000|4:56-I1.000|6:11-I1.000|6:11-I1.000|5:35-I1.000|4:07-I1.000|3:58-I1.000|4:05-I0.901|3:48,,,,,3113,,250,0,,0,168070,250480,30378,,12345634,,,,,,,,,,,,,,,,,,,,,,,,,,,,,,,,,,,,,,,,"3,5",
25077840,01b3402f-1b2b-48c0-b3b9-f30e1a8ced31,1614873903,60,1614874279,,0,0,13,3722,3851,249,244,,,0,2.8,0.72,1.02,1.05,416,809,150,178,,,,57.43,43.08,58.82,1,58.79,1742,,,3.5,1.1,100,99,,,,,,110,81,13.06,13.02,13.28,-9.2,-8.6,320,320,,1,330,330,,,,,,,,,"3,11,16,15,11,32,13,0,0","0,24,63,13,0","0,0,33,60,7",,,,,129,,,,,,,,,,,,,,,19,,,,,,,,,,,,,,,,,,,,,57.4,4,10,326,91,,1019,0,331,0,6,3,Balve,1,0,I1.000|5:22-I1.000|5:41-I1.000|5:36-I1.000|5:42-I1.000|5:45-I1.000|4:47-I1.000|4:19-I1.000|4:11-I1.000|4:10-I1.000|4:13-I1.000|4:04-I1.000|3:59-I1.000|4:10-I0.002|0:01,,,,,3113,,250,0,,0,168070,250480,30378,,12377683,,,,,,,,,,,,,,,,,,,,,,,,,,,,,,,,,,,,,,,,4,
25113858,790917b7-73ac-4bd1-acd6-659a2f20c467,1614954503,60,1614955418,,0,0,14.3,4054,4193,362,338,,,0,4.1,0.75,1,1.06,461,864,152,187,,,,57.06,43.9,58.97,1,58.58,1997,,,3.7,1.4,102,99,,,,,,125,81,13.51,13.14,13.82,-11.2,-5.1,329,329,,1,342,342,,,,,,,,,"6,8,10,19,15,25,17,1,0","0,15,55,29,0","0,0,33,59,8",,,,,131,,,,,,,,,,,,,,,19,,,,,,,,,,,,,,,,,,,,,59.5,4,13,32,59,,1029,1,380,0,2,3,Balve,1,0,I1.000|4:57-I1.000|5:23-I1.000|5:28-I1.000|5:09-I1.000|5:32-I1.000|5:50-I1.000|5:10-I1.000|4:09-I1.000|3:56-I1.000|4:02-I1.000|3:56-I1.000|4:15-I1.000|4:35-I1.000|4:00-I0.302|1:10,,,,,3113,,250,0,,0,168070,250480,30378,,12409781,,,,,,,,,,,,,,,,,,,,,,,,,,,,,,,,,,,,,,,,"4,4,5",
25156555,5889da54-2f8c-4b40-bdc2-0ffafda43e0c,1615049510,60,1615049794,,0,0,13.23,3674,3727,236,243,,,0,3.3,0.63,0.91,1.01,670,812,152,175,,,,58.54,44.7,59.79,1,59.06,1584,,,3.5,0.3,101,102,,,,,,111,80,13.68,13.8,13.82,-13,-13.1,332,332,,1,345,345,,,,,,,,,"8,3,9,16,14,17,30,2,0","0,15,63,22,0","0,1,28,58,12",,,,,135,,,,,,,,,,,,,,,16,,,,,,,,,,,,,,,,,,,,,68.1,4,7,13,62,,1032,0,394,0,3,3,Balve,1,0,I1.000|5:01-I1.000|5:20-I1.000|7:54-I1.000|5:19-I1.000|5:00-I1.000|4:40-I1.000|4:08-I1.000|3:55-I1.000|4:00-I1.000|3:43-I1.000|3:47-I1.000|3:41-I1.000|3:43-I0.229|1:04,,,,,3113,,250,0,,0,168070,250480,30378,,12448354,,,,,,,,,,,,,,,,,,,,,,,,,,,,,,,,,,,,,,,,4,
25198543,272265b3-7f37-4bb4-a2ac-f6cb4331b1f8,1615124409,60,1615125447,,0,0,16,4352,4610,401,372,,,0,4.5,0.78,1.13,1.04,632,559,120,135,,,,81,46.47,83.73,1,59.06,1217,,,2,0,,100,,,,,,57,83,13.89,13.68,14.84,-6.1,-13.3,347,347,,1,379,379,,,,,,,,,"2,4,10,18,19,20,27,1,0","0,100,0,0,0","0,0,29,54,16",,,,,133,,,,,,,,,,,,,,,23,,,,,,,,,,,,,,,,,,,,,9.2,6,9,337,50,,1023,2,386,0,2,3,Balve,1,0,I1.000|4:59-I1.000|5:04-I1.000|5:43-I1.000|4:54-I1.000|5:38-I1.000|4:29-I1.000|3:58-I1.000|3:50-I1.000|3:55-I1.000|3:50-I1.000|3:59-I1.000|4:54-I1.000|4:13-I1.000|4:14-I1.000|3:58-I1.000|4:54-I0.003|0:02,,,,,3113,,250,0,,0,168070,250480,30378,,12484097,,,,,,,,,,,,,,,,,,,,,,,,,,,,,,,,,,,,,,,,"4,4,4,4",
25251793,eef6774c-c972-4fcd-b3f7-7161c775c881,1615227460,60,1615227975,,0,0,13.7,3883,3908,115,100,,,0,0.5,0.19,1.31,0.94,1018,778,142,156,,,,62.65,43.77,63.39,1,59.76,1222,,,3.1,0,103,102,,,,,,93,81,12.8,12.74,13.34,-3.9,-18.6,320,320,,1,338,338,,,,,,,,,"0,0,2,10,76,12,0,0,0","0,25,75,0,0","0,0,31,64,5",,,,,131,,,,,,,,,,,,,,,14,,,,,,,,,,,,,,,,,,,,,30.3,5,2,36,67,,1022,0,385,1,4,3,"Porz am Rhein",1,0,I1.000|5:13-I1.000|4:42-I1.000|4:41-I1.000|4:43-I1.000|4:38-I1.000|4:33-I1.000|4:37-I1.000|4:39-I1.000|4:38-I1.000|4:44-I1.000|4:42-I1.000|4:51-I1.000|4:38-I0.703|3:24,,,,,3113,,250,0,,0,168070,250480,30378,,12531264,,,,,,,,,,,,,,,,,,,,,,,,,,,,,,,,,,,,,,,,"4,5",
25293900,fba33d3e-9de3-4c87-8e66-efc7d8c0fbfe,1615311496,60,1615312377,,0,0,14.01,4119,4361,124,112,,,0,0.7,0.23,1.24,0.94,626,785,139,150,,,,61.57,42.02,62.31,1,59.94,1164,92,,3,0,103,100,,,,,,89,79,12.36,12.3,12.84,-3.2,0.1,306,306,,1,321,321,,,,,,,,,"0,1,7,35,47,9,1,0,0","0,52,48,0,0","0,0,52,42,5",,,,,129,,,,,,,,,,,,,,,17,,,,,,,,,,,,,,,,,,,,,26,7,9,270,83,,1018,0,350,0,3,3,"Porz am Rhein",1,0,I1.000|5:07-I1.000|4:45-I1.000|4:44-I1.000|4:52-I1.000|5:04-I1.000|5:09-I1.000|5:08-I1.000|5:03-I1.000|4:55-I1.000|4:57-I1.000|4:46-I1.000|4:26-I1.000|4:40-I1.000|5:01-I0.008|0:03,,,,,3113,,250,0,,0,168070,250480,30378,,12569472,,,,,,,,,,,,,,,,,,,,,,,,,,,,,,,,,,,,,,,,4,
25331573,99f80f01-ecd4-4774-8c48-0d2806e34569,1615398458,60,1615396622,,0,0,5.4,1571,1578,32,64,,,0,0.3,0.33,1.12,0.93,,338,141,154,,,,61.23,39.91,61.23,1,59.95,874,59,,2.5,0,101,100,,,,,,36,80,12.25,12.42,12.32,2.6,4.9,298,298,,1,301,301,,,,,,,,,"0,0,6,29,53,12,0,0,0","1,38,62,0,0","0,0,55,43,2",,,,,129,,,,,,,,,,,,,,,20,,,,,,,,,,,,,,,,,,,,,26.8,9,14,195,70,,1014,0,325,0,4,3,"Porz am Rhein",1,0,I1.000|5:08-I1.000|4:45-I1.000|4:43-I1.000|4:38-I1.000|4:54-I0.395|2:04,,,,,3113,,250,0,,0,168070,250480,30378,,12604698,,,,,,,,,,,,,,,,,,,,,,,,,,,,,,,,,,,,,,,,,
25383505,e5bf546d-3e45-4ff6-9fe0-c0c8973a5d09,1615482607,60,1615484395,,0,0,16.39,4654,5094,180,167,,,0,1.6,0.4,1.17,0.92,349,930,144,158,92,,,61.35,44.3,62.25,1,59.89,1375,121,,3.3,0,103,99,,,,,,118,81,12.81,12.71,13.15,-1.6,-3.5,317,317,,1,329,329,,,,,,,,,"0,0,1,18,64,17,0,0,0","1,17,82,0,0","0,1,40,52,7",,,,,130,,,,,,,,,,,,,,,22,,,,,,,,,,,,,,,,,,,,,34.2,10,28,254,70,,1001,0,370,0,6,3,"Porz am Rhein",1,0,I1.000|4:41-I1.000|4:31-I1.000|4:33-I1.000|4:51-I1.000|5:01-I1.000|4:49-I1.000|4:47-I1.000|4:43-I1.000|4:41-I1.000|4:36-I1.000|4:39-I1.000|4:51-I1.000|4:45-I1.000|4:31-I1.000|4:51-I1.000|4:49-I0.390|1:56,,,,,3113,,250,0,,0,168070,250480,30378,,12652710,,,,,,,,,,,,,,,,,,,,,,,,,,,,,,,,,,,,,,,,"5,5,5",
25424248,e6d4e0a8-eb22-4362-8da0-3b30a23e2c05,1615567943,60,1615568902,,0,0,13.72,4120,4270,60,85,,,0,0,0.18,1.07,0.98,,956,152,186,,,,53.15,40.93,53.32,1,59.44,2286,214,,3.9,1.7,100,98,,,,,,127,82,11.99,12.06,12.05,12.1,11.7,291,291,,1,294,294,,,,,,,,,"1,2,6,36,53,1,0,0,0","0,22,36,41,0","0,0,59,40,0",,,,,122,,,,,,,,,,,,,,,21,,,,,,,,,,,,,,,,,,,,,67.4,8,21,229,68,,1005,0,395,0,6,3,"Porz am Rhein",1,0,I1.000|5:01-I1.000|4:40-I1.000|5:04-I1.000|5:04-I1.000|5:14-I1.000|5:17-I1.000|5:00-I1.000|4:51-I1.000|4:56-I1.000|4:55-I1.000|4:50-I1.000|4:59-I1.000|4:57-I0.721|3:51,,,,,3113,,250,0,,0,168070,250480,30378,,12690622,,,,,,,,,,,,,,,,,,,,,,,,,,,,,,,,,,,,,,,,,
25461955,6a5ddbdb-0b13-4566-b09c-fa75a7400d4a,1615654149,60,1615652741,,0,0,5.61,1836,1956,87,50,,,0,1.2,0.43,1.14,0.94,829,352,133,151,,,,57.04,34.78,58.6,1,59.29,1139,45,,2.2,0,97,100,,,,,,28,79,11.32,11.13,11.7,4,9.4,271,271,,1,285,285,,,,,,,,,"16,6,10,55,13,0,0,0,0","1,79,20,0,0","0,7,69,22,3",,,,,116,,,,,,,,,,,,,,,21,,,,,,,,,,,,,,,,,,,,,19.5,9,33,249,63,,999,0,404,0,6,3,"Porz am Rhein",1,0,I1.000|6:39-I1.000|5:12-I1.000|5:11-I0.961|4:58-I1.000|5:12-I0.644|3:23,,,,,3113,,250,0,,0,168070,250480,30378,,12725079,,,,,,,,,,,,,,,,,,,,,,,,,,,,,,,,,,,,,,,,5,
25496404,611c760a-0b90-46af-9be9-42c0de693a92,1615723162,60,1615725921,,0,0,21.88,6015,6158,232,240,,,0,1.9,0.37,1.17,0.93,576,1306,154,183,,,,58.18,47.07,58.92,1,59.12,2549,266,,4.2,2.3,100,97,,,,,,168,83,13.22,13.14,13.65,1.9,-0.2,331,331,,1,346,346,,,,,,,,,"0,1,2,11,47,37,3,0,0","0,2,84,13,1","0,1,30,60,10",,,,,131,,,,,,,,,,,,,,,21,,,,,,,,,,,,,,,,,,,,,72,6,17,289,80,,1010,1,473,0,6,3,"Porz am Rhein",1,0,I1.000|4:47-I1.000|4:37-I1.000|4:43-I1.000|4:34-I1.000|4:39-I1.000|4:43-I1.000|4:36-I1.000|4:36-I1.000|4:26-I1.000|4:32-I1.000|4:36-I1.000|4:19-I1.000|4:51-I1.000|4:40-I1.000|4:24-I1.000|4:33-I1.000|4:35-I1.000|4:27-I1.000|4:32-I1.000|4:33-I1.000|4:29-I0.878|4:05,,,,,3113,,250,0,,0,168070,250480,30378,,12755420,,,,,,,,,,,,,,,,,,,,,,,,,,,,,,,,,,,,,,,,"4,5",
25563438,8ce0a37f-f834-4b4d-9429-904ac430a73c,1615834580,60,1615876289,,0,0,10.01,2946,2953,64,68,,,0,0.1,0.25,1.17,0.94,,604,142,158,,,,59.8,40.92,60.25,1,59.15,1280,89,,3,0,103,100,,,,,,70,81,12.29,12.26,12.43,-3.7,-8.9,302,302,,1,308,308,,,,,,,,,"0,0,2,26,71,1,0,0,0","0,33,67,0,0","0,0,51,45,4",,,,,126,,,,,,,,,,,,,,,17,,,,,,,,,,,,,,,,,,,,,30.2,5,17,311,79,,1016,0,443,1,3,3,"Porz am Rhein",1,0,U1.000|5:07-U1.000|4:51-U1.000|4:51-U1.000|4:51-U1.000|4:53-U1.000|4:51-U1.000|4:53-U1.000|4:46-U1.000|4:53-U1.000|5:07-U0.009|0:03,,,,,3113,,250,0,,0,168070,250480,30378,,12812345,,,,,,,,,,,,,,,,,,,,,,,,,,,,,,,,,,,,,,,,,
25588745,76baa827-5116-4f7f-a634-99309335c1da,1615919700,60,1615920371,,0,0,15.01,4079,4103,120,127,,,0,0.5,0.26,1.2,0.94,867,912,150,164,,,,61.25,46.29,61.82,1,59.38,1584,154,,3.6,0,102,100,,,,,,118,82,13.32,13.28,13.61,0.6,3.4,334,334,,1,345,345,,,,,,,,,"0,0,0,4,48,47,0,0,0","0,5,95,0,0","0,0,18,75,7",,,,,135,,,,,,,,,,,,,,,17,,,,,,,,,,,,,,,,,,,,,37.9,6,9,302,77,,1023,0,401,1,6,3,"Porz am Rhein",1,0,U1.000|4:57-U1.000|4:32-U1.000|4:37-U1.000|4:39-U1.000|4:37-U1.000|4:25-U1.000|4:22-U1.000|4:27-U1.000|4:31-U1.000|4:35-U1.000|4:18-U1.000|4:26-U1.000|4:31-U1.000|4:29-U1.000|4:34-U0.011|0:03,,,,,3113,,250,0,,0,168070,250480,30378,,12835388,,,,,,,,,,,,,,,,,,,,,,,,,,,,,,,,,,,,,,,,5,
25627158,68be34da-7040-469d-b8cd-32c74c36e765,1616005831,60,1616002914,,0,0,1.68,550,550,12,2,,,0,0,0,1.04,,,114,135,149,,,,55.96,31.68,56.87,1,59.21,452,23,,1.6,0,100,99,,,,,,10,81,11.23,11.02,11.28,0.8,0.7,274,274,,1,276,276,,,,,,,,,"5,1,38,54,2,0,0,0,0","2,85,13,0,0","0,2,80,18,0",,,,,113,,,,,,,,,,,,,,,19,,,,,,,,,,,,,,,,,,,,,14,5,9,351,64,,1025,0,389,0,3,3,"Porz am Rhein",1,0,U1.000|5:36-U0.681|3:34,,,,,3113,,250,0,,0,168070,250480,30378,,12866905,,,,,,,,,,,,,,,,,,,,,,,,,,,,,,,,,,,,,,,,,
25666193,fbb01f55-7b6a-4478-8dad-25a8a0e0fece,1616088625,60,1616089052,,0,0,14.64,3770,3844,96,114,,,0,0.4,0.29,1.11,0.94,,893,155,165,,,,62.49,49.17,62.9,1,59.72,1872,180,,3.8,0.1,103,102,,,,,,120,84,13.99,14.02,14.13,-2.2,-4,354,354,,1,360,360,,,,,,,,,"0,0,0,1,13,80,6,0,0","0,3,87,9,0","0,0,8,80,12",,,,,139,212,,121,87,,,,,,,,,,,33,,,,,,,,,,,,,,,,,,,,,51,6,7,313,67,,1020,0,402,0,4,3,"Porz am Rhein",1,0,U1.000|4:46-U1.000|4:27-U1.000|4:24-U1.000|4:22-U1.000|4:16-U1.000|4:12-U1.000|4:17-U1.000|4:16-U1.000|4:14-U1.000|4:16-U1.000|4:11-U1.000|4:11-U1.000|4:15-U1.000|4:01-U0.635|2:42,,,,,3113,,250,0,,0,168070,250480,30378,2689423,12902859,387,2,2,20,16,0.02,0.05,0.69,1.38,1.1,1.76,100,0,96,0.7,977,0,28.31,0,221,0,,,,,,,,,,,,,,,,,,,,
25694538,0bb4de35-9d6b-4ee2-ac4d-116d31146072,1616160106,60,1616160350,,0,0,13.68,3617,3661,69,66,,,0,0,0.21,1.08,0.96,,864,156,170,,,,59.92,47.44,60.31,1,59.55,2550,195,,4,0,96,101,,,,,,122,84,13.68,13.66,13.76,7.1,7.8,345,345,,1,348,348,,,,,,,,,"0,0,0,2,30,68,0,0,0","2,4,61,33,0","0,0,6,89,5",,,,,135,216,,119,88,,,,,,,,,,,33,,,,,,,,,,,,,,,,,,,,,58.7,8,19,30,53,,1024,2,424,0,3,3,"Porz am Rhein",1,0,U1.000|4:48-U1.000|4:26-U1.000|4:21-U1.000|4:18-U1.000|4:15-U1.000|4:11-U1.000|4:18-U1.000|4:28-U1.000|4:18-U1.000|4:23-U1.000|4:31-U1.000|4:26-U1.000|4:27-U0.675|3:09,,,,,3113,,250,0,,0,168070,250480,30378,2696724,12928241,384,2,2,44,32,0.02,0.13,0.83,1.43,1.18,2.2,100,0,90,0.9,,0,4.01,0,,0,,,,,,,,,,,,,,,,,,,,
25744312,2f3e8e55-8113-40e7-8cf9-e7b8ff3e4db2,1616263298,60,1616263542,,0,0,12.33,3502,3581,82,64,,,0,0,0.11,1.21,0.93,625,713,143,164,,,,61.91,43.31,62.53,1,59.58,1396,108,,3.2,0,97,101,,,,,,90,80,12.78,12.72,13.1,2,-4.7,318,318,,1,329,329,,,,,,,,,"0,0,0,17,70,12,0,0,0","3,15,81,1,0","0,0,34,64,2",,,,,132,,,,,,,,,,,,,,,32,,,,,,,,,,,,,,,,,,,,,35.7,6,8,347,45,,1026,0,326,0,3,3,"Porz am Rhein",1,0,U1.000|4:51-U1.000|4:33-U1.000|4:40-U1.000|4:40-U1.000|4:47-U1.000|4:38-U1.000|4:38-U1.000|4:37-U1.000|4:36-U1.000|4:45-U1.000|4:55-U1.000|5:00-U0.334|1:41,,,,,3113,,250,0,,0,168070,250480,30378,2702305,12972998,414,38,37,55,29,3.55,5.14,2.17,0.68,0.42,1.07,28,5,89,5.2,,0,35.2,0,151,0,,,,,,,,,,,,,,,,,,,5,
25770156,a84415cb-e1db-4399-8cf4-692890cad607,1616331579,60,1616333573,,0,0,16.49,4768,5417,81,81,,,0,0,0.13,1.13,0.98,,976,147,160,,,,58.34,43.4,58.7,1,59.47,1522,139,,3.5,0,100,100,,,,,,127,81,12.49,12.49,12.59,-3.3,-1.6,307,307,,1,311,311,,,,,,,,,"0,0,2,22,69,7,0,0,0","1,10,89,0,0","0,1,39,58,2",,,,,128,,,,,,,,,,,,,,,34,,,,,,,,,,,,,,,,,,,,,42,8,18,340,70,,1022,,,0,4,1,"Porz am Rhein",1,0,U1.000|4:58-U1.000|4:38-U1.000|5:00-U1.000|4:51-U1.000|4:53-U1.000|4:47-U1.000|4:47-U1.000|4:53-U1.000|4:48-U1.000|4:45-U1.000|4:44-U1.000|4:54-U1.000|4:47-U1.000|4:42-U1.000|4:46-U1.000|4:47-U0.490|2:28,,,,,3113,,250,0,,0,168070,250480,30378,2705539,12994313,408,26,25,31,14,1.96,3.98,0.57,0.6,0.38,1.56,7,21,86,2.7,,0,53.33,0,161,0,,,,,,,,,,,,,,,,,,,,
25819582,67ac3850-9961-4e73-bfef-e2229731c6e4,1616435373,60,1616436667,,0,0,16.17,4420,4572,120,127,,,0,0.4,0.25,1.13,0.96,740,933,147,157,105,,,62.54,46.25,63.08,1,59.8,1396,135,,3.4,0,103,100,,,,,,120,82,13.22,13.2,13.44,0.3,-2.2,331,331,,1,340,340,,,,,,,,,"0,0,0,6,53,40,0,0,0","1,9,90,0,0","0,0,21,73,6",,,,,134,,,,,,,,,,,,,,,32,,,,,,,,,,,,,,,,,,,,,41.1,8,7,315,59,,1025,0,349,0,3,3,Eil,1,0,U1.000|4:49-U1.000|4:46-U1.000|4:33-U1.000|4:38-U1.000|4:27-U1.000|4:33-U1.000|4:28-U1.000|4:41-U1.000|4:29-U1.000|4:22-U1.000|4:26-U1.000|4:40-U1.000|4:26-U1.000|4:26-U1.000|4:26-U1.000|4:43-U0.166|0:48,,,,,3113,,250,0,,0,168070,250480,30378,2710901,13036507,408,9,9,25,18,0.23,0.44,0.04,0.73,0.5,1.28,38,0,93,0.3,467,0,23.25,0,149,0,,,,,,,,,,,,,,,,,,,5,
25864016,a8a4dc08-d7ba-41c2-8768-d92758856bcf,1616521843,60,1616522472,,0,0,2.55,1029,1276,43,11,,,0,0.9,0.52,1.12,0.67,,171,124,193,,,,47.9,25.75,49.64,1,59.8,62,15,,1,0,,100,,,,,,33,80,9.3,9.15,9.71,-23.9,-17.9,215,215,,1,228,228,,,,,,,,,"45,34,21,0,0,0,0,0,0","3,61,0,6,30","7,14,75,3,0",,,,,93,,,,,,,,,,,,,,,28,,,,,,,,,,,,,,,,,,,,,11.2,10,3,228,54,,1024,0,364,0,3,3,"Porz am Rhein",1,0,U1.000|6:40-U1.000|7:02-U0.548|3:27,,,,,3113,,250,0,,0,168070,250480,30378,2717013,13074282,498,37,35,54,6,3.94,11.76,1.97,0.97,0.67,1.36,93,0,16,6.5,266,0,11.37,0,172,0,,,,,,,,,,,,,,,,,,,,
25864044,9603656d-198e-4c33-8e51-0ef6ab0eb65d,1616525583,60,1616522495,,0,0,0.89,343,343,41,0,,,0,1.8,1,1.33,0.89,430,65,127,133,,,,49.3,24.46,54.96,1,60.25,1547,10,,0.6,0,,100,,,,,,5,80,11.05,9.37,11.68,11.2,-0.8,280,280,,1,293,293,,,,,,,,,"41,50,8,0,0,0,0,0,0","0,100,0,0,0","0,16,41,39,4",,,,,97,,,,,,,,,,,,,,,31,,,,,,,,,,,,,,,,,,,,,8.2,10,4,232,56,,1025,0,367,1,3,3,"Porz am Rhein",1,0,,,,,,3113,,250,0,,0,168070,250480,30378,2717021,13074307,471,9,7,10,0,0.14,5.09,0,0.56,0.48,0.66,0,3,87,1.6,,0,2.76,0,118,0,,,,,,,,,,,,,,,,,,,5,
25864077,09981eb8-4024-4acc-bb9e-0073b90c909c,1616523312,60,1616522535,,0,0,6.71,1950,1950,8,29,,,0,0,0.07,,,,429,153,179,,,,54.83,40.47,54.7,1,60.25,1557,181,,3.1,2.9,104,102,,,,,,65,82,12.56,14.04,14.16,13,5.6,316,316,,1,372,372,,,,,,,,,"37,4,1,1,2,2,48,5,0","0,34,14,52,0","9,24,12,4,52",,,,,126,,,,,,,,,,,,,,,36,,,,,,,,,,,,,,,,,,,,,65.5,9,3,232,56,,1025,0,367,0,3,3,"Porz am Rhein",1,0,U0.990|3:40-U0.400|2:59-U1.010|3:38-U0.400|2:38-U0.990|3:33-U0.440|3:16-U1.020|3:44-U0.400|3:49-U0.990|3:40-U0.070|1:33,,,,,3113,,250,0,,0,168070,250480,30378,2717026,13074336,392,14,11,57,12,0.16,11.47,0.02,0.8,0.25,1.39,60,11,40,4,300,0,11.13,0,143,0,,,,,,,,,,,,,,,,,,,,
25910277,9847f1f7-9295-49b5-862a-7b7e9d8854bc,1616609496,60,1616611736,,0,0,13.67,4054,4600,109,91,,,0,0.8,0.31,1.15,0.97,,804,141,166,,,,59.8,41.52,60.48,1,60.21,1364,109,,3.2,0,103,99,,,,,,96,80,12.27,12.38,12.57,-1.3,1,299,299,,1,310,310,,,,,,,,,"11,3,1,15,52,17,0,0,0","1,29,69,1,0","0,6,41,50,3",,,,,126,,,,,,,,,,,,,,,15,,,,,,,,,,,,,,,,,,,,,36.2,13,5,281,55,,1021,0,327,0,3,3,"Porz am Rhein",1,0,U1.000|6:49-U1.000|5:31-U1.000|4:36-U1.000|4:28-U1.000|4:27-U1.000|4:33-U1.000|4:30-U1.000|4:42-U1.000|4:49-U1.000|4:53-U1.000|4:59-U1.000|4:56-U1.000|4:57-U0.667|3:25,,,,,3113,,250,0,,0,168070,250480,30378,,13113469,,,,,,,,,,,,,,,,,,,,,,,,,,,,,,,,,,,,,,,,,
25946114,904711d4-81c9-46a9-a686-6d0c23ad5cbe,1616690888,60,1616690289,,0,0,10.3,2837,2891,89,108,,,0,0,0.2,1.12,0.92,671,657,150,168,,,,60.24,44.31,60.75,1,60.08,1471,128,,3.4,0,103,100,,,,,,80,81,13.09,13.09,13.29,2.4,4.5,327,327,,1,334,334,,,,,,,,,"0,0,0,3,70,28,0,0,0","1,6,92,2,0","0,0,23,74,3",,,,,134,,,,,,,,,,,,,,,14,,,,,,,,,,,,,,,,,,,,,44.1,14,10,280,57,,1020,1,348,0,3,3,"Porz am Rhein",1,0,U1.000|4:36-U1.000|4:27-U1.000|4:32-U1.000|4:40-U1.000|4:41-U1.000|4:38-U1.000|4:38-U1.000|4:32-U1.000|4:30-U1.000|4:38-U0.298|1:26,,,,,3113,,250,0,,0,168070,250480,30378,,13146818,,,,,,,,,,,,,,,,,,,,,,,,,,,,,,,,,,,,,,,,5,
25982382,c0ebf314-b3bf-4478-85e4-3e13cd094a51,1616765794,60,1616765618,,0,0,10.06,3008,3119,257,246,,,0,3.2,0.82,1.02,1.03,511,658,150,169,,,,54.44,40.18,56.23,1,59.24,1959,128,,3.4,0,100,96,,,,,,71,81,12.7,12.35,12.99,-4.6,9.5,305,305,,1,315,315,,,,,,,,,"11,7,14,18,20,17,9,2,0","1,15,65,19,0","0,0,45,51,3",,,,,124,,,,,,,,,,,,,,,16,,,,,,,,,,,,,,,,,,,,,50,14,19,210,49,,1016,2,359,0,3,3,Balve,1,0,U1.000|4:51-U1.000|5:25-U1.000|5:33-U1.000|5:23-U1.000|6:10-U1.000|4:58-U1.000|4:33-U1.000|4:32-U1.000|4:13-U1.000|4:13-U0.064|0:17,,,,,3113,,250,0,,0,168070,250480,30378,,13179866,,,,,,,,,,,,,,,,,,,,,,,,,,,,,,,,,,,,,,,,4,
26040534,,1616846700,60,1616882824,,0,0,10,3000,3000,,,,,0,,,,,,719,,,,,,,40.01,,1,,,,,,,,,,,,,,71,,,,,,,,,,,,,,,,,,,,,,,,,,,,,,,,,,,,,,,,,,,,,,,,,,,,,,,,,,,,,,,,,,,,,,,,,,1,,,0,0,,,,,,connect,,,0,,0,168070,250480,30378,,13228788,,,,,,,,,,,,,,,,,,,,,,,,,,,,,,,,,,,,,,,,,
26182070,8ff8b185-cb53-42a6-8fcb-a1f4236ceda4,1617211182,120,1617208366,,0,0,14.11,4342,4342,397,388,,,0,4.7,0.8,1.06,1.08,540,921,155,171,,,,50.15,39.87,51.94,1,58.51,2655,183,,3.9,0,100,96,,,,,,142,79,12.49,12.11,12.91,-1,3.9,300,300,,1,316,316,,,,,,,,,"16,8,13,18,20,15,7,2,0","0,12,47,41,0","0,3,47,45,5",,,,,123,,,,,,,,,,,,,,,16,,,,,,,,,,,,,,,,,,,,,50.6,21,8,228,40,,1020,1,352,0,2,3,Balve,1,0,U1.000|4:46-U1.000|5:14-U0.835|4:59-U1.000|5:19-U1.000|5:37-U1.000|5:46-U0.329|2:03-U1.000|4:49-U1.000|5:22-U1.000|6:06-U1.000|5:27-U1.000|4:28-U1.000|4:17-U1.000|3:56-U0.947|4:13,,,,,3113,,250,0,,0,168070,250480,30378,,13354672,,,,,,,,,,,,,,,,,,,,,,,,,,,,,,,,,,,,,,,,"3,4",
26200127,aa67312d-e3a4-4ff3-ac3c-eff3f4240ef8,1617264120,120,1617261597,,0,0,13,4577,4635,376,379,,,0,4.3,0.82,0.93,1.03,500,939,151,168,,,,44.09,33.83,45.65,1,57.94,3222,167,,3.8,0,97,94,,,,,,109,81,11.15,10.84,11.38,-4.3,7,256,256,,1,270,270,,,,,,,,,"41,9,10,10,10,9,7,3,1","2,18,61,19,0","1,19,55,25,1",,,,,105,,,,,,,,,,,,,,,32,,,,,,,,,,,,,,,,,,,,,58.3,10,7,102,68,,1020,0,341,0,4,3,Balve,1,0,U1.000|5:22-U1.000|6:15-U1.000|6:38-U1.000|7:03-U1.000|6:15-U1.000|6:40-U1.000|5:13-U1.000|6:44-U1.000|7:05-U1.000|4:57-U1.000|4:33-U1.000|4:31-U0.995|5:01,,,,,3113,,250,0,,0,168070,250480,30378,2761686,13369041,398,20,20,48,26,0.43,0.6,0.8,0.78,0.29,1.54,56,14,96,0.8,254,0,11.66,1,148,0,,,,,,,,,,,,,,,,,,,"3,4",
26252125,fcba1e6b-43da-402a-92d5-d625c66137e5,1617385359,120,1617380201,,0,0,5.49,1654,2006,73,67,,,0,1.2,0.56,1.04,1.05,337,319,137,156,,,,60.87,38.33,61.95,1,57.87,1319,52,,2.4,0,99,100,,,,,,36,78,12.2,12.12,12.31,-6.6,0.1,294,294,,1,299,299,,,,,,,,,"6,6,14,26,25,17,5,1,0","4,51,45,0,0","0,2,56,42,0",,,,,128,,,,,,,,,,,,,,,20,,,,,,,,,,,,,,,,,,,,,20.5,9,19,344,56,,1023,1,382,0,3,3,Balve,1,0,U1.000|5:19-U1.000|5:29-U1.000|5:22-U1.000|4:35-U1.000|4:28-U0.493|2:21,,,,,3113,,250,0,,0,168070,250480,30378,,13416183,,,,,,,,,,,,,,,,,,,,,,,,,,,,,,,,,,,,,,,,5,
26277400,6e275fbd-f6cc-4acc-b523-10c4e5197a37,1617439795,120,1617444940,,0,0,21.11,6604,6974,497,497,,,4,5,0.72,1.08,1.07,565,1589,151,178,,,,51.01,40.38,52.49,1,,,,,,,,,,,,,,178,81,12.17,11.88,12.51,-3.3,1.8,291,291,,1,304,304,,,,,,,,,"13,7,16,22,23,15,4,1,0","0,14,64,22,0","0,4,56,35,5",,,,,118,,,,,,,,,,,,,,,,,,,,,,,,,,,,,,,,,,,,59.2,4,7,320,91,,1027,1,383,0,4,3,Balve,1,0,U1.000|5:18-U1.000|5:26-U1.000|5:36-U1.000|4:59-U1.000|5:48-U1.000|5:47-U1.000|7:27-U1.000|6:01-U1.000|5:18-U1.000|5:01-U1.000|4:58-U0.635|3:21-U1.000|5:40-U1.000|5:05-U1.000|5:03-U1.000|5:19-U1.000|4:50-U1.000|4:13-U1.000|4:11-U1.000|4:16-U1.000|4:27-U0.439|2:03,,,,,wahoo_fitness-33,,518,0,,0,168070,250480,30378,,13439119,,,,,,,,,,,,,,,,,,,,,,,,,,,,,,,,,,,,,,,,"3,4,5,5",
26375718,706af889-a2e1-4fae-81f5-1bfabf8b0e73,1617642722,120,1617689784,,0,0,11.95,3898,4072,353,354,,,4,4.2,0.73,1.04,1.09,497,822,145,179,,,,51.22,36.76,53.09,1,,,,,,,,,,,,,,93,80,11.82,11.95,13.12,-5.7,7.9,284,284,,1,330,330,,,,,,,,,"28,7,11,14,14,11,8,4,2","2,43,26,29,0","1,25,40,15,19",,,,,115,,,,,,,,,,,,,,,,,,,,,,,,,,,,,,,,,,,,61.4,1,20,290,84,,1009,1,416,0,7,3,Balve,1,0,U1.000|5:29-U0.901|5:18-U0.214|1:01-U0.123|1:01-U0.219|1:02-U0.121|1:01-U0.253|1:03-U0.124|1:03-U0.241|1:02-U0.121|1:02-U0.252|1:01-U0.117|1:01-U0.260|1:02-U0.116|1:01-U0.246|1:02-U0.100|1:02-U0.226|1:02-U0.100|1:03-U0.239|1:02-U0.140|1:01-U0.282|1:01-U0.088|1:00-U0.214|1:01-U0.097|1:02-U0.190|1:01-U0.038|0:32-U0.062|0:17-U1.000|6:12-U1.000|5:29-U1.000|4:58-U1.000|5:03-U0.127|0:31-U1.000|3:09-U0.726|4:26,,,,,wahoo_fitness-33,,518,0,,0,168070,250480,30378,,13527057,,,,,,,,,,,,,,,,,,,,,,,,,,,,,,,,,,,,,,,,3,
26444273,ddab07b3-9102-4ce5-8e83-f5278f300fc5,1617820919,120,1617818211,,0,0,13.89,4154,4154,349,335,,,0,4.2,0.77,1.03,1.1,539,797,145,169,,,,57.02,41.16,58.86,1,57.76,1583,134,,3.4,1,103,98,,,,,,89,81,12.82,12.55,13.16,-7.7,-0.5,310,310,,1,324,324,,,,,,,,,"10,10,16,16,19,18,10,2,0","0,33,65,2,0","0,2,46,45,7",,,,,124,,,,,,,,,,,,,,,29,,,,,,,,,,,,,,,,,,,,,34.4,2,19,285,96,,1018,0,405,0,6,3,Balve,1,0,U1.000|4:59-U1.000|5:31-U1.000|6:28-U1.000|5:31-U1.000|5:53-U1.000|5:30-U1.000|4:30-U1.000|4:16-U1.000|4:19-U1.000|4:37-U1.000|5:07-U1.000|5:05-U1.000|3:51-U0.887|3:36,,,,,3113,,250,0,,0,168070,250480,30378,2799863,13589286,414,22,21,31,17,1.67,2.87,0.98,0.72,0.39,1.19,40,14,74,2.8,334,0,12.26,0,146,0,,,,,,,,,,,,,,,,,,,"3,4",
26547497,6cb02227-b3fa-4754-9326-3fab47cdab8b,1617906845,120,1618049956,,0,0,9.13,3499,3633,305,305,,,4,3.9,0.71,1.54,0.91,634,693,136,190,,,,45.65,29.76,47.54,1,,,,,,,,,,,,,,77,77,10.1,10.66,12.94,19.2,-13.4,254,248,,1,342,340,,,,,,,,,"41,7,8,13,11,7,4,3,6","7,50,29,13,2","21,31,12,20,16",,,,,102,,,,,,,,,,,,,,,,,,,,,,,,,,,,,,,,,,,,50.6,4,10,211,75,,1022,0,352,0,3,3,Balve,1,0,U1.000|4:38-U1.000|5:01-U0.368|1:54-U0.009|0:09-U0.217|0:49-U0.260|1:46-U0.221|0:53-U0.249|1:54-U0.232|0:50-U0.280|1:57-U0.228|0:49-U0.272|2:30-U0.231|0:55-U0.244|2:09-U0.228|0:51-U0.251|2:11-U0.223|0:51-U0.254|2:34-U0.221|0:51-U0.240|2:33-U0.218|0:58-U0.259|3:31-U0.219|0:54-U1.000|8:01-U1.000|7:18-U0.197|1:34,,,,,wahoo_fitness-33,,518,0,,0,168070,250480,30378,,13680567,,,,,,,,,,,,,,,,,,,,,,,,,,,,,,,,,,,,,,,,"4,4,4,5,5,5",
26547498,39429c4b-8e03-4756-b6a3-d4329b5ca055,1617987339,120,1618049960,,0,0,13.03,3831,4069,280,286,,,4,3.5,0.63,1.01,1.05,501,903,150,166,,,,55.58,41.78,57.03,1,,,,,,,,,,,,,,106,80,12.91,12.96,13.29,-14.5,-6.6,314,314,,1,326,326,,,,,,,,,"12,10,13,14,14,14,19,3,0","0,11,82,6,0","0,1,40,49,9",,,,,128,,,,,,,,,,,,,,,,,,,,,,,,,,,,,,,,,,,,48.5,10,10,232,62,,1013,1,373,0,4,3,Balve,1,0,U1.000|5:31-U1.000|5:53-U1.000|6:03-U1.000|5:32-U1.000|6:33-U1.000|5:09-U1.000|4:25-U1.000|3:54-U1.000|3:52-U1.000|3:53-U1.000|4:00-U1.000|3:56-U1.000|5:06-U0.008|0:04,,,,,wahoo_fitness-33,,518,0,,0,168070,250480,30378,,13680568,,,,,,,,,,,,,,,,,,,,,,,,,,,,,,,,,,,,,,,,3,
26547541,afc68bac-cb37-462e-8fc1-26a4f9a93174,1617726765,120,1618050047,,0,0,27.57,3617,3617,,,,,0,,,,,,539,133,169,,,,,,,1,,,,,,,,,,,,,,61,95,,28.88,,5.5,2.9,154,148,,0,185,183,,,,,,,,,"4,3,27,20,40,6,1","5,51,34,11,0","35,40,22,2,1",,,,,,,,,,,,,,,,,,,,,,,,,,,,,,,,,,,,,,,,,36.9,,,,,,,,,,1,,,1,0,,,,,,,,252,0,,0,168072,,30378,,13680603,,,,,,,,,,,,,,,,,,,,,,,,,,,,,,,,,,,,,,,,,
26547542,9fc8aa31-fb27-425f-8fa6-358e4246335b,1617735761,120,1618050050,,0,0,7.44,1434,1434,,,,,0,,,,,,151,121,149,,,,,,,1,,,,,,,,,,,,,,15,87,,22.91,,-38.9,-35.6,121,104,,0,139,134,,,,,,,,,"31,19,16,15,11,2,6","6,84,10,0,0","50,42,8,0,0",,,,,,,,,,,,,,,,,,,,,,,,,,,,,,,,,,,,,,,,,11.6,,,,,,,,,,1,,,1,0,,,,,,,,329,0,,0,168072,,30378,2812526,13680605,496,22,22,58,54,1.76,2.95,0.21,1.09,0.52,1.71,84,0,63,1.8,191,0,29.73,0,139,0,,,,,,,,,,,,,,,,,,,,
26611116,e69f58b3-26ff-4190-b2b5-2fd54ac8d190,1618064652,120,1618169628,,0,0,9.78,2874,3026,368,369,,,4,5.1,0.83,1.04,1.19,629,725,156,171,,,,52.6,40.93,55.04,1,,,,,,,,,,,,,,93,81,13.76,13.66,14.46,-14.7,7.1,326,326,,1,352,352,,,,,,,,,"24,7,9,11,9,8,17,13,1","0,3,65,32,0","0,5,30,56,9",,,,,126,,,,,,,,,,,,,,,,,,,,,,,,,,,,,,,,,,,,56.5,6,7,90,86,,1013,2,384,0,6,3,Balve,1,0,U1.000|5:25-U1.000|5:30-U1.000|4:36-U1.000|6:59-U1.000|6:27-U1.000|5:39-U1.000|3:42-U1.000|3:31-U1.000|3:26-U0.764|2:40,,,,,wahoo_fitness-33,,518,0,,0,168070,250480,30378,,13736791,,,,,,,,,,,,,,,,,,,,,,,,,,,,,,,,,,,,,,,,"3,4",
26611119,2758af96-eec9-4b14-959c-6fe6d822db6a,1618139833,120,1618169633,,0,0,19.63,6235,6762,623,624,,,4,5.8,0.77,1.08,1.13,679,1374,144,188,,,,53.43,39.45,55.52,1,,,,,,,,,,,,,,150,81,12.35,11.96,12.77,-0.8,2.5,291,291,,1,306,306,,,,,,,,,"19,13,16,10,16,20,7,1,0","0,38,60,2,0","0,7,51,36,6",,,,,117,,,,,,,,,,,,,,,,,,,,,,,,,,,,,,,,,,,,38.5,4,11,303,94,,1012,2,392,0,6,3,Balve,1,0,U1.000|5:04-U1.000|5:41-U1.000|6:18-U1.000|5:37-U0.367|2:09-U1.000|5:47-U1.000|4:35-U1.000|4:26-U1.000|4:14-U1.000|7:37-U1.000|5:55-U1.000|5:45-U1.000|4:55-U1.000|5:43-U1.000|6:58-U1.000|4:57-U1.000|4:40-U1.000|4:23-U1.000|4:11-U1.000|3:54-U0.227|1:06,,,,,wahoo_fitness-33,,518,0,,0,168070,250480,30378,,13736794,,,,,,,,,,,,,,,,,,,,,,,,,,,,,,,,,,,,,,,,"3,4,4,5",
26702719,8d7195ce-15a9-44dc-acc9-e10ffa113d6d,1618337602,120,1618341734,,0,0,5.93,1785,1785,0,2,,,4,0,0,,,,442,157,199,,,,50.59,38.54,50.57,1,,,,,,,,,,,,,,63,80,11.97,13.96,13.98,5.4,-2,304,304,,1,366,366,,,,,,,,,"37,1,2,1,1,4,34,19,1","0,25,25,46,4","19,17,7,9,48",,,,,125,,,,,,,,,,,,,,,,,,,,,,,,,,,,,,,,,,,,62.5,6,10,328,70,,1031,0,451,0,3,3,Balve,1,0,U0.390|1:29-U0.404|1:28-U0.399|1:28-U0.234|2:01-U0.399|1:23-U0.405|1:25-U0.172|1:57-U0.402|1:19-U0.205|2:05-U0.798|2:59-U0.402|1:29-U0.119|2:04-U0.398|1:25-U0.406|1:30-U0.137|2:03-U0.401|1:20-U0.260|2:23,,,,,wahoo_fitness-33,,518,0,,0,168070,250480,30378,,13818771,,,,,,,,,,,,,,,,,,,,,,,,,,,,,,,,,,,,,,,,,
26702808,43d9ca7b-f394-4d29-b008-4c35f47e970a,1618250220,120,1618341767,,0,0,0.07,139,139,0,0,,,0,0,0,,,,29,100,102,,,,,,,1,,,,,,,,,,,,,,0,76,,2.28,,,,2,1,,1,2,2,,,,,,,,,"100,0,0,0,0,0,0","67,33,0,0,0","100,0,0,0,0",,,,,,,,,,,,,,,,,,,,,,,,,,,,,,,,,,,,,,,,,0.1,5,12,337,80,,1027,1,424,0,3,3,Balve,1,0,,,,,,,,329,0,,0,168072,,30378,2833531,13818855,596,31,18,19,0,17.33,54.67,0,,,,,,,,,0,,0,,0,,,,,,,,,,,,,,,,,,,,
26702814,8a53c68e-a0c8-4f2c-8a7a-46a5a614d493,1618250360,120,1618341769,,0,0,28.22,4835,4838,0,0,,,0,0,0,,,,744,136,160,,,,,,,1,,,,,,,,,,,,,,90,91,,24.66,,1.5,-17.7,166,164,,0,177,175,,,,,,,,,"16,24,26,16,13,5,1","0,62,37,0,0","23,53,20,4,1",,,,,,,,,,,,,,,,,,,,,,,,,,,,,,,,,,,,,,,,,22,5,10,255,80,,1028,0,428,0,3,3,Balve,1,0,,,,,,,,329,0,,0,168072,,30378,2833534,13818855,441,21,18,42,23,4.44,17.17,0.53,0.87,0.27,1.42,66,18,19,11.8,118,0,18,0,57,0,,,,,,,,,,,,,,,,,,,,
26733507,c8b66942-e0df-4138-b870-70d4ccc1ca11,1618423006,120,1618421657,,0,0,17.24,4707,4818,520,521,,,4,4.9,0.77,1.04,1,645,1216,159,173,,,,56.01,46.55,58.1,1,,,,,,,,,,,,,,165,83,14.23,13.88,14.6,-4,3.2,348,348,,1,362,362,,,,,,,,,"6,6,11,14,16,17,20,8,1","0,5,39,57,0","0,3,24,51,23",,,,,132,,,,,,,,,,,,,,,,,,,,,,,,,,,,,,,,,,,,60.3,5,9,351,73,,1029,0,453,0,3,3,Balve,1,0,U1.000|4:17-U1.000|4:40-U1.000|5:39-U1.000|4:55-U1.000|5:35-U1.000|5:18-U1.000|5:37-U1.000|4:20-U0.233|0:56-U1.000|3:52-U1.000|5:12-U1.000|5:30-U1.000|4:32-U1.000|3:54-U1.000|3:34-U1.000|3:44-U1.000|3:38-U0.973|3:14,,,,,wahoo_fitness-33,,518,0,,0,168070,250480,30378,,13845089,,,,,,,,,,,,,,,,,,,,,,,,,,,,,,,,,,,,,,,,"3,4",
26769091,7121b0d1-dea4-4af2-9d6d-2b9ace00ef8a,1618488134,120,1618500169,,0,0,2.5,854,854,13,12,,,4,0,0.27,0.77,1.13,,179,140,165,,,,50.69,31.34,51.04,1,,,,,,,,,,,,,,17,78,10.71,11.42,11.5,-22.2,-11.9,260,258,,1,285,284,,,,,,,,,"17,3,6,19,40,13,1,0,0","7,30,59,3,0","11,10,39,40,0",,,,,113,,,,,,,,,,,,,,,,,,,,,,,,,,,,,,,,,,,,21.9,6,11,21,73,,1030,2,437,0,3,3,Balve,1,0,U1.125|7:00-U0.006|0:06-U0.005|0:05-U1.325|6:39-U0.035|0:22-U0.006|0:03,,,,,wahoo_fitness-33,,518,1,,0,168070,250480,30378,,13877580,,,,,,,,,,,,,,,,,,,,,,,,,,,,,,,,,,,,,,,,,
26779674,8d63d027-f1bc-4dfd-85c9-b406f6a2098d,1618509658,120,1618514146,,0,0,1.62,417,417,0,0,,,4,0,0,,,,103,154,167,,,,63.1,41.41,63.1,1,,,,,,,,,,,,,,12,82,13.8,13.88,13.89,0.5,0.2,351,351,,1,352,352,,,,,,,,,"2,0,1,3,23,56,13,1,1","2,7,50,41,0","0,0,5,93,2",,,,,142,,,,,,,,,,,,,,,,,,,,,,,,,,,,,,,,,,,,29.3,6,11,34,63,,1029,0,418,0,4,3,Balve,1,0,U0.400|1:45-U0.400|1:43-U0.100|0:23-U0.100|0:29-U0.200|0:51-U0.400|1:41-U0.017|0:06,,,,,wahoo_fitness-33,,518,1,,0,168070,250480,30378,,13886795,,,,,,,,,,,,,,,,,,,,,,,,,,,,,,,,,,,,,,,,,
26779677,9f86d2b7-6f70-4659-89c8-155b7058f0fe,1618508243,120,1618514150,,0,0,4.93,1353,1353,4,0,,,4,0,0,,,,324,151,165,,,,59.95,42.52,60.07,1,,,,,,,,,,,,,,36,81,13.2,13.24,13.3,1.4,0,332,332,,1,335,335,,,,,,,,,"3,2,4,8,29,46,8,1,0","1,11,76,11,0","0,1,16,80,3",,,,,135,,,,,,,,,,,,,,,,,,,,,,,,,,,,,,,,,,,,41.6,8,13,30,56,,1029,1,420,0,3,3,Balve,1,0,U1.100|5:28-U0.400|1:46-U0.400|1:50-U0.400|1:43-U0.200|0:55-U0.100|0:32-U0.200|0:50-U0.100|0:26-U0.100|0:26-U0.310|1:28-U0.304|1:24-U0.100|0:28-U0.400|1:44-U0.400|1:44-U0.400|1:45-U0.013|0:06,,,,,wahoo_fitness-33,,518,1,,0,168070,250480,30378,,13886798,,,,,,,,,,,,,,,,,,,,,,,,,,,,,,,,,,,,,,,,,
26779680,00815346-7d9b-4087-ae3c-e466935daf1f,1618510150,120,1618514153,,0,0,1.81,501,501,0,1,,,4,0,0,,,,99,143,181,,,,63.91,38.64,63.87,1,,,,,,,,,,,,,,12,81,12.89,13.06,13.08,27.4,27.8,323,323,,1,328,328,,,,,,,,,"7,1,2,6,23,60,1,0,0","4,31,57,4,3","0,2,23,75,0",,,,,134,,,,,,,,,,,,,,,,,,,,,,,,,,,,,,,,,,,,21,6,11,34,63,,1029,0,418,0,4,3,Balve,1,0,U0.400|1:47-U0.400|1:44-U0.485|2:16-U0.159|0:43-U0.143|0:42-U0.100|0:34-U0.100|0:27-U0.017|0:06,,,,,wahoo_fitness-33,,518,1,,0,168070,250480,30378,,13886801,,,,,,,,,,,,,,,,,,,,,,,,,,,,,,,,,,,,,,,,,
26779681,bf1e1949-d8ae-4c6d-b988-7760f7741d40,1618510712,120,1618514156,,0,0,0.52,131,131,0,1,,,4,0,0.04,,,,24,127,151,,,,83.46,37.88,83.26,1,,,,,,,,,,,,,,2,80,11.7,11.97,12.06,31.9,30.9,288,288,,1,297,297,,,,,,,,,"7,2,7,17,67,0,0,0,0","22,25,52,0,0","0,1,55,45,0",,,,,149,,,,,,,,,,,,,,,,,,,,,,,,,,,,,,,,,,,,4.9,7,12,31,58,,1029,0,419,0,3,3,Balve,1,0,U0.100|0:27-U0.100|0:27-U0.100|0:22-U0.100|0:23-U0.100|0:23-U0.022|0:10,,,,,wahoo_fitness-33,,518,1,,0,168070,250480,30378,,13886802,,,,,,,,,,,,,,,,,,,,,,,,,,,,,,,,,,,,,,,,,
26779682,01bd0c00-a155-42f6-a3db-9083f0302ef8,1618510903,120,1618514158,,0,0,1.51,402,402,2,0,,,4,0,0,,,,102,167,183,,,,53.63,39.55,53.81,1,,,,,,,,,,,,,,16,82,13.59,13.6,13.68,-1.1,-0.1,345,345,,1,347,347,,,,,,,,,"2,0,0,4,20,64,10,0,0","1,2,17,67,13","0,0,9,83,8",,,,,137,,,,,,,,,,,,,,,,,,,,,,,,,,,,,,,,,,,,47,7,11,31,58,,1029,0,419,0,3,3,Balve,1,0,U0.400|1:44-U0.400|1:46-U0.400|1:47-U0.300|1:22-U0.009|0:04,,,,,wahoo_fitness-33,,518,1,,0,168070,250480,30378,,13886803,,,,,,,,,,,,,,,,,,,,,,,,,,,,,,,,,,,,,,,,,
26779714,f95cc157-3601-4de4-a887-9e4913db559b,1618511581,120,1618514194,,0,0,7.77,2477,2477,234,244,,,4,3.7,0.79,0.84,0.86,611,505,138,170,,,,56.24,36.61,58.25,1,,,,,,,,,,,,,,57,81,12.26,12.02,12.67,-18.6,0.5,291,288,,1,303,303,,,,,,,,,"21,5,10,17,18,25,5,0,0","21,10,46,24,0","3,3,50,39,5",,,,,116,,,,,,,,,,,,,,,,,,,,,,,,,,,,,,,,,,,,50.2,6,11,34,63,,1029,0,418,0,4,3,Balve,1,0,U1.000|5:23-U1.000|5:39-U1.000|6:53-U1.000|6:21-U0.175|0:43-U1.000|4:19-U1.000|4:21-U1.000|4:41-U0.574|2:56-U0.010|0:01,,,,,wahoo_fitness-33,,518,1,,0,168070,250480,30378,,13886832,,,,,,,,,,,,,,,,,,,,,,,,,,,,,,,,,,,,,,,,3,
26872008,a7d47bea-faaa-4af6-932c-481c25515931,1618743973,120,1618747760,,0,0,7.66,8397,8397,278,350,,,0,4.6,0.82,,,263,619,87,133,,,,,,,1,57.58,192,8,,0.7,0,,99,,,,,,25,55,,3.94,,-33.3,,,,,,,,,,,,,,,,"84,16,0,0,0,0","77,23,0,0,0",,,,,,,,,,,,,,,,,,,,,17,,,,,,,,,,,,,,,,,,,,,7.1,7,9,314,78,,1022,3,403,0,4,3,Königswinter,1,0,U2.123|51:09-U5.540|1:28:48,,"Königswinter Hiking",,,3113,,250,3,6627986211,0,168075,,30378,,13968379,,,,,,,,,,,,,,,,,,,,,,,,,,,,,,,,,,,,,,,,3,
26918441,f8411e4d-fb61-435c-a98c-75fe8aba8b94,1618590056,120,1618836261,,0,0,7.84,2151,2151,190,190,,,4,2.8,0.64,1.01,1.05,512,506,150,172,,,,60.54,43.72,62.35,1,,,,,,,,,,,,,,55,82,13.88,13.49,14.1,-3,10.2,341,341,,1,349,349,,,,,,,,,"4,4,8,14,25,23,20,3,0","3,7,73,18,0","0,0,18,68,13",,,,,133,,,,,,,,,,,,,,,,,,,,,,,,,,,,,,,,,,,,41,8,13,26,60,,1026,1,404,0,4,3,Balve,1,0,U1.000|5:00-U0.693|3:28-U1.000|4:58-U1.000|5:25-U1.000|4:19-U1.000|3:57-U1.000|4:08-U1.000|4:02-U0.126|0:35,,,,,wahoo_fitness-33,,518,1,,0,168070,250480,30378,,14009867,,,,,,,,,,,,,,,,,,,,,,,,,,,,,,,,,,,,,,,,"4,4",
26919617,1777ee94-d7ce-41ed-aaea-db78e738b7e2,1618772317,120,1618840657,,0,0,5.42,1570,1608,70,64,,,0,0.8,0.33,1.18,0.96,803,323,140,149,,,,62.13,40.12,63.21,1,57.99,1241,57,,2.8,0,103,101,,,,,,34,79,12.58,12.45,12.87,-1.4,-7.3,310,310,,1,319,319,,,,,,,,,"0,1,7,23,50,19,0,0,0","1,41,58,0,0","0,0,52,42,6",,,,,131,,,,,,,,,,,,,,,16,,,,,,,,,,,,,,,,,,,,,25.1,12,6,348,64,,1021,0,394,0,4,3,Porz,1,0,U1.000|4:59-U1.000|4:35-U1.000|4:50-U1.000|4:56-U1.000|4:48-U0.416|2:03,,"Cologne Running",,,3113,,250,3,6634178785,0,168070,250480,30378,,14010935,,,,,,,,,,,,,,,,,,,,,,,,,,,,,,,,,,,,,,,,5,
26922955,,1618679400,,1618845074,,0,0,13.5,3900,,,,,,0,,,,,,953,,,,,,,42.76,,1,,,,,,,,,,,,,,81,,,,,,,,,,,,,,,,,,,,,,,,,,,,,,,,,,,,,,,,,,,,,,,,,,,,,,,,,,,,,,,,,,,,,,,,,,1,,,0,0,,,,,,,,,0,,0,168070,250480,30378,,,,,,,,,,,,,,,,,,,,,,,,,,,,,,,,,,,,,,,,,,,
26990639,d08cd1d7-660e-425f-97f9-b18a1d3d1cd4,1618860140,120,1618988338,,0,0,5.34,1542,1602,16,17,,,4,0,0,,0.91,,317,138,167,,,,63.55,40.23,63.77,1,,,,,,,,,,,,,,34,79,12.48,12.51,12.55,0.2,0.5,308,308,,1,311,311,,,,,,,,,"2,2,6,22,44,21,3,0,0","0,69,28,3,0","0,0,37,63,0",,,,,132,,,,,,,,,,,,,,,,,,,,,,,,,,,,,,,,,,,,22.9,13,5,46,68,,1019,0,392,0,3,3,Porz,1,0,U1.000|4:43-U1.000|4:35-U1.000|4:53-U1.000|4:55-U1.000|4:56-U0.332|1:41,,,,,wahoo_fitness-33,,518,1,,0,168070,250480,30378,,14073528,,,,,,,,,,,,,,,,,,,,,,,,,,,,,,,,,,,,,,,,,
26990640,f91443cd-f0cb-4018-bfc5-2ba0b2c893f0,1618933129,120,1618988342,,0,0,16.56,4270,4448,101,87,,,4,0.1,0.24,1.09,0.98,,1121,160,171,,,,59.55,49.57,60.06,1,,,,,,,,,,,,,,130,81,13.99,13.89,14.08,1.4,1.3,354,354,,1,358,358,,,,,,,,,"1,1,3,7,23,43,18,4,0","1,4,39,57,0","0,0,11,74,15",,,,,144,,,,,,,,,,,,,,,,,,,,,,,,,,,,,,,,,,,,66.5,17,5,317,45,,1015,2,371,0,3,3,Porz,1,0,U1.000|4:36-U1.000|4:12-U1.000|4:33-U1.000|4:26-U1.000|4:20-U1.000|4:28-U1.000|4:24-U1.000|4:29-U1.000|4:29-U1.000|4:08-U1.000|4:06-U1.000|4:20-U1.000|4:11-U1.000|4:01-U1.000|4:05-U1.000|4:10-U0.524|2:13,,,,,wahoo_fitness-33,,518,1,,0,168070,250480,30378,,14073529,,,,,,,,,,,,,,,,,,,,,,,,,,,,,,,,,,,,,,,,,
27017108,b109bf78-ee88-4d84-8024-737faf42ea78,1619030027,120,1619032458,,0,0,14.38,3892,3992,37,37,,,4,0,0.04,,,,888,147,164,,,,63.31,46.35,63.51,1,,,,,,,,,,,,,,105,81,13.32,13.33,13.37,1,-0.3,334,334,,1,336,336,,,,,,,,,"1,1,1,5,41,46,6,0,0","1,9,89,1,0","0,0,9,89,2",,,,,137,,,,,,,,,,,,,,,,,,,,,,,,,,,,,,,,,,,,43.5,13,15,2,66,,1016,0,364,0,3,3,Porz,1,0,U1.000|4:44-U1.000|4:26-U1.000|4:32-U1.000|4:35-U1.000|4:32-U1.000|4:33-U1.000|4:36-U1.000|4:33-U1.000|4:30-U1.000|4:29-U1.000|4:30-U1.000|4:23-U1.000|4:07-U1.000|4:45-U0.353|1:39,,,,,wahoo_fitness-33,,518,1,,0,168070,250480,30378,,14097565,,,,,,,,,,,,,,,,,,,,,,,,,,,,,,,,,,,,,,,,,
27052445,3d723dcd-1d22-468b-958c-24158811195f,1619119651,120,1619120932,,0,0,14.17,3915,4385,22,22,,,4,0,0.01,,,,910,147,182,,,,61.71,45.2,61.83,1,,,,,,,,,,,,,,114,81,13.06,13.62,13.66,9.2,3.3,331,328,,1,351,350,,,,,,,,,"4,1,4,19,34,14,16,8,0","5,17,50,27,1","2,1,34,45,18",,,,,134,,,,,,,,,,,,,,,,,,,,,,,,,,,,,,,,,,,,87,11,9,338,53,,1026,0,370,0,3,3,Porz,1,0,U1.000|4:23-U1.000|4:02-U1.000|3:59-U1.000|4:02-U1.000|4:52-U1.000|4:58-U0.680|3:56-U1.000|3:38-U1.000|3:28-U0.531|1:49-U1.000|6:31-U1.000|4:51-U1.000|4:59-U1.000|4:57-U0.942|4:51,,,,,wahoo_fitness-33,,518,1,,0,168070,250480,30378,,14129833,,,,,,,,,,,,,,,,,,,,,,,,,,,,,,,,,,,,,,,,,
27125463,3159e7f6-3d45-4e65-a15b-1c72bbdd7b12,1619197882,120,1619285028,,0,0,14.05,3639,3883,29,29,,,4,0,0.01,,,,913,157,173,,,,60.9,48.69,61.05,1,,,,,,,,,,,,,,125,81,13.92,13.93,13.97,-0.7,-0.9,353,353,,1,355,355,,,,,,,,,"1,0,1,3,18,63,15,0,0","0,5,64,31,0","0,0,3,93,4",,,,,143,,,,,,,,,,,,,,,,,,,,,,,,,,,,,,,,,,,,57.4,16,16,280,36,,1027,,,0,2,1,Porz,1,0,U1.000|4:42-U1.000|4:11-U1.000|4:16-U1.000|4:19-U1.000|4:18-U1.000|4:17-U1.000|4:15-U1.000|4:16-U1.000|4:22-U1.000|4:18-U1.000|4:18-U1.000|4:24-U1.000|4:20-U1.000|4:18-U0.018|0:05,,,,,wahoo_fitness-33,,518,1,,0,168070,250480,30378,,14194688,,,,,,,,,,,,,,,,,,,,,,,,,,,,,,,,,,,,,,,,,
27125466,07dcc247-6a1f-4d9a-ac1b-9e91e79cff2c,1619284312,120,1619285033,,0,0,21.17,5684,6193,160,157,,,4,0,0.2,0.94,0.82,432,1328,149,173,,,,62.76,48.25,63.35,1,,,,,,,,,,,,,,149,81,14.88,13.3,13.52,-24.7,0.3,337,335,,1,342,341,,,,,,,,,"2,1,4,11,27,40,14,1,0","1,10,85,4,0","1,0,20,71,8",,,,,138,,,,,,,,,,,,,,,,,,,,,,,,,,,,,,,,,,,,48.2,14,13,20,44,,1025,1,316,0,4,3,Porz,1,0,U1.000|5:01-U1.000|4:19-U1.000|4:28-U1.000|4:32-U1.000|4:44-U1.000|4:31-U1.000|4:42-U1.000|4:29-U1.000|4:20-U1.000|4:39-U1.000|4:41-U1.000|4:31-U1.000|4:26-U1.000|4:24-U1.000|4:26-U1.000|4:27-U1.000|4:23-U1.000|4:19-U1.000|4:12-U1.000|4:14-U1.000|4:24-U0.130|0:34,,,,,wahoo_fitness-33,,518,1,,0,168070,250480,30378,,14194691,,,,,,,,,,,,,,,,,,,,,,,,,,,,,,,,,,,,,,,,5,
27153186,7f6c39a5-6842-433c-ad21-9bb4924e1a77,1619349786,120,1619358991,,0,0,16.8,16141,16141,672,624,,,0,6.6,0.81,,,282,1312,94,134,,,,,,,1,57.99,921,22,,2,0,,93,,,,,,52,54,,4.21,,-27.3,,,,,,,,,,,,,,,,"78,22,0,0,0,0","62,38,0,0,0",,,,,,,,,,,,,,,,,,,,,23,,,,,,,,,,,,,,,,,,,,,8.7,11,12,12,42,,1026,5,354,0,2,3,Königswinter,1,0,U3.097|48:38-U5.266|1:32:06-U8.432|2:08:17,,"Königswinter Hiking",,,3113,,250,3,6670242164,0,168075,,30378,,14218816,,,,,,,,,,,,,,,,,,,,,,,,,,,,,,,,,,,,,,,,"3,3,4,4,4",
27180433,,1619347980,,1619427254,,0,0,7,2100,,,,,,0,,,,,,513,,,,,,,39.08,,1,,,,,,,,,,,,,,51,,,,,,,,,,,,,,,,,,,,,,,,,,,,,,,,,,,,,,,,,,,,,,,,,,,,,,,,,,,,,,,,,,,,,,,,,,1,,,0,0,,,,,,,,,0,,0,168070,250480,30378,,,,,,,,,,,,,,,,,,,,,,,,,,,,,,,,,,,,,,,,,,,
27207266,8c19cbd9-d9f6-45a0-b56d-76de79d2bd5d,1619459319,120,1619473158,,0,0,16.42,4575,5090,112,108,,,4,0,0.17,1.09,0.95,,982,142,167,,,,63.99,45.29,64.55,1,,,,,,,,,,,,,,111,81,13.01,12.98,13.12,0.6,2.4,324,324,,1,328,328,,,,,,,,,"1,1,3,14,45,29,7,0,0","1,31,67,1,0","0,0,23,72,5",,,,,133,,,,,,,,,,,,,,,,,,,,,,,,,,,,,,,,,,,,29.4,12,9,44,48,,1014,1,371,0,2,3,Porz,1,0,U1.000|5:01-U1.000|4:32-U1.000|4:38-U1.000|4:34-U1.000|4:29-U1.000|4:34-U1.000|4:44-U1.000|4:51-U1.000|4:44-U1.000|4:28-U1.000|4:34-U1.000|4:39-U1.000|4:51-U1.000|4:32-U1.000|4:43-U1.000|4:34-U0.393|1:47,,,,,wahoo_fitness-33,,518,7,,0,168070,250480,30378,,14266165,,,,,,,,,,,,,,,,,,,,,,,,,,,,,,,,,,,,,,,,,
27245437,61df2e9e-d52f-4982-ae2d-2bc9cae1a85f,1619549755,120,1619549076,,0,0,14.61,4125,4452,34,27,,,4,0,0.06,,,,895,142,187,,,,62.95,44.19,63.17,1,,,,,,,,,,,,,,91,81,12.79,12.96,13.03,0.7,-6,318,318,,1,327,327,,,,,,,,,"5,4,5,12,37,28,4,4,1","2,35,58,5,0","0,3,31,61,6",,,,,131,,,,,,,,,,,,,,,,,,,,,,,,,,,,,,,,,,,,41,12,5,78,54,,1007,0,394,0,2,3,Porz,1,0,U1.000|5:10-U1.000|4:36-U1.000|4:50-U1.000|4:33-U1.000|4:56-U1.000|5:00-U1.000|5:02-U1.000|4:26-U1.000|4:28-U1.000|4:30-U1.000|4:22-U0.434|1:58-U0.305|1:02-U0.196|1:04-U0.282|1:02-U0.150|1:03-U0.313|1:05-U0.163|1:02-U0.299|1:01-U1.000|5:18-U0.445|2:17,,,,,wahoo_fitness-33,,518,7,,0,168070,250480,30378,,14300888,,,,,,,,,,,,,,,,,,,,,,,,,,,,,,,,,,,,,,,,,
27282732,87535a0e-4e25-4e86-b07b-f14932746242,1619637420,120,1619631475,,0,0,1.19,465,717,4,5,,,4,0,0,0.65,,,92,134,156,,,,45.41,24.88,45.55,1,,,,,,,,,,,,,,8,77,9.28,9.88,9.89,-25.3,-20.3,218,218,,1,237,237,,,,,,,,,"31,9,29,17,8,1,1,2,2","1,74,25,0,0","14,11,67,8,1",,,,,100,,,,,,,,,,,,,,,,,,,,,,,,,,,,,,,,,,,,13.3,17,7,119,46,,1002,0,384,0,4,3,Porz,1,0,U1.000|6:39-U0.188|1:06,,,,,wahoo_fitness-33,,518,7,,0,168070,250480,30378,,14333052,,,,,,,,,,,,,,,,,,,,,,,,,,,,,,,,,,,,,,,,,
27282736,378fa5f4-405e-48b2-bab4-04a6cc044f2d,1619635593,120,1619631479,,0,0,5.42,1723,1723,0,0,,,4,0,0,,,,405,150,204,,,,50.48,35.93,50.48,1,,,,,,,,,,,,,,53,80,11.41,13.5,13.52,28.9,-2.8,287,287,,1,353,353,,,,,,,,,"33,1,2,5,9,12,14,21,3","2,30,31,29,8","28,4,12,25,32",,,,,118,,,,,,,,,,,,,,,,,,,,,,,,,,,,,,,,,,,,64.8,16,7,119,46,,1002,0,384,0,4,3,Urbach,1,0,U0.400|1:42-U0.400|1:26-U0.400|1:46-U0.400|1:27-U0.400|1:56-U0.400|1:26-U0.400|2:07-U0.400|1:25-U0.168|2:57-U0.400|1:15-U0.134|2:01-U0.400|1:19-U0.128|2:18-U0.400|1:19-U0.143|2:08-U0.400|1:20-U0.046|0:51,,,,,wahoo_fitness-33,,518,7,,0,168070,250480,30378,,14333056,,,,,,,,,,,,,,,,,,,,,,,,,,,,,,,,,,,,,,,,,
27282739,df7e99c2-e9f1-4b96-96dc-f38188d993b5,1619635187,120,1619631479,,0,0,0.83,270,270,3,0,,,4,0,0,,,,57,143,163,,,,52.36,29.48,52.83,1,,,,,,,,,,,,,,6,79,11.22,11.22,11.35,-4.1,-7,274,274,,1,278,278,,,,,,,,,"9,4,10,41,27,9,0,0,0","6,23,70,1,0","3,5,58,34,0",,,,,117,,,,,,,,,,,,,,,,,,,,,,,,,,,,,,,,,,,,14.8,18,7,117,42,,1002,1,385,0,3,3,Porz,1,0,,,,,,wahoo_fitness-33,,518,7,,0,168070,250480,30378,,14333058,,,,,,,,,,,,,,,,,,,,,,,,,,,,,,,,,,,,,,,,,
27312457,463c17a0-1537-4236-95e4-01416e409861,1619704198,120,1619702330,,0,0,15.04,3812,3825,23,21,,,4,0,0.03,,,,969,158,171,,,,61.97,50.19,62.1,1,,,,,,,,,,,,,,121,83,14.24,14.28,14.32,2.6,2.6,363,363,,1,366,366,,,,,,,,,"1,1,1,3,16,49,27,3,0","0,1,70,29,0","0,0,4,84,13",,,,,143,,,,,,,,,,,,,,,,,,,,,,,,,,,,,,,,,,,,58.3,13,26,263,53,,1005,3,397,0,3,3,Porz,1,0,U1.000|4:28-U1.000|4:03-U1.000|4:15-U1.000|4:06-U1.000|4:18-U1.000|4:12-U1.000|4:06-U1.000|4:04-U1.000|4:27-U1.000|4:28-U1.000|4:11-U1.000|4:07-U1.000|4:09-U1.000|4:12-U1.000|4:25-U0.005|0:02,,,,,wahoo_fitness-33,,518,1,,0,168070,250480,30378,,14358916,,,,,,,,,,,,,,,,,,,,,,,,,,,,,,,,,,,,,,,,,
27369181,f7d0b060-8eb1-450c-904b-efd21f0c1022,1619807358,120,1619804956,,0,0,14.25,4049,4711,197,194,,,0,2.3,0.45,1.22,0.92,680,763,143,174,,,,61.88,43.78,62.95,1,57.57,1860,127,,3.5,2.1,104,97,,,,,,94,80,12.89,12.84,13.86,5.3,12.3,320,320,,1,360,360,,,,,,,,,"3,1,3,18,46,24,4,2,0","1,25,70,3,0","1,3,41,46,9",,,,,132,,,,,,,,,,,,,,,30,,,,,,,,,,,,,,,,,,,,,42.9,13,5,309,56,,1012,0,374,0,3,3,Porz,1,0,U0.281|1:25-U1.000|4:27-U1.000|4:29-U1.000|4:32-U1.000|4:40-U0.447|2:12-U0.692|2:28-U1.000|5:21-U1.000|4:59-U1.000|4:58-U1.000|4:44-U1.000|5:15-U1.000|4:48-U1.000|4:29-U1.000|4:43-U0.828|3:57,,"Cologne - Run Workout",,,3113,,250,3,6699587295,0,168070,250480,30378,2923504,14409009,419,29,29,40,12,2.16,2.49,1.25,0.77,0.48,1.7,50,2,79,3,246,0,11.65,0,143,0,,,,,,,,,,,,,,,,,,,"4,4",
27404106,db6f22a0-0cb8-4aab-8eb5-095ec67b65eb,1619888709,120,1619883874,,0,0,,71,72,1,1,,,4,0,0,,,,9,109,113,,,,,,,1,,,,,,,,,,,,,,1,24,,0.15,0.28,83.5,59.8,4,1,,1,5,3,,,,,,,,,"100,0,0,0,0,0,0,0,0","0,100,0,0,0","100,0,0,0,0",,,,,,,,,,,,,,,,,,,,,,,,,,,,,,,,,,,,,,,,,0.8,13,8,342,52,,1012,2,360,0,4,3,Zündorf,1,0,,,,,,wahoo_fitness-33,,518,7,,0,168070,250480,30378,,14438804,,,,,,,,,,,,,,,,,,,,,,,,,,,,,,,,,,,,,,,,,
27404122,a0c60b80-2584-4a2c-8d4f-88441378491c,1619888821,120,1619883886,,0,0,5.12,1572,1787,4,4,,,4,0,0.08,,,,295,131,164,,,,62.88,37.32,62.94,1,,,,,,,,,,,,,,30,80,11.74,11.81,11.85,4.5,2.5,287,287,,1,291,291,,,,,,,,,"3,4,12,32,41,6,0,0,0","8,67,23,3,0","0,0,63,37,0",,,,,122,,,,,,,,,,,,,,,,,,,,,,,,,,,,,,,,,,,,21.7,12,8,342,52,,1012,2,360,0,4,3,Zündorf,1,0,U1.000|5:17-U1.000|5:06-U1.000|4:50-U1.000|4:52-U1.000|5:30-U0.108|0:38,,,,,wahoo_fitness-33,,518,7,,0,168070,250480,30378,,14438818,,,,,,,,,,,,,,,,,,,,,,,,,,,,,,,,,,,,,,,,,
27404123,1e46e83b-7987-49f6-bb8a-8a94619cc9ff,1619888536,120,1619883886,,0,0,0.38,125,125,2,0,,,4,0,0,1.06,,,24,131,141,,,,57.75,27.11,58.5,1,,,,,,,,,,,,,,2,79,11.04,10.93,11.07,-6.7,4.3,267,267,,1,273,273,,,,,,,,,"31,5,13,21,17,1,2,3,7","0,93,7,0,0","0,26,48,18,8",,,,,115,,,,,,,,,,,,,,,,,,,,,,,,,,,,,,,,,,,,4.6,12,8,342,52,,1012,2,360,0,4,3,Zündorf,1,0,,,,,,wahoo_fitness-33,,518,7,,0,168070,250480,30378,,14438819,,,,,,,,,,,,,,,,,,,,,,,,,,,,,,,,,,,,,,,,,
27404125,8670111f-8b75-4a0c-9a6c-185d86935841,1619886582,120,1619883887,,0,0,7.1,1848,1916,22,23,,,4,0,0.06,,,,427,150,179,,,,64.61,46.24,64.84,1,,,,,,,,,,,,,,54,81,13.85,14.01,14.06,-5.3,-10.4,350,350,,1,359,359,,,,,,,,,"0,0,1,7,33,32,24,2,0","1,10,71,19,0","0,0,13,70,17",,,,,142,,,,,,,,,,,,,,,,,,,,,,,,,,,,,,,,,,,,51.3,12,8,342,52,,1012,2,360,0,4,3,Porz,1,0,U1.000|4:50-U1.000|4:36-U1.000|4:43-U1.000|4:07-U1.000|3:52-U1.000|4:29-U1.000|3:46-U0.087|0:25,,,,,wahoo_fitness-33,,518,7,,0,168070,250480,30378,,14438821,,,,,,,,,,,,,,,,,,,,,,,,,,,,,,,,,,,,,,,,,
27441684,49edd34f-b022-486d-83fa-7ac46af213d2,1619957764,120,1619966177,,0,0,17.36,14057,14057,105,106,,,4,0.1,0.24,,,92,2043,131,184,,,,,,,1,,,,,,,,,,,,,,373,58,,4.81,,-10,,,,,,,,,,,,,,,,"54,46,0,0,0,0","13,52,4,31,1",,,,,,,,,,,,,,,,,,,,,,,,,,,,,,,,,,,,,,,,,,63.4,11,17,301,54,,1017,3,399,0,3,3,Eil,1,0,U1.000|17:24-U1.000|11:43-U1.000|12:34-U1.000|11:20-U1.000|12:12-U1.000|12:54-U1.000|12:21-U1.000|19:51-U1.000|12:38-U1.000|12:07-U1.000|11:50-U1.000|17:15-U1.000|13:09-U1.000|12:33-U1.000|14:53-U1.000|11:51-U1.000|13:20-U0.347|4:26,,,,,wahoo_fitness-33,,518,7,,0,168075,,30378,,14468935,,,,,,,,,,,,,,,,,,,,,,,,,,,,,,,,,,,,,,,,5,
27449405,b8df2810-b8be-4e82-acc0-0105718a3879,1619975213,120,1619977386,,0,0,16.42,4524,4807,113,112,,,4,0,0.19,1.1,1,,994,145,184,,,,63.09,45.88,63.64,1,,,,,,,,,,,,,,85,82,13.16,13.12,13.27,-1.6,-1.5,328,328,,1,333,333,,,,,,,,,"2,1,4,13,37,33,9,1,0","0,29,58,12,1","0,0,23,72,5",,,,,133,,,,,,,,,,,,,,,,,,,,,,,,,,,,,,,,,,,,52,9,13,306,67,,1018,1,391,0,3,3,Porz,1,0,U1.000|5:04-U1.000|4:32-U1.000|4:46-U1.000|4:34-U1.000|4:39-U1.000|4:34-U1.000|4:40-U1.000|4:41-U1.000|4:34-U1.000|4:30-U0.164|0:42-U0.797|3:38-U1.000|4:15-U0.045|0:14-U1.000|4:37-U1.000|4:30-U1.000|4:35-U1.000|4:33-U0.380|1:46,,,,,wahoo_fitness-33,,518,7,,0,168070,250480,30378,,14475575,,,,,,,,,,,,,,,,,,,,,,,,,,,,,,,,,,,,,,,,,
27544975,8c0fd31d-b25c-4423-a1a5-398f43c7dd4c,1620152192,120,1620199654,,0,0,16.55,4755,5087,101,102,,,4,0,0.23,1.16,0.93,,1124,153,179,,,,55.61,43.73,56.03,1,,,,,,,,,,,,,,113,80,12.61,12.58,12.74,10.8,12.9,311,311,,1,316,316,,,,,,,,,"2,2,6,23,39,21,5,1,0","0,9,67,24,0","0,0,41,57,2",,,,,131,,,,,,,,,,,,,,,,,,,,,,,,,,,,,,,,,,,,45.8,10,26,256,64,,1002,1,369,0,3,3,Porz,1,0,U1.000|4:31-U1.000|4:33-U1.000|4:37-U1.000|4:43-U1.000|4:37-U1.000|4:51-U1.000|4:46-U1.000|4:51-U1.000|4:43-U1.000|4:43-U1.000|4:45-U1.000|4:57-U1.000|4:53-U1.000|4:54-U1.000|5:12-U1.000|5:01-U0.520|2:40,,,,,wahoo_fitness-33,,518,7,,0,168070,250480,30378,,14559749,,,,,,,,,,,,,,,,,,,,,,,,,,,,,,,,,,,,,,,,,
27544978,579e944f-bd09-4a09-a1cd-5fb1cac935c6,1620069595,120,1620199659,,0,0,13.76,3972,4263,33,33,,,4,0,0.01,,,,833,140,167,,,,62.4,42.86,62.59,1,,,,,,,,,,,,,,60,79,12.49,12.48,12.53,0.6,0.7,309,309,,1,310,310,,,,,,,,,"2,1,2,15,65,14,1,0,0","1,51,46,2,0","0,0,37,63,0",,,,,132,,,,,,,,,,,,,,,,,,,,,,,,,,,,,,,,,,,,22.7,10,9,188,60,,1014,0,394,0,4,3,Porz,1,0,U1.000|5:03-U1.000|4:43-U1.000|4:45-U1.000|4:50-U1.000|4:46-U1.000|4:45-U1.000|4:43-U1.000|4:56-U1.000|4:53-U1.000|4:49-U1.000|4:52-U1.000|4:51-U1.000|4:48-U0.727|3:29,,,,,wahoo_fitness-33,,518,7,,0,168070,250480,30378,,14559752,,,,,,,,,,,,,,,,,,,,,,,,,,,,,,,,,,,,,,,,,
27591950,d9168c89-1d57-4d96-994a-dd2b9fa99df3,1620240191,120,1620297851,,0,0,13.39,3789,3930,41,39,,,4,0,0.03,,,,901,155,179,,,,55.62,43.77,55.84,1,,,,,,,,,,,,,,99,80,12.76,12.76,12.8,1.1,1.1,317,317,,1,319,319,,,,,,,,,"1,1,3,14,57,23,2,0,0","1,10,52,38,0","0,0,25,75,0",,,,,133,,,,,,,,,,,,,,,,,,,,,,,,,,,,,,,,,,,,63.3,8,14,251,66,,1009,0,401,0,6,3,Porz,1,0,U1.000|4:59-U1.000|4:38-U1.000|4:37-U1.000|4:40-U1.000|4:43-U1.000|4:35-U1.000|4:36-U1.000|4:39-U1.000|4:41-U1.000|4:34-U1.000|4:46-U1.000|4:52-U1.000|5:02-U0.371|1:48,,,,,wahoo_fitness-33,,518,1,,0,168070,250480,30378,,14602970,,,,,,,,,,,,,,,,,,,,,,,,,,,,,,,,,,,,,,,,,
27617233,f890b719-783c-4f6d-9a65-0af157aaf2b3,1620329898,120,1620331527,,0,0,5.25,1945,2039,2,5,,,4,0,0,,0.41,,416,141,177,,,,45.44,29.86,45.43,1,,,,,,,,,,,,,,34,75,9.66,11.11,11.17,1.2,-8.2,235,235,,1,284,284,,,,,,,,,"46,8,10,9,3,3,6,11,4","0,62,15,23,0","22,22,31,8,16",,,,,108,,,,,,,,,,,,,,,,,,,,,,,,,,,,,,,,,,,,37,8,5,304,83,,1004,0,405,0,6,3,Urbach,1,0,U0.200|1:02-U0.200|0:43-U0.200|1:35-U0.200|0:41-U0.200|1:50-U0.200|0:40-U0.200|1:53-U0.200|0:40-U0.200|1:54-U0.200|0:41-U0.200|1:58-U0.200|0:38-U0.200|1:50-U0.200|0:39-U0.200|1:59-U0.200|0:39-U0.200|2:04-U0.200|0:40-U0.200|1:45-U0.200|0:37-U1.252|7:56,,,,,wahoo_fitness-33,,518,7,,0,168070,250480,30378,,14625844,,,,,,,,,,,,,,,,,,,,,,,,,,,,,,,,,,,,,,,,,
27617234,3aa28451-ad62-4cbb-bccf-f3ef3e4fe47f,1620328144,120,1620331531,,0,0,4.7,1377,1377,5,4,,,4,0,0,,,,279,137,144,,,,63,39.25,63.1,1,,,,,,,,,,,,,,18,79,12.33,12.33,12.37,0.9,0.3,304,304,,1,306,306,,,,,,,,,"1,2,5,18,66,8,1,0,0","1,84,15,0,0","0,0,41,59,0",,,,,130,,,,,,,,,,,,,,,,,,,,,,,,,,,,,,,,,,,,18.7,8,6,329,81,,1004,0,406,0,6,3,Porz,1,0,U1.000|5:11-U1.000|4:50-U1.000|4:46-U1.000|4:52-U0.696|3:18,,,,,wahoo_fitness-33,,518,7,,0,168070,250480,30378,,14625845,,,,,,,,,,,,,,,,,,,,,,,,,,,,,,,,,,,,,,,,,
27693368,f9ac3050-e3f3-49ba-98f6-3504303e28b0,1620501105,120,1620543860,,0,0,7.12,2138,2454,37,35,,,4,0,0.08,1.07,0.91,,429,136,151,,,,61.69,39.08,62.11,1,,,,,,,,,,,,,,40,78,12.03,12.02,12.11,0.4,-1,295,295,,1,298,298,,,,,,,,,"4,3,9,29,41,13,1,0,0","1,76,23,0,0","0,1,54,44,0",,,,,128,,,,,,,,,,,,,,,,,,,,,,,,,,,,,,,,,,,,19,16,14,169,66,,1010,0,325,0,4,3,Eil,1,0,U1.000|4:58-U1.000|5:04-U1.000|5:02-U1.000|5:04-U1.000|5:08-U1.000|4:54-U1.000|4:58-U0.101|0:31,,,,,wahoo_fitness-33,,518,7,,0,168070,250480,30378,,14693275,,,,,,,,,,,,,,,,,,,,,,,,,,,,,,,,,,,,,,,,,
27693369,e8f0577a-de13-4f38-9f63-8f3310cefec8,1620413039,120,1620543865,,0,0,20.32,5470,5658,136,134,,,4,0,0.21,1.07,0.93,,1330,153,169,,,,60.27,47.94,60.77,1,,,,,,,,,,,,,,158,80,13.46,13.4,13.54,-1.5,-1.4,338,338,,1,341,341,,,,,,,,,"1,0,2,8,37,44,8,1,0","0,3,91,6,0","0,0,14,81,5",,,,,139,,,,,,,,,,,,,,,,,,,,,,,,,,,,,,,,,,,,46.6,9,7,205,63,,1017,0,399,0,3,3,Eil,1,0,U1.000|4:33-U1.000|4:32-U1.000|4:38-U1.000|4:40-U1.000|4:32-U1.000|4:33-U1.000|4:35-U1.000|4:43-U1.000|4:42-U1.000|4:37-U1.000|4:31-U1.000|4:30-U1.000|4:18-U1.000|4:25-U1.000|4:24-U1.000|4:24-U1.000|4:25-U1.000|4:25-U1.000|4:23-U1.000|4:12-U0.273|1:10,,,,,wahoo_fitness-33,,518,7,,0,168070,250480,30378,,14693276,,,,,,,,,,,,,,,,,,,,,,,,,,,,,,,,,,,,,,,,,
27710325,499cbda5-5d9f-48d9-a8d9-f72049abb199,1620569869,120,1620566160,,0,0,1.01,370,370,4,3,,,4,0,0,1.11,,,74,136,145,,,,48.27,26.31,48.56,1,,,,,,,,,,,,,,7,79,9.86,9.97,10.03,5.2,3.5,233,233,,1,237,237,,,,,,,,,"22,21,39,15,2,0,0,0,0","1,76,23,0,0","0,11,89,0,0",,,,,104,,,,,,,,,,,,,,,,,,,,,,,,,,,,,,,,,,,,11.2,25,21,177,51,,1004,4,328,0,3,3,Porz,1,0,U1.000|6:08-U0.005|0:02,,,,,wahoo_fitness-33,,518,7,,0,168070,250480,30378,,14707451,,,,,,,,,,,,,,,,,,,,,,,,,,,,,,,,,,,,,,,,,
27710326,ae750b06-a299-4562-9f4a-47f5e35fbafb,1620564010,120,1620566161,,0,0,17.16,4739,5210,127,124,,,4,0,0.24,1.07,0.93,,1170,154,165,,,,57.85,45.92,58.39,1,,,,,,,,,,,,,,143,81,13.16,13.14,13.29,3.6,4.3,328,328,,1,333,333,,,,,,,,,"4,2,5,13,31,29,13,3,0","0,3,81,15,0","0,1,25,68,7",,,,,134,,,,,,,,,,,,,,,,,,,,,,,,,,,,,,,,,,,,48.5,26,38,160,36,,1004,,,0,2,1,Porz,1,0,U1.000|4:46-U1.000|4:19-U1.000|4:28-U1.000|4:52-U1.000|4:28-U1.000|4:35-U1.000|4:52-U1.000|4:44-U1.000|4:31-U1.000|4:24-U1.000|4:33-U1.000|4:20-U1.000|4:48-U1.000|4:33-U1.000|4:39-U1.000|4:37-U1.000|4:53-U0.132|0:38,,,,,wahoo_fitness-33,,518,7,,0,168070,250480,30378,,14707452,,,,,,,,,,,,,,,,,,,,,,,,,,,,,,,,,,,,,,,,,
27756256,0ba15afe-6332-42be-b9d8-0a2d5287f0e0,1620675226,120,1620669770,,0,0,1.9,609,1389,18,2,,,0,0,0,1.07,,,94,120,141,,,,66.06,32.88,67.53,1,57.57,,9,,0.9,0,,100,,,,,,8,78,11.58,11.3,11.63,-4.7,-4.5,276,276,,1,280,280,,,,,,,,,"6,7,17,46,24,0,0,0,0","11,89,0,0,0","0,1,80,19,0",,,,,120,,,,,,,,,,,,,,,18,,,,,,,,,,,,,,,,,,,,,9.4,18,7,184,68,,1008,0,345,0,4,3,Porz,1,0,U1.000|5:23-U0.904|4:46,,"Cologne Running",,,3113,,250,3,6756399217,0,168070,250480,30378,,14748572,,,,,,,,,,,,,,,,,,,,,,,,,,,,,,,,,,,,,,,,,
27887476,c25cc37f-a74d-4ef8-8223-d4e00a7c0f6d,1620930497,120,1620924627,,0,0,3.02,859,1001,31,2,,,0,0,0.13,1.14,,,167,137,151,,,,65.35,39.4,66.96,1,58.03,897,33,,2.3,0,105,100,,,,,,18,79,13.04,12.69,13.14,10.7,12.4,328,328,,1,332,332,,,,,,,,,"0,1,4,20,51,22,3,0,0","1,56,43,0,0","0,0,21,76,3",,,,,134,,,,,,,,,,,,,,,27,,,,,,,,,,,,,,,,,,,,,21,15,13,260,68,,1006,1,360,0,4,3,Porz,1,0,U1.000|4:42-U1.000|4:40-U1.000|4:51-U0.020|0:05,,"Cologne Running",,,3113,,250,3,6773296877,0,168070,250480,30378,2996304,14859475,437,7,6,30,3,0.21,0.47,1.29,0.95,0.55,1.56,87,0,68,2.1,395,0,14.49,0,151,0,,,,,,,,,,,,,,,,,,,,
28016369,15495a5d-6efd-4f11-863a-8292a6f5b494,1620758226,120,1621178617,,0,0,2.5,931,1263,3,2,,,4,0,0,,,,156,123,138,,,,53.38,28.31,53.48,1,,,,,,,,,,,,,,14,76,9.68,10.36,10.4,18.5,10.9,229,229,,1,251,251,,,,,,,,,"28,9,17,23,19,4,0,0,0","16,84,0,0,0","12,14,61,13,0",,,,,106,,,,,,,,,,,,,,,,,,,,,,,,,,,,,,,,,,,,11.8,13,12,296,84,,1008,0,359,0,6,3,Porz,1,0,U1.000|5:15-U1.000|7:36-U0.500|2:41,,,,,wahoo_fitness-33,,518,7,,0,168070,250480,30378,,14971608,,,,,,,,,,,,,,,,,,,,,,,,,,,,,,,,,,,,,,,,,
28066324,911e6bd9-71c9-49af-8aa3-6e7f09b0d92d,1621281015,120,1621294365,,0,0,10.54,3128,3406,334,336,,,4,4.3,0.8,1.12,1.12,548,767,155,176,,,,52.45,40.67,54.49,1,,,,,,,,,,,,,,104,80,13.11,12.47,13.55,-5.3,6.5,316,316,,1,333,333,,,,,,,,,"8,9,14,17,19,24,8,1,0","0,18,36,47,0","0,4,42,39,15",,,,,126,,,,,,,,,,,,,,,,,,,,,,,,,,,,,,,,,,,,59.7,10,16,261,90,,1006,0,383,0,6,3,Balve,1,0,U1.000|4:57-U1.000|5:28-U1.000|5:43-U1.000|5:08-U1.000|5:31-U1.000|5:52-U1.000|4:21-U1.000|4:05-U1.000|4:25-U1.000|4:21-U0.519|2:18,,,,,wahoo_fitness-33,,518,7,,0,168070,250480,30378,,15016936,,,,,,,,,,,,,,,,,,,,,,,,,,,,,,,,,,,,,,,,3,
28142653,bf34699b-9008-46b9-ba23-2880fe6a92fd,1621360484,120,1621429085,,0,0,5.73,1721,2250,142,143,,,4,2.8,0.64,1.17,0.95,557,425,158,188,,,,50.26,38.56,51.79,1,,,,,,,,,,,,,,61,80,12.71,12.5,13.24,16.4,28.3,309,309,,1,328,328,,,,,,,,,"8,7,11,18,38,13,1,1,3","1,14,40,40,5","0,6,40,41,13",,,,,125,,,,,,,,,,,,,,,,,,,,,,,,,,,,,,,,,,,,69.9,11,11,268,82,,1013,1,386,0,6,3,Balve,1,0,U1.000|4:59-U1.000|5:22-U1.000|5:59-U1.000|4:39-U0.023|0:04-U1.000|4:10-U0.694|3:28,,,,,wahoo_fitness-33,,518,7,,0,168070,250480,30378,,15085210,,,,,,,,,,,,,,,,,,,,,,,,,,,,,,,,,,,,,,,,4,
28179412,,1621420740,,1621499991,,0,0,11,3300,,,,,,0,,,,,,807,,,,,,,40.29,,1,,,,,,,,,,,,,,80,,,,,,,,,,,,,,,,,,,,,,,,,,,,,,,,,,,,,,,,,,,,,,,,,,,,,,,,,,,,,,,,,,,,,,,,,,1,,,0,0,,,,,,,,,0,,0,168070,250480,30378,,,,,,,,,,,,,,,,,,,,,,,,,,,,,,,,,,,,,,,,,,,
28180570,65dbdcbc-3d1a-4e4f-9fc9-f9c3b5810df9,1621512153,120,1621504991,,0,0,,8,8,0,0,,,4,0,0,,,,1,,,,,,,,,1,,,,,,,,,,,,,,0,,,5.46,,,,5,5,,1,5,5,,,,,,,,,"100,0,0,0,0,0,0",,"100,0,0,0,0",,,,,,,,,,,,,,,,,,,,,,,,,,,,,,,,,,,,,,,,,,13,11,238,70,,1020,4,349,0,3,3,Balve,1,0,,,,,,wahoo_fitness-43,,258,7,,0,168072,,30378,,15119353,,,,,,,,,,,,,,,,,,,,,,,,,,,,,,,,,,,,,,,,,
28194443,34529ff6-2435-4b15-adca-99a649171954,1621529181,120,1621530969,,0,0,54.02,7996,8862,1077,1076,,,4,4.8,0.64,1.28,1,788,1250,144,179,,,,,,,1,,,,,,,,,,,,,,211,83,,30.93,,-6.2,0.4,182,157,,0,202,191,,,,,,,,,"28,19,17,8,6,7,15","0,39,43,19,0","25,42,27,5,1",,,,,,,,,,,,,,,,,,,,,50,,,,,,,,,,,,,,,,,,,,52.2,14,13,203,67,,1016,2,351,0,4,3,Balve,1,0,,,,,,wahoo_fitness-43,,258,7,,0,168072,,30378,,15131808,,,,,,,,,,,,,,,,,,,,,,,,,,,,,,,,,,,,,,,,"4,4,4,4,4,4,5,5,5",
28218345,efac2c1a-e30b-43e1-a769-d0e0abfab3bd,1621598563,120,1621596994,,0,0,12.05,3631,3822,310,254,,,0,3.6,0.65,1.06,1.02,436,766,152,171,115,,,52.93,40.36,54.92,1,57.29,3433,147,,4.1,0,97,98,,,,,,112,78,12.58,12.17,12.97,-4.5,-9.5,304,304,,1,316,316,,,,,,,,,"9,3,8,28,31,18,2,0,0","0,12,64,23,0","0,2,45,46,6",,,,,128,,,,,,,,,,,,,,,33,,,,,,,,,,,,,,,,,,,,,54.2,15,24,230,56,,1006,4,360,0,3,3,Balve,1,0,U1.000|5:15-U1.000|5:03-U1.000|5:07-U1.000|4:30-U1.000|5:07-U1.000|5:34-U1.000|6:09-U1.000|4:57-U1.000|4:45-U1.000|4:32-U1.000|4:53-U1.000|4:23-U0.054|0:16,,"Balve Running",,,3113,,250,3,6816621342,0,168070,250480,30378,3040157,15152959,393,10,10,27,19,0.41,0.52,0.47,0.82,0.33,1.21,71,9,89,0.6,380,1,0.78,0,158,1,,,,,,,,,,,,,,,,,,,"4,4,5",
28225924,8790d0b6-c49e-472e-b7b1-0de49b7fc66b,1621615667,120,1621612755,,0,0,12.09,3736,3889,264,256,,,0,3.2,0.68,1.02,1.02,390,772,149,166,,,,52.76,39.2,54.23,1,57.13,4418,134,,3.8,0.7,99,99,,,,,,95,79,12.22,12.07,12.39,-8.4,-2.5,291,291,,1,299,299,,,,,,,,,"11,15,15,14,22,17,5,1,0","0,8,86,6,0","0,3,53,40,3",,,,,123,,,,,,,,,,,,,,,31,,,,,,,,,,,,,,,,,,,,,37.7,14,21,227,62,,1005,2,368,0,3,3,Balve,1,0,U1.000|5:26-U1.000|5:42-U1.000|6:27-U1.000|5:47-U1.000|6:29-U1.000|5:07-U1.000|4:33-U1.000|4:39-U1.000|4:36-U1.000|4:11-U1.000|4:44-U1.000|4:10-U0.089|0:26,,"Balve Running",,,3113,,250,3,6817837535,0,168070,250480,30378,3041002,15159037,402,5,4,20,12,0.12,0.18,0.03,0.92,0.46,1.32,92,1,96,0.1,3712,1,14.75,1,,0,,,,,,,,,,,,,,,,,,,4,
28259864,6f29f49e-f4bf-437d-a5d1-aba42a8cd6ee,1621703307,120,1621700100,,0,0,10.5,3587,3831,266,270,,,0,3.8,0.79,1.03,1.05,456,565,131,152,96,,,55.11,34.47,56.82,1,57.26,2928,58,,2.9,0,104,99,,,,,,55,77,11.3,11.02,11.54,-7.3,5.4,261,261,,1,273,273,,,,,,,,,"21,8,19,24,23,5,0,0,0","1,87,12,0,0","0,11,68,19,2",,,,,114,,,,,,,,,,,,,,,16,,,,,,,,,,,,,,,,,,,,,22.7,9,24,237,85,,1007,2,367,0,6,3,Balve,1,0,U1.000|5:44-U1.000|5:27-U1.000|5:55-U1.000|7:32-U1.000|7:36-U1.000|4:53-U1.000|5:10-U1.000|5:05-U1.000|4:52-U1.000|5:05-U0.500|2:29,,"Balve Running",,,3113,,250,3,6823563316,0,168070,250480,30378,,15188579,,,,,,,,,,,,,,,,,,,,,,,,,,,,,,,,,,,,,,,,"4,5",
28281554,10b77eb2-0091-4e21-a822-419389c248ac,1621767637,120,1621764802,,0,0,1.74,531,684,15,16,,,0,0.3,0.35,0.81,0.92,,123,154,171,,,,51.15,34.45,51.65,1,57.24,1595,60,,2.4,1.9,99,100,,,,,,16,79,12.29,12.3,12.37,-2.4,-19,294,294,,1,307,307,,,,,,,,,"11,1,4,27,32,12,5,6,3","0,7,78,15,0","5,5,38,44,8",,,,,124,,,,,,,,,,,,,,,33,,,,,,,,,,,,,,,,,,,,,32.5,10,21,240,81,,1014,3,371,0,3,3,Balve,1,0,U1.000|5:06-U0.742|3:45,,"Balve Running",,,3113,,250,3,6827189085,0,168070,250480,30378,3049343,15207559,389,4,3,23,0,0,0.23,1.26,1.01,0.7,1.5,92,0,75,1.3,335,0,13.14,0,159,0,,,,,,,,,,,,,,,,,,,,
28281569,0be5fd41-b5da-4eb8-90ca-881e10e74df1,1621768670,120,1621764818,,0,0,9.74,2352,2352,239,240,,,0,3.1,0.79,1,1.05,645,642,179,188,,,,54.11,51.48,55.74,1,56.57,5760,323,,5,2.4,98,98,,,,,,126,83,15.71,15.55,15.87,-9.2,-0.7,396,396,,1,404,404,,,,,,,,,"0,1,5,14,19,12,21,26,3","0,0,0,62,38","0,0,0,57,42",,,,,150,,,,,,,,,,,,,,,41,,,,,,,,,,,,,,,,,,,,,124.1,11,22,242,74,,1014,4,369,0,3,3,Balve,1,0,U1.000|4:22-U1.000|4:59-U1.000|4:37-U1.000|5:08-U1.000|3:46-U1.000|3:31-U1.000|3:30-U1.000|3:28-U1.000|3:05-U0.740|2:46,,"Balve Running",,,3113,,250,3,6827189349,0,168070,250480,30378,3049347,15207574,335,6,4,10,5,0.14,0.74,0.26,0.48,0.3,1,0,59,99,0.6,,0,24.77,0,165,1,,,,,,,,,,,,,,,,,,,4,
28292447,5611089a-e30e-4d80-8ae2-c1426ccddd4c,1621785425,120,1621782585,,0,0,26.46,4223,4321,477,478,,,4,3.8,0.62,1.13,0.89,655,579,134,166,,,,,,,1,,,,,,,,,,,,,,87,78,,30.98,,-15.4,-21.8,165,138,,0,187,173,,,,,,,,,"38,21,9,10,8,4,11","0,62,36,1,0","33,43,22,1,1",,,,,,,,,,,,,,,,,,,,,53,,,,,,,,,,,,,,,,,,,,30.9,14,21,245,51,,1015,3,359,0,3,3,Balve,1,0,,,,,,wahoo_fitness-43,,258,7,,0,168072,,30378,,15217272,,,,,,,,,,,,,,,,,,,,,,,,,,,,,,,,,,,,,,,,"4,4,5,5",
28323841,6e8190f6-36ef-4448-9e06-86c3c04f4671,1621853277,120,1621854921,,0,0,51.15,7850,8818,965,967,,,4,4.4,0.58,1.17,0.99,785,1201,139,169,,,,,,,1,,,,,,,,,,,,,,188,81,,29.86,,-18.8,-7.3,185,154,,0,203,190,,,,,,,,,"28,24,16,8,6,4,14","2,48,38,12,0","26,41,29,4,1",,,,,,,,,,,,,,,,,,,,,52,,,,,,,,,,,,,,,,,,,,53.3,15,22,194,58,,1010,4,363,0,3,3,Balve,1,0,,,,,,wahoo_fitness-43,,258,7,,0,168072,,30378,,15243217,,,,,,,,,,,,,,,,,,,,,,,,,,,,,,,,,,,,,,,,"4,4,4,4,4,5,5",
28406440,f6c941ee-51df-44d1-ae81-b5e948a4efef,1621878329,120,1622032370,,0,0,8.91,2943,3347,232,204,,,0,3.4,0.62,1.02,1.07,873,537,140,162,,,,52.84,35.44,54.75,1,57.14,3783,81,,3.2,0,100,99,,,,,,69,77,11.83,11.5,11.98,-9,2.8,275,275,,1,284,284,,,,,,,,,"23,5,7,22,33,11,0,0,0","1,43,55,1,0","0,9,58,32,0",,,,,118,,,,,,,,,,,,,,,15,,,,,,,,,,,,,,,,,,,,,33.9,11,17,203,83,,1010,1,366,0,6,3,Balve,1,0,U1.000|5:22-U1.000|5:13-U1.000|5:34-U1.000|8:02-U1.000|6:29-U1.000|4:43-U1.000|4:41-U1.000|4:34-U0.913|4:25,,"Balve Running",,,3113,,250,3,6845153184,0,168070,250480,30378,,15315101,,,,,,,,,,,,,,,,,,,,,,,,,,,,,,,,,,,,,,,,3,
28409923,ed0778bd-f8b4-4942-8fcf-969015788f0f,1622042576,120,1622038812,,0,0,10.35,2954,3403,268,230,,,0,3.6,0.82,1.03,1.09,513,597,148,178,,,,58.74,42.52,60.89,1,57.26,2376,124,,3.6,1.1,104,99,,,,,,82,80,13.5,13.17,13.67,-7.3,6.4,322,322,,1,331,331,,,,,,,,,"6,9,12,21,14,14,24,1,0","1,25,65,9,0","0,3,23,70,5",,,,,131,,,,,,,,,,,,,,,16,,,,,,,,,,,,,,,,,,,,,48.1,11,14,240,82,,1011,3,407,0,6,3,Balve,1,0,U1.000|4:47-U1.000|5:01-U1.000|5:42-U1.000|5:19-U1.000|6:17-U1.000|5:01-U1.000|3:45-U1.000|3:55-U1.000|4:09-U1.000|3:53-U0.348|1:26,,"Balve Running",,,3113,,250,3,6845661436,0,168070,250480,30378,,15318372,,,,,,,,,,,,,,,,,,,,,,,,,,,,,,,,,,,,,,,,"4,5",
28450768,12b95e1d-6dc4-4461-963d-77afc397bd13,1622136951,120,1622132067,,0,0,4.89,1562,1687,56,53,,,0,0.6,0.37,1.07,0.98,,305,138,155,95,,,56.1,35.51,56.94,1,57.24,1502,51,,2.6,0,99,100,,,,,,32,79,11.47,11.43,11.6,-7.5,-6.2,276,276,,1,281,281,,,,,,,,,"7,4,21,37,26,4,1,0,0","0,54,46,0,0","0,3,73,22,1",,,,,119,,,,,,,,,,,,,,,18,,,,,,,,,,,,,,,,,,,,,21.8,10,16,285,89,,1018,1,371,0,6,3,Balve,1,0,U1.000|5:29-U1.000|5:26-U1.000|5:57-U1.000|4:51-U0.893|4:19,,"Balve Running",,,3113,,250,3,6851689769,0,168070,250480,30378,,15354626,,,,,,,,,,,,,,,,,,,,,,,,,,,,,,,,,,,,,,,,,
28490160,fae1a79c-03ed-4adb-bb08-f591fb12ea56,1622221075,120,1622219226,,0,0,16.29,4896,5051,465,432,,,0,4.8,0.81,1.02,1.05,562,1078,159,183,120,,,49.75,41.45,51.63,1,56.44,5760,262,,5,2.4,100,96,,,,,,171,80,12.89,12.38,13.14,-0.2,10.7,307,307,,1,316,316,,,,,,,,,"10,10,16,14,17,26,6,0,0","0,2,47,50,1","0,0,44,52,3",,,,,125,,,,,,,,,,,,,,,20,,,,,,,,,,,,,,,,,,,,,72.8,16,9,15,56,,1023,2,350,0,3,3,Balve,1,0,U1.000|4:56-U1.000|5:12-U1.000|5:56-U1.000|5:19-U1.000|5:50-U1.000|5:40-U1.000|4:36-U1.000|5:15-U1.000|4:50-U1.000|4:20-U1.000|6:02-U1.000|5:33-U1.000|4:26-U1.000|4:21-U1.000|4:10-U1.000|3:55-U0.285|1:14,,"Balve Running",,,3113,,250,3,6857316499,0,168070,250480,30378,,15387967,,,,,,,,,,,,,,,,,,,,,,,,,,,,,,,,,,,,,,,,"4,4,4,5",
28637008,90c1a3da-2db8-4544-9a31-a164d990c8bb,1622579141,120,1622573413,,0,0,4.78,1363,1429,77,53,,,0,1.1,0.47,1.03,1.08,315,250,134,157,,,,67,40.57,68.76,1,57.39,1032,45,,2.4,0.2,105,107,,,,,,28,78,13.07,12.83,13.23,-5,-1.1,317,317,,1,321,321,,,,,,,,,"4,3,5,28,28,19,11,2,0","3,57,40,0,0","0,1,26,72,1",,,,,135,,,,,,,,,,,,,,,14,,,,,,,,,,,,,,,,,,,,,19,20,9,89,53,,1017,0,342,0,3,3,Balve,1,0,U1.000|5:10-U1.000|4:57-U1.000|5:07-U1.000|4:17-U0.778|3:11,,"Balve Running",,,3113,,250,3,6881960478,0,168070,250480,30378,,15516883,,,,,,,,,,,,,,,,,,,,,,,,,,,,,,,,,,,,,,,,5,
28637016,6178b286-bf20-441c-8c85-652f0cc2c229,1622321326,120,1622573428,,0,0,12.9,3737,3774,289,326,,,0,3.3,0.72,1.02,1.04,602,701,144,182,,,,59.86,42.47,61.3,1,56.51,3936,128,,3.3,2.2,100,101,,,,,,97,79,13.01,12.91,13.17,-13.1,-8.2,313,313,,1,322,322,,,,,,,,,"7,8,12,18,19,20,15,1,0","0,40,53,6,1","0,1,34,61,4",,,,,131,,,,,,,,,,,,,,,21,,,,,,,,,,,,,,,,,,,,,51.5,12,9,39,75,,1027,0,349,0,2,3,Balve,1,0,U1.000|4:50-U1.000|4:37-U1.000|5:05-U1.000|6:00-U1.000|5:56-U1.000|5:44-U1.000|5:08-U1.000|4:08-U1.000|3:54-U1.000|3:54-U1.000|3:56-U1.000|4:27-U0.898|4:39,,"Balve Running",,,3113,,250,3,6881960263,0,168070,250480,30378,,15516888,,,,,,,,,,,,,,,,,,,,,,,,,,,,,,,,,,,,,,,,"4,5",
28648201,6cb08c1b-5176-43e0-9b5c-75e730df908e,1622488402,120,1622611014,,0,0,14.72,4285,4611,356,355,,,4,4.1,0.73,1,1.03,691,924,142,168,,,,60.62,42.67,62.44,1,,,,,,,,,,,,,,100,80,13.18,12.87,13.36,-4,0.1,318,318,,1,328,328,,,,,,,,,"13,4,6,13,24,25,12,2,0","1,42,53,5,0","0,2,38,52,8",,,,,129,,,,,,,,,,,,,,,,,,,,,,,,,,,,,,,,,,,,35.9,20,10,66,49,,1020,0,339,0,2,3,Balve,1,0,U1.000|5:25-U1.000|4:18-U1.000|4:56-U1.000|4:57-U1.000|5:32-U1.000|7:28-U1.000|4:40-U1.000|4:15-U1.000|3:58-U1.000|4:01-U1.000|4:19-U1.000|4:40-U1.000|4:43-U1.000|4:56-U0.702|3:18,,,,,wahoo_fitness-33,,518,7,,0,168070,250480,30378,,15527053,,,,,,,,,,,,,,,,,,,,,,,,,,,,,,,,,,,,,,,,"3,5",
28648202,9bbcc0ba-7807-42d5-ad2e-c1f3f98c1ae8,1622391143,120,1622611014,,0,0,14.19,3784,3980,138,137,,,4,0.9,0.33,0.97,1.01,368,906,151,172,,,,62.12,47.11,62.87,1,,,,,,,,,,,,,,109,81,13.7,13.76,13.85,7.2,7.6,343,343,,1,350,350,,,,,,,,,"3,2,4,8,19,44,17,2,0","0,20,52,28,0","0,0,17,77,6",,,,,139,,,,,,,,,,,,,,,,,,,,,,,,,,,,,,,,,,,,60.2,20,13,35,52,,1026,3,335,0,3,3,Balve,1,0,U1.000|5:00-U0.060|0:20-U1.000|4:32-U1.000|4:20-U1.000|4:27-U1.000|4:29-U1.000|4:21-U1.000|4:07-U1.000|3:58-U1.000|4:01-U1.000|4:03-U1.000|4:03-U1.000|4:13-U1.000|5:37-U1.000|5:07-U0.099|0:32,,,,,wahoo_fitness-33,,518,7,,0,168070,250480,30378,,15527054,,,,,,,,,,,,,,,,,,,,,,,,,,,,,,,,,,,,,,,,5,
28648203,0f9a2978-5334-406b-a9aa-47f8ecf08eeb,1621968606,120,1622611017,,0,0,2.18,688,859,6,6,,,4,0,0,,,,162,152,166,,,,49.99,33.94,50.16,1,,,,,,,,,,,,,,21,78,11.44,11.47,11.5,-3.6,-0.7,277,277,,1,279,279,,,,,,,,,"3,8,18,39,27,5,0,0,0","1,10,59,30,0","0,0,87,13,0",,,,,122,,,,,,,,,,,,,,,,,,,,,,,,,,,,,,,,,,,,37.2,9,18,241,86,,1015,1,411,0,6,3,Balve,1,0,U1.000|5:22-U1.000|5:12-U0.176|0:54,,,,,wahoo_fitness-33,,518,7,,0,168070,250480,30378,,15527055,,,,,,,,,,,,,,,,,,,,,,,,,,,,,,,,,,,,,,,,,
28661329,69793e94-9f7f-4dd2-9e40-b7a2778c8908,1622622314,120,1622628043,,0,0,91.19,11938,12906,1072,1074,,,4,2.9,0.37,1.1,0.97,731,1836,139,169,,,,,,,1,,,,,,,,,,,,,,248,87,,31.77,,10.9,-11.1,174,156,,0,182,173,,,,,,,,,"15,15,13,12,22,13,10","2,54,41,4,0","18,57,22,2,1",,,,,,,,,,,,,,,,,,,,,52,,,,,,,,,,,,,,,,,,,,49,21,8,168,55,,1016,3,364,0,3,3,Balve,1,0,,,,,,wahoo_fitness-43,,258,7,,0,168072,,30378,,15534094,,,,,,,,,,,,,,,,,,,,,,,,,,,,,,,,,,,,,,,,"4,4,4,4,5,5",
28807484,9a77f641-65ab-464e-964a-782672ff0aaa,1622827804,120,1622993823,,0,0,13.14,3965,4416,363,338,,,0,4.1,0.83,1.02,1.08,471,756,147,171,97,,,55.35,40.56,57.37,1,56.55,4032,138,,3.7,0,104,100,,,,,,100,79,12.76,12.29,12.93,-8.2,0,305,305,,1,315,315,,,,,,,,,"8,10,16,19,18,24,5,0,0","0,29,64,7,0","0,2,38,57,3",,,,,126,,,,,,,,,,,,,,,18,,,,,,,,,,,,,,,,,,,,,49.3,22,5,67,83,,1020,2,331,0,4,3,Balve,1,0,U1.000|4:51-U1.000|4:56-U1.000|5:53-U1.000|5:38-U1.000|5:28-U1.000|5:29-U1.000|5:53-U1.000|5:05-U1.000|4:23-U1.000|4:14-U1.000|4:16-U1.000|4:11-U1.000|5:04-U0.135|0:43,,"Balve Running",,,3113,,250,3,6911081474,0,168070,250480,30378,,15661114,,,,,,,,,,,,,,,,,,,,,,,,,,,,,,,,,,,,,,,,3,
28807490,64ee5ef8-ae1b-47a2-88b8-e6893f3954ff,1622885997,120,1622993835,,0,0,10.02,3006,3016,172,171,,,0,2.4,0.68,1.02,1.03,413,598,145,165,,,,56.8,40.02,58.01,1,56.6,2973,90,,3.1,0.1,100,100,,,,,,72,79,12.34,12.19,12.53,-5.7,-8.5,300,300,,1,307,307,,,,,,,,,"4,6,13,26,32,16,3,0,0","0,37,60,3,0","0,0,48,50,2",,,,,127,,,,,,,,,,,,,,,31,,,,,,,,,,,,,,,,,,,,,38,19,8,231,89,,1020,3,339,0,4,3,Balve,1,0,U1.000|5:33-U1.000|5:07-U1.000|5:12-U1.000|5:05-U1.000|4:50-U1.000|5:06-U1.000|5:23-U1.000|4:15-U1.000|4:23-U1.000|5:06-U0.023|0:06,,"Balve Running",,,3113,,250,3,6911081838,0,168070,250480,30378,3122031,15661120,414,6,5,26,9,0.18,0.25,0.03,0.81,0.51,1.16,65,0,100,0.1,257,0,7.84,0,138,0,,,,,,,,,,,,,,,,,,,"5,5",
28807494,e26fd20f-efff-42c5-9a56-ec91d27d4698,1622718802,120,1622993841,,0,0,15.08,3945,4252,43,32,,,0,0,0.07,1.12,,,993,169,181,,,,53.8,48.39,54.03,1,56.55,5480,321,,5,2,100,95,,,,,,171,80,13.82,13.86,13.92,5.7,7,347,347,,1,352,352,,,,,,,,,"1,1,3,7,25,42,18,3,0","0,2,9,89,0","0,1,8,83,8",,,,,143,,,,,,,,,,,,,,,16,,,,,,,,,,,,,,,,,,,,,96.9,23,10,191,58,,1019,4,349,0,4,3,Sundern,1,0,U1.000|4:17-U1.000|4:00-U1.000|4:17-U1.000|4:15-U1.000|4:15-U1.000|4:30-U1.000|4:23-U1.000|4:13-U1.000|4:13-U1.000|4:18-U1.000|4:28-U1.000|4:20-U1.000|4:27-U1.000|4:32-U1.000|4:51-U0.084|0:27,,"Sundern (Sauerland) Running",,,3113,,250,3,6911081083,0,168070,250480,30378,,15661123,,,,,,,,,,,,,,,,,,,,,,,,,,,,,,,,,,,,,,,,,
28807498,39368226-6e28-432b-8a3e-321446f3154a,1622971970,120,1622993849,,0,0,32.8,10336,10999,853,776,,,0,5.4,0.76,1,1.05,483,1711,146,168,,,,52.96,41.26,54.82,1,56.46,4399,201,,4.3,0.1,101,99,,,,,,253,79,12.23,11.88,12.49,0.4,3.1,288,288,,1,300,300,,,,,,,,,"14,7,12,19,30,16,2,0,0","0,32,65,3,0","0,7,48,42,3",,,,,121,,,,,,,,,,,,,,,31,,,,,,,,,,,,,,,,,,,,,44.5,15,8,323,100,,1022,3,341,0,4,3,Balve,1,0,U1.000|5:23-U1.000|4:52-U1.000|5:01-U1.000|5:09-U1.000|4:55-U1.000|5:30-U1.000|6:06-U1.000|6:11-U1.000|5:13-U1.000|5:24-U1.000|5:27-U1.000|4:49-U1.000|4:51-U1.000|4:32-U1.000|5:06-U1.000|5:25-U1.000|5:02-U1.000|5:19-U1.000|4:51-U1.000|4:46-U1.000|4:30-U1.000|4:31-U1.000|10:44-U0.396|1:59-U1.000|6:36-U1.000|5:15-U1.000|5:04-U1.000|4:42-U1.000|4:07-U0.601|2:29-U1.000|4:16-U1.000|4:30-U1.000|5:29-U0.806|4:13,,"Balve Running",,,3113,,250,3,6911082892,0,168070,250480,30378,3122032,15661126,411,7,7,29,21,0.13,0.28,0.01,0.82,0.41,1.52,64,3,93,0.2,200,0,14.14,1,140,0,,,,,,,,,,,,,,,,,,,"3,4,4,4,4",
28848302,f89c0205-f967-40b6-a7b7-ffb318320e07,1623092343,120,1623088679,,0,0,10,3058,3195,176,163,,,0,2.1,0.69,0.99,1.01,697,497,134,168,,,,61.45,39.12,62.89,1,56.64,2136,63,,2.4,1,104,101,,,,,,52,78,12.1,11.94,12.32,1.1,2,293,293,,1,302,302,,,,,,,,,"5,7,15,26,34,9,2,1,0","1,73,25,1,0","0,1,57,40,2",,,,,126,,,,,,,,,,,,,,,28,,,,,,,,,,,,,,,,,,,,,22.5,17,9,15,70,,1022,,,0,4,1,Balve,1,0,U1.000|5:30-U1.000|5:03-U0.415|2:02-U0.150|0:30-U1.000|5:30-U1.000|4:57-U1.000|5:07-U1.000|5:27-U1.000|4:53-U1.000|4:35-U1.000|5:00-U0.435|2:25,,"Balve Running",,,3113,,250,3,6917212857,0,168070,250480,30378,3126676,15696189,448,12,11,37,17,1.22,2.7,0,0.74,0.41,1.44,49,6,69,1.7,278,0,11.92,0,120,0,,,,,,,,,,,,,,,,,,,5,
28881249,5f32a933-8b93-42f1-8f8a-c525bb93d1fc,1623178790,120,1623174729,,0,0,9.97,2946,2950,165,173,,,0,2.6,0.67,0.99,1.03,372,628,142,164,,,,59.51,40.72,60.67,1,57.33,1532,111,,3.3,0,102,103,,,,,,55,78,12.47,12.32,12.61,-0.9,-2.5,304,304,,1,309,309,,,,,,,,,"2,5,12,20,41,18,2,0,0","0,48,50,1,0","0,0,52,46,2",,,,,130,,,,,,,,,,,,,,,30,,,,,,,,,,,,,,,,,,,,,32.5,21,7,13,67,,1021,1,343,0,3,3,Balve,1,0,U1.000|5:19-U1.000|4:47-U1.000|4:52-U1.000|4:59-U1.000|4:53-U1.000|5:16-U1.000|5:12-U1.000|4:24-U1.000|4:29-U0.967|4:55,,"Balve Running",,,3113,,250,3,6923126287,0,168070,250480,30378,3131077,15726024,421,5,3,28,12,0.06,0.11,0.04,0.79,0.51,1.18,54,0,100,0.1,293,0,12.01,0,139,0,,,,,,,,,,,,,,,,,,,5,
28934708,feda0bcf-24a2-4f03-aa99-8bcb8c3a6203,1623265849,120,1623267948,,0,0,3.99,1270,1396,62,67,,,4,1.6,0.9,1.31,0.96,,319,156,184,,,,47.66,35.23,48.5,1,,,,,,,,,,,,,,46,80,11.44,14.61,14.77,18.6,-10.7,335,292,,1,406,392,,,,,,,,,"31,3,1,1,1,3,18,37,5","0,32,11,45,11","24,14,11,8,44",,,,,118,,,,,,,,,,,,,,,,,,,,,,,,,,,,,,,,,,,,78.6,22,4,319,65,,1020,0,339,0,3,3,"Menden (Sauerland)",1,0,U0.497|3:05-U0.024|0:09-U1.000|3:27-U0.200|1:54-U1.000|3:23-U0.231|2:20-U1.000|3:17-U0.034|3:34,,,,,wahoo_fitness-33,,518,7,,0,168070,250480,30378,,15773205,,,,,,,,,,,,,,,,,,,,,,,,,,,,,,,,,,,,,,,,,
28934734,94c11dae-4ef0-44b9-b7ad-ea7779372c73,1623263694,120,1623267971,,0,0,3.94,1036,1036,16,28,,,4,0,0.13,,0.8,,243,149,163,,,,64.4,44.05,64.48,1,,,,,,,,,,,,,,29,81,13.8,13.94,13.96,-2.6,-5.4,349,346,,1,356,355,,,,,,,,,"1,0,1,6,15,55,22,0,0","1,10,82,6,0","3,1,7,81,8",,,,,141,,,,,,,,,,,,,,,,,,,,,,,,,,,,,,,,,,,,39.1,22,5,276,61,,1020,1,345,0,3,3,"Menden (Sauerland)",1,0,U1.000|4:59-U1.000|4:18-U1.000|4:05-U0.933|3:52-U0.007|0:02,,,,,wahoo_fitness-33,,518,7,,0,168070,250480,30378,,15773231,,,,,,,,,,,,,,,,,,,,,,,,,,,,,,,,,,,,,,,,,
28934735,189bd01f-a6f7-409d-945b-852bf6ddaf08,1623267340,120,1623267971,,0,0,1.46,447,447,9,13,,,4,0,0.03,,0.92,,98,143,151,,,,56.43,33.66,56.67,1,,,,,,,,,,,,,,11,82,11.65,11.8,11.83,5.5,3.7,283,283,,1,288,288,,,,,,,,,"2,4,14,32,42,6,0,0,0","0,25,75,0,0","0,1,66,33,0",,,,,119,,,,,,,,,,,,,,,,,,,,,,,,,,,,,,,,,,,,18.1,22,4,319,65,,1020,0,339,0,3,3,"Menden (Sauerland)",1,0,U1.000|5:09-U0.452|2:18,,,,,wahoo_fitness-33,,518,7,,0,168070,250480,30378,,15773232,,,,,,,,,,,,,,,,,,,,,,,,,,,,,,,,,,,,,,,,,
28971209,71eba329-8288-4505-b4c9-464ccecaa6bc,1623346071,120,1623345356,,0,0,11.94,3906,3999,370,371,,,4,4.4,0.78,1.15,1.07,579,876,145,177,,,,51.04,36.63,52.99,1,,,,,,,,,,,,,,104,79,11.8,11.54,13.08,5.4,11.4,289,285,,1,334,333,,,,,,,,,"18,6,11,19,27,11,7,2,0","0,44,33,23,0","3,20,42,18,17",,,,,116,,,,,,,,,,,,,,,,,,,,,,,,,,,,,,,,,,,,64.7,23,7,352,49,,1020,2,341,0,3,3,Balve,1,0,U1.000|5:09-U1.000|5:04-U0.540|3:05-U0.209|1:01-U0.118|1:01-U0.239|1:02-U0.119|1:01-U0.240|1:01-U0.121|1:01-U0.254|1:01-U0.121|1:02-U0.257|1:02-U0.129|1:02-U0.276|1:02-U0.119|1:03-U0.247|1:03-U0.112|1:02-U0.229|1:01-U0.115|1:03-U0.251|1:02-U0.167|1:02-U0.286|1:03-U0.097|1:02-U0.205|1:01-U0.087|0:59-U0.223|1:03-U0.031|2:06-U1.000|5:16-U1.000|4:54-U1.000|4:57-U1.000|4:46-U1.000|5:34-U0.140|0:40,,,,,wahoo_fitness-33,,518,7,,0,168070,250480,30378,,15806411,,,,,,,,,,,,,,,,,,,,,,,,,,,,,,,,,,,,,,,,3,
29008706,2d670684-c154-4a95-9ef6-39b799c2085c,1623430117,120,1623424903,,0,0,7.08,1342,1858,70,70,,,4,0.8,0.4,1.87,0.02,557,212,119,154,,,,,,,1,,,,,,,,,,,,,,18,74,,24.06,,30.6,4.4,89,70,,1,121,113,,,,,,,,,"43,21,12,8,3,11,3","12,73,15,0,0","66,31,3,0,0",,,,,,,,,,,,,,,,,,,,,,,,,,,,,,,,,,,,,,,,,11.3,25,12,296,48,,1018,3,328,0,3,3,Balve,1,0,,,,,,wahoo_fitness-43,,258,7,,0,168072,,30378,,15840904,,,,,,,,,,,,,,,,,,,,,,,,,,,,,,,,,,,,,,,,5,
29082423,5802e80e-c3e9-4b6b-9664-2f4774ca8735,1623589663,120,1623587437,,0,0,2.62,631,843,51,52,,,4,1.6,0.7,,,580,57,,,,,,,,,1,,,,,,,,,,,,,,8,54,,17.09,,,,173,93,,0,213,172,,,,,,,,,"52,27,9,11,1,0,0",,"63,15,12,9,0",,,,,,,,,,,,,,,,,,,,,62,,,,,,,,,,,,,,,,,,,,,18,9,349,54,,1028,8,321,0,2,3,Balve,1,0,,,,,,wahoo_fitness-43,,258,7,,0,168072,,30378,,15906934,,,,,,,,,,,,,,,,,,,,,,,,,,,,,,,,,,,,,,,,5,
29110392,adee79ae-6627-4c34-80d4-5e6e5381b9f3,1623602101,120,1623656700,,0,0,38.26,4709,4709,,,,,0,,,,,,768,133,156,,,,,,,1,,,,,,,,,,,,,,90,96,,29.65,,4.3,-11.4,162,162,,0,176,176,,,,,,,,,"0,0,17,25,54,4,0","1,68,31,0,0","26,51,20,3,0",,,,,,,,,,,,,,,,,,,,,,,,,,,,,,,,,,,,,,,,,22.5,,,,,,,,,,1,,,1,0,,,,,,,,252,1,,0,168072,,30378,,15931193,,,,,,,,,,,,,,,,,,,,,,,,,,,,,,,,,,,,,,,,,
29279859,fca2bb5e-3a81-42fc-a434-6bd8c114e66d,1624036191,120,1624029860,,0,0,1,592,592,0,0,,,4,0,0,1.08,1.18,,77,108,120,,,,34.6,,34.6,1,,,,,,,,,,,,,,5,70,6.1,6.19,6.17,10.2,9.2,130,130,,1,132,132,,,,,,,,,"100,0,0,0,0,0,0,0,0","21,79,0,0,0","3,97,0,0,0",,,,,72,,,,,,,,,,,,,,,,,,,,,,,,,,,,,,,,,,,,2.1,18,19,7,93,,1014,3,332,0,3,3,Dornum,1,0,U1.001|9:51-U0.001|0:01,,,,,wahoo_fitness-33,,518,7,,0,168070,250480,30378,,16082571,,,,,,,,,,,,,,,,,,,,,,,,,,,,,,,,,,,,,,,,,
29396666,3e904d4d-e246-4b8b-9b1f-20c05778764f,1623918311,120,1624222322,,0,0,0.12,60,60,0,0,,,0,0,0,,,,8,111,123,,,,41.49,15.22,41.49,1,,,,,,,,,,,,,,1,70,7.25,7.46,7.46,34.9,28.3,160,160,,1,166,166,,,,,,,,,"71,2,7,5,15,0,0,0,0","25,75,0,0,0","0,86,14,0,0",,,,,86,,,,,,,,,,,,,,,,,,,,,,,,,,,,,,,,,,,,0.1,,,,,,,,,,1,,,1,0,,,,,,wahoo_fitness-33,,518,7,,0,168070,250480,30378,,16188692,,,,,,,,,,,,,,,,,,,,,,,,,,,,,,,,,,,,,,,,,
29396673,fc1df342-acfc-41f7-b53b-c0b4fd636a06,1624208070,120,1624222325,,0,0,46.14,6477,6806,676,678,,,4,3.9,0.48,1.22,0.89,896,964,138,163,,,,,,,1,,,,,,,,,,,,,,174,82,,31.19,,,,164,150,,0,174,169,,,,,,,,,"25,16,6,11,22,8,13","0,44,51,6,0","21,56,20,2,0",,,,,,,,,,,,,,,,,,,,,52,,,,,,,,,,,,,,,,,,,,16,27,9,180,50,,1009,2,326,0,3,3,Balve,1,0,,,,,,wahoo_fitness-43,,258,7,,0,168072,,30378,,16188698,,,,,,,,,,,,,,,,,,,,,,,,,,,,,,,,,,,,,,,,"3,4,5",
29396679,0e6085de-4429-4793-8196-bf95aa68a5a3,1623918198,120,1624222328,,0,0,0.07,62,62,0,0,,,0,0,0,,,,5,83,110,,,,26.43,,26.43,1,,,,,,,,,,,,,,0,59,4.14,4.09,4.09,-86.6,,92,90,,1,88,86,,,,,,,,,"100,0,0,0,0,0,0,0,0","89,11,0,0,0","44,56,0,0,0",,,,,57,,,,,,,,,,,,,,,,,,,,,,,,,,,,,,,,,,,,0,,,,,,,,,,1,,,1,0,,,,,,wahoo_fitness-33,,518,7,,0,168070,250480,30378,,16188705,,,,,,,,,,,,,,,,,,,,,,,,,,,,,,,,,,,,,,,,,
29396715,f2fb37f9-d407-4b31-94d2-3341647fb922,1623918403,120,1624222343,,0,0,,16,16,,,,,0,,,,,,2,102,108,,,,,,,1,,,,,,,,,,,,,,0,,,,,,,,,,,,,,,,,,,,,,"36,64,0,0,0",,,,,,,,,,,,,,,,,,,,,,,,,,,,,,,,,,,,,,,,,,,,,,,,,,,,1,,,1,0,,,,,,wahoo_fitness-33,,518,7,,0,168070,250480,30378,,16188741,,,,,,,,,,,,,,,,,,,,,,,,,,,,,,,,,,,,,,,,,
29396735,d3ea7d7e-05d8-42ff-89d6-11b821ba7d28,1623602180,120,1624222351,,0,0,,4763,4763,0,0,,,4,0,0,,,,1018,,,,,,,,,1,,,,,,,,,,,,,,61,,,0.93,,,,7,2,,1,9,6,,,,,,,,,"100,0,0,0,0,0,0",,"100,0,0,0,0",,,,,,,,,,,,,,,,,,,,,,,,,,,,,,,,,,,,,,,,,,21,8,6,45,,1027,4,321,0,2,3,Balve,1,0,,,,,,wahoo_fitness-43,,258,7,,0,168072,,30378,,16188761,,,,,,,,,,,,,,,,,,,,,,,,,,,,,,,,,,,,,,,,,
29396843,69837885-5a0d-4df3-9328-b72c22854105,1623601034,120,1624222397,,0,0,,1138,1138,0,2,,,4,0,0.06,,,,243,,,,,,,,,1,,,,,,,,,,,,,,15,0,,0.87,,,,5,2,,1,8,6,,,,,,,,,"100,0,0,0,0,0,0",,"100,0,0,0,0",,,,,,,,,,,,,,,,,,,,,51,,,,,,,,,,,,,,,,,,,,,21,8,358,44,,1027,5,321,0,2,3,Balve,1,0,,,,,,wahoo_fitness-43,,258,7,,0,168072,,30378,,16188867,,,,,,,,,,,,,,,,,,,,,,,,,,,,,,,,,,,,,,,,,
29396844,e7bdba5b-1c00-4554-a7b1-8110b3464b7b,1623918129,120,1624222400,,0,0,,4,4,,,,,0,,,,,,0,,,,,,,,,1,,,,,,,,,,,,,,0,,,,,,,,,,,,,,,,,,,,,,,,,,,,,,,,,,,,,,,,,,,,,,,,,,,,,,,,,,,,,,,,,,,,,,,,,,1,,,1,0,,,,,,wahoo_fitness-33,,518,7,,0,168070,250480,30378,,16188870,,,,,,,,,,,,,,,,,,,,,,,,,,,,,,,,,,,,,,,,,
29609950,57df91b4-6e64-4a13-900a-407596181646,1624540182,120,1624692861,,0,0,,1650,1650,1,0,,,4,0,0,1.1,0.88,,231,131,158,,,,,,,1,,,,,,,,,,,,,,30,93,,2.5,,-1.3,-34.8,151,151,,0,158,158,,,,,,,,,"100,0,0,0,0,0,0","0,76,24,0,0","42,26,32,0,0",,,,,,,,,,,,,,,,,,,,,50,,,,,,,,,,,,,,,,,,,,16.7,17,6,22,81,,1019,4,335,0,6,3,Balve,1,0,,,,,,wahoo_fitness-43,,258,7,,0,168072,,30378,,16376513,,,,,,,,,,,,,,,,,,,,,,,,,,,,,,,,,,,,,,,,,
29609963,4a698676-bbc0-4478-b61e-053229243b10,1624387122,120,1624692903,,0,0,,7202,8344,3,2,,,4,0,0,1.16,1.09,,992,125,150,,,,,,,1,,,,,,,,,,,,,,113,89,,2.33,,49.3,-5.5,143,143,,0,155,154,,,,,,,,,"100,0,0,0,0,0,0","6,80,13,0,0","29,63,8,0,0",,,,,,,,,,,,,,,,,,,,,50,,,,,,,,,,,,,,,,,,,,15.8,14,7,11,84,,1016,0,340,0,6,3,Balve,1,0,,,,,,wahoo_fitness-43,,258,7,,0,168072,,30378,,16376526,,,,,,,,,,,,,,,,,,,,,,,,,,,,,,,,,,,,,,,,,
29650559,0041706a-9b48-4732-bc19-94a108addb9a,1624786531,120,1624787877,,0,0,4.76,1550,1582,12,11,,,4,0,0,1.15,,,369,158,173,,,,45.49,34.65,45.64,1,,,,,,,,,,,,,,54,78,11.08,11.12,11.16,7.3,7.3,267,267,,1,270,270,,,,,,,,,"12,11,20,31,17,7,2,0,0","1,6,41,52,0","0,1,83,17,0",,,,,118,,,,,,,,,,,,,,,,,,,,,,,,,,,,,,,,,,,,50.9,22,10,136,66,,1016,2,338,0,3,3,Porz,1,0,U1.000|5:29-U1.000|5:17-U1.000|5:25-U1.000|5:19-U0.756|4:20,,,,,wahoo_fitness-33,,518,7,,0,168070,250480,30378,,16411668,,,,,,,,,,,,,,,,,,,,,,,,,,,,,,,,,,,,,,,,,
29668348,b978c75f-fe6e-4e9f-a3ec-aa3c6bd4afa4,1624820677,120,1624814759,,0,0,1.32,1133,1133,184,35,,,4,3.8,1,1.43,1.06,527,205,130,165,,,,17.36,,23.32,1,,,,,,,,,,,,,,21,69,6.52,6.8,10.2,32.4,-49.4,191,182,,1,260,257,,,,,,,,,"90,2,1,2,3,2,1,0,0","3,67,27,3,0","37,25,16,12,11",,,,,51,,,,,,,,,,,,,,,,,,,,,,,,,,,,,,,,,,,,14.2,23,8,119,60,,1015,1,326,0,6,3,Werdohl,1,0,U0.874|11:52-U0.136|2:31-U0.312|4:30,,,,,wahoo_fitness-33,,518,7,,0,168070,250480,30378,,16426895,,,,,,,,,,,,,,,,,,,,,,,,,,,,,,,,,,,,,,,,3,
29693130,29e9656d-b728-4b0a-ae4b-de15ef91463e,1624872734,120,1624874971,,0,0,62.61,8789,9380,845,843,,,4,3.1,0.46,1.32,0.82,672,1223,143,180,,,,,,,1,,,,,,,,,,,,,,223,85,,29.8,,17.2,5.4,164,142,,0,189,180,,,,,,,,,"10,18,27,12,15,8,9","0,44,37,19,0","31,43,21,3,1",,,,,,,,,,,,,,,,,,,,,50,,,,,,,,,,,,,,,,,,,,64.4,24,6,129,64,,1015,4,323,0,3,3,Balve,1,0,,,,,,wahoo_fitness-43,,258,7,,0,168072,,30378,,16449196,,,,,,,,,,,,,,,,,,,,,,,,,,,,,,,,,,,,,,,,"4,4,4,5",
29741605,a41e47e2-3518-4888-8162-36883602b6dc,1624982856,120,1624982334,,0,0,8.93,2924,3003,290,270,,,4,4.2,0.82,1.19,1.06,563,640,143,164,,,,51.94,35.81,54.17,1,,,,,,,,,,,,,,60,77,11.78,11.14,12.47,2.8,17.6,282,282,,1,307,307,,,,,,,,,"11,11,18,33,24,3,0,0,0","0,42,54,4,0","0,18,42,31,9",,,,,119,,,,,,,,,,,,,,,,,,,,,,,,,,,,,,,,,,,,33.6,22,11,309,79,,1011,3,334,0,3,3,Balve,1,0,U1.000|5:53-U1.000|5:12-U1.000|5:14-U1.000|5:51-U1.000|6:12-U1.000|5:33-U1.000|5:11-U1.000|5:01-U0.921|4:38,,,,,wahoo_fitness-33,,518,7,,0,168070,250480,30378,,16492291,,,,,,,,,,,,,,,,,,,,,,,,,,,,,,,,,,,,,,,,"3,5",
29745731,7cbaa172-785d-4c9d-8c5c-4b14e44068b2,1624989499,120,1624989331,,0,0,39.07,6267,6942,558,551,,,4,2.4,0.45,1.32,0.87,833,678,127,169,,,,,,,1,,,,,,,,,,,,,,81,78,,26.51,,15.8,-13.6,134,111,,0,151,143,,,,,,,,,"28,15,13,24,10,3,6","9,68,21,2,0","45,39,14,1,0",,,,,,,,,,,,,,,,,,,,,51,,,,,,,,,,,,,,,,,,,,29.4,19,10,199,92,,1011,1,331,0,6,3,Balve,1,0,,,,,,wahoo_fitness-43,,258,7,,0,168072,,30378,,16495919,,,,,,,,,,,,,,,,,,,,,,,,,,,,,,,,,,,,,,,,"4,5,5",
29785788,ab708edd-114d-4427-a01e-45b010be174e,1625079888,120,1625077757,,0,0,7.52,2193,2193,103,108,,,4,0,0.19,1.07,0.81,,564,159,188,,,,51.63,40.59,52.47,1,,,,,,,,,,,,,,76,80,12.58,14.34,14.56,3.1,-1.9,317,316,,1,383,382,,,,,,,,,"39,2,1,1,1,3,30,24,0","0,33,10,41,17","9,25,10,12,43",,,,,129,,,,,,,,,,,,,,,,,,,,,,,,,,,,,,,,,,,,84.3,16,11,303,96,,1013,1,341,0,6,3,"Menden (Sauerland)",1,0,U0.300|1:29-U0.400|1:27-U0.400|1:22-U0.400|3:52-U0.400|1:30-U0.400|1:26-U0.400|1:24-U0.400|3:34-U0.400|1:28-U0.400|1:24-U0.400|1:22-U0.400|3:40-U0.400|1:29-U0.400|1:27-U0.400|1:22-U0.400|3:34-U0.800|2:53-U0.400|1:22-U0.023|0:27-U0.000|0:02,,,,,wahoo_fitness-33,,518,7,,0,168070,250480,30378,,16531186,,,,,,,,,,,,,,,,,,,,,,,,,,,,,,,,,,,,,,,,,
29785794,5d69e43d-dedf-46a7-bee0-f8cebfbe58a6,1625082298,120,1625077766,,0,0,3.25,1067,1067,12,18,,,4,0,0.06,1.12,0.91,,238,144,153,,,,51.29,33.5,51.41,1,,,,,,,,,,,,,,21,81,10.94,10.99,11,-2.1,-4.5,261,261,,1,264,264,,,,,,,,,"7,12,28,36,12,4,0,0,0","0,13,87,0,0","0,2,89,9,0",,,,,113,,,,,,,,,,,,,,,,,,,,,,,,,,,,,,,,,,,,17.7,16,10,265,95,,1013,0,342,0,6,3,"Menden (Sauerland)",1,0,U1.000|5:36-U1.000|5:30-U1.000|5:23-U0.241|1:19,,,,,wahoo_fitness-33,,518,7,,0,168070,250480,30378,,16531192,,,,,,,,,,,,,,,,,,,,,,,,,,,,,,,,,,,,,,,,,
29785795,6570ac78-a85c-40bb-9f8e-c941feb8d5aa,1625077975,120,1625077765,,0,0,3.94,1207,1207,18,30,,,4,0,0.08,1.12,0.88,,257,141,153,,,,57.45,36.83,57.55,1,,,,,,,,,,,,,,22,79,11.81,11.87,11.88,0.4,0,287,285,,1,291,290,,,,,,,,,"1,2,11,33,45,7,1,0,0","1,31,68,0,0","2,1,57,40,0",,,,,124,,,,,,,,,,,,,,,,,,,,,,,,,,,,,,,,,,,,17.2,16,11,305,96,,1012,1,340,0,4,3,"Menden (Sauerland)",1,0,U1.000|5:30-U1.000|4:54-U1.000|4:58-U0.932|4:45,,,,,wahoo_fitness-33,,518,7,,0,168070,250480,30378,,16531193,,,,,,,,,,,,,,,,,,,,,,,,,,,,,,,,,,,,,,,,,
29838573,9087758f-3255-451d-9655-fa56edbdb3f0,1625163925,120,1625212953,,0,0,10.24,3459,3719,227,244,,,4,2.8,0.63,1.13,0.93,386,679,136,163,,,,53.35,34.86,54.7,1,,,,,,,,,,,,,,56,78,11.04,10.87,11.62,8.7,4.6,263,263,,1,285,285,,,,,,,,,"14,16,28,20,16,5,1,0,0","2,58,39,1,0","2,20,47,26,5",,,,,114,,,,,,,,,,,,,,,,,,,,,,,,,,,,,,,,,,,,23.7,13,12,264,99,,1017,1,338,0,6,3,Sundern,1,0,U1.000|5:00-U1.000|4:47-U1.000|5:01-U1.000|5:31-U1.000|5:47-U1.000|6:22-U1.000|6:20-U1.000|5:54-U1.000|5:48-U1.000|5:53-U0.228|1:16,,,,,wahoo_fitness-33,,518,7,,0,168070,250480,30378,,16575347,,,,,,,,,,,,,,,,,,,,,,,,,,,,,,,,,,,,,,,,4,
29895491,fc044a4d-cb7c-4e0b-8387-c3d8d709d284,1625245645,120,1625332477,,0,0,76.87,10848,12560,1223,1223,,,4,4,0.57,1.19,0.89,714,1605,135,173,,,,,,,1,,,,,,,,,,,,,,177,86,,31.05,,3.6,-6.2,172,152,,0,184,177,,,,,,,,,"17,22,17,12,13,4,14","3,59,34,3,0","23,46,29,2,0",,,,,,,,,,,,,,,,,,,,,50,,,,,,,,,,,,,,,,,,,,30.4,20,9,304,63,,1017,1,341,0,3,3,Balve,1,0,,,,,,wahoo_fitness-43,,258,7,,0,168072,,30378,,16627553,,,,,,,,,,,,,,,,,,,,,,,,,,,,,,,,,,,,,,,,"3,4,4,4",
29963216,f92f2dc4-efa3-4e4e-9c31-2e4b9bea9093,1625427966,120,1625489492,,0,0,4.4,1363,1941,132,130,,,4,2.7,0.72,1.12,1.01,599,278,137,158,,,,58.81,36.6,61.03,1,,,,,,,,,,,,,,23,78,12.3,12.08,12.86,0.3,8.6,296,296,,1,311,311,,,,,,,,,"16,4,13,24,22,14,7,1,0","2,61,37,0,0","0,7,45,41,6",,,,,124,,,,,,,,,,,,,,,,,,,,,,,,,,,,,,,,,,,,13.8,17,7,228,90,,1010,0,339,0,6,3,Balve,1,0,U1.000|5:08-U1.000|6:10-U1.000|4:59-U0.137|0:44-U1.000|4:20-U0.255|1:23,,,,,wahoo_fitness-33,,518,7,,0,168070,250480,30378,,16689445,,,,,,,,,,,,,,,,,,,,,,,,,,,,,,,,,,,,,,,,4,
29963217,154cc838-7e60-4e4f-80e7-ab38dcb70037,1625304681,120,1625489495,,0,0,8.53,2507,5050,107,106,,,4,1.1,0.43,1.09,0.95,,564,147,171,,,,57.18,40.54,58.07,1,,,,,,,,,,,,,,57,79,12.44,12.51,12.72,-9.3,-14.3,305,305,,1,316,316,,,,,,,,,"5,4,11,22,34,16,6,2,0","1,28,53,18,0","0,1,48,44,6",,,,,129,,,,,,,,,,,,,,,,,,,,,,,,,,,,,,,,,,,,35.7,19,4,253,72,,1017,3,325,0,3,3,Balve,1,0,U1.000|5:24-U1.000|4:53-U1.000|5:16-U1.000|5:08-U1.000|5:14-U0.233|1:09-U1.000|3:50-U1.000|4:32-U1.000|4:58-U0.279|1:23,,,,,wahoo_fitness-33,,518,7,,0,168070,250480,30378,,16689446,,,,,,,,,,,,,,,,,,,,,,,,,,,,,,,,,,,,,,,,,
29982684,4cacdcdf-f68f-46b6-ad49-113a5de7455f,1625510686,120,1625526771,,0,0,12.2,3431,3785,47,47,,,4,0,0.12,0.99,0.96,,819,152,185,,,,57.63,43.78,57.91,1,,,,,,,,,,,,,,88,80,12.88,13.12,13.22,4.4,-2.3,321,321,,1,334,334,,,,,,,,,"2,3,7,18,39,22,2,5,1","1,8,73,17,1","0,1,38,53,8",,,,,133,,,,,,,,,,,,,,,,,,,,,,,,,,,,,,,,,,,,47.7,17,8,174,88,,1010,1,324,0,4,3,Balve,1,0,U1.000|5:02-U1.000|4:54-U1.000|4:25-U1.000|4:29-U1.000|4:43-U0.681|3:12-U0.433|1:25-U1.000|4:52-U0.536|2:36-U0.416|1:22-U1.000|5:07-U0.242|1:08-U0.428|1:21-U1.000|5:21-U1.000|4:44-U0.449|2:31,,,,,wahoo_fitness-33,,518,7,,0,168070,250480,30378,,16706230,,,,,,,,,,,,,,,,,,,,,,,,,,,,,,,,,,,,,,,,,
30002230,7da5e029-6623-42be-9c88-54e47ac8cc25,1625424492,120,1625574639,,0,0,,157310,157310,,,,,0,,,,,,801,107,195,,,,,,,1,,,,,,,,,,,,,,2923,,,,,,,,,,,,,,,,,,,,,,"68,6,7,16,4",,,,,,,,,,,,,,,,,,,,,,,,,,,,,,,,,,,,,,,,,,94.2,,,,,,,,,,1,,,1,0,,,,,,wahoo_fitness-33,,518,7,,0,168072,,30378,,16724269,,,,,,,,,,,,,,,,,,,,,,,,,,,,,,,,,,,,,,,,,
30019077,9e42b1f8-ff40-4d6f-a7a5-bf83163e10c4,1625600236,120,1625603481,,0,0,1.02,406,406,13,16,,,4,0,0.2,1.04,0.89,,75,130,134,,,,46.07,23.93,46.63,1,,,,,,,,,,,,,,5,81,9.05,9.39,9.57,-11.2,-9,212,209,,1,227,225,,,,,,,,,"39,16,37,8,1,0,0,0,0","0,100,0,0,0","8,38,50,5,0",,,,,93,,,,,,,,,,,,,,,,,,,,,,,,,,,,,,,,,,,,7.4,20,17,222,67,,1011,0,339,0,4,3,"Menden (Sauerland)",1,0,U1.000|6:41-U0.014|0:06,,,,,wahoo_fitness-33,,518,7,,0,168070,250480,30378,,16739379,,,,,,,,,,,,,,,,,,,,,,,,,,,,,,,,,,,,,,,,,
30019078,9c2cd11e-9924-4210-9485-e7f77406aec4,1625597750,120,1625603483,,0,0,8.38,2426,2426,117,117,,,4,1.3,0.59,1.33,1.05,,610,160,183,,,,51.62,41.22,52.51,1,,,,,,,,,,,,,,83,82,12.67,14.51,14.77,21.9,2.4,356,324,,1,395,385,,,,,,,,,"17,3,4,3,3,9,36,24,1","0,17,21,60,2","16,7,10,26,41",,,,,126,,,,,,,,,,,,,,,,,,,,,,,,,,,,,,,,,,,,80.6,20,16,222,67,,1011,0,339,0,4,3,"Menden (Sauerland)",1,0,U0.785|2:58-U0.200|0:43-U1.000|3:39-U0.400|2:26-U0.500|1:43-U0.200|1:26-U0.500|1:40-U0.200|1:14-U1.000|3:40-U0.238|1:35-U0.500|1:41-U0.200|1:24-U0.500|1:48-U0.119|1:56-U1.000|3:49-U1.000|3:45-U0.038|4:59,,,,,wahoo_fitness-33,,518,7,,0,168070,250480,30378,,16739380,,,,,,,,,,,,,,,,,,,,,,,,,,,,,,,,,,,,,,,,,
30019079,f304e76c-47fc-4dde-88d3-61a9e284eb03,1625596371,120,1625603485,,0,0,3.94,1062,1062,21,27,,,4,0,0.08,,0.92,,249,150,160,,,,61.88,42.8,62.17,1,,,,,,,,,,,,,,25,82,13.35,13.4,13.4,-1.5,-4.2,334,334,,1,336,336,,,,,,,,,"0,0,1,9,34,51,5,0,0","0,7,93,0,0","0,1,9,89,0",,,,,136,,,,,,,,,,,,,,,,,,,,,,,,,,,,,,,,,,,,31,21,20,223,64,,1010,1,338,0,4,3,"Menden (Sauerland)",1,0,U1.000|4:44-U1.000|4:28-U1.000|4:23-U0.933|4:07,,,,,wahoo_fitness-33,,518,7,,0,168070,250480,30378,,16739381,,,,,,,,,,,,,,,,,,,,,,,,,,,,,,,,,,,,,,,,,
30053940,60824442-36af-468c-b40a-98c95f7c9ba7,1625684765,120,1625682985,,0,0,15,4421,4478,140,153,,,4,0.7,0.3,1,1.03,,977,144,171,,,,58.59,42.12,59.21,1,,,,,,,,,,,,,,91,80,12.38,12.35,12.53,1.6,-1,303,303,,1,309,309,,,,,,,,,"3,2,5,23,48,16,1,0,0","1,24,71,5,0","0,1,44,54,1",,,,,127,,,,,,,,,,,,,,,,,,,,,,,,,,,,,,,,,,,,41.7,21,7,241,64,,1018,0,342,0,3,3,Balve,1,0,U1.000|5:23-U1.000|4:47-U1.000|4:55-U1.000|5:06-U1.000|5:08-U1.000|5:05-U1.000|5:00-U1.000|4:47-U1.000|4:52-U1.000|4:39-U1.000|4:36-U1.000|4:26-U1.000|4:50-U1.000|4:40-U0.978|5:27,,,,,wahoo_fitness-33,,518,7,,0,168070,250480,30378,,16771105,,,,,,,,,,,,,,,,,,,,,,,,,,,,,,,,,,,,,,,,,
30074668,3948701f-0ced-4f0a-a205-afb2285f0309,1625424749,120,1625735025,,0,0,0.13,1208,1407,10,9,,,4,0,0,,1.1,,106,169,195,,,,,,,1,,,,,,,,,,,,,,49,62,,2.23,,,-58.6,62,55,,0,55,52,,,,,,,,,"94,6,0,0,0,0,0","0,4,17,66,13","90,10,0,0,0",,,,,,,,,,,,,,,,,,,,,53,,,,,,,,,,,,,,,,,,,,83.2,18,7,231,87,,1010,1,338,0,6,3,Balve,1,0,,,,,,wahoo_fitness-43,,258,7,,0,168072,,30378,,16789452,,,,,,,,,,,,,,,,,,,,,,,,,,,,,,,,,,,,,,,,,
30095332,83e8284f-3a55-4e20-87b3-22683e149e18,1625774671,120,1625773705,,0,0,15.24,4744,4965,408,405,,,4,4.4,0.87,1.12,1.1,565,1068,146,168,,,,53.76,39.58,55.56,1,,,,,,,,,,,,,,104,79,12.29,11.86,12.67,-6.6,2.5,294,294,,1,309,309,,,,,,,,,"12,10,16,20,22,16,4,0,0","0,32,64,4,0","0,6,52,34,8",,,,,122,,,,,,,,,,,,,,,,,,,,,,,,,,,,,,,,,,,,37.9,17,6,319,83,,1021,0,337,0,6,3,Balve,1,0,U1.000|5:50-U1.000|6:01-U1.000|5:36-U1.000|6:21-U1.000|5:19-U1.000|4:49-U1.000|5:20-U1.000|5:24-U1.000|5:15-U1.000|5:02-U1.000|5:28-U1.000|4:29-U1.000|4:20-U1.000|4:30-U1.000|4:17-U0.226|1:03,,,,,wahoo_fitness-33,,518,7,,0,168070,250480,30378,,16809343,,,,,,,,,,,,,,,,,,,,,,,,,,,,,,,,,,,,,,,,"3,5,5",
30213210,ef948619-656a-4f54-8388-c5069039d924,1626017764,120,1626023320,,0,0,23.47,7677,8270,594,594,,,4,4.9,0.77,1.07,1.05,446,1630,141,160,,,,52.98,38.63,54.64,1,,,,,,,,,,,,,,141,79,11.66,11.31,12.09,3.5,6,276,276,,1,293,293,,,,,,,,,"17,12,17,21,21,9,1,0,0","0,47,53,0,0","0,12,55,27,5",,,,,116,,,,,,,,,,,,,,,,,,,,,,,,,,,,,,,,,,,,37.7,18,6,240,78,,1017,3,322,0,4,3,Balve,1,0,U1.000|5:03-U1.000|4:56-U1.000|6:10-U1.000|6:02-U1.000|5:46-U1.000|5:46-U1.000|4:53-U1.000|4:28-U1.000|4:32-U1.000|5:54-U1.000|5:54-U1.000|6:23-U1.000|5:55-U1.000|5:02-U1.000|5:10-U1.000|5:53-U1.000|5:49-U1.000|4:55-U1.000|4:47-U1.000|4:42-U1.000|4:52-U1.000|6:29-U1.000|6:13-U0.426|2:25,,,,,wahoo_fitness-33,,518,7,,0,168070,250480,30378,,16919419,,,,,,,,,,,,,,,,,,,,,,,,,,,,,,,,,,,,,,,,"3,4,4,5",
30214493,f3c88aa6-054c-4300-abf0-82ce5f8516e8,1625935414,120,1626025500,,0,0,46.14,6858,9835,852,823,,,4,4.3,0.59,1.23,1.09,848,1029,138,169,,,,,,,1,,,,,,,,,,,,,,122,80,,30.77,,-31.5,-16,180,154,,0,189,177,,,,,,,,,"30,19,12,9,7,5,17","2,49,47,2,0","27,39,32,2,1",,,,,,,,,,,,,,,,,,,,,50,,,,,,,,,,,,,,,,,,,,38,23,6,111,57,,1015,2,325,0,4,3,Balve,1,0,,,,,,wahoo_fitness-43,,258,7,,0,168072,,30378,,16920523,,,,,,,,,,,,,,,,,,,,,,,,,,,,,,,,,,,,,,,,"4,4,4,5,5,5",
30218043,091e4be7-9014-42fa-b685-a99144366950,1625857143,120,1626033825,,0,0,3.38,1113,1255,87,30,,,0,1.9,0.82,1.05,1.1,460,229,144,164,,,,51.1,33.48,53.8,1,56.86,1212,57,,2.6,1,97,98,,,,,,23,78,11.79,11.12,11.93,-2.4,-0.9,286,286,,1,292,292,,,,,,,,,"12,7,31,27,16,4,2,1,0","1,35,58,6,0","0,4,53,41,2",,,,,117,,,,,,,,,,,,,,,30,,,,,,,,,,,,,,,,,,,,,27.6,19,5,321,75,,1020,1,345,0,6,3,Balve,1,0,U1.000|5:44-U1.000|5:37-U1.000|4:56-U0.384|2:15,,"Balve Running",,,3113,,250,3,7109778752,0,168070,250480,30378,3304677,16923893,417,5,4,34,17,0.07,0.15,0.04,0.93,0.3,1.48,83,1,67,0.3,253,0,0.78,0,137,0,,,,,,,,,,,,,,,,,,,5,
30218055,5ab38a5e-d03e-49cf-8065-cb16cdf317e8,1625858588,120,1626033855,,0,0,4.97,2149,2149,236,229,,,0,4.3,0.88,2.94,1.18,461,406,146,182,,,,35.81,24.66,38,1,56.73,3004,150,,3.2,3.1,97,98,,,,,,52,74,8.91,9.74,13.3,5.7,-7.7,225,225,,1,359,359,,,,,,,,,"57,11,6,1,6,9,4,5,1","0,54,14,32,0","37,31,6,5,22",,,,,94,,,,,,,,,,,,,,,32,,,,,,,,,,,,,,,,,,,,,45.5,18,5,302,82,,1020,0,343,0,6,3,Balve,1,0,U0.215|0:49-U0.302|2:23-U0.222|0:52-U0.274|2:27-U0.221|0:52-U0.264|2:09-U0.222|0:52-U0.269|2:26-U0.218|0:53-U0.435|3:56-U0.224|0:55-U0.269|2:36-U0.223|0:53-U0.269|2:36-U0.221|0:53-U0.265|2:40-U0.222|0:53-U0.283|3:21-U0.224|0:50-U0.131|2:33,,"Balve Running",,,3113,,250,3,7109780626,0,168070,250480,30378,3304680,16923904,410,7,6,57,18,0.29,0.69,0.02,1.12,0.62,1.58,94,0,94,0.3,828,0,15.64,0,175,0,,,,,,,,,,,,,,,,,,,"4,4,5,5,5",
30218057,5940029b-e9d3-4ad6-9acd-9db77a874f9f,1625860856,120,1626033864,,0,0,1.22,462,492,19,37,,,0,1.1,0.66,1.46,0.97,,80,129,138,118,,,49.45,25.87,49.5,1,56.86,2976,14,,1.2,0,,100,,,,,,6,79,9.25,9.48,9.83,-11.7,-40.8,212,212,,1,233,233,,,,,,,,,"34,48,14,5,0,0,0,0,0","0,100,0,0,0","0,70,18,10,2",,,,,100,,,,,,,,,,,,,,,28,,,,,,,,,,,,,,,,,,,,,9.8,18,4,302,82,,1020,0,343,0,6,3,Balve,1,0,U1.000|6:29-U0.216|1:13,,"Balve Running",,,3113,,250,3,7109781311,0,168070,250480,30378,3304681,16923906,462,5,3,16,0,0,0.1,0,0.83,0.53,1.57,67,0,93,0,268,1,10.23,1,132,1,,,,,,,,,,,,,,,,,,,,
30298243,95e0a67b-93e6-4a38-8194-83ecb1b755eb,1626205308,120,1626205998,,0,0,3.96,1191,1191,26,25,,,4,0,0.08,1.1,0.91,,281,152,166,,,,53.05,37.65,53.5,1,,,,,,,,,,,,,,34,82,12.01,12.05,12.1,-6,-8.8,294,294,,1,298,298,,,,,,,,,"5,4,12,25,37,16,1,0,0","0,5,90,5,0","0,2,52,45,1",,,,,122,,,,,,,,,,,,,,,,,,,,,,,,,,,,,,,,,,,,48.8,19,12,358,87,,1010,0,332,0,6,3,"Menden (Sauerland)",1,0,U1.000|5:27-U1.000|5:03-U1.000|4:46-U0.951|4:35,,,,,wahoo_fitness-33,,518,7,,0,168070,250480,30378,,16993799,,,,,,,,,,,,,,,,,,,,,,,,,,,,,,,,,,,,,,,,,
30298248,b40f4b9d-d149-4a43-b6b6-bfc49cad0def,1626202487,120,1626206039,,0,0,8.14,2493,2493,115,116,,,4,1.7,0.83,1.1,0.81,,601,158,188,,,,49.06,38.5,49.91,1,,,,,,,,,,,,,,89,81,11.92,13.97,14.23,5.8,-5,305,302,,1,372,372,,,,,,,,,"36,4,4,2,2,5,20,22,5","0,26,17,50,7","22,10,14,17,37",,,,,121,,,,,,,,,,,,,,,,,,,,,,,,,,,,,,,,,,,,83.8,20,12,325,82,,1009,1,332,0,4,3,"Menden (Sauerland)",1,0,U0.174|0:38-U0.100|0:39-U0.200|0:39-U0.100|0:36-U0.200|0:39-U0.100|0:33-U0.200|0:38-U0.100|0:37-U0.200|0:38-U0.200|3:40-U1.000|3:43-U1.000|3:37-U0.400|3:02-U1.000|3:31-U0.400|3:31-U0.200|0:38-U0.300|1:18-U0.100|0:37-U0.200|0:38-U0.100|0:41-U0.200|0:39-U0.100|0:39-U0.200|0:41-U0.300|4:08-U1.000|3:24-U0.071|1:29,,,,,wahoo_fitness-33,,518,7,,0,168070,250480,30378,,16993803,,,,,,,,,,,,,,,,,,,,,,,,,,,,,,,,,,,,,,,,,
30298249,f6641dd0-d5e9-44f3-a1de-8cdfebedb4b1,1626201072,120,1626206044,,0,0,4.01,1062,1062,16,25,,,4,0,0.14,1.06,0.93,,253,153,174,,,,61.49,43.74,61.63,1,,,,,,,,,,,,,,32,82,13.6,13.71,13.71,-0.1,-3.8,341,341,,1,346,346,,,,,,,,,"1,1,2,9,21,51,15,0,0","1,9,70,20,0","0,3,8,85,3",,,,,138,,,,,,,,,,,,,,,,,,,,,,,,,,,,,,,,,,,,55.7,20,12,325,82,,1009,1,332,0,4,3,"Menden (Sauerland)",1,0,U1.000|4:43-U1.000|4:24-U1.000|4:16-U1.000|4:17-U0.004|0:03,,,,,wahoo_fitness-33,,518,7,,0,168070,250480,30378,,16993804,,,,,,,,,,,,,,,,,,,,,,,,,,,,,,,,,,,,,,,,,
30298855,e5cf9857-9eaf-448e-ac6a-30d77bd0d79b,1626120005,120,1626207321,,0,0,8.91,2951,2959,155,156,,,0,2.4,0.68,0.97,1.01,328,581,133,160,,,,56.21,35.32,57.41,1,56.5,1441,74,,3.1,0,100,98,,,,,,64,78,11.18,11.03,11.29,-0.4,-0.2,265,265,,1,270,270,,,,,,,,,"14,11,18,41,13,2,0,0,0","0,79,21,0,0","0,0,85,15,0",,,,,116,,,,,,,,,,,,,,,,,,,,,,,,,,,,,,,,,,,,26.8,20,6,198,75,,1010,0,325,0,4,3,Balve,1,0,U1.000|5:54-U1.000|5:21-U1.000|5:23-U1.000|5:23-U1.000|5:50-U1.000|5:54-U1.000|4:54-U1.000|5:04-U0.912|5:28,,"Balve Running",,,3113,,250,3,7120658445,0,168070,250480,30378,,16994340,,,,,,,,,,,,,,,,,,,,,,,,,,,,,,,,,,,,,,,,5,
30475947,2400b99b-07d4-4ce3-a668-b7f6fe88ad48,1626617257,120,1626620347,,0,0,16.95,5820,6761,402,449,,,4,3.7,0.56,1.26,1.23,677,1322,147,172,,,,47.2,35.59,48.42,1,,,,,,,,,,,,,,177,80,11.03,10.98,11.91,-16.8,-8.5,259,259,,1,290,290,,,,,,,,,"29,13,18,13,16,9,2,0,0","0,39,28,33,0","2,22,50,20,7",,,,,109,,,,,,,,,,,,,,,,,,,,,,,,,,,,,,,,,,,,68.2,23,13,346,62,,1023,6,301,0,3,3,Balve,1,0,U1.000|5:56-U1.000|6:03-U0.086|0:33-U1.000|7:39-U1.000|6:55-U0.592|4:01-U1.000|6:03-U1.000|5:33-U1.000|6:16-U1.000|4:28-U1.000|4:51-U0.690|3:07-U1.000|6:33-U1.000|5:55-U1.000|5:59-U1.000|4:40-U1.000|4:55-U1.000|4:58-U0.563|2:39,,,,,wahoo_fitness-33,,518,7,,0,168070,250480,30378,,17148506,,,,,,,,,,,,,,,,,,,,,,,,,,,,,,,,,,,,,,,,"4,4",
30475960,55795570-7db3-4f47-b300-cc0d0b0c2cd7,1626553409,120,1626620368,,0,0,10.01,3099,3099,301,301,,,4,3.6,0.69,1.09,0.94,533,785,158,176,,,,48.41,38.56,50.21,1,,,,,,,,,,,,,,116,79,12.57,12.08,12.85,4.4,15.3,298,298,,1,310,310,,,,,,,,,"15,11,16,14,21,18,4,2,0","0,1,54,44,0","0,6,44,44,6",,,,,123,,,,,,,,,,,,,,,,,,,,,,,,,,,,,,,,,,,,83.6,19,13,355,77,,1024,0,309,0,2,3,Balve,1,0,U1.000|5:45-U1.000|6:29-U1.000|5:42-U1.000|6:14-U1.000|4:55-U1.000|4:42-U1.000|4:34-U1.000|4:29-U1.000|4:04-U0.997|4:47,,,,,wahoo_fitness-33,,518,7,,0,168070,250480,30378,,17148517,,,,,,,,,,,,,,,,,,,,,,,,,,,,,,,,,,,,,,,,3,
30565870,1b43c894-4255-4f73-af07-2181d0dbf10c,1626806387,120,1626809196,,0,0,3.95,1145,1171,16,27,,,4,0,0.18,1.08,0.8,,246,141,151,,,,61.5,39.31,61.6,1,,,,,,,,,,,,,,30,80,12.47,12.63,12.65,-2.6,-2.7,308,306,,1,315,314,,,,,,,,,"3,2,5,16,42,28,4,0,0","2,20,78,0,0","3,2,24,72,0",,,,,129,,,,,,,,,,,,,,,,,,,,,,,,,,,,,,,,,,,,25.9,20,8,15,60,,1021,1,330,0,2,3,"Menden (Sauerland)",1,0,U1.000|5:22-U1.000|4:34-U1.000|4:42-U0.943|4:28,,,,,wahoo_fitness-33,,518,7,,0,168070,250480,30378,,17230118,,,,,,,,,,,,,,,,,,,,,,,,,,,,,,,,,,,,,,,,,
30565871,8a8042e4-7976-4359-8e7b-317f5124d76e,1626463003,120,1626809195,,0,0,5.84,2000,2143,90,90,,,4,1.7,0.55,1.01,1.02,339,409,138,164,,,,51.48,33.03,52.46,1,,,,,,,,,,,,,,49,78,10.8,10.66,10.92,6.7,6.8,254,254,,1,260,260,,,,,,,,,"16,9,28,37,9,1,0,0,0","0,59,38,3,0","0,5,83,12,0",,,,,112,,,,,,,,,,,,,,,,,,,,,,,,,,,,,,,,,,,,31.1,19,9,335,80,,1023,1,310,0,3,3,Balve,1,0,U1.000|5:39-U1.000|5:17-U1.000|5:26-U1.000|5:48-U1.000|6:28-U0.832|4:43,,,,,wahoo_fitness-33,,518,7,,0,168070,250480,30378,,17230119,,,,,,,,,,,,,,,,,,,,,,,,,,,,,,,,,,,,,,,,5,
30565882,9f6f5fc3-a4df-458e-bf3f-739a6ddad805,1626726477,120,1626809206,,0,0,9.28,2816,2894,119,117,,,4,1.6,0.46,1.08,1.03,293,618,145,170,,,,56,39.27,56.9,1,,,,,,,,,,,,,,82,78,12.13,12.02,12.23,11.9,10.8,295,295,,1,299,299,,,,,,,,,"6,6,8,25,41,13,1,0,0","1,42,39,18,0","0,1,61,38,1",,,,,127,,,,,,,,,,,,,,,,,,,,,,,,,,,,,,,,,,,,45.9,17,6,3,76,,1021,0,323,0,3,3,Balve,1,0,U1.000|5:45-U1.000|4:42-U1.000|4:50-U1.000|4:52-U1.000|4:54-U1.000|4:57-U1.000|4:56-U1.000|5:45-U1.000|4:50-U0.267|1:26,,,,,wahoo_fitness-33,,518,7,,0,168070,250480,30378,,17230130,,,,,,,,,,,,,,,,,,,,,,,,,,,,,,,,,,,,,,,,5,
30565888,b310a8a9-70e5-49c6-9b41-35f4f7a81f69,1626807914,120,1626809214,,0,0,9.57,3067,3067,140,136,,,4,1.1,0.45,1.03,0.69,,724,154,194,,,,48.15,36.91,49.04,1,,,,,,,,,,,,,,113,77,11.44,14.06,14.34,13,-1.9,296,291,,1,381,379,,,,,,,,,"43,1,1,1,1,3,12,33,3","0,31,22,43,4","28,13,8,11,40",,,,,122,,,,,,,,,,,,,,,,,,,,,,,,,,,,,,,,,,,,70.2,20,7,19,64,,1021,1,328,0,2,3,"Menden (Sauerland)",1,0,U0.400|1:22-U0.100|0:46-U0.400|1:22-U0.100|0:43-U0.400|1:19-U0.100|0:44-U0.400|1:18-U0.200|1:50-U0.800|2:41-U0.200|1:59-U0.800|2:43-U0.200|3:48-U1.600|5:38-U0.200|2:39-U0.800|2:45-U0.200|3:49-U0.400|1:19-U0.266|3:43-U0.400|1:21-U0.100|0:59-U0.400|1:19-U0.100|1:19-U0.400|1:20-U0.100|1:16-U0.400|1:18-U0.100|1:48,,,,,wahoo_fitness-33,,518,7,,0,168070,250480,30378,,17230137,,,,,,,,,,,,,,,,,,,,,,,,,,,,,,,,,,,,,,,,,
30578472,e2156017-9c62-4e18-b9d7-2fb085e6da7d,1626854404,120,1626847318,,0,0,0.02,4,4,0,0,,,4,0,0,,,,0,,,,,,,,,1,,,,,,,,,,,,,,0,,,8.53,,,,8,8,,1,8,8,,,,,,,,,"100,0,0,0,0,0,0",,"100,0,0,0,0",,,,,,,,,,,,,,,,,,,,,,,,,,,,,,,,,,,,,,,,,,13,3,135,85,,1024,1,310,0,2,3,Balve,1,0,,,,,,wahoo_fitness-43,,258,7,,0,168072,,30378,,17241934,,,,,,,,,,,,,,,,,,,,,,,,,,,,,,,,,,,,,,,,,
30611040,42087e82-3931-4e6f-b92f-3478b84907d9,1626892177,120,1626893497,,0,0,0.69,321,321,22,0,,,4,1.3,0.71,1.2,0.98,,46,114,126,,,,44.1,19.05,47.6,1,,,,,,,,,,,,,,4,76,8.64,7.87,9.15,10.9,15.2,207,207,,1,217,217,,,,,,,,,"88,7,3,2,0,0,0,0,0","8,92,0,0,0","0,59,33,8,0",,,,,85,,,,,,,,,,,,,,,,,,,,,,,,,,,,,,,,,,,,4,22,9,8,59,,1023,1,305,0,3,3,Sundern,1,0,,,,,,wahoo_fitness-33,,518,7,,0,168070,250480,30378,,17269723,,,,,,,,,,,,,,,,,,,,,,,,,,,,,,,,,,,,,,,,,
30611053,c6299f47-82ec-4c98-8f30-8a84fb52c082,1626892662,120,1626893510,,0,0,14.52,3506,3506,267,275,,,4,1.4,0.46,1.16,0.92,201,933,163,179,,,,62.8,52.94,64.19,1,,,,,,,,,,,,,,147,83,15.14,14.95,15.38,9,6.4,388,388,,1,396,396,,,,,,,,,"0,0,1,2,8,38,44,7,0","0,9,14,76,0","0,0,11,48,41",,,,,150,,,,,,,,,,,,,,,,,,,,,,,,,,,,,,,,,,,,86.2,22,9,13,60,,1023,1,305,0,3,3,Sundern,1,0,U1.000|4:05-U1.000|3:59-U1.000|3:59-U1.000|3:59-U1.000|4:06-U1.000|3:53-U1.000|4:02-U1.000|4:06-U1.000|4:03-U1.000|3:59-U1.000|4:09-U1.000|4:10-U1.000|4:03-U1.000|3:55-U0.491|1:58,,,,,wahoo_fitness-33,,518,7,,0,168070,250480,30378,,17269735,,,,,,,,,,,,,,,,,,,,,,,,,,,,,,,,,,,,,,,,"5,5",
30623021,,1626335580,,1626933263,,0,0,9,2700,,,,,,0,,,,,,660,,,,,,,39.72,,1,,,,,,,,,,,,,,72,,,,,,,,,,,,,,,,,,,,,,,,,,,,,,,,,,,,,,,,,,,,,,,,,,,,,,,,,,,,,,,,,,,,,,,,,,1,,,0,0,,,,,,,,,0,,0,168070,250480,30378,,,,,,,,,,,,,,,,,,,,,,,,,,,,,,,,,,,,,,,,,,,
30672769,c9fc112e-fe93-4e3e-bcb8-aa8c1000cb42,1626980858,120,1627027176,,0,0,11.62,3414,3737,333,338,,,4,4,0.72,1.12,0.94,528,719,143,172,,,,59.37,41.45,61.45,1,,,,,,,,,,,,,,95,81,13.12,12.66,13.48,7.5,18.6,318,318,,1,332,332,,,,,,,,,"8,8,13,18,19,23,11,1,0","1,35,55,10,0","0,3,39,46,13",,,,,126,,,,,,,,,,,,,,,,,,,,,,,,,,,,,,,,,,,,44,21,8,356,74,,1020,0,312,0,3,3,Balve,1,0,U1.000|4:51-U1.000|5:24-U1.000|5:44-U1.000|5:17-U1.000|5:45-U1.000|4:48-U1.000|4:22-U1.000|4:05-U1.000|4:05-U1.000|4:10-U1.000|5:39-U0.596|2:45,,,,,wahoo_fitness-33,,518,7,,0,168070,250480,30378,,17326296,,,,,,,,,,,,,,,,,,,,,,,,,,,,,,,,,,,,,,,,"3,5",
30699425,4401ef3a-3de4-409d-ac0f-6aac76cb419c,1627042442,120,1627078221,,0,0,6.17,1804,1804,91,92,,,4,1.7,0.52,1.09,0.94,280,397,149,170,,,,56.49,39.98,57.5,1,,,,,,,,,,,,,,56,80,12.6,12.47,12.7,-0.8,-2.6,308,308,,1,313,313,,,,,,,,,"4,6,11,11,38,29,1,0,0","0,20,62,19,0","0,0,45,53,1",,,,,128,,,,,,,,,,,,,,,,,,,,,,,,,,,,,,,,,,,,44.2,22,7,8,68,,1018,6,315,0,3,3,Balve,1,0,U1.000|5:20-U1.000|4:43-U1.000|4:30-U1.000|4:40-U1.000|5:10-U1.000|4:56-U0.160|0:45,,,,,wahoo_fitness-33,,518,7,,0,168070,250480,30378,,17350295,,,,,,,,,,,,,,,,,,,,,,,,,,,,,,,,,,,,,,,,5,
30725847,7761a8e8-5c13-44ff-b3e0-2da722f71a6c,1627125075,120,1627141773,,0,0,105.63,18330,23430,1286,1296,,,0,3.5,0.41,,,650,3920,,,,,,,,,1,,,,,,,,,,,,,,289,,,25.06,,,,98,80,,1,123,117,,,,,,,,,"34,13,15,22,10,3,3",,"61,39,0,0,0",,,,,,,,,,,,,,,,,,,,,,,,,,,,,,,,,,,,,,,,,,27,9,204,61,,1010,4,319,0,4,3,Rohrbach,1,0,,,,,,,,329,7,,0,168072,,30378,,17372935,,,,,,,,,,,,,,,,,,,,,,,,,,,,,,,,,,,,,,,,"3,3,4,4,4,5",
30771747,906f1fe5-20ce-4228-936d-49c1b49c3251,1627199234,120,1627240075,,0,0,14.82,4214,4307,80,82,,,4,0,0.05,1.01,0.85,,987,152,169,,,,56.85,43.88,57.22,1,,,,,,,,,,,,,,138,80,12.72,12.88,12.98,7.8,9.5,316,316,,1,327,327,,,,,,,,,"12,6,10,14,19,18,14,5,2","0,9,80,11,0","0,4,37,49,10",,,,,132,,,,,,,,,,,,,,,,,,,,,,,,,,,,,,,,,,,,46.6,19,6,219,98,,1011,1,339,0,3,3,Südstadt,1,0,U1.000|4:50-U1.000|4:58-U1.000|4:36-U1.000|4:30-U1.000|4:41-U1.000|4:46-U1.000|4:41-U1.000|5:00-U1.000|4:36-U1.000|4:44-U1.000|4:57-U1.000|4:50-U1.000|5:03-U1.000|4:44-U0.776|3:20,,,,,wahoo_fitness-33,,518,7,,0,168070,250480,30378,,17413744,,,,,,,,,,,,,,,,,,,,,,,,,,,,,,,,,,,,,,,,,
30845427,b1324a8b-7c84-4191-82ac-c8d92dccbefd,1627412550,120,1627410685,,0,0,8.66,2250,2251,130,125,,,4,1.8,0.82,1.08,0.83,,542,157,188,,,,60.66,46.9,61.83,1,,,,,,,,,,,,,,85,84,14.02,15.07,15.36,6.5,-2.6,361,361,,1,404,404,,,,,,,,,"21,5,4,2,3,8,29,27,2","0,23,29,41,7","3,14,14,23,45",,,,,137,,,,,,,,,,,,,,,,,,,,,,,,,,,,,,,,,,,,75.1,20,12,225,73,,1012,1,333,0,4,3,"Menden (Sauerland)",1,0,U0.203|0:41-U0.800|3:01-U1.000|3:33-U0.400|2:30-U1.000|3:31-U0.400|2:34-U1.000|3:27-U0.400|3:01-U1.000|3:30-U0.400|3:11-U1.000|3:44-U1.000|3:38-U0.057|1:09,,,,,wahoo_fitness-33,,518,7,,0,168070,250480,30378,,17479008,,,,,,,,,,,,,,,,,,,,,,,,,,,,,,,,,,,,,,,,,
30845437,cfdb003b-70b3-4b81-b322-05703f9305d0,1627410771,120,1627410700,,0,0,3.88,1060,1060,11,23,,,4,0,0.12,1.13,0.74,,237,145,156,,,,63.76,42.08,63.74,1,,,,,,,,,,,,,,30,81,13.26,13.36,13.38,-1.7,-2.9,332,329,,1,337,337,,,,,,,,,"1,2,3,6,24,56,8,0,0","0,22,78,0,0","3,1,10,85,1",,,,,136,,,,,,,,,,,,,,,,,,,,,,,,,,,,,,,,,,,,29.2,20,10,216,72,,1012,1,333,0,4,3,"Menden (Sauerland)",1,0,U1.000|5:06-U1.000|4:26-U1.000|4:18-U0.872|3:50,,,,,wahoo_fitness-33,,518,7,,0,168070,250480,30378,,17479017,,,,,,,,,,,,,,,,,,,,,,,,,,,,,,,,,,,,,,,,,
30845440,7c092f89-0fd0-4d92-b6f4-5c7929874080,1627415085,120,1627410705,,0,0,3.78,1223,1223,10,21,,,4,0,0.11,,0.78,,318,164,181,,,,43.36,34.43,43.34,1,,,,,,,,,,,,,,52,81,11.07,11.27,11.27,-8.3,-10,266,266,,1,273,273,,,,,,,,,"11,6,17,31,26,9,1,0,0","0,8,11,80,1","3,6,64,27,0",,,,,114,,,,,,,,,,,,,,,,,,,,,,,,,,,,,,,,,,,,71.6,20,13,210,76,,1012,0,334,0,6,3,"Menden (Sauerland)",1,0,U1.000|6:02-U1.000|5:16-U1.000|5:08-U0.773|3:57,,,,,wahoo_fitness-33,,518,7,,0,168070,250480,30378,,17479020,,,,,,,,,,,,,,,,,,,,,,,,,,,,,,,,,,,,,,,,,
30888703,57812497-4a8c-49d1-9007-96622f44ec65,1627495178,120,1627493597,,0,0,14.68,4715,4962,342,335,,,0,3.4,0.68,0.97,0.9,559,981,147,191,,,,51.25,38.04,52.76,1,55.85,4086,236,,4.5,2.9,100,98,,,,,,144,80,11.9,12.08,12.26,2.1,0.8,280,280,,1,298,298,,,,,,,,,"25,15,16,10,13,7,12,2,0","1,41,38,16,5","0,10,61,24,6",,,,,117,,,,,,,,,,,,,,,,,,,,,,,,,,,,,,,,,,,,101.5,20,16,234,68,,1011,1,336,0,3,3,Balve,1,0,U1.000|6:12-U1.000|6:41-U1.000|6:13-U1.000|7:26-U1.000|5:28-U1.000|5:24-U1.000|6:06-U1.000|5:48-U1.000|4:53-U1.000|4:41-U1.000|4:05-U1.000|3:52-U1.000|3:44-U1.000|3:46-U0.677|4:17,,"Balve Running",,,3113,,250,3,7205389263,0,168070,250480,30378,,17518803,,,,,,,,,,,,,,,,,,,,,,,,,,,,,,,,,,,,,,,,4,
30929223,96671301-70f1-4b6a-bf53-696f6fce4deb,1627582939,120,1627580295,,0,0,13.78,3975,4098,167,147,,,0,1.3,0.37,0.99,0.99,610,847,145,166,,,,59.61,42.9,60.61,1,56.81,4320,168,,4.4,0,102,104,,,,,,74,80,12.76,12.88,13.03,-4.9,-8.8,313,313,,1,323,323,,,,,,,,,"5,5,12,23,16,29,10,1,0","0,36,58,6,0","0,1,45,49,5",,,,,130,,,,,,,,,,,,,,,,,,,,,,,,,,,,,,,,,,,,33.7,19,15,248,69,,1012,1,321,0,3,3,Balve,1,0,U1.000|5:37-U1.000|4:57-U1.000|5:10-U1.000|5:26-U1.000|5:28-U1.000|5:19-U1.000|4:14-U1.000|4:03-U1.000|4:19-U1.000|4:19-U1.000|4:13-U1.000|4:02-U1.000|4:07-U0.782|5:01,,"Balve Running",,,3113,,250,3,7211231479,0,168070,250480,30378,,17555039,,,,,,,,,,,,,,,,,,,,,,,,,,,,,,,,,,,,,,,,5,
30994553,303cf24b-405e-44f4-a282-6a7ebd5f1bf1,1627653914,120,1627736896,,0,0,9.88,3030,3104,190,194,,,4,1.8,0.45,1.02,0.98,382,697,149,176,,,,53.26,38.96,54.49,1,,,,,,,,,,,,,,69,80,12.36,12.25,12.83,1.5,5.3,299,299,,1,316,316,,,,,,,,,"12,7,8,15,28,24,6,1,0","7,9,61,23,0","4,6,32,53,5",,,,,122,,,,,,,,,,,,,,,,,,,,,,,,,,,,,,,,,,,,46.7,23,19,225,54,,1008,4,327,0,3,3,Balve,1,0,U1.000|5:06-U1.000|5:02-U1.000|5:23-U1.000|5:43-U1.000|6:24-U1.000|4:33-U1.000|4:26-U1.000|4:15-U1.000|4:35-U0.859|5:03,,,,,wahoo_fitness-33,,518,7,,0,168070,250480,30378,,17611339,,,,,,,,,,,,,,,,,,,,,,,,,,,,,,,,,,,,,,,,4,
30994554,848dd96e-c7b8-4ae2-b86b-ce7ddb859234,1627725625,120,1627736898,,0,0,14.03,4368,4493,348,348,,,4,4,0.69,1.04,1.08,523,1004,148,177,,,,52.76,39.31,54.38,1,,,,,,,,,,,,,,91,82,12.34,12.33,12.74,-16.3,-11.2,294,294,,1,310,310,,,,,,,,,"21,13,13,12,13,13,13,2,0","0,21,64,14,0","0,8,46,39,7",,,,,118,,,,,,,,,,,,,,,,,,,,,,,,,,,,,,,,,,,,52.4,15,20,237,73,,1008,3,339,0,4,3,Balve,1,0,U1.000|6:08-U1.000|6:29-U1.000|6:29-U1.000|7:08-U1.000|5:11-U1.000|5:09-U1.000|5:55-U1.000|5:30-U1.000|4:37-U1.000|4:35-U1.000|3:55-U1.000|3:53-U1.000|3:48-U1.008|4:01,,,,,wahoo_fitness-33,,518,7,,0,168070,250480,30378,,17611340,,,,,,,,,,,,,,,,,,,,,,,,,,,,,,,,,,,,,,,,"3,5,5",
31027501,638f8039-8c54-4693-b4b7-0142431970f3,1627822700,120,1627823621,,0,0,21.03,6983,7784,621,545,,,0,5.4,0.77,0.97,1.07,521,1433,136,161,,,,54.49,37.65,56.72,1,56.8,4762,187,,4.6,0,104,97,,,,,,140,80,11.76,11.39,12.02,0.2,1.4,273,273,,1,283,283,,,,,,,,,"22,17,12,13,20,15,1,0,0","1,67,33,0,0","0,9,62,27,2",,,,,113,,,,,,,,,,,,,,,,,,,,,,,,,,,,,,,,,,,,32.2,20,13,257,60,,1010,4,344,0,3,3,Balve,1,0,U1.000|5:01-U1.000|5:14-U1.000|6:27-U1.000|6:22-U1.000|6:07-U1.000|5:56-U1.000|4:55-U1.000|4:23-U1.000|4:30-U1.000|8:08-U1.000|5:54-U1.000|5:50-U1.000|5:01-U1.000|6:49-U1.000|6:28-U1.000|5:11-U1.000|4:34-U1.000|4:26-U1.000|4:35-U1.000|4:30-U1.000|5:51-U0.025|0:09,,"Balve Running",,,3113,,250,3,7226988396,0,168070,250480,30378,,17639981,,,,,,,,,,,,,,,,,,,,,,,,,,,,,,,,,,,,,,,,"4,4,4,4,5,5",
31078721,d48eaa3b-adad-4edb-b73e-54eda7b296ea,1627930742,120,1627929399,,0,0,12,3488,3662,286,245,,,0,3.4,0.77,0.98,0.97,631,769,142,162,92,,,60.73,42.08,62.78,1,57.23,4320,140,,4,0,100,100,,,,,,60,80,13.09,12.7,13.38,-3.9,3.6,318,318,,1,332,332,,,,,,,,,"4,7,12,17,23,29,7,0,0","1,39,59,1,0","0,1,36,57,6",,,,,129,,,,,,,,,,,,,,,,,,,,,,,,,,,,,,,,,,,,25.5,18,8,294,72,,1014,0,345,0,3,3,Balve,1,0,U1.000|5:34-U1.000|5:48-U1.000|5:03-U1.000|5:58-U1.000|5:00-U1.000|4:38-U1.000|4:17-U1.000|4:16-U1.000|4:27-U1.000|4:17-U1.000|4:06-U1.000|4:45-U0.002|0:01,,"Balve Running",,,3113,,250,3,7234326302,0,168070,250480,30378,,17684800,,,,,,,,,,,,,,,,,,,,,,,,,,,,,,,,,,,,,,,,4,
31127117,1019e252-d3f3-4c56-aa69-307b578de40f,1628020333,120,1628018650,,0,0,1.4,504,504,20,19,,,4,0,0.13,1.03,0.75,,97,133,141,,,,50.71,27.85,51.65,1,,,,,,,,,,,,,,6,83,10.09,10.06,10.38,-4.1,-8.9,239,239,,1,248,248,,,,,,,,,"28,22,31,14,4,1,0,0,0","0,99,1,0,0","0,27,61,12,0",,,,,100,,,,,,,,,,,,,,,,,,,,,,,,,,,,,,,,,,,,11.4,16,5,30,80,,1012,0,337,0,3,3,"Menden (Sauerland)",1,0,U1.000|6:01-U0.394|2:24,,,,,wahoo_fitness-33,,518,7,,0,168070,250480,30378,,17729220,,,,,,,,,,,,,,,,,,,,,,,,,,,,,,,,,,,,,,,,,
31127118,834ac044-5200-4700-9dd6-1656e0c7dd05,1628017069,120,1628018652,,0,0,11.69,3019,3019,154,153,,,4,1.5,0.74,1.2,0.93,,814,164,187,,,,57.26,48.19,58.2,1,,,,,,,,,,,,,,108,84,14.1,15.02,15.29,5,-0.7,364,362,,1,400,399,,,,,,,,,"12,2,4,6,5,13,34,23,1","0,10,19,67,5","6,5,14,34,41",,,,,138,,,,,,,,,,,,,,,,,,,,,,,,,,,,,,,,,,,,102.3,16,5,24,80,,1012,1,339,0,4,3,"Menden (Sauerland)",1,0,U3.200|11:54-U0.800|4:30-U1.600|5:55-U0.400|3:09-U1.600|5:56-U0.817|5:45-U3.200|11:39-U0.079|1:31,,,,,wahoo_fitness-33,,518,7,,0,168070,250480,30378,,17729221,,,,,,,,,,,,,,,,,,,,,,,,,,,,,,,,,,,,,,,,,
31127120,fa8f3817-f629-4b3f-b4ea-8d1b55eb125e,1628015736,120,1628018653,,0,0,3.87,1001,1001,11,12,,,4,0,0.01,,1.05,,256,159,189,,,,59.87,44.84,60.06,1,,,,,,,,,,,,,,33,83,13.94,14.01,14.01,14.1,13.1,353,353,,1,356,356,,,,,,,,,"2,1,2,5,18,50,20,2,0","0,21,22,44,13","0,0,8,83,9",,,,,140,,,,,,,,,,,,,,,,,,,,,,,,,,,,,,,,,,,,83.8,16,5,24,80,,1012,1,339,0,4,3,"Menden (Sauerland)",1,0,U1.000|4:29-U1.000|4:19-U1.000|4:09-U0.862|3:44,,,,,wahoo_fitness-33,,518,7,,0,168070,250480,30378,,17729223,,,,,,,,,,,,,,,,,,,,,,,,,,,,,,,,,,,,,,,,,
31180861,a33eff72-bd42-4709-944f-baaff306118b,1628100023,120,1628149073,,0,0,15.55,4067,4067,314,320,,,4,2.5,0.54,1.15,0.95,826,953,150,173,,,,64.22,48.52,65.8,1,,,,,,,,,,,,,,99,83,14.07,13.89,14.48,1.4,2.5,354,354,,1,369,369,,,,,,,,,"1,1,3,9,25,37,18,5,1","0,5,88,6,0","0,1,23,55,22",,,,,138,,,,,,,,,,,,,,,,,,,,,,,,,,,,,,,,,,,,31.6,17,5,85,75,,1012,1,343,0,6,3,Sundern,1,0,U1.000|4:30-U1.000|4:16-U1.000|4:34-U1.000|4:30-U1.000|4:25-U1.000|4:21-U1.000|4:19-U1.000|3:55-U1.000|4:18-U1.000|4:20-U1.000|4:26-U1.000|4:19-U1.000|4:15-U1.000|3:52-U1.000|4:51-U0.520|2:36,,,,,wahoo_fitness-33,,518,7,,0,168070,250480,30378,,17778076,,,,,,,,,,,,,,,,,,,,,,,,,,,,,,,,,,,,,,,,"5,5",
31197165,6295cc5c-a9be-4c33-87bf-4aa4d52a2d24,1628186006,120,1628182740,,0,0,3.42,1209,1252,60,61,,,4,1.8,0.71,1,1.01,376,237,135,154,,,,50.91,30.79,51.99,1,,,,,,,,,,,,,,19,80,10.48,10.31,10.58,-4.3,5.8,245,245,,1,249,249,,,,,,,,,"20,24,25,22,8,1,0,0,0","1,76,24,0,0","0,8,89,4,0",,,,,106,,,,,,,,,,,,,,,,,,,,,,,,,,,,,,,,,,,,13.3,20,8,183,62,,1007,1,342,0,3,3,Balve,1,0,U1.000|6:16-U1.000|6:07-U1.000|5:27-U0.417|2:18,,,,,wahoo_fitness-33,,518,7,,0,168070,250480,30378,,17792416,,,,,,,,,,,,,,,,,,,,,,,,,,,,,,,,,,,,,,,,4,
31197168,b4d7883c-0332-4b8b-9f83-96f4f1f4f3a8,1628181206,120,1628182742,,0,0,3.24,997,1365,63,63,,,4,1.8,0.69,1.02,1.03,385,210,140,163,,,,57.67,36.15,59.05,1,,,,,,,,,,,,,,19,79,12.08,11.82,12.28,-5.6,8.3,292,292,,1,299,299,,,,,,,,,"8,5,9,36,30,10,2,0,0","1,47,47,4,0","0,0,56,42,2",,,,,123,,,,,,,,,,,,,,,,,,,,,,,,,,,,,,,,,,,,21.1,20,8,194,64,,1008,3,343,0,3,3,Balve,1,0,U1.000|5:24-U1.000|5:12-U1.000|4:50-U0.232|1:11,,,,,wahoo_fitness-33,,518,7,,0,168070,250480,30378,,17792419,,,,,,,,,,,,,,,,,,,,,,,,,,,,,,,,,,,,,,,,5,
31197169,a51d064b-ea3e-4cd2-abf9-41ccd201eac4,1628183108,120,1628182744,,0,0,7.36,2541,2545,0,0,,,4,0,0,,,,559,145,181,,,,47.76,33.19,47.76,1,,,,,,,,,,,,,,60,78,10.43,13.03,13.05,16.5,-3.1,264,262,,1,343,342,,,,,,,,,"50,2,2,1,1,2,9,32,0","0,48,20,31,0","25,23,10,8,34",,,,,111,,,,,,,,,,,,,,,,,,,,,,,,,,,,,,,,,,,,41.5,20,8,183,62,,1007,1,342,0,3,3,Balve,1,0,U0.407|1:29-U0.209|1:28-U0.423|1:25-U0.188|1:24-U0.411|1:24-U0.219|1:39-U0.409|1:20-U0.198|3:04-U0.411|1:26-U0.211|1:41-U0.410|1:24-U0.211|1:43-U0.412|1:23-U0.212|1:48-U0.416|1:22-U0.156|3:07-U0.413|1:25-U0.210|1:47-U0.415|1:23-U0.209|1:46-U0.415|1:23-U0.214|1:58-U0.411|1:23-U0.165|4:07-U0.004|0:01,,,,,wahoo_fitness-33,,518,7,,0,168070,250480,30378,,17792420,,,,,,,,,,,,,,,,,,,,,,,,,,,,,,,,,,,,,,,,,
31217252,264043d4-c36d-48bf-9954-b44c1d8dc4eb,1628237662,120,1628237977,,0,0,9.97,3511,3594,163,163,,,4,2.4,0.63,1.06,0.89,309,702,139,183,,,,49.28,33.13,50.28,1,,,,,,,,,,,,,,79,80,10.51,10.35,10.7,6.6,4.2,247,247,,1,254,254,,,,,,,,,"20,16,32,25,5,1,0,0,0","20,16,35,29,1","0,10,80,10,0",,,,,106,,,,,,,,,,,,,,,,,,,,,,,,,,,,,,,,,,,,54.1,15,14,190,88,,1004,1,345,0,4,3,Balve,1,0,U1.000|6:04-U1.000|5:37-U1.000|6:01-U1.000|5:55-U1.000|5:39-U1.000|6:04-U1.000|6:32-U1.000|5:29-U1.000|5:18-U0.955|5:52,,,,,wahoo_fitness-33,,518,7,,0,168070,250480,30378,,17809773,,,,,,,,,,,,,,,,,,,,,,,,,,,,,,,,,,,,,,,,4,
31257089,55421209-29c9-4694-9ed8-1863e4481173,1628320025,120,1628337754,,0,0,12.03,4108,4247,361,359,,,4,4.4,0.82,1.14,0.97,494,980,154,184,,,,44.52,34.85,46.19,1,,,,,,,,,,,,,,114,81,11.32,11.02,12,3.2,10.6,266,266,,1,290,290,,,,,,,,,"30,13,14,16,14,8,4,2,0","0,11,67,22,0","0,21,48,24,7",,,,,108,,,,,,,,,,,,,,,,,,,,,,,,,,,,,,,,,,,,52.8,12,8,191,97,,1006,0,323,0,3,3,Winterberg,1,0,U1.000|4:58-U1.000|5:18-U1.000|6:23-U1.000|6:50-U1.000|5:59-U1.000|6:28-U1.000|5:10-U1.000|4:50-U1.000|4:38-U1.000|5:35-U1.000|5:21-U1.000|6:47-U0.018|0:12,,,,,wahoo_fitness-33,,518,7,,0,168070,250480,30378,,17845287,,,,,,,,,,,,,,,,,,,,,,,,,,,,,,,,,,,,,,,,"3,4",
31257090,c67f4932-b474-40c4-b861-d6b2aac988a7,1628330858,120,1628337754,,0,0,13.94,13844,13864,372,373,,,4,4.1,0.69,,,182,1328,99,142,,,,,,,1,,,,,,,,,,,,,,66,55,,4.17,,15.1,,,,,,,,,,,,,,,,"78,22,0,0,0,0","51,48,0,0,0",,,,,,,,,,,,,,,,,,,,,,,,,,,,,,,,,,,,,,,,,,5.6,16,15,201,79,,1005,4,328,0,4,3,Winterberg,1,0,U1.000|12:42-U1.000|12:28-U1.000|12:49-U1.000|19:20-U1.000|19:37-U1.000|16:23-U1.000|13:34-U1.000|13:07-U1.000|23:34-U1.000|22:45-U1.000|14:45-U1.000|13:41-U1.000|20:25-U0.036|0:51-U0.890|14:44,,,,,wahoo_fitness-33,,518,7,,0,168075,,30378,,17845286,,,,,,,,,,,,,,,,,,,,,,,,,,,,,,,,,,,,,,,,"4,4",
31320078,9197645d-7a8b-4d6f-9bde-918fa425edd7,1628446052,120,1628492500,,0,0,14.65,4677,4981,309,309,,,4,3.7,0.66,1.02,0.94,532,995,143,183,,,,53.59,38.31,54.99,1,,,,,,,,,,,,,,96,80,11.87,11.85,12.19,-4,1.6,282,282,,1,295,295,,,,,,,,,"23,13,11,13,16,18,6,0,0","0,51,39,10,0","0,10,48,39,3",,,,,117,,,,,,,,,,,,,,,,,,,,,,,,,,,,,,,,,,,,42.5,17,17,228,71,,1013,1,353,0,6,3,Balve,1,0,U1.000|5:48-U1.000|5:30-U1.000|6:56-U1.000|6:19-U1.000|6:09-U1.000|6:40-U1.000|5:37-U1.000|5:02-U1.000|4:31-U1.000|4:07-U1.000|4:26-U1.000|4:21-U1.000|4:10-U1.000|4:31-U0.620|3:51,,,,,wahoo_fitness-33,,518,7,,0,168070,250480,30378,,17900774,,,,,,,,,,,,,,,,,,,,,,,,,,,,,,,,,,,,,,,,3,
31414582,,1628586900,,1628666165,,0,0,14,4200,,,,,,0,,,,,,1027,,,,,,,41.04,,1,,,,,,,,,,,,,,82,,,,,,,,,,,,,,,,,,,,,,,,,,,,,,,,,,,,,,,,,,,,,,,,,,,,,,,,,,,,,,,,,,,,,,,,,,1,,,0,0,,,"Bahntraining MCM",,,,,,0,,0,168070,250480,30378,,,,,,,,,,,,,,,,,,,,,,,,,,,,,,,,,,,,,,,,,,,
31414725,bc6f4644-c1b3-48e8-9f15-1b4df467451e,1628533684,120,1628666469,,0,0,14.01,4434,101404,351,355,,,4,4,0.68,1.1,1.05,528,912,139,174,,,,56.22,38.56,57.94,1,,,,,,,,,,,,,,79,81,12.02,11.7,12.39,-2.9,8.2,287,287,,1,301,301,,,,,,,,,"13,11,17,16,24,16,2,0,0","0,49,50,0,0","0,8,51,35,5",,,,,117,,,,,,,,,,,,,,,,,,,,,,,,,,,,,,,,,,,,21.5,14,9,211,87,,1018,1,352,0,6,3,Balve,1,0,U1.000|6:06-U1.000|6:01-U1.000|5:44-U1.000|6:32-U1.000|5:18-U1.000|5:09-U1.000|6:01-U1.000|5:29-U1.000|4:36-U1.000|4:40-U1.000|4:22-U1.000|4:33-U1.000|4:39-U0.965|4:44,,,,,wahoo_fitness-33,,518,7,,0,168070,250480,30378,,17986279,,,,,,,,,,,,,,,,,,,,,,,,,,,,,,,,,,,,,,,,"3,5",
31415749,c50601b7-82cb-4cdd-ab26-39175824d6f0,1627337165,120,1628667441,,0,0,3.92,1364,1364,74,74,,,4,1.4,0.62,1,0.93,,320,151,173,,,,44.73,31.65,45.78,1,,,,,,,,,,,,,,39,77,10.8,10.61,10.95,-0.7,-7.1,253,253,,1,260,260,,,,,,,,,"26,14,19,18,17,6,1,0,0","0,4,87,10,0","0,12,73,15,0",,,,,112,,,,,,,,,,,,,,,,,,,,,,,,,,,,,,,,,,,,41.9,17,7,203,82,,1012,0,343,1,3,3,Balve,1,0,U1.000|5:43-U1.000|5:58-U1.000|5:16-U0.915|5:46,,,,,wahoo_fitness-33,,518,7,,0,168070,250480,30378,,17987259,,,,,,,,,,,,,,,,,,,,,,,,,,,,,,,,,,,,,,,,,
31441386,5a00d640-3cbf-4f02-ad72-54c7f206288b,1628700624,120,1628706948,,0,0,15.03,5350,5819,265,268,,,4,3.2,0.55,1.12,1.05,540,935,136,203,,,,50.01,33.78,51.09,1,,,,,,,,,,,,,,97,79,10.5,10.84,11.33,7.3,-12.6,248,248,,1,278,278,,,,,,,,,"39,11,15,17,9,5,2,1,3","3,55,32,9,1","4,28,43,20,4",,,,,107,,,,,,,,,,,,,,,,,,,,,,,,,,,,,,,,,,,,46.3,24,5,262,55,,1019,2,309,0,3,3,Balve,1,0,U1.000|6:29-U1.000|6:38-U1.000|6:15-U1.000|7:06-U1.000|5:43-U1.000|5:25-U1.000|5:28-U1.000|5:24-U1.000|5:09-U1.000|4:59-U1.000|4:17-U0.752|4:40-U0.219|0:37-U0.407|2:08-U0.203|1:57-U0.211|0:36-U0.205|1:59-U0.210|0:36-U0.199|2:02-U0.209|0:36-U1.000|8:04-U0.384|3:04,,,,,wahoo_fitness-33,,518,7,,0,168070,250480,30378,,18010866,,,,,,,,,,,,,,,,,,,,,,,,,,,,,,,,,,,,,,,,3,
31478720,d6b68128-d1e8-4cc2-8e6f-2757e6c688c9,1628793458,120,1628793929,,0,0,39.11,5673,6040,651,602,,,4,3.4,0.51,,,602,937,,,,,,,,,1,,,,,,,,,,,,,,53,86,,32.61,,,,180,166,,0,194,185,,,,,,,,,"26,21,17,8,7,4,17",,"13,58,25,3,1",,,,,,,,,,,,,,,,,,,,,49,,,,,,,,,,,,,,,,,,,,,23,4,254,70,,1020,0,313,0,4,3,Balve,1,0,,,,,,wahoo_fitness-43,,258,7,,0,168072,,30378,,18043393,,,,,,,,,,,,,,,,,,,,,,,,,,,,,,,,,,,,,,,,"4,4,4,5",
31515330,e93f906b-de42-4fe0-aae0-dbdd9261f194,1628874688,120,1628870196,,0,0,4.88,1765,1823,75,68,,,0,1.6,0.67,1,0.91,490,320,135,178,106,,,49.49,30.61,50.52,1,57.26,1455,77,,2.9,1.6,100,100,,,,,,30,75,10.17,10.89,11.26,18.7,2.3,244,244,,1,277,277,,,,,,,,,"35,3,4,30,17,3,3,2,3","7,49,42,2,0","15,15,34,33,4",,,,,111,,,,,,,,,,,,,,,,,,,,,,,,,,,,,,,,,,,,26,23,13,261,69,,1022,2,301,0,4,3,Balve,1,0,U1.000|5:19-U1.000|5:26-U1.000|4:43-U0.631|4:51-U0.009|0:08-U1.000|7:26-U0.244|1:33,,"Balve Running",,,3113,,250,3,7298203559,0,168070,250480,30378,,18076884,,,,,,,,,,,,,,,,,,,,,,,,,,,,,,,,,,,,,,,,5,
31544706,ed054e3e-fe8d-477f-8a67-5c9799a665d4,1628942460,120,1628943013,1629102257,0,0,20.03,4952,4952,360,425,,,4,4,0.63,1.03,1.01,512,1490,176,186,,,,54.04,52.84,55.03,1,,,,,,,,,,,,,,247,84,14.96,14.92,15.18,3.8,7,377,376,,1,385,385,,,,,,,,,"3,2,4,8,11,23,33,15,1","0,0,1,71,27","0,0,7,64,29",,,,,144,,,,,,,,,,,,,,,,,,,,,,,,,,,,,,,,,,,,121.2,22,15,246,55,,1021,6,303,0,2,3,"Menden (Sauerland)",1,0,U1.000|4:12-U1.000|3:53-U1.000|4:02-U1.000|3:31-U1.000|3:35-U1.000|4:37-U1.000|3:55-U1.000|4:17-U1.000|4:38-U1.000|4:05-U1.000|3:45-U1.000|4:40-U1.000|4:00-U1.000|4:28-U1.000|4:39-U1.000|3:59-U1.000|3:43-U1.000|4:58-U1.000|3:56-U0.988|3:39,,,,,wahoo_fitness-33,,518,7,,0,168070,250484,30378,,18103335,,,,,,,,,,,,,,,,,,,,,,20.03,4952,,,0,,,,,,,,0,0,30378,31544706,,,"4,4,4,5,5,5","276240,276243"
31592936,6788db30-3c10-4c6b-849e-1e1399fecf20,1629017058,120,1629037556,,0,0,161.94,22146,27172,1427,1434,,,4,1.4,0.25,1.11,1,632,3186,129,160,,,,,,,1,,,,,,,,,,,,,,369,85,,30.3,,-9.6,-0.2,162,146,,0,172,165,,,,,,,,,"12,17,14,20,21,7,8","2,79,19,0,0","20,60,19,1,0",,,,,,,,,,,,,,,,,,,,,49,,,,,,,,,,,,,,,,,,,,30.5,22,16,249,65,,1015,4,307,0,3,3,Balve,1,0,,,,,,wahoo_fitness-43,,258,7,,0,168072,,30378,,18146861,,,,,,,,,,,,,,,,,,,,,,,,,,,,,,,,,,,,,,,,"4,4,4,5,5,5",
31686547,3b3fb7bc-b016-43cb-87c4-442452f3a4e7,1629229447,120,1629233230,,0,0,1.65,635,635,20,19,,,4,0,0.14,1.08,0.83,,139,150,174,,,,39.86,26.23,40.49,1,,,,,,,,,,,,,,19,79,9.46,9.53,9.76,7.6,8.7,221,221,,1,230,230,,,,,,,,,"27,42,21,9,1,0,0,0,0","0,24,46,30,0","4,29,68,0,0",,,,,99,,,,,,,,,,,,,,,,,,,,,,,,,,,,,,,,,,,,36.1,13,16,243,91,,1015,0,328,0,6,3,"Menden (Sauerland)",1,0,U1.000|6:42-U0.649|3:54,,,,,wahoo_fitness-33,,518,7,,0,168070,250480,30378,,18230923,,,,,,,,,,,,,,,,,,,,,,,,,,,,,,,,,,,,,,,,,
31686549,8a205404-51d4-44b6-9066-3f39ebbe0743,1629227175,120,1629233234,,0,0,7.08,2162,2162,105,97,,,4,1.5,0.74,1.05,0.77,,514,154,197,,,,51.11,38.3,52.11,1,,,,,,,,,,,,,,72,81,12.06,13.72,14.05,22.8,8,305,305,,1,370,370,,,,,,,,,"40,4,3,3,3,3,11,25,8","1,24,38,26,11","19,15,14,13,38",,,,,121,,,,,,,,,,,,,,,,,,,,,,,,,,,,,,,,,,,,99.5,13,16,243,91,,1015,0,328,0,6,3,"Menden (Sauerland)",1,0,U0.400|1:20-U0.100|0:38-U0.400|1:21-U0.100|0:35-U0.400|1:20-U0.400|2:22-U0.800|2:45-U0.200|2:15-U0.200|0:37-U0.100|0:40-U0.200|0:37-U0.100|0:55-U0.200|0:37-U0.100|1:04-U0.200|0:38-U0.100|0:52-U0.200|0:38-U0.100|1:17-U0.200|0:39-U0.152|2:18-U0.400|1:15-U0.400|2:57-U0.400|1:20-U0.100|0:48-U0.400|1:21-U0.100|0:48-U0.400|1:20-U0.062|1:38-U0.100|0:18-U0.061|0:49,,,,,wahoo_fitness-33,,518,7,,0,168070,250480,30378,,18230925,,,,,,,,,,,,,,,,,,,,,,,,,,,,,,,,,,,,,,,,,
31686554,11ed6a55-95f8-4dc8-b41e-7ae3777b2466,1629139356,120,1629233237,,0,0,9.97,3507,3529,167,168,,,4,2.3,0.63,1.01,0.99,449,666,132,161,,,,52.67,33.17,53.75,1,,,,,,,,,,,,,,63,79,10.51,10.38,10.75,1.6,-0.1,247,247,,1,256,256,,,,,,,,,"21,18,29,24,7,2,0,0,0","0,79,21,0,0","0,11,77,12,0",,,,,108,,,,,,,,,,,,,,,,,,,,,,,,,,,,,,,,,,,,18.7,14,16,252,90,,1013,0,323,0,6,3,Balve,1,0,U1.000|5:34-U1.000|5:22-U1.000|5:48-U1.000|5:55-U1.000|5:46-U1.000|6:29-U1.000|6:48-U1.000|5:34-U1.000|5:28-U0.958|5:44,,,,,wahoo_fitness-33,,518,7,,0,168070,250480,30378,,18230930,,,,,,,,,,,,,,,,,,,,,,,,,,,,,,,,,,,,,,,,"5,5",
31725864,89cf84be-5cab-408e-ad55-d757177fc6f4,1629311789,120,1629312172,,0,0,15.9,5341,5589,377,380,,,4,3.9,0.62,1.02,1.07,450,1053,136,202,,,,53.71,36.33,55.28,1,,,,,,,,,,,,,,116,79,11.35,11.14,11.62,-12.8,-3.4,266,266,,1,278,278,,,,,,,,,"25,16,13,12,22,10,1,0,0","0,73,23,1,4","0,15,58,26,2",,,,,113,,,,,,,,,,,,,,,,,,,,,,,,,,,,,,,,,,,,87.3,18,14,254,81,,1014,0,301,0,3,3,Balve,1,0,U1.000|6:14-U1.000|6:44-U1.000|6:22-U1.000|7:11-U1.000|5:39-U1.000|5:38-U1.000|6:20-U1.000|5:58-U1.000|6:27-U1.000|5:01-U1.000|5:10-U1.000|4:43-U1.000|4:28-U1.000|4:39-U1.000|4:32-U0.878|3:57,,,,,wahoo_fitness-33,,518,7,,0,168070,250480,30378,,18266096,,,,,,,,,,,,,,,,,,,,,,,,,,,,,,,,,,,,,,,,"3,5,5",
31740866,,1629226380,,1629356029,,0,0,3,900,,,,,,0,,,,,,220,,,,,,,37.02,,1,,,,,,,,,,,,,,21,,,,,,,,,,,,,,,,,,,,,,,,,,,,,,,,,,,,,,,,,,,,,,,,,,,,,,,,,,,,,,,,,,,,,,,,,,1,,,0,0,,,,,,,,,0,,0,168070,250480,30378,,,,,,,,,,,,,,,,,,,,,,,,,,,,,,,,,,,,,,,,,,,
31771746,87756f0e-c4f9-47f9-8e20-d44400645cfa,1629397980,120,1629399543,,0,0,2.12,720,720,4,1,,,0,0,0,,,,161,155,176,,,,44.41,31.1,44.59,1,57.02,1175,45,,2.5,0,96,94,,,,,,24,79,10.68,10.87,10.94,22.2,21.8,257,257,,1,265,265,,,,,,,,,"19,2,13,44,19,2,0,1,0","2,12,43,43,0","0,14,78,7,0",,,,,112,,,,,,,,,,,,,,,,,,,,,,,,,,,,,,,,,,,,34.7,18,9,296,74,,1015,0,310,0,3,3,Balve,1,0,U1.600|8:43-U0.520|3:17,,"Balve Track Running",,,3113,,250,3,7334168909,0,168070,250480,30378,,18306359,,,,,,,,,,,,,,,,,,,,,,,,,,,,,,,,,,,,,,,,,
31771749,c0d83a25-2198-43b4-8cd3-47bbea9df8b9,1629399144,120,1629399547,,0,0,10.92,3710,4644,317,273,,,0,3.9,0.82,1.08,1.08,519,770,145,190,,,,48.72,34.8,50.71,1,56.88,4403,222,,4.4,2.7,95,102,,,,,,103,79,11.37,10.86,12.09,-12.8,8.6,271,271,,1,302,302,,,,,,,,,"21,9,17,27,13,7,5,1,0","0,47,17,34,1","3,25,39,19,14",,,,,112,,,,,,,,,,,,,,,,,,,,,,,,,,,,,,,,,,,,62.3,18,9,296,74,,1015,0,310,0,3,3,Balve,1,0,U0.832|5:08-U0.110|0:33-U0.067|0:32-U0.119|0:32-U0.069|0:32-U0.123|0:31-U0.067|0:31-U0.119|0:31-U0.077|0:31-U0.122|0:32-U0.084|0:33-U0.130|0:33-U0.082|0:31-U0.129|0:33-U0.084|0:32-U0.133|0:33-U0.084|0:32-U0.132|0:33-U0.072|0:32-U0.135|0:32-U0.056|0:30-U0.135|0:31-U0.050|0:31-U0.128|0:32-U0.053|0:32-U0.124|0:31-U0.048|0:30-U0.116|0:31-U0.048|0:32-U0.128|0:32-U0.046|0:34-U0.125|0:31-U0.090|0:51-U0.162|0:31-U0.051|0:34-U0.171|0:35-U0.047|0:32-U0.131|0:33-U0.037|0:32-U0.115|0:32-U0.032|0:32-U0.099|0:31-U0.043|0:30-U0.183|0:54-U1.000|6:35-U1.000|5:07-U1.000|5:28-U1.000|5:24-U1.000|5:31-U0.936|5:04,,"Balve Running",,,3113,,250,3,7334169152,0,168070,250480,30378,,18306362,,,,,,,,,,,,,,,,,,,,,,,,,,,,,,,,,,,,,,,,3,
31806361,9140094b-de15-45f0-8a5f-153a48258969,1629479917,120,1629480022,,0,0,15.26,3932,4436,305,309,,,4,2.4,0.4,1.16,0.95,1072,942,152,172,,,,64.21,49.3,65.78,1,,,,,,,,,,,,,,86,82,14.29,14.09,14.59,4.7,4.1,360,360,,1,370,370,,,,,,,,,"2,0,2,7,21,42,20,4,1","0,5,85,10,0","0,0,20,53,26",,,,,142,,,,,,,,,,,,,,,,,,,,,,,,,,,,,,,,,,,,28.9,21,10,244,63,,1016,1,315,0,3,3,Sundern,1,0,U1.000|4:21-U1.000|4:03-U1.000|4:14-U1.000|4:15-U1.000|4:13-U1.000|4:17-U1.000|4:12-U1.000|4:01-U1.000|4:16-U1.000|4:03-U1.000|4:29-U1.000|4:13-U1.000|4:23-U1.000|4:47-U1.000|4:38-U0.235|1:08,,,,,wahoo_fitness-33,,518,7,,0,168070,250480,30378,,18336676,,,,,,,,,,,,,,,,,,,,,,,,,,,,,,,,,,,,,,,,"5,5",
31839578,8871385e-045a-40c9-b2c8-c662cbec8950,1629545891,120,1629561392,,0,0,65.22,9924,11243,311,308,,,4,0,0.1,,,,1021,,,,,,,,,1,,,,,,,,,,,,,,60,77,,24.7,,,,116,104,,0,124,117,,,,,,,,,"6,13,38,35,5,1,0",,"46,49,5,0,0",,,,,,,,,,,,,,,,,,,,,50,,,,,,,,,,,,,,,,,,,,,23,7,122,62,,1018,5,306,0,3,3,Müngersdorf,1,0,,,,,,wahoo_fitness-43,,258,7,,0,168072,,30378,,18366216,,,,,,,,,,,,,,,,,,,,,,,,,,,,,,,,,,,,,,,,,
31841606,44d12f55-875c-461c-969a-33cdae5509ab,1629531408,120,1629564001,,0,0,12.04,3966,4565,202,203,,,4,2.6,0.64,1.09,0.95,412,981,159,185,,,,44.43,36.36,45.35,1,,,,,,,,,,,,,,115,81,11.24,11.08,11.42,-0.9,-2.4,268,268,,1,274,274,,,,,,,,,"12,11,23,30,18,5,1,0,0","2,9,34,51,3","0,3,78,19,0",,,,,112,,,,,,,,,,,,,,,,,,,,,,,,,,,,,,,,,,,,69.9,14,4,146,83,,1020,1,306,0,3,3,Balve,1,0,U1.000|5:53-U1.000|5:26-U1.000|5:25-U1.000|5:44-U1.000|5:25-U1.000|5:51-U1.000|6:00-U1.000|4:50-U1.000|4:51-U1.000|5:47-U1.000|5:08-U1.000|5:40-U0.013|0:04-U0.011|0:03,,,,,wahoo_fitness-33,,518,7,,0,168070,250480,30378,,18368101,,,,,,,,,,,,,,,,,,,,,,,,,,,,,,,,,,,,,,,,"4,5",
31884304,f32cb565-251c-42d9-8e43-0f0d3dac6e34,1629648966,120,1629654495,,0,0,13.37,3600,3666,46,45,,,4,0,0.03,,,,842,148,160,,,,63.12,46.37,63.4,1,,,,,,,,,,,,,,70,81,13.41,13.4,13.44,3.8,3.2,336,336,,1,338,338,,,,,,,,,"1,1,2,7,37,45,8,1,0","1,8,91,0,0","0,0,8,90,1",,,,,138,,,,,,,,,,,,,,,,,,,,,,,,,,,,,,,,,,,,23.5,22,18,280,68,,1016,,,0,3,1,Porz,1,0,U1.000|4:53-U1.000|4:24-U1.000|4:27-U1.000|4:32-U1.000|4:35-U1.000|4:25-U1.000|4:27-U1.000|4:26-U1.000|4:30-U1.000|4:26-U1.000|4:28-U1.000|4:27-U1.000|4:27-U0.350|1:34,,,,,wahoo_fitness-33,,518,7,,0,168070,250480,30378,,18406789,,,,,,,,,,,,,,,,,,,,,,,,,,,,,,,,,,,,,,,,,
31907764,f153be8d-202a-4e94-aba3-6da3999013e3,1629705252,120,1629724338,,0,0,11.39,3365,3515,24,23,,,4,0,0.05,,,,664,135,148,,,,63.53,41.12,63.7,1,,,,,,,,,,,,,,40,80,12.21,12.23,12.27,2.7,2.5,300,300,,1,303,303,,,,,,,,,"4,4,7,27,40,15,3,1,0","1,84,16,0,0","0,0,55,45,1",,,,,127,,,,,,,,,,,,,,,,,,,,,,,,,,,,,,,,,,,,15.3,16,4,4,86,,1020,1,322,0,3,3,Porz,1,0,U1.000|4:52-U1.000|4:44-U1.000|4:50-U1.000|4:51-U1.000|4:58-U1.000|4:58-U1.000|5:01-U1.000|4:53-U1.000|5:02-U1.000|4:59-U1.000|5:03-U0.371|1:55,,,,,wahoo_fitness-33,,518,7,,0,168070,250480,30378,,18427567,,,,,,,,,,,,,,,,,,,,,,,,,,,,,,,,,,,,,,,,,
31911565,cbfcb8bd-7e22-48e1-9c7a-49ab3225ed6b,1629731542,120,1629732197,,0,0,44.09,6305,7800,479,478,,,4,2.4,0.39,1.26,0.93,911,907,120,161,,,,,,,1,,,,,,,,,,,,,,48,79,,28.41,,-4.6,-8.9,179,145,,0,209,194,,,,,,,,,"13,13,22,25,14,5,8","16,65,19,0,0","37,32,24,7,1",,,,,,,,,,,,,,,,,,,,,49,,,,,,,,,,,,,,,,,,,,22.3,20,15,10,77,,1022,3,314,0,3,3,Kerkrade,1,0,,,,,,wahoo_fitness-43,,258,7,,0,168072,,30378,,18430754,,,,,,,,,,,,,,,,,,,,,,,,,,,,,,,,,,,,,,,,"4,4,5",
31949537,fedf35fe-2efd-458f-8be7-d2ad06992752,1629799031,120,1629803651,,0,0,55.73,8210,9503,660,657,,,4,2.2,0.34,,,898,1160,,,,,,,,,1,,,,,,,,,,,,,,50,81,,27.03,,,,175,144,,0,209,196,,,,,,,,,"8,19,22,28,14,5,5",,"37,32,23,8,1",,,,,,,,,,,,,,,,,,,,,48,,,,,,,,,,,,,,,,,,,,,18,18,54,68,,1027,4,316,0,3,3,Kerkrade,1,0,,,,,,wahoo_fitness-43,,258,7,,0,168072,,30378,,18464856,,,,,,,,,,,,,,,,,,,,,,,,,,,,,,,,,,,,,,,,"4,4,4,5",
32012756,2f9148bb-94ee-441f-a7b2-03cec2a4639d,1629917178,120,1629915884,,0,0,15.12,4061,4309,130,113,,,0,0.2,0.24,1.18,0.56,,940,155,186,93,,,59.32,46.95,60.03,1,57.75,5760,381,,5,4.2,104,99,,,,,,110,82,13.51,14.22,14.64,11.1,1.9,339,339,,1,377,377,,,,,,,,,"11,3,6,12,9,15,32,12,0","1,28,27,43,2","7,6,21,27,39",,,,,136,,,,,,,,,,,,,,,,,,,,,,,,,,,,,,,,,,,,86.7,17,10,318,62,,1019,0,302,0,3,3,Sundern,1,0,U1.000|4:20-U1.000|4:11-U1.000|4:17-U1.000|3:40-U0.207|1:14-U1.000|3:38-U0.200|1:26-U1.000|3:38-U0.215|1:42-U1.000|3:41-U1.000|5:58-U1.000|3:38-U0.199|1:29-U1.000|3:37-U0.196|1:49-U1.000|3:39-U0.211|1:47-U1.000|3:31-U1.000|5:51-U0.891|4:33,,"Sundern (Sauerland) Running",,,3113,,250,3,7369310340,0,168070,250480,30378,,18519414,,,,,,,,,,,,,,,,,,,,,,,,,,,,,,,,,,,,,,,,,
32081759,59f068f0-33ac-480b-8ac1-c5bcb640f902,1630071073,120,1630070376,,0,0,15.52,4664,4758,421,421,,,4,4.3,0.79,1.07,1.07,568,1058,147,173,,,,55.63,41.3,57.5,1,,,,,,,,,,,,,,126,82,12.75,12.38,13.07,-8.7,-0.7,302,302,,1,314,314,,,,,,,,,"9,9,17,20,17,16,13,0,0","0,24,70,6,0","0,4,47,42,7",,,,,122,,,,,,,,,,,,,,,,,,,,,,,,,,,,,,,,,,,,40.6,15,15,328,95,,1016,3,341,0,6,3,Balve,1,0,U1.000|5:44-U1.000|5:51-U1.000|5:24-U1.000|6:12-U1.000|5:09-U1.000|4:52-U1.000|5:25-U1.000|5:14-U0.587|3:05-U1.000|5:11-U1.000|4:50-U1.000|5:03-U1.000|4:07-U1.000|3:58-U1.000|4:01-U0.915|3:38,,,,,wahoo_fitness-33,,518,7,,0,168070,250480,30378,,18579494,,,,,,,,,,,,,,,,,,,,,,,,,,,,,,,,,,,,,,,,"3,5,5",
32116874,7411b043-15f0-4951-92dd-be14920716c7,1630146951,120,1630151293,,0,0,15.04,4566,4684,248,246,,,4,2.5,0.49,0.98,1.01,445,993,143,168,,,,57.02,40.71,58.19,1,,,,,,,,,,,,,,114,81,12.25,12.07,12.44,-2.1,-3.6,292,292,,1,300,300,,,,,,,,,"10,7,9,21,31,16,5,1,0","0,37,60,3,0","0,5,48,45,2",,,,,122,,,,,,,,,,,,,,,,,,,,,,,,,,,,,,,,,,,,37.8,14,8,342,100,,1018,3,331,0,6,3,"Menden (Sauerland)",1,0,U1.000|6:12-U1.000|5:16-U1.000|4:37-U1.000|4:42-U1.000|4:53-U1.000|4:54-U1.000|5:24-U1.000|5:04-U1.000|4:43-U1.000|4:35-U1.000|5:56-U1.000|5:11-U1.000|4:35-U1.000|4:46-U1.000|5:15-U0.014|0:04,,,,,wahoo_fitness-33,,518,7,,0,168070,250480,30378,,18610727,,,,,,,,,,,,,,,,,,,,,,,,,,,,,,,,,,,,,,,,"4,4",
32158626,e1cc94e1-d0b1-4b73-988a-710154d3e9eb,1630240722,120,1630243051,,0,0,25.12,8417,9297,616,513,,,0,5,0.68,1.03,1,552,1672,133,159,,,,55.41,37.72,57.37,1,57.67,5691,203,,4.8,0,103,97,,,,,,150,80,11.42,10.97,11.82,2.5,5.4,265,265,,1,279,279,,,,,,,,,"18,12,18,28,22,2,0,0,0","1,70,29,0,0","0,12,61,26,1",,,,,112,,,,,,,,,,,,,,,,,,,,,,,,,,,,,,,,,,,,32.1,13,10,339,98,,1018,3,324,0,6,3,Balve,1,0,U1.000|4:54-U1.000|5:06-U1.000|5:31-U1.000|6:41-U1.000|6:07-U1.000|6:27-U1.000|5:03-U1.000|5:05-U1.000|5:42-U1.000|5:35-U1.000|5:05-U1.000|5:01-U1.000|5:21-U1.000|5:42-U1.000|5:23-U1.000|5:40-U1.000|6:01-U1.000|5:33-U1.000|6:35-U1.000|6:45-U1.000|5:28-U1.000|4:59-U1.000|5:02-U1.000|5:31-U1.000|5:21-U0.123|0:39,,"Balve Running",,,3113,,250,3,7390326796,0,168070,250480,30378,,18646270,,,,,,,,,,,,,,,,,,,,,,,,,,,,,,,,,,,,,,,,"3,4,4,5,5",
32216423,5837bec4-9973-4701-b13d-0f081e80e131,1630356038,120,1630349038,,0,0,,153,153,0,0,,,4,0,0,,,,17,90,100,,,,,,,1,,,,,,,,,,,,,,1,79,,0,,,-0.8,110,110,,0,111,111,,,,,,,,,"100,0,0,0,0,0,0","100,0,0,0,0","1,99,0,0,0",,,,,,,,,,,,,,,,,,,,,52,,,,,,,,,,,,,,,,,,,,0.6,15,7,4,89,,1019,0,321,1,3,3,Balve,1,0,,,,,,wahoo_fitness-43,,258,7,,0,168072,,30378,,18699174,,,,,,,,,,,,,,,,,,,,,,,,,,,,,,,,,,,,,,,,,
32231555,ff4672af-61b9-4c7c-8a41-703a4dc68545,1630355381,120,1630395474,,0,0,38.23,4719,4719,,,,,0,,,,,,769,119,147,,,,,,,1,,,,,,,,,,,,,,60,87,,29.65,,7.5,-6.9,163,162,,0,176,176,,,,,,,,,"1,1,14,26,54,4,0","11,88,2,0,0","27,49,21,3,0",,,,,,,,,,,,,,,,,,,,,,,,,,,,,,,,,,,,,,,,,14.2,,,,,,,,,,1,,,1,0,,,,,,,,252,1,,0,168072,,30378,,18713109,,,,,,,,,,,,,,,,,,,,,,,,,,,,,,,,,,,,,,,,,
32248676,ffa4ffee-3798-49c1-9e2a-b4d18fc54fc6,1630431363,120,1630425922,,0,0,15.29,1674,1677,95,203,,,4,0.2,0.28,1.41,0.81,,308,132,165,,,,,,,1,,,,,,,,,,,,,,36,91,,34.39,,-6.9,-21.4,204,186,,0,211,202,,,,,,,,,"5,4,7,8,21,44,12","8,48,42,2,0","18,30,44,6,1",,,,,,,,,,,,,,,,,,,,,50,,,,,,,,,,,,,,,,,,,,35.9,19,10,351,68,,1023,1,317,0,3,3,,1,0,,,,,,wahoo_fitness-47,,329,7,,0,168072,,30378,,18728777,,,,,,,,,,,,,,,,,,,,,,,,,,,,,,,,,,,,,,,,,
32253890,77224300-322a-4a71-b7ea-54d86fa603b3,1630435021,120,1630431960,,0,0,4.04,1061,1061,38,37,,,4,0,0.1,1.17,0.86,,262,155,168,,,,60.99,44.19,61.72,1,,,,,,,,,,,,,,35,82,13.87,13.95,14.17,-5.5,-8.1,347,347,,1,357,357,,,,,,,,,"7,2,3,5,13,38,29,3,0","1,6,79,15,0","0,6,8,67,18",,,,,139,,,,,,,,,,,,,,,,,,,,,,,,,,,,,,,,,,,,50.6,19,8,351,72,,1023,0,318,0,3,3,,1,0,U1.000|4:43-U1.000|4:17-U1.000|4:15-U1.000|4:14-U0.036|0:12,,,,,wahoo_fitness-33,,518,7,,0,168070,250480,30378,,18733419,,,,,,,,,,,,,,,,,,,,,,,,,,,,,,,,,,,,,,,,,
32254045,eb34731a-587d-4ed6-b3e5-b4cbe01e66ad,1630436725,120,1630432155,,0,0,8.87,2573,2576,128,129,,,4,1.6,0.59,1.34,0.99,,675,161,188,,,,51.02,41.28,51.92,1,,,,,,,,,,,,,,103,83,12.54,14.35,14.61,19.6,-3.5,344,317,,1,384,376,,,,,,,,,"16,5,10,8,5,8,17,25,6","0,12,30,49,9","13,7,22,18,39",,,,,125,,,,,,,,,,,,,,,,,,,,,,,,,,,,,,,,,,,,95.3,18,8,353,75,,1023,0,318,0,3,3,"Menden (Sauerland)",1,0,U1.000|3:42-U0.400|2:06-U0.200|0:39-U0.100|0:36-U0.200|0:37-U0.100|0:38-U0.200|0:36-U0.100|0:40-U0.200|0:37-U0.100|0:38-U0.200|0:37-U0.400|2:21-U1.000|3:38-U0.400|2:13-U0.400|1:20-U0.200|1:13-U0.400|1:22-U0.200|1:11-U0.400|1:19-U0.200|1:10-U0.400|1:20-U0.200|1:14-U0.400|1:20-U0.400|2:25-U1.000|3:27-U0.051|5:54,,,,,wahoo_fitness-33,,518,7,,0,168070,250480,30378,,18733551,,,,,,,,,,,,,,,,,,,,,,,,,,,,,,,,,,,,,,,,,
32256263,9c577026-265d-4242-af8f-bdfa9dce4502,1630439783,120,1630435248,,0,0,17.39,2308,2629,215,97,,,4,0.8,0.28,1.13,1.29,,399,141,159,,,,,,,1,,,,,,,,,,,,,,58,91,,28.78,,11.8,-10.9,186,173,,0,194,188,,,,,,,,,"11,6,8,29,43,3,0","2,29,70,0,0","11,58,29,2,0",,,,,,,,,,,,,,,,,,,,,49,,,,,,,,,,,,,,,,,,,,34.1,17,8,355,78,,1023,0,318,0,3,3,"Menden (Sauerland)",1,0,,,,,,wahoo_fitness-47,,329,7,,0,168072,,30378,3553372,18735495,424,12,11,45,20,0.33,0.75,0,0.77,0.45,1.84,44,3,90,0.6,201,1,31.45,1,145,1,,,,,,,,,,,,,,,,,,,,
32317707,abdaf5ba-09bd-4df0-8035-765cc35002f6,1630504014,120,1630571142,,0,0,15.48,5524,5636,416,409,,,4,4.4,0.87,1.11,1.09,499,1075,134,174,,,,50.79,33.76,52.51,1,,,,,,,,,,,,,,117,79,10.69,10.28,11.13,-4.3,8.5,245,245,,1,262,262,,,,,,,,,"29,18,19,22,9,2,0,0,0","1,69,28,2,0","0,24,61,14,2",,,,,106,,,,,,,,,,,,,,,,,,,,,,,,,,,,,,,,,,,,30.7,17,6,347,72,,1028,4,298,0,3,3,Balve,1,0,U1.000|6:23-U1.000|6:29-U1.000|6:27-U1.000|6:42-U1.000|6:02-U1.000|5:32-U1.000|6:13-U1.000|6:11-U1.000|5:56-U1.000|6:04-U1.000|6:23-U1.000|5:57-U1.000|5:19-U1.000|5:16-U1.000|4:59-U0.451|2:13,,,,,wahoo_fitness-33,,518,7,,0,168070,250480,30378,,18790940,,,,,,,,,,,,,,,,,,,,,,,,,,,,,,,,,,,,,,,,"3,5,5",
32367161,14406ac7-87ec-40df-ad73-5bac50e2c1f6,1630609282,120,1630662027,,0,0,15.38,4078,4136,272,273,,,4,2.2,0.51,1.15,0.96,,921,147,173,,,,64.94,47.72,66.35,1,,,,,,,,,,,,,,119,82,13.84,13.75,14.18,7.4,5.5,342,342,,1,355,355,,,,,,,,,"1,1,4,13,26,34,16,5,0","6,15,57,23,0","0,1,28,54,17",,,,,138,,,,,,,,,,,,,,,,,,,,,,,,,,,,,,,,,,,,70.8,18,5,55,79,,1025,0,290,0,2,3,Sundern,1,0,U1.000|4:40-U1.000|4:25-U1.000|4:31-U1.000|4:46-U1.000|4:42-U1.000|4:41-U1.000|4:07-U1.000|3:57-U1.000|3:53-U1.000|3:55-U1.000|3:58-U1.000|4:21-U1.000|4:50-U1.000|4:43-U1.000|4:53-U0.350|1:37,,,,,wahoo_fitness-33,,518,7,,0,168070,250480,30378,,18832822,,,,,,,,,,,,,,,,,,,,,,,,,,,,,,,,,,,,,,,,,
32396585,9632ba2d-33cf-4b67-9ae3-7036ffea27f6,1630691636,120,1630696786,,0,0,5.11,2403,2628,67,68,,,4,1.1,0.56,1.76,0.89,,499,140,185,,,,34.13,22.27,34.68,1,,,,,,,,,,,,,,64,74,7.64,11.5,11.83,42.2,9.3,231,189,,1,324,308,,,,,,,,,"62,2,1,1,1,3,7,16,8","1,54,16,27,2","51,13,8,7,21",,,,,86,,,,,,,,,,,,,,,,,,,,,,,,,,,,,,,,,,,,63.3,21,7,18,71,,1019,0,286,0,2,3,"Menden (Sauerland)",1,0,U0.500|1:43-U0.100|0:45-U0.300|0:57-U0.100|0:44-U0.500|1:41-U0.100|0:45-U0.300|1:00-U0.200|3:45-U0.300|0:56-U0.100|0:45-U0.200|0:37-U0.100|0:53-U0.300|0:57-U0.100|0:59-U0.200|0:38-U0.288|10:46-U0.155|0:27-U0.200|2:51-U0.152|0:25-U0.200|3:07-U0.147|0:25-U0.598|4:57,,,,,wahoo_fitness-33,,518,7,,0,168070,250480,30378,,18860053,,,,,,,,,,,,,,,,,,,,,,,,,,,,,,,,,,,,,,,,,
32396664,0fe412e7-fb50-4002-9408-5576330727d9,1630686982,120,1630696798,,0,0,6.9,3110,4569,182,191,,,4,3,0.74,2.58,2.29,379,577,130,163,,,,39.51,23.95,40.74,1,,,,,,,,,,,,,,63,76,8.31,10.75,11.51,41,7.9,269,199,,1,298,277,,,,,,,,,"29,6,8,12,17,16,8,3,1","6,59,33,1,0","32,6,36,19,7",,,,,88,,,,,,,,,,,,,,,,,,,,,,,,,,,,,,,,,,,,33.1,23,10,20,62,,1019,2,287,0,2,3,"Menden (Sauerland)",1,0,U1.000|5:40-U1.000|5:57-U1.000|5:31-U1.000|4:58-U1.000|4:55-U1.000|4:39-U0.421|3:09-U0.417|1:32-U0.054|15:29,,,,,wahoo_fitness-33,,518,7,,0,168070,250480,30378,,18860131,,,,,,,,,,,,,,,,,,,,,,,,,,,,,,,,,,,,,,,,4,
32453332,99748b07-8e04-4b40-bb5e-e2a2f15c2bf2,1630742837,120,1630827857,,0,0,95.9,11689,12978,922,893,,,4,2.1,0.31,1.17,1.06,786,2500,135,166,,,,,,,1,,,,,,,,,,,,,,261,87,,33,,2.8,-4.7,190,175,,0,208,200,,,,,,,,,"9,11,13,15,19,16,17","2,57,39,2,0","22,35,35,7,1",,,,,,,,,,,,,,,,,,,,,49,,,,,,,,,,,,,,,,,,,,37,14,5,51,85,,1019,1,286,0,2,3,Balve,1,0,,,,,,wahoo_fitness-43,,258,7,,0,168072,,30378,,18912240,,,,,,,,,,,,,,,,,,,,,,,,,,,,,,,,,,,,,,,,"4,4,4,4,5,5,5",
32460447,718d8714-5710-408b-87fe-12e2e40b35f6,1630842539,120,1630837059,,0,0,3.03,1090,1090,29,29,,,4,0.4,0.33,1.07,0.97,,222,137,154,,,,48.9,29.91,49.48,1,,,,,,,,,,,,,,24,80,10.14,10.06,10.35,-4.1,-7.6,235,235,,1,243,243,,,,,,,,,"10,31,44,14,1,0,0,0,0","0,71,29,0,0","1,11,82,6,0",,,,,104,,,,,,,,,,,,,,,,,,,,,,,,,,,,,,,,,,,,25,21,6,4,66,,1021,5,289,0,2,3,Balve,1,0,U1.000|6:07-U1.000|5:52-U1.000|6:02-U0.028|0:09,,,,,wahoo_fitness-33,,518,7,,0,168070,250480,30378,,18918441,,,,,,,,,,,,,,,,,,,,,,,,,,,,,,,,,,,,,,,,,
32460459,409f04b4-f369-44d6-a631-f86400096a06,1630839550,120,1630837067,,0,0,9.37,2267,2267,225,226,,,4,3.2,0.61,1.05,1,532,651,173,196,,,,57.08,51.24,58.77,1,,,,,,,,,,,,,,112,84,15.74,15.25,16.12,2.2,6.5,393,393,,1,407,407,,,,,,,,,"3,2,3,6,11,22,35,15,3","0,1,5,80,14","0,0,11,47,43",,,,,148,,,,,,,,,,,,,,,,,,,,,,,,,,,,,,,,,,,,114.9,20,5,38,67,,1020,4,289,0,2,3,Balve,1,0,U1.000|4:07-U1.000|4:05-U1.000|3:29-U1.000|4:17-U1.000|4:01-U1.000|3:55-U1.000|3:59-U1.000|4:44-U1.000|3:49-U0.347|1:21,,,,,wahoo_fitness-33,,518,7,,0,168070,250480,30378,,18918453,,,,,,,,,,,,,,,,,,,,,,,,,,,,,,,,,,,,,,,,"4,4,5",
32460465,d549852a-b551-4ac4-836b-27efc101081e,1630837282,120,1630837074,,0,0,3.04,927,988,30,29,,,4,0,0.2,0.99,0.95,,209,146,161,,,,55.15,36.36,55.84,1,,,,,,,,,,,,,,25,80,11.94,11.92,12.07,6.5,4.1,287,287,,1,292,292,,,,,,,,,"8,3,9,26,43,11,0,0,0","0,10,88,2,0","0,0,64,36,0",,,,,123,,,,,,,,,,,,,,,,,,,,,,,,,,,,,,,,,,,,33.3,18,4,101,70,,1020,3,290,0,2,3,Balve,1,0,U1.000|4:54-U1.000|4:57-U1.000|5:26-U0.035|0:11,,,,,wahoo_fitness-33,,518,7,,0,168070,250480,30378,,18918459,,,,,,,,,,,,,,,,,,,,,,,,,,,,,,,,,,,,,,,,,
32471656,38fa496e-7cae-4c56-accf-79407b4a3d30,1630850893,120,1630852781,,0,0,36.67,5848,7838,677,679,,,4,4.2,0.56,1.26,1.02,855,821,130,158,,,,,,,1,,,,,,,,,,,,,,114,75,,28.69,,-4.7,-6.2,172,142,,0,190,176,,,,,,,,,"30,23,13,15,6,4,10","3,67,30,0,0","31,38,28,2,0",,,,,,,,,,,,,,,,,,,,,53,,,,,,,,,,,,,,,,,,,,33.5,23,7,3,58,,1021,4,292,0,3,3,Balve,1,0,,,,,,wahoo_fitness-47,,329,7,,0,168072,,30378,3578873,18928333,463,11,10,60,40,0.42,1.41,0,1.01,0.44,1.64,70,2,52,0.9,253,0,9.35,0,147,0,,,,,,,,,,,,,,,,,,,"4,4,4,4,5",
32531593,50d1d6ba-9ecf-47ca-b823-d0e115af3ef3,1630944960,120,1630960770,,0,0,15.53,4787,4853,411,410,,,4,4.4,0.79,1.13,0.96,566,1043,144,175,,,,55.44,40.1,57.26,1,,,,,,,,,,,,,,131,81,12.4,12.06,12.79,1.8,10.4,293,293,,1,308,308,,,,,,,,,"10,12,18,20,17,14,9,0,0","4,26,55,16,0","0,8,49,36,7",,,,,120,,,,,,,,,,,,,,,,,,,,,,,,,,,,,,,,,,,,68.5,23,6,0,47,,1024,2,292,0,3,3,Balve,1,0,U1.000|5:25-U1.000|6:02-U1.000|5:33-U1.000|6:34-U1.000|5:19-U1.000|5:00-U1.000|5:43-U1.000|5:22-U1.000|5:25-U1.000|5:19-U1.000|4:54-U1.000|4:40-U1.000|4:11-U1.000|4:15-U1.000|4:07-U0.499|1:59,,,,,wahoo_fitness-33,,518,7,,0,168070,250480,30378,,18980201,,,,,,,,,,,,,,,,,,,,,,,,,,,,,,,,,,,,,,,,"3,5,5",
32577526,9508cb1b-03ef-44b4-8b01-d70b1b0d998a,1631041820,120,1631040155,,0,0,8.53,2262,2262,117,117,,,4,0.4,0.31,1.13,0.89,,578,162,208,,,,56.46,45.75,57.42,1,,,,,,,,,,,,,,92,84,13.74,15.06,15.28,21.4,7.3,352,347,,1,399,397,,,,,,,,,"22,4,6,6,5,6,14,27,10","0,12,30,46,12","7,10,24,12,47",,,,,135,,,,,,,,,,,,,,,,,,,,,,,,,,,,,,,,,,,,101.5,20,7,57,71,,1022,0,281,0,3,3,"Menden (Sauerland)",1,0,U0.400|1:21-U0.400|2:05-U0.800|2:41-U0.400|2:07-U1.200|4:02-U0.400|2:24-U0.800|2:45-U0.100|1:14-U0.400|1:18-U0.400|3:03-U1.200|4:02-U0.400|3:02-U0.800|2:42-U0.400|2:43-U0.400|1:17-U0.027|0:57,,,,,wahoo_fitness-33,,518,7,,0,168070,250480,30378,,19021663,,,,,,,,,,,,,,,,,,,,,,,,,,,,,,,,,,,,,,,,,
32577552,91e30707-f59c-43b0-8d8b-7ae2c7290611,1631040078,120,1631040160,,0,0,4.07,1126,1126,31,31,,,4,0,0.11,1.07,0.87,,269,152,177,,,,58.81,41.61,59.36,1,,,,,,,,,,,,,,36,81,13.19,13.35,13.54,-12.4,-10.9,325,325,,1,339,339,,,,,,,,,"10,3,8,9,14,39,10,5,1","0,17,54,29,0","0,6,19,65,10",,,,,134,,,,,,,,,,,,,,,,,,,,,,,,,,,,,,,,,,,,52,21,8,48,67,,1022,0,281,0,3,3,"Menden (Sauerland)",1,0,U1.000|4:48-U1.000|4:27-U1.000|4:24-U1.000|4:41-U0.060|0:26,,,,,wahoo_fitness-33,,518,7,,0,168070,250480,30378,,19021688,,,,,,,,,,,,,,,,,,,,,,,,,,,,,,,,,,,,,,,,,
32577599,2a43b3cc-e7bf-4b34-b61d-9d7609fef60c,1631044421,120,1631040167,,0,0,3.12,1101,1105,65,70,,,4,1.6,0.68,1.19,0.93,214,254,150,173,,,,44.37,30.67,45.43,1,,,,,,,,,,,,,,33,81,10.59,10.36,10.9,6.5,12.2,244,244,,1,258,258,,,,,,,,,"29,17,17,19,11,7,0,0,0","0,25,46,29,0","0,21,64,14,1",,,,,105,,,,,,,,,,,,,,,,,,,,,,,,,,,,,,,,,,,,48,19,7,72,74,,1022,0,282,0,3,3,"Menden (Sauerland)",1,0,U1.000|6:24-U1.000|6:00-U1.000|5:17-U0.113|0:40,,,,,wahoo_fitness-33,,518,7,,0,168070,250480,30378,,19021736,,,,,,,,,,,,,,,,,,,,,,,,,,,,,,,,,,,,,,,,5,
32632921,de35f0b2-152e-437d-88d5-18b0c7138c45,1631119785,120,1631130974,,0,0,15.28,4903,5057,468,471,,,4,4.7,0.83,1.03,1.1,504,1024,139,163,,,,55.27,38.21,57.36,1,,,,,,,,,,,,,,117,80,12.15,12.13,12.57,-3.6,-0.5,282,282,,1,296,296,,,,,,,,,"24,15,15,12,13,8,8,5,0","0,48,51,1,0","0,7,58,29,6",,,,,117,,,,,,,,,,,,,,,,,,,,,,,,,,,,,,,,,,,,34.7,24,9,130,53,,1016,1,283,0,2,3,Balve,1,0,U1.000|6:02-U1.000|6:30-U1.000|6:03-U1.000|6:46-U1.000|5:09-U1.000|4:46-U1.000|4:43-U1.000|5:30-U1.000|7:09-U1.000|6:09-U1.000|5:52-U1.000|4:41-U1.000|3:47-U1.000|3:46-U1.000|3:38-U0.263|1:12,,,,,wahoo_fitness-33,,518,7,,0,168070,250480,30378,,19071572,,,,,,,,,,,,,,,,,,,,,,,,,,,,,,,,,,,,,,,,"3,4",
32698258,e49b9e39-5eb1-485b-80f9-1d20bfad8551,1631215761,120,1631255218,,0,0,10.12,3274,3417,305,305,,,4,3.7,0.66,1.17,1.01,479,697,143,179,,,,52.72,36.65,54.69,1,,,,,,,,,,,,,,89,79,12.03,11.86,12.37,6.6,16.1,278,278,,1,289,289,,,,,,,,,"31,12,10,8,14,15,8,1,0","1,53,25,21,0","0,8,59,30,3",,,,,117,,,,,,,,,,,,,,,,,,,,,,,,,,,,,,,,,,,,66.1,20,8,186,89,,1012,0,294,0,6,3,Balve,1,0,U1.000|6:17-U1.000|6:54-U1.000|6:23-U1.000|6:54-U1.000|5:38-U1.000|4:24-U1.000|4:34-U1.000|4:19-U1.000|4:01-U1.000|4:40-U0.102|0:31,,,,,wahoo_fitness-33,,518,7,,0,168070,250480,30378,,19132596,,,,,,,,,,,,,,,,,,,,,,,,,,,,,,,,,,,,,,,,3,
32712973,a60219b6-3d84-4484-b669-7dbce4d9d271,1631280918,120,1631278539,,0,0,15.23,4422,4547,448,445,,,4,4.6,0.85,1.02,1.02,613,1004,147,174,,,,58.05,42.92,60.17,1,,,,,,,,,,,,,,129,82,13.22,12.66,13.84,-0.3,7.2,317,317,,1,343,343,,,,,,,,,"5,6,10,18,28,24,9,0,0","0,47,25,28,0","0,5,41,39,15",,,,,126,,,,,,,,,,,,,,,,,,,,,,,,,,,,,,,,,,,,56.2,22,10,215,80,,1014,3,292,0,4,3,Balve,1,0,U1.000|5:34-U1.000|4:54-U1.000|4:35-U1.000|5:08-U1.000|5:03-U1.000|4:54-U1.000|4:42-U1.000|4:51-U1.000|5:54-U1.000|5:00-U1.000|5:17-U1.000|4:38-U1.000|4:13-U1.000|4:10-U1.000|4:00-U0.188|0:48,,,,,wahoo_fitness-33,,518,7,,0,168070,250480,30378,,19146233,,,,,,,,,,,,,,,,,,,,,,,,,,,,,,,,,,,,,,,,"3,4",
32779373,f077b90f-e70c-4010-9f37-6ec74ac4f846,1631436229,120,1631436279,,0,0,16.65,5540,6004,353,305,,,0,3.7,0.61,1.08,0.92,549,1177,153,180,,,,46.4,36.87,47.78,1,56.51,4286,182,,4.4,1.2,95,95,,,,,,183,80,11.41,11.18,11.65,9.1,11.9,264,264,,1,274,274,,,,,,,,,"22,9,19,24,15,7,2,1,0","0,12,58,30,0","0,10,74,15,2",,,,,113,,,,,,,,,,,,,,,,,,,,,,,,,,,,,,,,,,,,69.9,16,7,259,95,,1019,1,284,0,4,3,Balve,1,0,U1.000|5:41-U1.000|5:27-U1.000|5:58-U1.000|6:54-U1.000|6:55-U1.000|6:48-U1.000|5:38-U1.000|5:35-U1.000|5:07-U1.000|5:56-U1.000|4:45-U1.000|5:14-U1.000|4:36-U1.000|4:56-U1.000|4:32-U1.000|4:41-U0.654|3:38,,"Balve Running",,,3113,,250,3,7473176847,0,168070,250480,30378,,19203026,,,,,,,,,,,,,,,,,,,,,,,,,,,,,,,,,,,,,,,,"4,5",
32855246,c1aa06cf-ea89-4d9f-a0d0-3178813e61e3,1631560869,120,1631558691,,0,0,15.18,4217,4237,95,95,,,0,0,0.19,1.07,0.96,,907,143,162,83,,,63.63,45.16,64.12,1,57.67,4320,162,,4.3,0,104,105,,,,,,100,81,13.05,13.05,13.24,1.5,2.2,321,321,,1,327,327,,,,,,,,,"1,1,5,17,34,35,7,0,0","1,33,66,0,0","0,0,27,70,2",,,,,133,,,,,,,,,,,,,,,,,,,,,,,,,,,,,,,,,,,,31.8,19,4,62,71,,1017,0,283,1,4,3,Eil,1,0,U1.000|4:49-U1.000|4:24-U1.000|4:13-U1.000|4:24-U1.000|4:39-U1.000|4:33-U1.000|4:58-U1.000|4:33-U1.000|4:30-U1.000|4:29-U1.000|4:27-U1.000|4:36-U1.000|4:35-U1.000|5:08-U1.000|5:02-U0.180|0:55,,"Cologne Running",,,3113,,250,3,7483083015,0,168070,250480,30378,,19271306,,,,,,,,,,,,,,,,,,,,,,,,,,,,,,,,,,,,,,,,,
32963307,b987b014-ca3e-4604-882f-44992845c5ab,1631641619,120,1631774676,,0,0,5.34,1610,1899,27,37,,,0,0,0.13,1.08,0.7,,321,136,174,,,,61.38,38.23,61.62,1,58.74,3138,141,,3.1,2.9,106,100,,,,,,34,78,11.89,12.44,12.59,18.5,5.4,288,288,,1,313,313,,,,,,,,,"8,3,7,29,35,10,7,2,0","3,70,15,12,0","4,5,47,36,8",,,,,128,,,,,,,,,,,,,,,,,,,,,,,,,,,,,,,,,,,,35.9,24,8,169,68,,1013,1,284,0,4,3,Zündorf,1,0,U1.000|4:37-U1.000|4:43-U1.000|5:02-U0.413|2:07-U0.608|2:11-U1.000|5:56-U0.314|2:13,,"Cologne Running",,,3113,,250,3,7497511257,0,168070,250480,30378,,19368518,,,,,,,,,,,,,,,,,,,,,,,,,,,,,,,,,,,,,,,,,
32963308,372e4851-f372-4727-983e-7a4d0ab80dad,1631729187,120,1631774679,,0,0,13.03,4009,4278,94,67,,,0,0,0.16,1.09,0.71,,799,136,168,,,,59.86,39.63,60.55,1,59.74,2880,148,,3.8,1.3,104,99,,,,,,84,79,11.84,12.28,12.51,5.1,9.4,286,286,,1,310,310,,,,,,,,,"11,9,19,19,19,10,11,2,0","0,73,11,15,0","2,5,56,27,10",,,,,123,,,,,,,,,,,,,,,,,,,,,,,,,,,,,,,,,,,,58.9,19,9,282,93,,1011,0,279,0,6,3,Porz,1,0,U1.000|4:43-U1.000|4:39-U1.000|5:04-U1.000|3:55-U0.393|2:01-U1.000|3:48-U1.000|4:00-U0.397|3:46-U1.000|5:27-U1.000|6:02-U1.000|5:32-U1.000|5:26-U1.000|5:25-U1.000|5:40-U0.239|1:21,,"Cologne Running",,,3113,,250,3,7497511408,0,168070,250480,30378,,19368519,,,,,,,,,,,,,,,,,,,,,,,,,,,,,,,,,,,,,,,,,
32994174,cdd51d4c-b85c-4e57-8287-368faaa495da,1631812169,120,1631823247,,0,0,17.43,5402,5634,412,383,,,0,4,0.67,0.99,1.05,525,1152,136,160,,,,59.33,40.21,61.19,1,59.78,3168,148,,4,0,102,100,,,,,,119,80,12.32,11.93,12.45,-3.7,0.9,289,289,,1,296,296,,,,,,,,,"14,10,10,16,35,14,2,0,0","0,67,32,0,0","0,2,54,42,1",,,,,121,,,,,,,,,,,,,,,27,,,,,,,,,,,,,,,,,,,,,28.7,18,10,311,72,,1017,0,289,0,3,3,Balve,1,0,U1.000|5:32-U1.000|4:43-U1.000|5:03-U1.000|4:56-U1.000|4:57-U1.000|5:22-U1.000|6:22-U1.000|6:22-U1.000|6:05-U1.000|4:59-U1.000|5:07-U1.000|4:40-U1.000|4:22-U1.000|4:15-U1.000|4:31-U1.000|5:27-U1.000|5:17-U0.429|2:03,,"Balve Running",,,3113,,250,3,7501464324,0,168070,250480,30378,3635080,19396432,440,3,3,31,21,0.03,0.11,0.34,1.45,0.83,1.97,100,0,94,0.4,794,0,47.4,0,218,0,,,,,,,,,,,,,,,,,,,"4,4,5,5",
33025794,b24fd458-39a3-4fd9-aa5b-e2c836d3c2a8,1631897942,120,1631895419,,0,0,12.4,4029,4342,257,235,,,0,3.2,0.72,1,1.07,443,800,134,164,,,,57.02,37.03,58.6,1,59.48,2336,91,,3.2,0,97,99,,,,,,49,79,11.64,11.58,11.84,-7.7,-10.2,271,271,,1,281,281,,,,,,,,,"24,9,10,18,22,14,3,0,0","2,66,31,1,0","0,7,65,27,0",,,,,117,,,,,,,,,,,,,,,,,,,,,,,,,,,,,,,,,,,,19.2,18,6,323,69,,1015,1,278,0,4,3,Balve,1,0,U1.000|7:29-U1.000|5:13-U1.000|5:19-U1.000|5:23-U1.000|5:15-U1.000|5:51-U1.000|5:54-U1.000|6:36-U1.000|4:44-U1.000|4:21-U1.000|4:14-U1.000|4:44-U0.399|2:07,,"Balve Running",,,3113,,250,3,7505768911,0,168070,250480,30378,,19425231,,,,,,,,,,,,,,,,,,,,,,,,,,,,,,,,,,,,,,,,4,
33027172,091037cf-cc83-47c5-9ab5-bd9bf52daf43,1631389539,120,1631897875,,0,0,8,2563,2563,187,185,,,4,3.1,0.57,1.05,1.04,467,538,140,163,,,,54.87,36.47,56.47,1,,,,,,,,,,,,,,46,79,11.84,12.15,12.59,-10.4,-8.9,279,279,,1,300,300,,,,,,,,,"18,9,18,25,17,5,2,5,1","0,52,46,2,0","0,9,64,20,8",,,,,119,,,,,,,,,,,,,,,,,,,,,,,,,,,,,,,,,,,,23.9,17,7,241,81,,1017,0,295,1,3,3,Balve,1,0,U1.000|5:52-U1.000|5:14-U1.000|6:24-U1.000|6:19-U1.000|5:10-U1.000|4:58-U0.591|2:57-U1.000|3:18-U0.403|2:32,,,,,wahoo_fitness-33,,518,7,,0,168070,250480,30378,,19426419,,,,,,,,,,,,,,,,,,,,,,,,,,,,,,,,,,,,,,,,4,
33073999,e8d3c0af-5116-40bc-950c-00b8e65a3b85,1631992367,120,1631988289,,0,0,9.06,2748,2779,110,106,,,0,1.3,0.42,1,1.01,427,558,136,160,,,,60.93,39.23,61.88,1,59.68,1746,72,,3,0,101,100,,,,,,36,80,12.17,11.99,12.29,2.1,1.4,291,291,,1,298,298,,,,,,,,,"5,5,11,29,35,12,2,0,0","0,74,25,0,0","0,3,51,46,0",,,,,124,,,,,,,,,,,,,,,,,,,,,,,,,,,,,,,,,,,,12.5,15,7,40,74,,1017,0,279,0,2,3,Balve,1,0,U1.000|4:51-U1.000|5:14-U1.000|5:03-U1.000|4:41-U1.000|5:13-U1.000|4:57-U1.000|4:53-U1.000|4:56-U1.000|5:40-U0.064|0:20,,"Balve Running",,,3113,,250,3,7512503123,0,168070,250480,30378,,19468622,,,,,,,,,,,,,,,,,,,,,,,,,,,,,,,,,,,,,,,,5,
33095041,575c6582-c943-4d46-a266-aec45b4f82de,1632046075,120,1632051514,,0,0,21.35,6645,7279,508,421,,,0,4.4,0.73,1.12,1,502,1513,158,192,129,,,48.1,40.66,49.75,1,58.52,5760,335,,5,2.6,101,94,,,,,,224,80,12.24,11.89,12.5,3.2,6.2,287,287,,1,298,298,,,,,,,,,"12,11,14,19,25,16,3,0,0","0,15,37,41,7","0,4,60,33,3",,,,,120,,,,,,,,,,,,,,,,,,,,,,,,,,,,,,,,,,,,117.7,16,10,99,74,,1016,2,286,0,3,3,Balve,1,0,U1.000|5:44-U1.000|6:15-U1.000|5:57-U1.000|6:20-U1.000|5:52-U1.000|5:12-U1.000|5:10-U1.000|5:12-U1.000|5:19-U0.932|4:45-U1.000|4:30-U1.000|4:18-U0.489|2:36-U1.000|4:41-U1.000|5:18-U1.000|4:40-U1.000|5:43-U1.000|5:06-U1.000|4:53-U1.000|4:29-U1.000|4:27-U0.928|4:18,,"Balve Running",,,3113,,250,3,7516387621,0,168070,250480,30378,,19487132,,,,,,,,,,,,,,,,,,,,,,,,,,,,,,,,,,,,,,,,"4,4,5",
33161380,ef66d8fd-04de-4464-a22f-6e22b4f9d828,1632160010,120,1632160666,,0,0,10.23,2885,2890,169,176,,,0,2.3,0.67,0.99,1.04,484,627,143,165,,,,62.45,43.08,63.68,1,58.64,3636,112,,3.4,0,101,100,,,,,,61,80,13.14,13.07,13.26,2.4,2.7,318,318,,1,323,323,,,,,,,,,"5,6,7,15,24,31,12,1,0","0,36,61,3,0","0,0,36,63,1",,,,,133,,,,,,,,,,,,,,,,,,,,,,,,,,,,,,,,,,,,41.1,14,11,51,65,,1022,0,289,0,3,3,Balve,1,0,U1.000|5:04-U1.000|4:32-U1.000|4:52-U1.000|4:54-U1.000|4:33-U1.000|5:14-U1.000|5:04-U1.000|3:54-U1.000|4:06-U1.000|4:43-U0.230|1:09,,"Balve Running",,,3113,,250,3,7524085564,0,168070,250480,30378,,19543187,,,,,,,,,,,,,,,,,,,,,,,,,,,,,,,,,,,,,,,,5,
33209102,32976233-ace7-4706-8a39-1c194f847aa6,1632249184,120,1632250220,,0,0,3.97,1056,1116,36,21,,,0,0,0.08,1.13,,571,230,137,167,,,,71.01,43.49,72.15,1,58.94,2880,53,,2.6,0,105,106,,,,,,15,81,13.78,13.67,13.89,1,-4.6,349,349,,1,355,355,,,,,,,,,"3,2,2,6,25,43,16,2,0","0,57,41,1,0","0,0,10,76,14",,,,,139,,,,,,,,,,,,,,,,,,,,,,,,,,,,,,,,,,,,26.3,14,5,67,66,,1029,0,280,0,3,3,"Menden (Sauerland)",1,0,,,"Menden (Sauerland) Running",,,3113,,250,3,7530249546,0,168070,250480,30378,,19586929,,,,,,,,,,,,,,,,,,,,,,,,,,,,,,,,,,,,,,,,5,
33209104,64cdc792-667e-4bcb-a939-a5d719faf705,1632253373,120,1632250223,,0,0,3.25,997,997,5,22,,,0,0,0.13,,0.88,,210,134,142,,,,61.21,36.29,60.93,1,60.03,4946,39,,2.2,0,101,102,,,,,,13,82,11.67,11.86,11.76,-2.5,-3.1,277,277,,1,281,281,,,,,,,,,"5,4,7,33,46,4,0,0,0","1,99,1,0,0","1,2,76,20,0",,,,,119,,,,,,,,,,,,,,,,,,,,,,,,,,,,,,,,,,,,19.5,11,2,3,1,,1030,,,1,4,1,"Menden (Sauerland)",1,0,,,"Menden (Sauerland) Track Running",,,3113,,250,3,7530250017,0,168070,250480,30378,,19586931,,,,,,,,,,,,,,,,,,,,,,,,,,,,,,,,,,,,,,,,,
33209105,82d33e0d-5110-4d0a-b8b5-c44876ad93ec,1632250794,120,1632250224,1632304293,0,0,9.63,2270,2272,9,0,,,0,0,0.02,,,,537,157,181,,,,68.42,52.92,68.58,1,59.94,5376,195,,3.7,2.5,106,103,,,,,,63,85,15.33,15.9,15.99,3.1,0.9,395,395,,1,418,418,,,,,,,,,"7,4,6,4,5,8,34,28,5","0,12,49,39,0","0,2,20,14,64",,,,,150,,,,,,,,,,,,,,,,,,,,,,,,,,,,,,,,,,,,71.8,13,4,70,69,,1029,0,280,0,3,3,"Menden (Sauerland)",1,0,I0.400|1:27-I0.400|1:25-I0.400|1:25-I0.400|1:25-I0.410|2:21-I0.400|1:26-I0.400|1:26-I0.400|1:25-I0.400|1:25-I0.400|2:18-I0.400|1:26-I0.400|1:25-I0.400|1:25-I0.400|1:26-I0.400|2:23-I0.400|1:26-I0.400|1:26-I0.400|1:26-I0.400|1:25-I0.400|2:13-I0.390|1:24-I0.400|1:20-I0.400|1:19-I0.410|1:22-I0.020|0:22,,"Menden (Sauerland) Track Running",,,3113,,250,3,7530249810,0,168070,250480,30378,,19586932,,,,,,,,,,,,,,,,,,,,,,,,,,,,,,,,,,,,,,,,,
33237569,f80f50b7-3afb-4700-9613-75d5749d5d38,1632320409,120,1632324495,,0,0,13.93,4222,4275,320,322,,,4,3.8,0.68,1.02,1.04,598,918,143,169,,,,57.14,40.54,58.75,1,,,,,,,,,,,,,,107,79,12.54,12.26,12.79,-8.3,1.2,297,297,,1,307,307,,,,,,,,,"11,11,13,13,22,23,5,1,0","0,33,65,2,0","0,4,49,43,4",,,,,125,,,,,,,,,,,,,,,,,,,,,,,,,,,,,,,,,,,,33.5,17,7,296,62,,1029,3,273,0,3,3,Balve,1,0,U1.000|4:37-U1.000|4:40-U1.000|5:58-U1.000|5:54-U1.000|5:55-U1.000|6:26-U1.000|5:00-U1.000|4:36-U1.000|4:19-U1.000|4:19-U1.000|4:23-U1.000|5:08-U1.000|4:37-U0.906|4:31,,,,,wahoo_fitness-33,,518,7,,0,168070,250480,30378,,19611715,,,,,,,,,,,,,,,,,,,,,,,,,,,,,,,,,,,,,,,,3,
33270806,012517a8-e299-497f-b54a-75ef5e9e815a,1632379369,120,1632378623,,0,0,14.01,4655,4964,329,329,,,4,3.7,0.66,1.06,1.02,520,1058,150,176,,,,47.8,36.43,49.19,1,,,,,,,,,,,,,,141,80,11.49,11.3,11.68,-2.8,4,266,266,,1,273,273,,,,,,,,,"27,11,12,15,21,12,1,0,0","0,28,40,32,0","0,9,68,23,1",,,,,113,,,,,,,,,,,,,,,,,,,,,,,,,,,,,,,,,,,,62.9,9,9,206,97,,1021,0,279,0,3,3,Balve,1,0,U1.000|5:24-U1.000|5:34-U1.000|7:03-U1.000|7:10-U1.000|6:34-U1.000|6:40-U1.000|5:13-U1.000|4:52-U1.000|4:41-U1.000|4:29-U1.000|4:28-U1.000|5:24-U1.000|4:56-U0.991|5:07,,,,,wahoo_fitness-33,,518,7,,0,168070,250480,30378,,19642433,,,,,,,,,,,,,,,,,,,,,,,,,,,,,,,,,,,,,,,,3,
33330156,20a49f9a-5aba-4aea-be81-5b137cae58fa,1632467330,120,1632496853,,0,0,12.14,3539,3625,39,32,,,0,0,0.08,1.11,,,775,143,159,,,,59.95,41.97,60.23,1,60.17,1873,114,,3.4,0,100,100,,,,,,89,81,12.4,12.39,12.45,1.7,2.2,300,300,,1,303,303,,,,,,,,,"2,1,4,21,60,12,1,0,0","0,22,78,0,0","0,0,48,52,0",,,,,127,,,,,,,,,,,,,,,,,,,,,,,,,,,,,,,,,,,,32.8,12,13,224,95,,1015,0,266,0,3,3,Amsterdam,1,0,,,"Amsterdam Running",,,3113,,250,3,7545926804,0,168070,250480,30378,,19696248,,,,,,,,,,,,,,,,,,,,,,,,,,,,,,,,,,,,,,,,,
33411479,1ce339bb-c833-4c87-8e8a-dfbdba5df8df,1632592824,120,1632667654,,0,0,8.01,2400,2431,22,16,,,0,0,0,,0.95,,518,141,154,,,,59.04,39.47,59.3,1,60.41,1570,81,,3,0,100,101,,,,,,59,80,12.08,12.13,12.19,-4.8,-7.5,292,292,,1,296,296,,,,,,,,,"4,4,11,28,35,15,3,0,0","0,47,53,0,0","0,1,62,37,0",,,,,125,,,,,,,,,,,,,,,,,,,,,,,,,,,,,,,,,,,,29.8,21,6,169,77,,1014,0,279,0,3,3,Amsterdam,1,0,,,"Amsterdam Running",,,3113,,250,3,7557939797,0,168070,250480,30378,,19762318,,,,,,,,,,,,,,,,,,,,,,,,,,,,,,,,,,,,,,,,,
33419923,4b36ec71-3cfd-4745-9b09-5d82c674c431,1632676126,120,1632675151,,0,0,3.6,975,998,48,56,,,0,1.2,0.56,1.01,0.96,,224,145,157,,,,64.45,42.28,65.33,1,60.43,990,54,,2.6,0,101,100,,,,,,23,80,13.54,13.53,13.66,1.8,1.6,330,330,,1,335,335,,,,,,,,,"1,2,6,10,34,33,10,4,0","1,11,88,0,0","0,0,23,75,2",,,,,138,,,,,,,,,,,,,,,,,,,,,,,,,,,,,,,,,,,,28.4,18,10,212,82,,1015,1,280,0,4,3,Altena,1,0,,,"Altena Running",,,3113,,250,3,7558801164,0,168070,250480,30378,,19770212,,,,,,,,,,,,,,,,,,,,,,,,,,,,,,,,,,,,,,,,,
33419925,461c6397-10fb-425e-88d6-e1cc408c236a,1632679814,120,1632675152,,0,0,1.75,576,592,41,10,,,0,0.9,0.42,1.09,1.06,446,122,138,149,109,,,54.07,31.63,56.82,1,60.4,4291,27,,2,0,97,98,,,,7,3,11,80,11.77,10.91,11.99,4.5,10.6,287,287,,1,294,294,,,,,,,,,"13,15,23,31,11,5,2,0,0","0,43,57,0,0","0,6,65,26,3",,,,,114,,,,,,,,,,,,,,,,,,,,,,,,,,,,,,,,,,,,18.8,17,8,207,88,,1015,0,282,0,6,3,Neuenrade,1,0,,,"Neuenrade Running",,,3113,,250,3,7558801460,0,168070,250480,30378,,19770214,,,,,,,,,,,,,,,,,,,,,,,,,,,,,,,,,,,,,,,,5,
33419926,5c889f0f-fe2a-4a04-acae-f74b3b0f588f,1632677400,120,1632675152,1632735178,0,0,10,2303,2303,76,73,,,0,0,0.22,1.04,0.98,,608,166,184,,,,64.75,54.51,65.38,1,60.47,4320,226,,4.4,1.4,105,96,,,,19,4,92,85,15.74,15.67,15.85,7.5,8.2,404,404,,1,408,408,,,,,,,,,"0,0,1,1,4,16,69,9,0","0,5,14,80,1","0,0,0,50,50",,,,,153,,,,,,,,,,,,,,,,,,,,,,,,,,,,,,,,,,,,93.7,16,8,207,88,,1015,0,282,0,6,3,Neuenrade,1,0,U3.289|12:50-U3.267|12:24-U3.287|12:35-U0.161|0:34,,"Neuenrade Running",,,3113,,250,3,7558801346,0,168070,250483,30378,,19770215,,,,,,,,,,,,,,,,,,,,,,10,2303,,,0,"Neuenrade Running",,,,,,,0,0,30378,33419926,,,,
33485958,43cfbe61-6954-40f5-99bb-19e0feb209a6,1632770856,120,1632825830,,0,0,9.94,3144,3166,144,144,,,4,2.3,0.63,1,1.01,788,619,135,162,,,,58.39,37.59,59.44,1,,,,,,,,,,,,,,61,79,11.69,11.6,11.92,-0.4,-5.5,277,277,,1,287,287,,,,,,,,,"12,7,15,30,27,7,1,1,0","1,68,30,1,0","0,1,71,26,2",,,,,120,,,,,,,,,,,,,,,,,,,,,,,,,,,,,,,,,,,,28.8,16,14,220,87,,1017,0,283,1,6,3,Balve,1,0,U1.000|5:33-U1.000|5:07-U1.000|5:29-U1.000|5:14-U1.000|5:04-U1.000|5:40-U1.000|6:05-U1.000|4:54-U1.000|4:34-U0.921|4:45,,,,,wahoo_fitness-33,,518,7,,0,168070,250480,30378,,19828648,,,,,,,,,,,,,,,,,,,,,,,,,,,,,,,,,,,,,,,,5,
33504670,c6a65866-9025-428d-b3b8-54a95a4809af,1632858561,120,1632852002,,0,0,0.66,249,249,14,14,,,4,0,0,1.14,0.83,,48,138,165,,,,45.69,24.26,46.89,1,,,,,,,,,,,,,,5,79,9.59,9.51,9.72,10.4,3.8,220,220,,1,225,225,,,,,,,,,"44,16,23,8,9,0,0,0,0","6,45,42,7,0","0,39,54,7,0",,,,,101,,,,,,,,,,,,,,,,,,,,,,,,,,,,,,,,,,,,14.8,14,3,133,75,,1022,0,287,1,4,3,"Menden (Sauerland)",1,0,,,,,,wahoo_fitness-33,,518,7,,0,168070,250480,30378,,19845698,,,,,,,,,,,,,,,,,,,,,,,,,,,,,,,,,,,,,,,,,
33504674,7b561fea-55d9-4ec6-82f3-c7fd9fce84af,1632856361,120,1632852005,,0,0,7.54,1954,1954,98,92,,,4,1.8,0.87,1.07,0.88,,525,166,191,,,,55.96,46.65,56.92,1,,,,,,,,,,,,,,83,84,14.12,15.19,15.47,5.5,-2.5,359,359,,1,402,402,,,,,,,,,"23,5,3,2,2,3,24,37,2","0,12,14,52,22","8,8,17,15,51",,,,,138,,,,,,,,,,,,,,,,,,,,,,,,,,,,,,,,,,,,100.9,14,3,133,75,,1022,0,287,1,4,3,"Menden (Sauerland)",1,0,U0.400|1:20-U0.100|0:40-U0.400|1:21-U0.200|1:10-U0.400|1:28-U0.400|1:26-U0.400|1:22-U0.400|2:38-U0.400|1:21-U0.100|0:37-U0.400|1:20-U0.200|1:17-U0.400|1:27-U0.400|1:26-U0.400|1:24-U0.200|2:44-U0.400|1:21-U0.100|0:42-U0.400|1:19-U0.200|1:14-U0.400|1:25-U0.400|1:23-U0.400|1:21-U0.039|0:47,,,,,wahoo_fitness-33,,518,7,,0,168070,250480,30378,,19845700,,,,,,,,,,,,,,,,,,,,,,,,,,,,,,,,,,,,,,,,,
33524599,,1632821280,,1632900555,,0,0,6,1620,,,,,,0,,,,,,396,,,,,,,43.85,,1,,,,,,,,,,,,,,40,,,,,,,,,,,,,,,,,,,,,,,,,,,,,,,,,,,,,,,,,,,,,,,,,,,,,,,,,,,,,,,,,,,,,,,,,,1,,,0,0,,,,,,,,,0,,0,168070,250480,30378,,,,,,,,,,,,,,,,,,,,,,,,,,,,,,,,,,,,,,,,,,,
33546197,ca350292-a024-4696-9794-74ff3b036f65,1632936582,120,1632934643,,0,0,15.32,4918,5040,396,386,,,0,4.2,0.86,1.08,1.05,553,1061,148,178,,,,50.81,38.2,52.47,1,59.43,2210,136,,3.6,0.3,98,95,,,,11,3,136,80,11.91,11.66,12.01,9.1,11.6,277,277,,1,283,283,,,,,,,,,"17,15,17,12,19,17,2,0,0","0,27,54,19,0","0,1,70,28,1",,,,,117,,,,,,,,,,,,,,,,,,,,,,,,,,,,,,,,,,,,70.3,10,20,249,82,,1019,0,320,0,3,3,Balve,1,0,,,"Balve Running",,,3113,,250,3,7575263383,0,168070,250480,30378,,19880455,,,,,,,,,,,,,,,,,,,,,,,,,,,,,,,,,,,,,,,,"4,4",
33595756,00ec91e9-d6c1-47f9-8061-9e85edeaf30d,1633030335,120,1633025326,,0,0,6,2100,2109,114,102,,,0,1.9,0.54,1.05,0.93,327,431,141,174,,,,48.74,32.23,50.01,1,58.94,1512,69,,2.8,0,100,97,,,,7,3,49,79,10.68,10.42,10.92,9.8,10,249,249,,1,259,259,,,,,,,,,"18,12,46,18,3,0,0,1,0","1,43,46,10,0","0,18,68,14,0",,,,,108,,,,,,,,,,,,,,,,,,,,,,,,,,,,,,,,,,,,48.2,10,9,187,68,,1025,0,292,1,3,3,Balve,1,0,,,"Balve Running",,,3113,,250,3,7581092176,0,168070,250480,30378,,19925259,,,,,,,,,,,,,,,,,,,,,,,,,,,,,,,,,,,,,,,,"5,5",
33614969,570a2480-40bc-45ec-a381-30f0390c1beb,1633071940,120,1633070396,,0,0,17.89,5389,5408,432,416,,,0,4.3,0.86,1.07,0.97,534,1316,164,200,,,,47.36,41.65,48.82,1,58.04,4861,494,,5,3.4,96,99,,,,13,4,189,82,12.61,12.44,12.89,10.6,14.6,299,299,,1,311,311,,,,,,,,,"10,13,15,17,12,22,11,0,0","0,6,45,24,25","0,2,49,43,6",,,,,121,,,,,,,,,,,,,,,,,,,,,,,,,,,,,,,,,,,,169,7,13,182,72,,1020,0,294,0,3,3,Balve,1,0,,,"Balve Running",,,3113,,250,3,7583231261,0,168070,250480,30378,,19942983,,,,,,,,,,,,,,,,,,,,,,,,,,,,,,,,,,,,,,,,"4,4,5,5",
33695096,d6e618eb-3a6d-4632-ad55-91fa3ae008d6,1633189866,120,1633242939,,0,0,8.62,2637,3155,158,127,,,0,2.2,0.58,1.04,0.98,323,530,138,169,124,,,59.18,38.7,60.78,1,58.89,2160,94,,2.9,1.2,105,100,,,,13,1,42,81,12.25,12.15,12.68,2.3,-6.3,290,290,,1,307,307,,,,,,,,,"10,10,14,24,22,13,7,0,0","0,63,35,2,0","0,7,51,35,7",,,,,121,,,,,,,,,,,,,,,28,,,,,,,,,,,,,,,,,,,,,33.8,15,19,192,77,,1009,1,301,0,4,3,Altena,1,0,U3.564|17:51-U1.617|6:29-U3.437|19:37,,"Altena Running",,,3113,,250,3,7593832082,0,168070,250480,30378,3714901,20015354,435,4,4,37,22,0.07,0.2,0.41,1.46,0.27,1.93,100,0,75,0.5,1245,1,43.1,1,,0,,,,,,,,,,,,,,,,,,,"4,5",
33709656,5cbb76bd-fc9b-4089-bb84-1aefdeb93865,1633270640,120,1633267781,,0,0,9.67,3306,4311,297,282,,,0,3.9,0.81,1.04,0.96,521,675,145,172,,,,48.34,34.23,50.27,1,58.45,1603,95,,3.1,0,98,98,,,,,1,75,80,11.49,11.01,11.65,5.3,-13.5,267,267,,1,284,284,,,,,,,,,"32,11,13,12,24,7,1,0,0","1,24,64,11,0","0,11,67,19,3",,,,,110,,,,,,,,,,,,,,,,,,,,,,,,,,,,,,,,,,,,55.7,17,30,190,76,,1001,2,292,0,4,3,Balve,1,0,U1.000|6:17-U1.000|6:34-U1.000|6:08-U1.000|6:50-U1.000|6:51-U1.000|4:52-U1.000|4:39-U1.000|4:49-U1.000|4:34-U0.669|3:30,,"Balve Running",,,3113,,250,3,7596168694,0,168070,250480,30378,,20027678,,,,,,,,,,,,,,,,,,,,,,,,,,,,,,,,,,,,,,,,"4,5",
33759647,4cb89c70-1943-49d5-a532-c00214aeb98b,1633370429,120,1633369046,,0,0,15.45,4702,4784,338,327,,,0,3.6,0.69,0.97,0.94,436,1079,159,184,132,,,48.99,40.68,50.36,1,58.06,2678,209,,4.2,0,102,98,,,,9,4,172,81,12.44,12.18,12.49,6.8,12.6,294,294,,1,298,298,,,,,,,,,"11,10,11,15,26,23,3,0,0","0,3,49,47,1","0,0,49,50,0",,,,,122,,,,,,,,,,,,,,,,,,,,,,,,,,,,,,,,,,,,100.6,12,10,186,73,,1017,0,304,0,4,3,Balve,1,0,U1.000|5:04-U1.000|4:58-U1.000|5:11-U1.000|5:53-U1.000|6:50-U1.000|5:35-U1.000|5:34-U1.000|4:36-U1.000|5:25-U1.000|5:00-U1.000|4:18-U1.000|4:12-U1.000|4:17-U1.000|4:23-U1.000|4:54-U0.446|2:14,,"Balve Running",,,3113,,250,3,7602610900,0,168070,250480,30378,,20072139,,,,,,,,,,,,,,,,,,,,,,,,,,,,,,,,,,,,,,,,"4,5",
33806002,377cba4b-70f7-40da-ac5e-d7bc8854b49b,1633463145,120,1633456384,,0,0,0.75,307,307,16,15,,,4,1.3,1,1.17,0.98,,55,128,135,,,,45.34,22.37,46.61,1,,,,,,,,,,,,,,5,81,9.18,8.88,9.33,-11,-16.6,206,206,,1,214,214,,,,,,,,,"50,39,11,0,0,0,0,0,0","0,100,0,0,0","1,47,52,0,0",,,,,90,,,,,,,,,,,,,,,,,,,,,,,,,,,,,,,,,,,,7.9,14,19,199,87,,1006,0,295,1,6,3,"Menden (Sauerland)",1,0,,,,,,wahoo_fitness-33,,518,7,,0,168070,250480,30378,,20113185,,,,,,,,,,,,,,,,,,,,,,,,,,,,,,,,,,,,,,,,,
33806004,1af7c25c-2c1a-42c8-bf09-18c8ed896e70,1633458842,120,1633456387,,0,0,4.09,1142,1160,32,37,,,4,0,0.16,1.02,0.8,,268,150,173,,,,59.24,41.17,59.72,1,,,,,,,,,,,,,,34,83,13.09,13.1,13.2,-11.2,-13,319,319,,1,325,325,,,,,,,,,"5,2,3,8,38,38,5,1,0","0,9,66,25,0","0,4,15,79,1",,,,,129,,,,,,,,,,,,,,,,,,,,,,,,,,,,,,,,,,,,42.2,14,19,188,81,,1005,0,291,0,6,3,"Menden (Sauerland)",1,0,U1.000|4:58-U1.000|4:24-U1.000|4:25-U1.000|4:40-U0.080|0:35,,,,,wahoo_fitness-33,,518,7,,0,168070,250480,30378,,20113187,,,,,,,,,,,,,,,,,,,,,,,,,,,,,,,,,,,,,,,,,
33806005,5045372a-c670-430b-8209-ec9502a9a0a0,1633460612,120,1633456387,,0,0,10.02,2477,2477,154,154,,,4,0.6,0.31,1.05,0.83,,634,158,180,,,,63.91,50.18,65.13,1,,,,,,,,,,,,,,91,86,14.78,15.65,15.94,0.5,-0.4,380,377,,1,418,417,,,,,,,,,"17,6,5,5,2,2,13,44,5","0,20,23,57,0","2,12,19,16,51",,,,,141,,,,,,,,,,,,,,,,,,,,,,,,,,,,,,,,,,,,80,13,19,199,87,,1006,0,295,1,6,3,"Menden (Sauerland)",1,0,U0.411|1:23-U0.214|1:09-U0.423|1:19-U0.226|1:17-U0.432|1:22-U0.211|1:16-U0.424|1:21-U0.304|2:31-U0.415|1:28-U0.420|1:25-U0.433|1:27-U0.428|1:27-U0.429|1:25-U0.423|3:12-U0.415|1:23-U0.203|1:08-U0.430|1:23-U0.218|1:22-U0.420|1:21-U0.216|1:18-U0.413|1:19-U0.399|2:45-U0.416|1:27-U0.420|1:26-U0.418|1:27-U0.418|1:29-U0.416|1:25-U0.022|0:04,,,,,wahoo_fitness-33,,518,7,,0,168070,250480,30378,,20113188,,,,,,,,,,,,,,,,,,,,,,,,,,,,,,,,,,,,,,,,,
33852417,b6fbace9-067b-4200-af8f-6d261b1ecdc3,1633535805,120,1633533853,,0,0,15.34,5027,5115,406,398,,,4,4.2,0.76,1.11,1.11,597,1021,138,155,,,,54.36,37.29,56.17,1,,,,,,,,,,,,,,111,81,11.67,11.28,11.99,-7.4,3.3,272,272,,1,284,284,,,,,,,,,"16,15,21,17,19,10,2,0,0","1,53,46,0,0","0,9,62,27,3",,,,,113,,,,,,,,,,,,,,,,,,,,,,,,,,,,,,,,,,,,29.8,11,17,226,82,,1017,1,299,0,6,3,Balve,1,0,U1.000|6:20-U1.000|6:13-U1.000|5:41-U1.000|6:34-U1.000|5:14-U1.000|5:10-U1.000|5:58-U1.000|5:49-U1.000|5:11-U1.000|5:30-U1.000|5:50-U1.000|5:14-U1.000|4:39-U1.000|4:31-U1.000|4:27-U0.321|1:27,,,,,wahoo_fitness-33,,518,7,,0,168070,250480,30378,,20149392,,,,,,,,,,,,,,,,,,,,,,,,,,,,,,,,,,,,,,,,"3,5",
33892942,084fa3b3-4c81-45d3-a7d2-34c621f23efb,1633605766,120,1633618062,,0,0,20.57,18903,19406,555,556,,,4,5.1,0.64,,,202,3943,145,199,,,,,,,1,,,,,,,,,,,,,,500,60,,4.49,,-24.1,,,,,,,,,,,,,,,,"58,32,0,0,0,10","2,37,43,9,9",,,,,,,,,,,,,,,,,,,,,,,,,,,,,,,,,,,,,,,,,,169.9,15,6,20,73,,1028,3,267,0,3,3,Simmerath,1,0,U1.000|19:25-U1.000|17:00-U1.000|19:19-U1.000|12:44-U1.000|13:35-U1.000|29:11-U1.000|13:54-U1.000|15:48-U1.000|14:51-U1.000|14:13-U1.000|15:52-U1.000|11:35-U1.000|12:29-U1.000|16:55-U1.000|11:43-U1.000|11:57-U1.000|12:45-U1.000|12:57-U1.000|18:01-U1.000|13:54-U0.556|7:00,,,,,wahoo_fitness-33,,518,7,,0,168075,,30378,,20185739,,,,,,,,,,,,,,,,,,,,,,,,,,,,,,,,,,,,,,,,"2,4,5,5",
33900878,df8034d7-1276-4d08-a876-546efb05f8d7,1633630823,120,1633627873,,0,0,12.32,4011,4070,333,318,,,0,4.2,0.66,0.96,0.97,620,846,148,181,,,,49.93,36.93,51.68,1,58.66,1728,158,,3.7,0.1,100,102,,,,13,4,106,81,12.03,11.46,12.28,-9,-8.5,279,279,,1,294,294,,,,,,,,,"25,7,9,20,23,13,2,0,0","0,42,30,28,0","2,10,43,45,0",,,,,114,,,,,,,,,,,,,,,,,,,,,,,,,,,,,,,,,,,,80.5,12,5,46,78,,1028,0,263,0,3,3,Heimbach,1,0,U1.000|5:00-U1.000|5:34-U1.000|6:34-U1.000|4:59-U1.000|7:17-U1.000|5:13-U1.000|4:35-U1.000|5:12-U1.000|5:12-U1.000|5:38-U1.000|4:44-U1.000|5:17-U0.317|1:37,,"Heimbach Running",,,3113,,250,3,7619117535,0,168070,250480,30378,,20192953,,,,,,,,,,,,,,,,,,,,,,,,,,,,,,,,,,,,,,,,"4,4,5",
33929455,c9a75dc1-4906-42cf-9156-d7d9ebc3a8f8,1633690664,120,1633701336,,0,0,18.34,17092,17290,417,420,,,0,4.3,0.55,,,199,1507,103,144,113,,,,,,1,58.66,874,32,,2.1,0,,100,,,,,,115,57,,4.42,,-19.6,,,,,,,,,,,,,,,,"69,31,0,0,0,0","35,64,0,0,0",,,,,,,,,,,,,,,,,,,,,,,,,,,,,,,,,,,,,,,,,,12.2,14,11,63,73,,1030,3,255,0,2,3,Kermeter,1,0,U9.481|2:30:19-U1.992|39:28-U6.866|1:35:06,,"Heimbach Hiking",,,3113,,250,3,7623259293,0,168075,,30378,,20217373,,,,,,,,,,,,,,,,,,,,,,,,,,,,,,,,,,,,,,,,"3,4",
33937506,409befd5-a8c2-42ee-b44b-da80060c230b,1633717212,120,1633711734,,0,0,5.03,1577,1615,90,90,,,0,1.4,0.56,1.02,1.03,236,335,143,182,,,,54.8,36.37,56.01,1,58.59,1321,72,,2.8,0,100,99,,,,13,2,36,80,12.04,12.06,12.28,13.9,15.6,282,282,,1,292,292,,,,,,,,,"13,13,19,27,10,7,8,3,0","2,45,44,9,1","0,1,77,18,4",,,,,120,,,,,,,,,,,,,,,,,,,,,,,,,,,,,,,,,,,,49.4,14,8,42,76,,1029,0,253,0,2,3,Heimbach,1,0,U1.000|5:32-U1.000|5:57-U1.000|4:30-U1.000|4:23-U1.000|5:47-U0.025|0:08,,"Heimbach Running",,,3113,,250,3,7624170908,0,168070,250480,30378,,20223804,,,,,,,,,,,,,,,,,,,,,,,,,,,,,,,,,,,,,,,,5,
34007594,59a4dfbb-e928-473a-b9a4-97fd81488af6,1633863774,120,1633866065,,0,0,7.2,1628,1628,156,171,,,0,2.8,0.8,1.14,1.1,520,443,178,185,129,,,59.23,54.61,60.66,1,58.47,3564,236,,4.1,2,99,100,,,,20,5,88,87,16.59,16.36,17.03,10.5,14.2,421,421,,1,438,438,,,,,,,,,"0,1,2,5,12,17,31,21,11","1,1,0,47,51","0,0,1,44,55",,,,,153,,,,,,,,,,,,,,,,,,,,,,,,,,,,,,,,,,,,124.8,12,4,87,63,,1028,2,261,0,3,3,Aachen-Mitte,1,0,U1.000|4:19-U1.000|4:01-U1.000|3:14-U1.000|3:37-U1.000|4:25-U1.000|3:45-U1.000|3:07-U0.204|0:40,,"Aachen Running",,,3113,,250,3,7634014416,0,168070,250480,30378,,20283699,,,,,,,,,,,,,,,,,,,,,,7.5,1628,,,0,"6. ATG Herbstlauf",,,,,,,0,0,30378,34007594,10447,,"4,5",
34007607,2581d254-56a3-4f37-ac00-e504ea479610,1633866578,120,1633866099,,0,0,4.53,1545,1545,103,93,,,0,2.2,0.71,1.07,0.97,371,302,136,153,,,,52.72,32.7,54.34,1,58.61,4343,44,,2.2,0,99,99,,,,7,3,31,80,10.99,10.7,11.84,-7.1,10,260,260,,1,285,285,,,,,,,,,"19,14,24,24,16,3,0,0,0","0,67,33,0,0","0,15,68,13,4",,,,,110,,,,,,,,,,,,,,,,,,,,,,,,,,,,,,,,,,,,21,13,4,357,59,,1028,2,261,0,3,3,Aachen-Mitte,1,0,U1.000|5:48-U1.000|6:16-U1.000|5:59-U1.000|5:11-U0.530|2:32,,"Aachen Running",,,3113,,250,3,7634016835,0,168070,250480,30378,,20283712,,,,,,,,,,,,,,,,,,,,,,,,,,,,,,,,,,,,,,,,4,
34007649,a49a16ab-fb46-47cc-98ad-c3720dc6dfc5,1633861144,120,1633866164,,0,0,4.65,1453,2085,106,42,,,0,1.9,0.56,1.09,0.97,513,319,145,175,139,,,54.01,36.35,56.46,1,58.65,932,60,,2.5,0,104,100,,,,7,3,32,80,12.21,11.61,12.64,1.8,-1.9,302,302,,1,315,315,,,,,,,,,"4,6,15,40,28,6,0,0,0","1,33,57,9,0","0,2,48,45,5",,,,,120,,,,,,,,,,,,,,,,,,,,,,,,,,,,,,,,,,,,42.3,10,4,140,69,,1028,1,261,0,3,3,Aachen-Mitte,1,0,U1.000|5:25-U1.000|5:13-U1.000|4:51-U1.000|5:05-U0.648|3:38,,"Aachen Running",,,3113,,250,3,7634011834,0,168070,250480,30378,,20283739,,,,,,,,,,,,,,,,,,,,,,,,,,,,,,,,,,,,,,,,4,
34063899,,1633978989,120,1633971877,,0,0,11,3900,3900,,,,,0,,,,,,774,,,,,,,33.11,,1,,,,,,,,,,,,,,90,,,,,,,,,,,,,,,,,,,,,,,,,,,,,,,,,,,,,,,,,,,,,,,,,,,,,,,,,,,,,,,,,,,,,,,,,,1,,,0,0,,,Running,,,connect,,,3,7640972291,0,168070,250480,30378,,20333556,,,,,,,,,,,,,,,,,,,,,,,,,,,,,,,,,,,,,,,,,
34112934,87549f81-ce1c-434f-831c-55e73aa2053a,1634063744,120,1634063707,,0,0,4.06,1090,1090,23,36,,,0,0,0.11,,0.92,,254,152,179,105,,,61.03,43.09,61.22,1,59.42,1164,71,,2.8,0,104,100,,,,7,3,33,81,13.38,13.51,13.41,1.6,1.9,328,328,,1,330,330,,,,,,,,,"1,2,1,6,26,60,4,0,0","1,14,54,32,0","0,0,14,86,0",,,,,138,,,,,,,,,,,,,,,,,,,,,,,,,,,,,,,,,,,,56.6,9,9,328,84,,1020,0,310,1,3,3,"Menden (Sauerland)",1,0,U1.000|4:34-U1.000|4:24-U1.000|4:22-U1.000|4:28-U0.060|0:22,,"Menden (Sauerland) Running",,,3113,,250,3,7646981381,0,168070,250480,30378,,20375873,,,,,,,,,,,,,,,,,,,,,,,,,,,,,,,,,,,,,,,,,
34112989,35a3e482-d389-4b05-95e3-50b96d6b17c3,1634065352,120,1634063807,,0,0,7.09,1828,1828,0,0,,,0,0,0,,,,416,153,172,,,,63.57,46.76,63.57,1,59.77,2016,130,,3.1,2,104,116,,,,,,56,85,13.95,15.33,15.33,-1.8,-9.1,355,355,,1,401,401,,,,,,,,,"18,4,11,7,4,5,13,30,8","0,15,55,31,0","4,8,29,10,50",,,,,137,,,,,,,,,,,,,,,,,,,,,,,,,,,,,,,,,,,,52.2,9,8,326,85,,1020,0,312,1,3,3,"Menden (Sauerland)",1,0,U0.990|3:22-U0.710|4:05-U1.000|3:20-U0.500|3:05-U1.010|3:21-U0.400|2:28-U0.990|3:27-U0.310|1:57-U1.010|3:20-U0.170|2:02,,"Menden (Sauerland) Track Running",,,3113,,250,3,7646990740,0,168070,250480,30378,,20375921,,,,,,,,,,,,,,,,,,,,,,,,,,,,,,,,,,,,,,,,,
34112996,3b46836a-8d6e-4764-98be-2cc8771f2b1b,1634067323,120,1634063826,,0,0,4.02,1150,1150,1,28,,,0,0,0.05,,0.91,,283,166,191,144,,,49.54,39.97,49.15,1,59.65,3240,123,,3,1.9,97,96,,,,7,3,48,82,12.43,12.71,12.58,4.7,3.2,299,299,,1,306,306,,,,,,,,,"2,4,6,12,44,31,1,0,0","0,7,21,55,17","0,5,27,67,0",,,,,128,,,,,,,,,,,,,,,,,,,,,,,,,,,,,,,,,,,,98.5,9,8,326,85,,1020,0,312,1,3,3,"Menden (Sauerland)",1,0,U1.000|5:02-U1.000|4:40-U1.000|4:34-U1.000|4:46-U0.018|0:08,,"Menden (Sauerland) Running",,,3113,,250,3,7646992162,0,168070,250480,30378,,20375928,,,,,,,,,,,,,,,,,,,,,,,,,,,,,,,,,,,,,,,,,
34155010,ab13397d-2c97-4408-a015-e99b3deb6bb1,1634149401,120,1634147436,,0,0,13.22,3849,3989,326,308,,,0,4.2,0.76,1,1.04,559,830,146,162,111,,,58.39,42.31,60.27,1,59.89,2304,122,,3.3,0.2,103,100,,,,11,4,94,81,13.33,13.16,13.45,-9.1,-8.5,316,316,,1,325,325,,,,,,,,,"19,5,5,9,17,25,17,3,0","0,15,84,0,0","0,0,38,58,4",,,,,127,,,,,,,,,,,,,,,,,,,,,,,,,,,,,,,,,,,,34.2,9,8,270,88,,1026,0,287,1,3,3,Balve,1,0,U1.000|4:50-U1.000|5:06-U1.000|6:52-U1.000|6:49-U1.000|4:23-U1.000|6:06-U1.000|4:37-U1.000|4:02-U1.000|4:08-U1.000|3:53-U1.000|3:36-U0.994|4:13-U1.000|4:34-U0.220|1:00,,"Balve Running",,,3113,,250,3,7652067659,0,168070,250480,30378,,20413417,,,,,,,,,,,,,,,,,,,,,,,,,,,,,,,,,,,,,,,,"3,4,5",
34191916,11810c84-87b4-4ebe-90e2-91c1186a9c06,1634235400,120,1634231995,,0,0,10.73,3333,3457,336,309,,,0,4.1,0.87,1.23,1.13,596,750,142,177,,,,55.95,38.61,58.29,1,60.01,2016,192,,3.6,2.1,102,102,,,,17,3,86,81,12.41,12,13.43,-9.1,-13.7,299,299,,1,341,341,,,,,,,,,"18,4,11,21,20,11,13,2,0","0,48,24,27,0","1,24,31,22,22",,,,,119,,,,,,,,,,,,,,,,,,,,,,,,,,,,,,,,,,,,65.7,11,12,238,86,,1023,0,285,1,4,3,Balve,1,0,U0.856|4:48-U0.106|0:31-U0.070|0:31-U0.125|0:34-U0.067|0:30-U0.124|0:31-U0.071|0:31-U0.129|0:31-U0.078|0:33-U0.133|0:31-U0.066|0:31-U0.132|0:32-U0.080|0:31-U0.140|0:31-U0.076|0:32-U0.131|0:32-U0.074|0:31-U0.133|0:31-U0.084|0:33-U0.143|0:31-U0.057|0:31-U0.135|0:31-U0.055|0:32-U0.132|0:32-U0.055|0:31-U0.131|0:31-U0.050|0:32-U0.124|0:32-U0.048|0:32-U0.128|0:33-U0.056|0:32-U0.142|0:32-U0.074|0:33-U0.159|0:31-U0.102|0:32-U0.151|0:32-U0.046|0:32-U0.117|0:34-U0.048|0:32-U0.101|0:31-U0.041|0:33-U0.111|0:32-U0.039|0:30-U0.132|0:32-U1.000|5:39-U1.000|5:06-U1.000|4:55-U0.767|3:42-U1.000|3:50-U0.906|4:49,,"Balve Running",,,3113,,250,3,7657122071,0,168070,250480,30378,,20445950,,,,,,,,,,,,,,,,,,,,,,,,,,,,,,,,,,,,,,,,"3,5",
34217182,c619542f-38e3-41e1-bd83-d904a11a262a,1634304325,120,1634301748,,0,0,14.17,4446,4588,345,325,,,0,3.9,0.79,1.07,1.05,522,920,144,171,,,,54.24,38.99,55.97,1,59.55,1730,138,,3.3,1.4,102,97,,,,13,2,104,81,12.16,11.97,12.61,-7.1,-12.9,286,286,,1,307,307,,,,,,,,,"18,12,11,15,20,20,4,0,0","0,26,68,7,0","1,4,64,25,6",,,,,118,,,,,,,,,,,,,,,,,,,,,,,,,,,,,,,,,,,,43,10,12,312,94,,1019,2,288,0,4,3,Balve,1,0,U1.000|4:53-U1.000|5:06-U1.000|6:31-U1.000|6:27-U1.000|6:16-U1.000|6:24-U1.000|4:54-U1.000|4:28-U1.000|4:15-U1.000|4:24-U1.000|4:52-U0.777|3:41-U1.000|4:00-U0.035|0:09-U1.000|5:56-U0.353|1:50,,"Balve Running",,,3113,,250,3,7660853751,0,168070,250480,30378,,20468215,,,,,,,,,,,,,,,,,,,,,,,,,,,,,,,,,,,,,,,,"4,5",
34252807,0dc4d10f-3f56-431d-9c35-0d7971841847,1634389216,120,1634387989,1634542532,0,0,14.44,3954,3959,586,554,,,4,6.4,0.9,1.07,1.1,677,1002,166,185,,,,52.29,45.74,55.06,1,59.1,4016,310,,4.7,2,104,97,,,,19,3,161,83,14.91,14.09,15.41,6.3,5.4,356,356,,1,373,373,,,,,,,,,"16,6,11,11,8,9,22,16,1","0,4,27,68,1","0,1,20,56,24",,,,,132,,,,,,,,,,,,,,,,,,,,,,,,,,,,,,,,,,,,88,12,4,285,74,,1023,2,277,0,3,3,"Menden (Sauerland)",1,0,U1.000|5:11-U1.000|4:41-U1.000|3:41-U1.000|4:27-U1.000|4:18-U1.000|5:36-U1.000|4:35-U1.000|3:33-U1.000|4:59-U1.000|4:18-U1.000|6:00-U1.000|3:59-U1.000|3:34-U1.000|5:01-U0.443|2:00,,"Menden (Sauerland) Running",,,3113,,250,3,7666108365,0,168070,250480,30378,,20497422,,,,,,,,,,,,,,,,,,,,,,,,,,,,,,,,,,,,,,,,"3,3,4,4",
34323309,edca760b-bc14-4fe2-99d8-05e66f7936ef,1634489755,120,1634542450,,0,0,11.11,3561,3703,353,352,,,4,4.4,0.78,1.05,1.08,574,768,143,168,,,,53.33,37.31,55.43,1,,,,,,,,,,,,,,78,81,12.21,11.66,12.59,-7.7,8.5,284,284,,1,298,298,,,,,,,,,"19,11,16,13,17,22,1,0,0","0,35,62,3,0","0,7,53,35,4",,,,,116,,,,,,,,,,,,,,,,,,,,,,,,,,,,,,,,,,,,28.6,12,6,230,69,,1020,0,282,0,4,3,Balve,1,0,U1.000|5:52-U1.000|6:13-U1.000|5:51-U1.000|6:27-U1.000|6:12-U1.000|5:42-U1.000|4:43-U1.000|4:19-U1.000|4:21-U1.000|4:35-U1.000|4:39-U0.096|0:28,,,,,wahoo_fitness-33,,518,7,,0,168070,250480,30378,,20556943,,,,,,,,,,,,,,,,,,,,,,,,,,,,,,,,,,,,,,,,"3,5",
34385274,8c241a34-db0c-4d00-901b-37979a6c75d9,1634672435,120,1634670404,,0,0,3.35,1033,1033,11,25,,,4,0,0.1,1.12,0.82,,234,146,166,,,,54.39,36.15,54.33,1,,,,,,,,,,,,,,19,82,11.62,11.76,11.75,-1.2,-3.2,276,276,,1,282,282,,,,,,,,,"5,5,12,34,34,7,2,0,0","0,16,81,3,0","0,7,66,27,0",,,,,119,,,,,,,,,,,,,,,,,,,,,,,,,,,,,,,,,,,,20.2,15,16,198,88,,1017,0,262,1,4,3,"Menden (Sauerland)",1,0,U1.000|5:30-U1.000|5:01-U1.000|4:55-U0.342|1:46-U0.008|0:02,,,,,wahoo_fitness-33,,518,7,,0,168070,250480,30378,,20611938,,,,,,,,,,,,,,,,,,,,,,,,,,,,,,,,,,,,,,,,,
34385276,edce9f8b-ce57-48af-8d12-d0109e17631d,1634670172,120,1634670405,,0,0,6.99,1992,1992,89,89,,,4,1.7,0.65,1.16,0.95,,503,160,200,,,,52.63,41.52,53.46,1,,,,,,,,,,,,,,66,83,12.85,14.82,15.03,25.6,7.9,334,324,,1,396,393,,,,,,,,,"33,2,2,3,2,3,10,27,18","0,19,30,32,19","14,17,14,7,47",,,,,127,,,,,,,,,,,,,,,,,,,,,,,,,,,,,,,,,,,,78.3,15,15,198,88,,1017,0,262,1,4,3,"Menden (Sauerland)",1,0,U1.200|4:01-U0.400|2:27-U0.400|1:20-U0.200|0:36-U0.173|1:22-U0.400|1:16-U0.200|0:37-U0.200|1:29-U0.400|1:20-U0.200|0:38-U0.345|3:31-U0.300|0:55-U0.100|1:04-U0.300|0:54-U0.100|1:06-U0.300|0:55-U0.100|1:11-U0.300|0:53-U0.136|3:10-U0.800|2:49-U0.400|1:19-U0.031|0:19,,,,,wahoo_fitness-33,,518,7,,0,168070,250480,30378,,20611940,,,,,,,,,,,,,,,,,,,,,,,,,,,,,,,,,,,,,,,,,
34385277,00c810a2-bdea-4558-8395-6c1cea796bb1,1634669723,120,1634670406,,0,0,1.08,310,310,22,13,,,4,0.6,0.44,1.64,0.86,,69,147,170,,,,58.87,34.98,60.97,1,,,,,,,,,,,,,,6,77,12.99,13.88,15.16,20.8,10.6,345,345,,1,411,411,,,,,,,,,"45,2,1,3,4,5,5,6,29","1,33,46,20,0","11,24,12,12,40",,,,,136,,,,,,,,,,,,,,,,,,,,,,,,,,,,,,,,,,,,11.7,16,17,202,90,,1017,0,263,1,4,3,"Menden (Sauerland)",1,0,U1.000|4:46-U0.075|0:24,,,,,wahoo_fitness-33,,518,7,,0,168070,250480,30378,,20611941,,,,,,,,,,,,,,,,,,,,,,,,,,,,,,,,,,,,,,,,,
34385278,4ab402e9-8bd5-4af4-9621-e1a9e611ff7f,1634668544,120,1634670409,,0,0,3.45,884,884,24,24,,,4,0,0.12,0.99,0.68,,100,104,127,,,,,44.94,,1,,,,,,,,,,,,,,3,83,14.22,14.27,14.42,-17.8,-24.2,356,356,,1,364,364,,,,,,,,,"3,2,1,6,14,41,28,4,0","50,50,0,0,0","0,2,11,70,16",,,,,141,,,,,,,,,,,,,,,,,,,,,,,,,,,,,,,,,,,,1.5,15,16,202,90,,1017,0,263,1,4,3,"Menden (Sauerland)",1,0,U1.000|4:34-U1.000|4:07-U1.000|4:01-U0.441|2:02,,,,,wahoo_fitness-33,,518,7,,0,168070,250480,30378,,20611942,,,,,,,,,,,,,,,,,,,,,,,,,,,,,,,,,,,,,,,,,
34447275,,1634719800,,1634799045,,0,0,15,4800,,,,,,0,,,,,,1173,,,,,,,38.27,,1,,,,,,,,,,,,,,77,,,,,,,,,,,,,,,,,,,,,,,,,,,,,,,,,,,,,,,,,,,,,,,,,,,,,,,,,,,,,,,,,,,,,,,,,,1,,,0,0,,,,,,,,,0,,0,168070,250480,30378,,,,,,,,,,,,,,,,,,,,,,,,,,,,,,,,,,,,,,,,,,,
34467708,82a9cea9-3a8f-4dbb-a2da-8d05854f0089,1634838053,120,1634836399,,0,0,13.46,3994,4898,146,131,,,0,1.2,0.33,1.04,0.91,760,929,160,183,114,,,50.07,41.44,50.81,1,58.98,2275,185,,3.8,1.2,96,99,,,,11,2,134,81,12.35,12.4,12.61,-14.4,-21.8,297,297,,1,308,308,,,,,,,,,"3,5,9,30,38,8,6,1,0","0,5,43,50,2","0,2,65,28,6",,,,,125,,,,,,,,,,,,,,,,,,,,,,,,,,,,,,,,,,,,83.1,7,19,266,96,,1007,0,313,0,6,3,Balve,1,0,U1.000|5:30-U1.000|4:49-U1.000|5:17-U1.000|5:04-U1.000|5:20-U1.000|5:08-U1.000|4:49-U1.000|4:44-U1.000|5:10-U1.000|4:59-U1.000|4:21-U1.000|3:55-U1.000|4:53-U0.457|2:36,,"Balve Running",,,3113,,250,3,7694447437,0,168070,250480,30378,,20686500,,,,,,,,,,,,,,,,,,,,,,,,,,,,,,,,,,,,,,,,4,
34537411,1f3b3536-16a4-4b73-b842-b93c3a92bfea,1635004779,120,1635001126,,0,0,7.06,2339,2382,245,242,,,4,3.8,0.83,1.07,0.95,583,575,155,177,,,,45.79,34.76,47.78,1,,,,,,,,,,,,,,55,80,12.13,11.69,12.32,6.7,21.5,276,276,,1,287,287,,,,,,,,,"27,5,13,15,16,20,4,0,0","1,13,48,39,0","0,10,58,28,3",,,,,113,,,,,,,,,,,,,,,,,,,,,,,,,,,,,,,,,,,,66.3,11,5,254,71,,1028,1,274,0,3,3,Balve,1,0,U1.000|5:34-U1.000|5:48-U1.000|7:08-U1.000|7:04-U1.000|4:31-U1.000|4:15-U1.000|4:24-U0.051|0:15,,,,,wahoo_fitness-33,,518,7,,0,168070,250480,30378,,20747001,,,,,,,,,,,,,,,,,,,,,,,,,,,,,,,,,,,,,,,,3,
34537412,74daf977-0d80-4f27-be30-6746d891091c,1634905752,120,1635001126,,0,0,15.72,5784,6121,380,379,,,4,4,0.71,1.23,0.91,528,1392,154,185,,,,40.6,32.6,41.82,1,,,,,,,,,,,,,,138,81,10.38,10.4,11.32,18.6,19.8,240,239,,1,273,273,,,,,,,,,"29,16,21,16,9,5,1,0,1","3,13,34,50,1","9,17,52,18,4",,,,,101,,,,,,,,,,,,,,,,,,,,,,,,,,,,,,,,,,,,52,9,28,252,86,,1014,2,294,0,6,3,Balve,1,0,U1.000|5:49-U1.000|6:18-U1.000|5:49-U1.000|6:43-U1.000|5:31-U1.000|4:56-U1.000|5:39-U1.000|5:55-U1.000|5:16-U1.000|5:27-U1.000|8:06-U1.000|8:24-U1.000|6:25-U1.000|6:11-U1.000|5:52-U0.699|4:04,,,,,wahoo_fitness-33,,518,7,,0,168070,250480,30378,,20747002,,,,,,,,,,,,,,,,,,,,,,,,,,,,,,,,,,,,,,,,"3,5,5",
34546287,,1634590140,,1635014994,,0,0,13,4800,,,,,,0,,,,,,1173,,,,,,,31.98,,1,,,,,,,,,,,,,,77,,,,,,,,,,,,,,,,,,,,,,,,,,,,,,,,,,,,,,,,,,,,,,,,,,,,,,,,,,,,,,,,,,,,,,,,,,1,,,0,0,,,,,,,,,0,,0,168070,250480,30378,,,,,,,,,,,,,,,,,,,,,,,,,,,,,,,,,,,,,,,,,,,
34563707,94fda065-cf16-43b6-a062-5e204654ccdc,1635069058,120,1635067901,,0,0,13.64,4038,4164,327,324,,,0,3.6,0.68,1.08,1.07,530,1022,167,200,94,,,47.05,41.59,48.46,1,58.41,4940,420,,5,3,102,97,,,,7,3,170,83,12.89,12.44,13.02,-1,5.2,306,306,,1,315,315,,,,,,,,,"5,7,16,16,24,30,3,0,0","0,13,20,41,26","0,4,35,60,1",,,,,122,,,,,,,,,,,,,,,,,,,,,,,,,,,,,,,,,,,,174.4,6,12,153,86,,1026,1,261,0,2,3,Balve,1,0,U1.000|5:42-U1.000|5:58-U1.000|5:31-U1.000|5:32-U1.000|5:11-U1.000|4:36-U1.000|4:30-U1.000|5:09-U1.000|4:48-U1.000|4:28-U1.000|4:36-U1.000|4:21-U1.000|4:14-U0.638|2:43,,"Balve Running",,,3113,,250,3,7707526121,0,168070,250480,30378,,20770720,,,,,,,,,,,,,,,,,,,,,,,,,,,,,,,,,,,,,,,,"4,5",
34626547,5a62dff4-14a0-4aa7-ad5b-6beb2ff48f40,1635164757,120,1635162975,,0,0,12.4,3303,3398,125,124,,,4,0.9,0.34,0.96,1,425,770,150,175,,,,62.79,46.69,63.58,1,,,,,,,,,,,,,,99,84,13.73,13.68,13.83,-2.4,-2.4,340,339,,1,344,344,,,,,,,,,"2,1,5,8,18,49,15,2,0","0,11,84,5,0","0,0,12,83,4",,,,,134,,,,,,,,,,,,,,,,,,,,,,,,,,,,,,,,,,,,43.4,12,13,201,62,,1020,2,257,0,3,3,Balve,1,0,U1.000|5:20-U1.000|4:08-U1.000|4:30-U1.000|4:26-U1.000|4:28-U1.000|4:18-U1.000|4:05-U1.000|4:05-U1.000|4:13-U1.000|4:17-U1.000|4:50-U1.000|4:49-U0.379|1:35,,,,,wahoo_fitness-33,,518,7,,0,168070,250480,30378,,20822565,,,,,,,,,,,,,,,,,,,,,,,,,,,,,,,,,,,,,,,,5,
34685553,6dd1c179-8740-4e1d-a74f-dd55995ec9de,1635277177,120,1635276137,,0,0,1.23,630,665,13,12,,,4,0,0.02,1.59,1.22,,104,123,139,,,,35.99,18.09,36.5,1,,,,,,,,,,,,,,10,73,7.08,7.98,8.16,-45.1,-37.1,159,157,,1,188,188,,,,,,,,,"59,19,22,0,0,0,0,0,0","1,99,0,0,0","33,30,37,0,0",,,,,80,,,,,,,,,,,,,,,,,,,,,,,,,,,,,,,,,,,,12.7,11,10,214,1,,1022,,,1,4,1,"Menden (Sauerland)",1,0,U1.000|9:07-U0.229|1:23,,,,,wahoo_fitness-33,,518,7,,0,168070,250480,30378,,20873338,,,,,,,,,,,,,,,,,,,,,,,,,,,,,,,,,,,,,,,,,
34685558,14fa78c5-e9f3-48eb-9bf2-10e41347459d,1635273002,120,1635276138,,0,0,4.57,1314,1398,24,28,,,4,0,0.16,1.15,0.93,,276,139,157,,,,63.29,40.06,63.64,1,,,,,,,,,,,,,,31,81,12.58,12.84,12.95,1.3,0.7,308,308,,1,320,320,,,,,,,,,"9,3,4,13,31,25,12,2,0","6,21,73,0,0","2,9,24,60,5",,,,,129,,,,,,,,,,,,,,,,,,,,,,,,,,,,,,,,,,,,33.1,12,16,227,76,,1022,0,259,1,4,3,"Menden (Sauerland)",1,0,U1.000|5:30-U1.000|4:36-U1.000|4:41-U1.000|4:22-U0.562|2:45,,,,,wahoo_fitness-33,,518,7,,0,168070,250480,30378,,20873344,,,,,,,,,,,,,,,,,,,,,,,,,,,,,,,,,,,,,,,,,
34685559,efe6cef0-fd8e-4376-a9be-9909767dde85,1635274828,120,1635276139,,0,0,6.62,2226,2226,66,68,,,4,0.7,0.42,1.14,0.86,,514,149,180,,,,47.54,34.02,48.11,1,,,,,,,,,,,,,,72,76,10.83,13.66,14.03,8.7,-3.2,274,271,,1,366,365,,,,,,,,,"38,0,1,1,5,10,20,23,1","0,36,9,55,0","33,8,4,19,36",,,,,117,,,,,,,,,,,,,,,,,,,,,,,,,,,,,,,,,,,,65.9,11,10,214,1,,1022,,,1,4,1,"Menden (Sauerland)",1,0,U1.000|4:16-U0.171|0:40-U0.190|3:12-U1.000|3:40-U0.230|0:45-U0.183|3:12-U1.000|3:50-U0.208|0:47-U0.178|3:01-U1.000|3:38-U0.128|0:26-U0.117|3:53-U1.000|3:42-U0.164|0:34-U0.035|1:30,,,,,wahoo_fitness-33,,518,7,,0,168070,250480,30378,,20873345,,,,,,,,,,,,,,,,,,,,,,,,,,,,,,,,,,,,,,,,,
34718618,edccfa14-057d-45d4-8c8f-b4e790f87afa,1635359650,120,1635353707,,0,0,2.84,1029,1154,58,58,,,4,2,0.78,1,1.13,358,174,125,139,,,,54.2,29.52,55.57,1,,,,,,,,,,,,,,17,78,10.33,10.22,10.47,-13,-1.7,236,236,,1,242,242,,,,,,,,,"34,22,14,20,9,2,0,0,0","0,100,0,0,0","0,16,79,5,0",,,,,106,,,,,,,,,,,,,,,,,,,,,,,,,,,,,,,,,,,,14.8,12,9,185,81,,1023,0,247,1,3,3,Balve,1,0,U1.000|6:16-U1.000|6:34-U0.835|4:19,,,,,wahoo_fitness-33,,518,7,,0,168070,250480,30378,,20902111,,,,,,,,,,,,,,,,,,,,,,,,,,,,,,,,,,,,,,,,4,
34718621,627b9549-42ae-44bf-a292-3793bb488612,1635357484,120,1635353710,,0,0,5.76,1671,1749,0,0,,,4,0,0,,,,398,151,178,,,,55.98,40.19,55.98,1,,,,,,,,,,,,,,55,80,12.39,14.25,14.29,21.3,-5.4,328,315,,1,374,369,,,,,,,,,"24,0,0,1,3,21,39,9,3","6,17,26,51,0","21,3,2,38,36",,,,,129,,,,,,,,,,,,,,,,,,,,,,,,,,,,,,,,,,,,66.5,13,11,202,73,,1023,0,247,0,3,3,Balve,1,0,U0.300|1:43-U0.400|1:32-U0.400|1:39-U0.400|1:29-U0.400|1:38-U0.400|1:27-U0.400|1:40-U0.400|1:29-U0.400|1:40-U0.400|1:28-U0.400|1:40-U0.400|1:30-U0.100|3:58-U0.400|1:13-U0.100|1:58-U0.400|1:16-U0.034|0:32,,,,,wahoo_fitness-33,,518,7,,0,168070,250480,30378,,20902114,,,,,,,,,,,,,,,,,,,,,,,,,,,,,,,,,,,,,,,,,
34776271,5086094d-6a6a-4e80-9422-66ce76adf1a4,1635443131,120,1635440531,,0,0,14.56,4369,4421,145,153,,,0,0.9,0.37,1,0.97,536,894,137,156,,,,61.17,41.16,61.88,1,58.84,1338,114,,3.3,0,99,102,,,,11,3,66,80,12.13,12.13,12.28,-3.2,-7.2,291,291,,1,297,297,,,,,,,,,"3,4,7,34,39,11,1,0,0","0,72,28,0,0","0,0,66,33,0",,,,,125,,,,,,,,,,,,,,,,,,,,,,,,,,,,,,,,,,,,23.2,10,12,167,74,,1017,0,259,1,2,3,Balve,1,0,U1.000|5:18-U1.000|4:36-U1.000|5:27-U1.000|5:20-U1.000|5:07-U1.000|5:09-U1.000|4:51-U1.000|5:00-U1.000|5:01-U1.000|5:11-U1.000|4:51-U1.000|4:13-U1.000|4:41-U1.000|4:47-U0.555|3:16,,"Balve Running",,,3113,,250,3,7730932014,0,168070,250480,30378,,20947480,,,,,,,,,,,,,,,,,,,,,,,,,,,,,,,,,,,,,,,,5,
34824733,19d00f9d-33c1-4f0d-9d91-6305b0b9ff39,1635529530,120,1635526241,,0,0,10.93,3555,3773,356,356,,,4,4.4,0.78,1.03,1.02,582,706,135,161,,,,56.42,36.63,58.69,1,,,,,,,,,,,,,,66,80,12,11.44,12.47,-3.6,8.9,279,279,,1,296,296,,,,,,,,,"20,14,15,13,22,13,3,0,0","1,59,39,0,0","0,14,48,34,4",,,,,115,,,,,,,,,,,,,,,,,,,,,,,,,,,,,,,,,,,,27,13,18,181,69,,1009,0,270,1,3,3,Balve,1,0,U1.000|5:57-U1.000|6:16-U1.000|5:49-U1.000|6:29-U1.000|5:56-U1.000|5:20-U1.000|4:37-U1.000|4:22-U1.000|4:42-U1.000|4:59-U0.912|4:48,,,,,wahoo_fitness-33,,518,7,,0,168070,250480,30378,,20984327,,,,,,,,,,,,,,,,,,,,,,,,,,,,,,,,,,,,,,,,"3,5",
34846277,65ce308d-096a-4e6d-b34d-ea762e7baa7d,1635589665,120,1635586300,,0,0,12.23,3677,3709,230,232,,,4,2.3,0.57,1.13,0.99,437,846,149,171,,,,54.57,40.51,55.83,1,,,,,,,,,,,,,,98,81,12.35,12.06,12.62,3.3,2.5,296,296,,1,307,307,,,,,,,,,"3,4,14,28,36,14,2,0,0","0,19,71,10,0","0,6,50,38,5",,,,,123,,,,,,,,,,,,,,,,,,,,,,,,,,,,,,,,,,,,40.1,12,17,182,74,,1007,1,290,0,4,3,Balve,1,0,U1.000|4:42-U1.000|5:23-U1.000|5:15-U1.000|4:43-U1.000|5:27-U1.000|5:04-U1.000|4:51-U1.000|4:46-U1.000|4:49-U1.000|4:52-U1.000|5:02-U1.000|5:16-U0.219|1:08,,,,,wahoo_fitness-33,,518,7,,0,168070,250480,30378,,21001920,,,,,,,,,,,,,,,,,,,,,,,,,,,,,,,,,,,,,,,,4,
34895560,02176224-a3c8-4b09-9a7c-6b0e72e965cb,1635676493,60,1635682192,,0,0,25.12,8316,8316,535,521,,,0,4.5,0.68,0.95,0.94,457,1685,138,166,,,,53.68,38.27,55.13,1,58.94,3194,221,,4.4,0.3,102,100,,,,18,2,138,80,11.44,11.43,11.97,2,2.7,269,269,,1,287,287,,,,,,,,,"21,9,12,19,25,10,4,0,0","4,43,52,1,0","5,8,52,32,2",,,,,113,,,,,,,,,,,,,,,27,,,,,,,,,,,,,,,,,,,,,33.3,14,19,176,82,,1006,1,287,0,4,3,Balve,1,0,U1.000|5:05-U1.000|4:55-U1.000|5:21-U1.000|6:27-U1.000|6:21-U1.000|6:02-U1.000|5:16-U1.000|4:37-U1.000|5:10-U1.000|5:00-U1.000|5:21-U1.000|5:06-U1.000|4:54-U1.000|5:52-U1.000|5:48-U1.000|6:26-U1.000|6:22-U1.000|5:24-U1.000|8:01-U1.000|6:23-U1.000|5:36-U1.000|4:49-U1.000|4:22-U1.000|4:10-U1.000|5:25-U0.123|0:24,,"Balve Running",,,3113,,250,3,7744975015,0,168070,250480,30378,3862940,21044844,433,2,2,54,28,0.02,0.17,1.32,1.48,1,2.05,100,0,83,1.4,1021,0,35.4,0,245,0,,,,,,,,,,,,,,,,,,,"3,4,5",
34947724,0862a09b-3d61-4211-9c9b-e546fe04314f,1635768026,60,1635770199,,0,0,12.2,3570,3734,224,225,,,4,2.5,0.69,1.1,1,500,813,147,167,,,,57.49,41.8,58.79,1,,,,,,,,,,,,,,89,81,12.72,12.42,12.99,0.1,0.7,306,306,,1,318,318,,,,,,,,,"2,5,11,23,32,21,5,1,0","0,15,81,4,0","0,4,46,42,8",,,,,127,,,,,,,,,,,,,,,,,,,,,,,,,,,,,,,,,,,,29.8,11,23,218,84,,1001,1,308,0,3,3,Balve,1,0,U1.000|4:44-U1.000|5:16-U1.000|4:43-U1.000|4:37-U1.000|5:30-U1.000|4:42-U1.000|4:40-U1.000|4:38-U1.000|4:35-U1.000|4:48-U1.000|4:56-U1.000|5:24-U0.183|0:58,,,,,wahoo_fitness-33,,518,7,,0,168070,250480,30378,,21090295,,,,,,,,,,,,,,,,,,,,,,,,,,,,,,,,,,,,,,,,4,
35013409,81a97c54-258e-47b1-b144-5a306fcc95fb,1635883138,60,1635880215,,0,0,1.16,440,440,23,22,,,4,1.5,1,1.12,0.91,,106,158,170,,,,37.66,25.68,38.63,1,,,,,,,,,,,,,,15,80,9.78,9.63,10.04,-0.4,-6.8,225,225,,1,234,234,,,,,,,,,"28,33,37,3,0,0,0,0,0","0,7,25,67,0","0,35,59,6,0",,,,,99,,,,,,,,,,,,,,,,,,,,,,,,,,,,,,,,,,,,33.8,7,8,196,91,,1001,,,1,4,1,"Menden (Sauerland)",1,0,U1.000|6:22-U0.160|0:58,,,,,wahoo_fitness-33,,518,7,,0,168070,250480,30378,,21150968,,,,,,,,,,,,,,,,,,,,,,,,,,,,,,,,,,,,,,,,,
35013413,5cf5cf9f-875a-4930-a417-f9bfc8c38697,1635878361,60,1635880218,,0,0,11.99,4197,4451,146,146,,,4,0.8,0.29,1.04,0.86,270,893,143,213,,,,47.84,33.84,48.55,1,,,,,,,,,,,,,,108,77,10.47,12.41,12.66,24.7,-15.7,268,256,,1,328,324,,,,,,,,,"41,1,3,4,12,11,3,13,10","5,40,31,19,5","30,12,13,26,19",,,,,111,,,,,,,,,,,,,,,,,,,,,,,,,,,,,,,,,,,,59.5,8,12,195,90,,1001,0,318,1,4,3,"Menden (Sauerland)",1,0,U1.000|5:01-U1.000|4:29-U1.000|4:36-U1.000|4:35-U0.516|3:09-U0.618|5:01-U0.348|1:07-U0.122|1:33-U0.353|1:07-U0.105|1:28-U0.351|1:06-U0.113|1:30-U0.347|1:06-U0.100|1:35-U0.346|1:08-U0.111|1:35-U0.357|1:08-U0.107|1:29-U0.351|1:07-U0.114|1:31-U0.346|1:07-U0.112|1:31-U0.362|1:08-U0.107|1:37-U0.341|1:10-U0.109|1:31-U0.345|1:07-U0.104|1:30-U0.339|1:08-U0.310|6:25-U0.309|0:52-U0.107|1:31-U0.307|0:56-U0.100|1:32-U0.297|0:56-U0.027|0:36,,,,,wahoo_fitness-33,,518,7,,0,168070,250480,30378,,21150972,,,,,,,,,,,,,,,,,,,,,,,,,,,,,,,,,,,,,,,,5,
35046237,459d425d-0387-4c6d-8adb-8e013d071b1b,1635947937,60,1635949724,,0,0,15.04,4992,5303,454,443,,,4,4.7,0.81,1.11,1.13,481,923,130,154,,,,57.64,36.68,59.85,1,,,,,,,,,,,,,,80,81,11.68,11.27,12,-8.3,0,270,270,,1,281,281,,,,,,,,,"24,15,14,15,17,13,2,0,0","1,82,16,0,0","0,9,64,24,3",,,,,112,,,,,,,,,,,,,,,,,,,,,,,,,,,,,,,,,,,,21,6,7,72,87,,1001,0,319,0,6,3,Balve,1,0,U1.000|6:43-U1.000|5:40-U1.000|6:02-U1.000|6:28-U1.000|6:02-U1.000|5:26-U1.000|5:56-U1.000|4:56-U1.000|5:23-U1.000|6:33-U1.000|5:48-U1.000|4:46-U1.000|4:29-U1.000|4:27-U1.000|4:28-U0.020|0:06,,,,,wahoo_fitness-33,,518,7,,0,168070,250480,30378,,21181446,,,,,,,,,,,,,,,,,,,,,,,,,,,,,,,,,,,,,,,,"3,4,5",
35146672,49435d04-2a53-444e-a755-224e290310f5,1636132433,60,1636180949,,0,0,8.62,2982,3238,82,84,,,4,1.1,0.42,1.2,1.05,399,543,129,166,,,,55.29,33.47,55.92,1,,,,,,,,,,,,,,50,75,10.58,12.01,12.13,34.3,16.1,261,253,,1,300,298,,,,,,,,,"30,3,7,16,16,12,9,4,2","15,48,34,2,0","23,4,28,40,6",,,,,116,,,,,,,,,,,,,,,,,,,,,,,,,,,,,,,,,,,,29.5,7,8,249,91,,1025,0,314,1,3,3,Balve,1,0,U1.000|4:57-U1.000|5:02-U1.000|4:06-U1.000|4:16-U1.000|4:22-U0.257|1:11-U1.000|5:11-U0.975|5:18-U0.183|0:48-U0.146|2:10-U0.320|2:56-U0.303|2:47-U0.417|6:38,,,,,wahoo_fitness-33,,518,7,,0,168070,250480,30378,,21268734,,,,,,,,,,,,,,,,,,,,,,,,,,,,,,,,,,,,,,,,5,
35173278,6b6345fa-629e-4314-b429-e52e882f667d,1636211948,60,1636227284,,0,0,2.09,672,672,9,6,,,4,0,0.19,1.12,0.93,,144,142,152,,,,53.62,33.08,54,1,,,,,,,,,,,,,,15,82,11.31,11.25,11.39,-1.2,-4,270,270,,1,272,272,,,,,,,,,"2,8,22,39,28,0,0,0,0","1,23,76,0,0","0,1,80,19,0",,,,,114,,,,,,,,,,,,,,,,,,,,,,,,,,,,,,,,,,,,18.9,10,18,221,72,,1025,0,267,0,4,3,Altstadt,1,0,U1.000|5:24-U1.000|5:20-U0.086|0:28,,,,,wahoo_fitness-33,,518,7,,0,168070,250480,30378,,21291682,,,,,,,,,,,,,,,,,,,,,,,,,,,,,,,,,,,,,,,,,
35173280,fac07acb-bd2b-4ed6-b9e6-a71dda624a77,1636209902,60,1636227288,,0,0,6.74,1575,1575,0,1,,,4,0,0,,,,475,176,194,,,,57.94,52.33,57.93,1,,,,,,,,,,,,,,80,87,15.41,15.46,15.5,4,4.2,395,395,,1,398,398,,,,,,,,,"0,0,2,5,9,18,44,21,0","0,1,1,77,21","0,0,2,45,53",,,,,148,,,,,,,,,,,,,,,,,,,,,,,,,,,,,,,,,,,,112.8,10,18,221,72,,1025,0,267,0,4,3,Altstadt,1,0,U1.000|3:53-U1.000|3:54-U1.000|3:51-U1.000|3:53-U1.000|3:59-U1.000|3:58-U0.731|2:47,,,,,wahoo_fitness-33,,518,7,,0,168070,250480,30378,,21291684,,,,,,,,,,,,,,,,,,,,,,,,,,,,,,,,,,,,,,,,,
35214980,bb20db5a-3ac3-4ade-8b90-d6daa00d2e3f,1636288829,60,1636317543,,0,0,12.77,4217,4505,379,376,,,0,4.4,0.9,1.11,1.01,505,953,158,186,123,,,44.71,36.42,46.36,1,57.85,4235,244,,4.4,2.3,95,98,,,,9,1,146,80,11.73,11.42,11.96,13.9,22.5,269,269,,1,279,279,,,,,,,,,"26,12,10,11,23,16,1,0,0","0,7,51,36,7","0,5,72,22,1",,,,,114,,,,,,,,,,,,,,,,,,,,,,,,,,,,,,,,,,,,110.6,8,20,276,91,,1016,1,287,0,6,3,Balve,1,0,U1.000|6:15-U1.000|6:29-U1.000|6:52-U1.000|5:41-U1.000|5:28-U1.000|5:22-U1.000|4:45-U1.000|4:47-U1.000|6:43-U1.000|5:31-U1.000|4:35-U1.000|4:29-U0.772|3:19,,"Balve Running",,,3113,,250,3,7784067182,0,168070,250480,30378,,21328268,,,,,,,,,,,,,,,,,,,,,,,,,,,,,,,,,,,,,,,,"3,4",
35234368,b034129b-50a4-40f6-9c3f-b570651cc9b7,1636379448,60,1636380538,,0,0,14.03,3824,3824,187,192,,,0,2,0.55,1.08,1,876,898,158,182,,,,56.65,45.89,57.56,1,57.9,4320,232,,4.4,0.9,101,102,,,,13,4,137,80,13.44,13.34,13.69,6.1,6,330,330,,1,340,340,,,,,,,,,"0,2,4,10,33,44,7,1,0","0,8,48,43,1","0,0,25,69,6",,,,,138,,,,,,,,,,,,,,,,,,,,,,,,,,,,,,,,,,,,93.6,9,10,267,81,,1023,1,289,0,3,3,Balve,1,0,U1.000|4:58-U1.000|4:25-U1.000|4:47-U1.000|4:41-U1.000|4:45-U1.000|4:44-U1.000|4:19-U1.000|4:23-U1.000|4:28-U1.000|4:20-U1.000|4:22-U1.000|4:55-U1.000|3:51-U1.000|4:39-U0.028|0:07,,"Balve Running",,,3113,,250,3,7786930467,0,168070,250480,30378,,21345079,,,,,,,,,,,,,,,,,,,,,,,,,,,,,,,,,,,,,,,,"5,5",
35289472,acca8137-3f14-47c4-97a7-d27d7e1a5cce,1636482735,60,1636487187,,0,0,12.92,3886,4603,113,92,,,0,0,0.17,1.25,0.64,514,826,151,202,,,,53.54,40.66,54.23,1,57.99,5088,302,,4,3.5,102,100,,,,19,4,120,81,12.15,12.96,13.29,5.9,-7.7,297,297,,1,333,333,,,,,,,,,"26,3,6,15,19,13,4,5,10","8,12,46,17,17","7,14,31,32,15",,,,,123,,,,,,,,,,,,,,,,,,,,,,,,,,,,,,,,,,,,123.7,5,6,162,86,,1027,0,286,1,3,3,"Menden (Sauerland)",1,0,U1.000|5:19-U1.000|4:33-U1.000|4:24-U1.000|4:21-U0.094|0:38-U0.409|2:07-U0.204|1:58-U0.202|0:32-U0.111|0:54-U0.200|0:34-U0.106|0:52-U0.307|0:53-U0.108|0:49-U0.408|1:15-U0.397|3:17-U0.016|0:07-U0.194|0:32-U0.105|0:50-U0.303|0:53-U0.105|0:51-U0.411|1:15-U0.410|3:38-U0.200|0:36-U0.118|0:55-U0.206|0:35-U0.106|0:48-U0.310|0:55-U0.105|0:49-U0.417|1:14-U1.000|6:19-U1.000|4:59-U1.000|5:10-U0.366|1:55,,"Menden (Sauerland) Running",,,3113,,250,3,7793915544,0,168070,250480,30378,,21393258,,,,,,,,,,,,,,,,,,,,,,,,,,,,,,,,,,,,,,,,5,
35358371,71770ad4-2169-44ed-99a7-03e6e672bbf3,1636547789,60,1636581708,,0,0,13.72,4285,4310,326,329,,,4,3.7,0.71,1.05,1.06,558,893,140,173,,,,56.62,39.1,58.27,1,,,,,,,,,,,,,,103,80,12.2,11.9,12.39,-10,-0.9,286,286,,1,294,294,,,,,,,,,"15,12,13,14,22,20,3,0,0","0,53,43,4,0","0,4,60,33,3",,,,,120,,,,,,,,,,,,,,,,,,,,,,,,,,,,,,,,,,,,37,9,2,215,63,,1025,1,286,0,3,3,Balve,1,0,U1.000|4:44-U1.000|5:10-U1.000|6:26-U1.000|6:05-U1.000|6:22-U1.000|5:50-U1.000|4:57-U1.000|4:28-U1.000|4:28-U1.000|4:20-U1.000|4:30-U1.000|5:31-U1.000|4:47-U0.690|3:47,,,,,wahoo_fitness-33,,518,7,,0,168070,250480,30378,,21455638,,,,,,,,,,,,,,,,,,,,,,,,,,,,,,,,,,,,,,,,3,
35376814,610be40b-93d0-4f57-a07b-f704c0a74394,1636635252,60,1636636717,,0,0,14.29,4686,4838,330,329,,,4,3.6,0.68,1.07,1.03,544,1053,147,181,,,,49.95,37.05,51.38,1,,,,,,,,,,,,,,135,80,11.58,11.35,11.81,3.3,12.2,270,270,,1,279,279,,,,,,,,,"22,12,13,17,22,12,2,0,0","0,30,56,14,0","0,9,67,22,2",,,,,114,,,,,,,,,,,,,,,,,,,,,,,,,,,,,,,,,,,,55.4,10,3,210,66,,1025,1,280,0,3,3,Balve,1,0,U1.000|4:45-U1.000|4:54-U1.000|6:33-U1.000|6:38-U0.465|2:52-U0.224|1:15-U0.099|0:25-U0.093|0:57-U0.078|0:20-U1.000|7:04-U1.000|5:24-U1.000|4:50-U1.000|4:48-U1.000|4:35-U1.000|4:54-U1.000|5:11-U1.000|6:06-U1.000|5:04-U0.308|1:32,,,,,wahoo_fitness-33,,518,7,,0,168070,250480,30378,,21471993,,,,,,,,,,,,,,,,,,,,,,,,,,,,,,,,,,,,,,,,3,
35431337,6d8cf759-9f60-473f-a9a0-47273812aa15,1636737026,60,1636736152,,0,0,7.91,2527,2651,60,59,,,4,0.7,0.31,1.02,1.15,436,527,143,195,,,,53.54,36.56,54.05,1,,,,,,,,,,,,,,66,78,11.4,11.9,12.08,20.3,8.2,274,274,,1,295,295,,,,,,,,,"20,8,15,14,21,13,3,4,2","1,50,33,14,1","7,9,46,34,5",,,,,120,,,,,,,,,,,,,,,,,,,,,,,,,,,,,,,,,,,,46.7,6,9,183,79,,1016,0,284,1,3,3,Balve,1,0,U1.000|5:02-U1.000|5:03-U1.000|4:34-U1.000|4:34-U0.876|3:51-U1.000|6:04-U0.801|4:48-U1.000|6:00-U0.214|2:11,,,,,wahoo_fitness-33,,518,7,,0,168070,250480,30378,,21520723,,,,,,,,,,,,,,,,,,,,,,,,,,,,,,,,,,,,,,,,5,
35466185,6c5f4a2d-5ef2-46ba-a217-f3394591fca1,1636813636,60,1636810856,,0,0,0.84,247,247,12,12,,,4,0.1,0.28,0.85,0.77,,64,165,183,,,,48.34,33.12,49.19,1,,,,,,,,,,,,,,11,89,12.72,13.14,13.61,27.9,28.1,310,310,,1,339,339,,,,,,,,,"15,4,12,17,8,17,21,6,0","3,7,14,72,4","4,8,11,67,9",,,,,115,,,,,,,,,,,,,,,,,,,,,,,,,,,,,,,,,,,,37.5,7,10,180,85,,1013,0,308,0,6,3,Breckerfeld,1,0,,,,,,wahoo_fitness-33,,518,7,,0,168070,250480,30378,,21552550,,,,,,,,,,,,,,,,,,,,,,,,,,,,,,,,,,,,,,,,,
35466187,7fb486de-a490-4703-b60c-02cd8cc66bcc,1636810470,60,1636810858,,0,0,4.47,2225,2920,69,67,,,4,0.8,0.5,1.38,1.29,123,491,145,176,,,,30.32,20.56,30.93,1,,,,,,,,,,,,,,64,74,7.49,9.06,9.26,39.5,18.4,188,169,,1,221,215,,,,,,,,,"54,7,9,15,11,3,0,0,0","2,40,28,31,0","28,25,40,7,0",,,,,81,,,,,,,,,,,,,,,,,,,,,,,,,,,,,,,,,,,,52,8,11,180,85,,1013,1,308,0,6,3,Breckerfeld,1,0,U1.000|6:18-U1.000|6:09-U1.000|6:34-U1.000|8:53-U0.463|9:11,,,,,wahoo_fitness-33,,518,7,,0,168070,250480,30378,,21552553,,,,,,,,,,,,,,,,,,,,,,,,,,,,,,,,,,,,,,,,5,
35499468,f1433c89-04e4-461e-ad82-655e7a6df3fa,1636814432,60,1636887124,,0,0,0.7,336,336,16,16,,,4,0,0.13,1.35,0.97,,67,135,158,,,,34.87,18.38,35.86,1,,,,,,,,,,,,,,7,79,7.6,7.81,8.21,-3.1,-0.3,172,169,,1,186,185,,,,,,,,,"97,3,0,0,0,0,0,0,0","2,58,40,0,0","10,52,38,0,0",,,,,79,,,,,,,,,,,,,,,,,,,,,,,,,,,,,,,,,,,,13.4,7,10,180,85,,1013,0,308,0,6,3,Breckerfeld,1,0,,,,,,wahoo_fitness-33,,518,7,,0,168070,250480,30378,,21582737,,,,,,,,,,,,,,,,,,,,,,,,,,,,,,,,,,,,,,,,,
35514390,df7f81a5-7e5c-4920-872f-a4dba4725e13,1636901215,60,1636903006,,0,0,8.1,2732,2934,256,256,,,4,3.9,0.85,0.99,1.04,562,607,147,169,,,,48.25,34.34,50.14,1,,,,,,,,,,,,,,77,80,11.76,11.36,11.96,-11.6,-1.5,267,267,,1,277,277,,,,,,,,,"28,11,9,11,23,16,1,0,0","0,35,52,13,0","0,11,65,21,2",,,,,111,,,,,,,,,,,,,,,,,,,,,,,,,,,,,,,,,,,,41.8,9,10,58,79,,1023,0,292,0,3,3,Balve,1,0,U1.000|6:11-U1.000|6:01-U1.000|7:26-U1.000|6:50-U1.000|4:50-U1.000|4:38-U1.000|4:37-U1.000|4:33-U0.090|0:27,,,,,wahoo_fitness-33,,518,7,,0,168070,250480,30378,,21594813,,,,,,,,,,,,,,,,,,,,,,,,,,,,,,,,,,,,,,,,3,
35553000,3407a504-7b91-4b73-ac09-13bd64d1bbdb,1636886342,60,1636982100,,0,0,15.14,3800,3849,263,255,,,4,1.6,0.43,1.21,0.9,351,980,163,189,,,,59.87,50.79,61.19,1,,,,,,,,,,,,,,145,82,14.6,14.44,14.92,1.6,-2,367,367,,1,378,378,,,,,,,,,"1,1,2,5,16,41,29,6,0","0,10,23,64,3","0,1,17,53,30",,,,,146,,,,,,,,,,,,,,,,,,,,,,,,,,,,,,,,,,,,89,8,6,59,86,,1022,1,297,0,3,3,Sundern,1,0,U1.000|4:26-U1.000|4:26-U1.000|4:15-U1.000|4:08-U1.000|4:11-U1.000|4:06-U1.000|4:12-U1.000|4:19-U1.000|4:21-U1.000|4:16-U1.000|4:17-U1.000|4:23-U1.000|3:45-U1.000|4:06-U1.000|3:41-U0.104|0:29,,,,,wahoo_fitness-33,,518,1,,0,168070,250480,30378,,21625682,,,,,,,,,,,,,,,,,,,,,,,,,,,,,,,,,,,,,,,,5,
35553028,,1636985760,,1636982214,,0,0,15.5,4980,,,,,,0,,,,,,1217,,,,,,,38.2,,1,,,,,,,,,,,,,,107,,,,,,,,,,,,,,,,,,,,,,,,,,,,,,,,,,,,,,,,,,,,,,,,,,,,,,,,,,,,,,,,,,,,,,,,,,1,,,0,0,,,,,,,,,0,,0,168070,250480,30378,,,,,,,,,,,,,,,,,,,,,,,,,,,,,,,,,,,,,,,,,,,
35618495,aac6bb0b-157f-4b52-b48b-71552abfb27d,1637091716,60,1637092792,,0,0,3.31,1061,1061,9,22,,,4,0,0.15,1.07,0.88,,219,138,151,,,,55.86,34.51,55.78,1,,,,,,,,,,,,,,20,80,11.2,11.32,11.29,0.5,-1.8,264,264,,1,268,268,,,,,,,,,"4,7,23,41,21,4,0,0,0","0,66,34,0,0","0,5,82,12,0",,,,,117,,,,,,,,,,,,,,,,,,,,,,,,,,,,,,,,,,,,18.6,4,5,243,80,,1022,0,285,1,3,3,"Menden (Sauerland)",1,0,U1.000|5:25-U1.000|5:08-U1.000|5:19-U0.308|1:49,,,,,wahoo_fitness-33,,518,7,,0,168070,250480,30378,,21680501,,,,,,,,,,,,,,,,,,,,,,,,,,,,,,,,,,,,,,,,,
35618496,a86ecb86-bcb1-45cf-92bd-ba678b4328a9,1637089191,60,1637092793,,0,0,8.33,2335,2384,113,118,,,4,0,0.2,1.06,0.82,,584,156,193,,,,55.75,42.8,56.64,1,,,,,,,,,,,,,,79,81,12.98,14.57,14.74,15.9,2.4,326,326,,1,381,381,,,,,,,,,"27,3,3,2,2,9,24,27,3","0,27,17,51,5","13,12,12,18,45",,,,,132,,,,,,,,,,,,,,,,,,,,,,,,,,,,,,,,,,,,68.7,4,5,243,80,,1022,0,285,1,3,3,"Menden (Sauerland)",1,0,U1.000|3:36-U0.200|1:15-U1.000|3:29-U0.200|1:42-U1.000|3:31-U0.200|1:46-U1.000|3:39-U0.200|1:37-U1.000|3:55-U0.100|2:28-U0.400|1:24-U0.400|3:47-U0.400|1:21-U0.200|1:36-U1.000|3:23-U0.024|0:27,,,,,wahoo_fitness-33,,518,7,,0,168070,250480,30378,,21680502,,,,,,,,,,,,,,,,,,,,,,,,,,,,,,,,,,,,,,,,,
35618497,13660c68-aa59-4003-b950-b611a47ab9da,1637087632,60,1637092793,,0,0,4.15,1198,1198,36,37,,,4,0,0.17,1.15,0.89,,263,146,175,,,,59.01,39.63,59.62,1,,,,,,,,,,,,,,29,81,12.66,12.64,12.75,-6.6,-10,308,308,,1,311,311,,,,,,,,,"5,2,6,18,37,25,7,0,0","1,29,55,15,0","0,2,37,59,2",,,,,128,,,,,,,,,,,,,,,,,,,,,,,,,,,,,,,,,,,,37.5,5,5,233,79,,1022,0,285,1,3,3,"Menden (Sauerland)",1,0,U1.000|4:45-U1.000|4:35-U1.000|4:48-U1.000|4:52-U0.152|0:58,,,,,wahoo_fitness-33,,518,7,,0,168070,250480,30378,,21680503,,,,,,,,,,,,,,,,,,,,,,,,,,,,,,,,,,,,,,,,,
35675872,e121a359-394c-49a9-a105-3b822fb390ba,1637154992,60,1637222549,,0,0,7.41,2554,2632,108,108,,,4,1.5,0.49,1.12,0.97,382,615,156,178,,,,43.2,33.27,43.98,1,,,,,,,,,,,,,,79,79,10.69,10.57,10.91,-6.7,-13.7,249,249,,1,258,258,,,,,,,,,"20,13,22,32,10,2,0,0,0","2,2,64,32,0","0,8,83,7,1",,,,,110,,,,,,,,,,,,,,,,,,,,,,,,,,,,,,,,,,,,48.5,6,12,227,86,,1022,1,281,0,4,3,Balve,1,0,U1.000|6:19-U1.000|5:31-U1.000|5:52-U1.000|5:46-U1.000|5:25-U1.000|6:15-U1.000|5:25-U0.394|2:02,,,,,wahoo_fitness-33,,518,7,,0,168070,250480,30378,,21729720,,,,,,,,,,,,,,,,,,,,,,,,,,,,,,,,,,,,,,,,5,
35686617,27ad9de7-2c8e-4457-9e39-746bd040561e,1637239465,60,1637240471,,0,0,14.12,4265,4470,125,126,,,4,0.6,0.3,0.96,0.95,,972,150,176,,,,53.76,40.74,54.34,1,,,,,,,,,,,,,,119,80,12.05,12.13,12.23,-9.1,-14.2,292,290,,1,297,297,,,,,,,,,"4,4,11,23,37,16,3,0,1","1,26,38,35,0","1,1,55,43,0",,,,,124,,,,,,,,,,,,,,,,,,,,,,,,,,,,,,,,,,,,61.5,8,14,239,83,,1029,1,283,0,4,3,Balve,1,0,U1.000|5:36-U1.000|4:55-U1.000|5:21-U1.000|5:08-U1.000|5:17-U1.000|5:12-U1.000|4:50-U1.000|4:45-U1.000|4:59-U1.000|5:36-U1.000|4:45-U1.000|4:33-U1.000|4:26-U1.000|5:16-U0.090|0:28,,,,,wahoo_fitness-33,,518,7,,0,168070,250480,30378,,21739833,,,,,,,,,,,,,,,,,,,,,,,,,,,,,,,,,,,,,,,,,
35745364,84b98e2f-e7ba-4e1d-88ce-65558e3a6920,1637346757,60,1637348195,,0,0,10,2694,2794,1,1,,,4,0,0,,,,582,143,161,,,,66.09,45.38,66.1,1,,,,,,,,,,,,,,62,80,13.37,13.44,13.47,2.9,2.3,331,331,,1,335,335,,,,,,,,,"1,0,1,8,34,48,8,0,0","1,21,77,0,0","0,0,17,82,1",,,,,139,,,,,,,,,,,,,,,,,,,,,,,,,,,,,,,,,,,,27.3,10,12,265,90,,1029,0,280,1,4,3,Balve,1,0,U0.400|2:06-U0.400|2:01-U0.400|1:58-U0.400|1:57-U0.400|1:46-U0.400|1:44-U0.800|3:27-U0.400|1:46-U0.400|1:45-U0.800|3:32-U0.400|1:47-U0.400|1:49-U0.400|1:48-U0.400|1:48-U0.400|1:47-U0.400|1:48-U0.400|1:49-U0.400|1:51-U0.400|1:37-U0.400|1:39-U0.400|1:40-U0.400|1:43-U0.400|1:47,,,,,wahoo_fitness-33,,518,7,,0,168070,250480,30378,,21787600,,,,,,,,,,,,,,,,,,,,,,,,,,,,,,,,,,,,,,,,,
35768531,0448af78-8732-4bcb-9d43-0a0c8b90b4d4,1637405219,60,1637408837,,0,0,15.12,4165,4277,227,229,,,4,1.6,0.49,1.18,0.89,,1007,153,179,,,,58.58,45.59,59.66,1,,,,,,,,,,,,,,127,82,13.26,13.81,14.26,4.6,1.8,329,329,,1,365,365,,,,,,,,,"6,8,13,15,16,10,21,11,0","0,28,31,40,0","1,9,37,27,26",,,,,133,,,,,,,,,,,,,,,,,,,,,,,,,,,,,,,,,,,,63.4,9,12,238,81,,1026,1,283,0,4,3,Sundern,1,0,U1.000|5:15-U1.000|4:41-U0.897|4:22-U1.000|3:32-U1.000|3:43-U0.487|2:49-U1.000|3:47-U1.000|3:46-U0.455|2:56-U1.000|3:32-U1.000|3:42-U0.436|2:46-U0.529|1:53-U0.539|2:39-U0.500|1:55-U1.000|5:36-U1.000|5:31-U1.000|5:35-U0.248|1:27,,,,,wahoo_fitness-33,,518,7,,0,168070,250480,30378,,21808969,,,,,,,,,,,,,,,,,,,,,,,,,,,,,,,,,,,,,,,,,
35812044,444b8c7a-e0a1-4a6d-8aa9-b8bd452353ac,1637485119,60,1637500673,,0,0,18.04,5733,6031,445,427,,,0,4.2,0.82,1.08,0.96,474,1308,159,186,120,,,46.44,39.16,47.92,1,57.42,5760,268,,5,1,97,98,,,,11,4,201,81,11.98,11.58,12.15,10.9,15.6,281,281,,1,290,290,,,,,,,,,"9,12,23,19,23,13,1,0,0","0,5,48,46,1","0,6,52,41,0",,,,,117,,,,,,,,,,,,,,,,,,,,,,,,,,,,,,,,,,,,83.7,6,11,251,100,,1012,0,299,0,6,3,Balve,1,0,U1.000|5:42-U1.000|6:11-U1.000|5:43-U1.000|5:41-U1.000|5:33-U1.000|5:51-U1.000|5:10-U1.000|5:39-U1.000|4:53-U1.000|5:01-U1.000|6:07-U1.000|5:17-U1.000|5:23-U1.000|4:45-U1.000|4:36-U1.000|4:27-U1.000|4:28-U1.000|4:54-U0.040|0:13,,"Balve Running",,,3113,,250,3,7852529537,0,168070,250480,30378,,21846720,,,,,,,,,,,,,,,,,,,,,,,,,,,,,,,,,,,,,,,,"4,4,5",
35853140,5ba3778c-3e9a-4fb8-98cb-443960f0cd4e,1637582587,60,1637583755,,0,0,15.38,4745,4745,434,434,,,4,4.6,0.83,1.1,1.06,540,1077,148,202,,,,53.36,40.02,55.22,1,,,,,,,,,,,,,,116,81,12.56,12.42,12.94,6.9,8.4,295,295,,1,308,307,,,,,,,,,"15,12,18,12,10,22,8,2,0","1,20,65,10,3","1,3,51,39,5",,,,,120,,,,,,,,,,,,,,,,,,,,,,,,,,,,,,,,,,,,51.8,5,13,40,86,,1027,1,324,0,3,3,Balve,1,0,U1.000|5:48-U1.000|6:08-U1.000|5:45-U1.000|6:22-U1.000|4:49-U1.000|4:18-U1.000|4:15-U1.000|5:00-U1.000|6:41-U1.000|5:29-U1.000|5:24-U1.000|4:34-U1.000|4:10-U1.000|4:09-U1.000|3:40-U0.346|2:33,,,,,wahoo_fitness-33,,518,7,,0,168070,250480,30378,,21883404,,,,,,,,,,,,,,,,,,,,,,,,,,,,,,,,,,,,,,,,"3,4",
35916208,431763a0-00ea-43da-983e-13877d916efe,1637694518,60,1637694872,,0,0,7.62,2202,2202,103,103,,,4,1.3,0.52,0.81,0.77,,512,155,198,,,,54.2,41.06,55.1,1,,,,,,,,,,,,,,65,83,12.76,14.58,14.7,3.9,-8.5,333,317,,1,386,381,,,,,,,,,"31,6,7,4,5,5,10,18,15","0,32,21,36,10","12,18,16,17,38",,,,,125,,,,,,,,,,,,,,,,,,,,,,,,,,,,,,,,,,,,64,4,4,237,87,,1029,0,309,1,3,3,"Menden (Sauerland)",1,0,U0.400|1:20-U0.200|0:57-U0.300|0:56-U0.100|0:31-U0.300|0:57-U0.100|0:31-U0.200|0:35-U0.400|3:24-U0.400|1:21-U0.200|1:07-U0.300|0:55-U0.100|0:35-U0.300|0:55-U0.100|0:33-U0.200|0:35-U0.400|3:41-U0.400|1:18-U0.200|1:17-U0.300|0:54-U0.100|0:34-U0.300|0:54-U0.100|0:34-U0.200|0:38-U0.400|3:34-U0.400|1:21-U0.200|1:07-U0.300|0:54-U0.100|0:32-U0.300|0:54-U0.100|0:34-U0.200|0:37-U0.023|2:07,,,,,wahoo_fitness-33,,518,7,,0,168070,250480,30378,,21940748,,,,,,,,,,,,,,,,,,,,,,,,,,,,,,,,,,,,,,,,,
35916216,07a15a4f-743d-414e-b90e-2ceb90115c5a,1637692611,60,1637694875,,0,0,4.06,1069,1069,27,26,,,4,0,0.1,1.04,0.74,,262,161,172,,,,57.49,44.08,57.98,1,,,,,,,,,,,,,,32,81,13.82,13.86,13.99,-14.3,-18,345,345,,1,351,351,,,,,,,,,"3,1,2,7,19,44,20,3,0","0,1,37,62,0","1,2,8,77,12",,,,,141,,,,,,,,,,,,,,,,,,,,,,,,,,,,,,,,,,,,38.7,3,4,237,87,,1029,0,309,1,3,3,"Menden (Sauerland)",1,0,U1.000|4:43-U1.000|4:25-U1.000|4:10-U1.000|4:11-U0.051|0:20,,,,,wahoo_fitness-33,,518,7,,0,168070,250480,30378,,21940757,,,,,,,,,,,,,,,,,,,,,,,,,,,,,,,,,,,,,,,,,
35916490,8235419a-748f-44b4-94f4-4bfa34018454,1637697050,60,1637694989,,0,0,2.94,921,921,19,20,,,4,0,0,1.12,1,,227,156,201,,,,48.61,35.14,48.98,1,,,,,,,,,,,,,,26,81,11.53,11.55,11.63,7.9,5.2,276,276,,1,279,279,,,,,,,,,"4,5,18,43,24,6,1,0,0","0,14,46,38,2","0,0,76,24,0",,,,,118,,,,,,,,,,,,,,,,,,,,,,,,,,,,,,,,,,,,40.3,4,4,225,86,,1029,0,309,1,3,3,"Menden (Sauerland)",1,0,U1.000|5:21-U1.000|5:12-U0.939|4:49,,,,,wahoo_fitness-33,,518,7,,0,168070,250480,30378,,21941011,,,,,,,,,,,,,,,,,,,,,,,,,,,,,,,,,,,,,,,,,
35953775,7c5dacf2-ce5f-44d5-bed2-6979ef763b19,1637761593,60,1637780235,,0,0,7.34,2389,2412,110,110,,,4,1.6,0.55,1.03,1.01,355,452,133,147,,,,57.43,35.59,58.49,1,,,,,,,,,,,,,,30,79,11.33,11.16,11.42,-0.1,-2.1,267,267,,1,271,271,,,,,,,,,"11,10,17,36,23,2,0,0,0","0,81,19,0,0","0,2,84,14,0",,,,,117,,,,,,,,,,,,,,,,,,,,,,,,,,,,,,,,,,,,6.9,7,5,145,74,,1021,0,306,0,3,3,Balve,1,0,U1.000|5:52-U1.000|5:04-U1.000|5:22-U1.000|5:22-U1.000|5:08-U1.000|5:49-U1.000|5:33-U0.327|1:40,,,,,wahoo_fitness-33,,518,7,,0,168070,250480,30378,,21971536,,,,,,,,,,,,,,,,,,,,,,,,,,,,,,,,,,,,,,,,5,
36014925,d65bbc0f-98e8-4a4e-93ac-2d51e444f0a8,1637846658,60,1637907597,,0,0,9.66,3375,3807,333,333,,,4,4.3,0.84,1.22,1,524,766,149,179,,,,45.34,33.36,47.28,1,,,,,,,,,,,,,,87,80,11.26,10.73,11.68,16.8,32.2,257,257,,1,272,272,,,,,,,,,"35,13,12,16,17,7,0,0,0","11,14,33,43,0","0,20,59,19,2",,,,,107,,,,,,,,,,,,,,,,,,,,,,,,,,,,,,,,,,,,49,3,10,241,83,,1010,0,304,0,3,3,Balve,1,0,U1.000|6:14-U1.000|6:38-U1.000|6:26-U1.000|6:59-U1.000|6:56-U1.000|5:12-U1.000|4:41-U1.000|4:57-U1.000|4:50-U0.642|3:22,,,,,wahoo_fitness-33,,518,7,,0,168070,250480,30378,,22017361,,,,,,,,,,,,,,,,,,,,,,,,,,,,,,,,,,,,,,,,3,
36074051,ee73d293-9b6d-4a00-bf85-94e2178f5c8b,1637953292,60,1638039043,,0,0,9.63,3479,3596,106,104,,,4,1.2,0.38,0.97,0.96,306,717,139,174,,,,47.75,32.05,48.41,1,,,,,,,,,,,,,,63,78,10.2,10.13,10.29,18.9,19.4,234,234,,1,239,239,,,,,,,,,"23,23,30,18,6,0,0,0,0","3,50,31,16,0","0,12,86,1,0",,,,,106,,,,,,,,,,,,,,,,,,,,,,,,,,,,,,,,,,,,37,0,21,184,88,,990,0,326,1,7,3,Balve,1,0,U1.000|6:15-U1.000|5:20-U1.000|5:57-U1.000|5:57-U0.331|1:59-U1.000|5:37-U1.000|6:00-U1.000|5:55-U1.000|6:58-U1.000|6:24-U0.284|1:39,,,,,wahoo_fitness-33,,518,7,,0,168070,250480,30378,,22071305,,,,,,,,,,,,,,,,,,,,,,,,,,,,,,,,,,,,,,,,5,
36074052,f64691a0-0fca-4011-911b-92725e310e0c,1638002023,60,1638039044,,0,0,19.03,5679,5754,285,285,,,4,2.9,0.45,0.86,0.98,515,1448,163,192,,,,48.35,42.32,49.25,1,,,,,,,,,,,,,,192,82,12.64,13.37,13.46,-6.4,-24.1,310,303,,1,336,334,,,,,,,,,"25,8,5,7,9,15,24,6,1","0,4,29,61,6","4,5,44,29,19",,,,,123,,,,,,,,,,,,,,,,,,,,,,,,,,,,,,,,,,,,85.9,2,10,207,91,,989,0,318,0,4,3,Balve,1,0,U1.000|6:46-U1.000|7:16-U1.000|6:23-U1.000|7:17-U1.000|5:12-U1.000|4:31-U1.000|4:09-U1.000|4:06-U1.000|3:55-U1.000|4:00-U1.000|3:45-U1.000|3:44-U0.168|4:01-U1.000|3:41-U1.000|3:43-U1.000|4:42-U1.000|3:35-U1.000|3:42-U1.000|5:58-U0.820|4:13,,,,,wahoo_fitness-33,,518,7,,0,168070,250480,30378,,22071306,,,,,,,,,,,,,,,,,,,,,,,,,,,,,,,,,,,,,,,,3,
36098512,f987a7b2-a539-40e1-926b-a70d6fcbb1b9,1638088485,60,1638094115,,0,0,17.47,5278,5292,542,542,,,4,4.7,0.7,1.07,1,600,1238,152,173,,,,52.76,41.43,54.78,1,,,,,,,,,,,,,,127,81,12.81,12.27,13.22,-6.1,1.7,303,303,,1,319,319,,,,,,,,,"9,10,15,17,21,21,6,0,0","0,17,59,23,0","0,6,46,39,10",,,,,123,,,,,,,,,,,,,,,,,,,,,,,,,,,,,,,,,,,,38.1,1,4,226,97,,997,0,334,0,4,3,Balve,1,0,U1.000|6:16-U1.000|6:10-U1.000|5:30-U1.000|5:38-U1.000|5:37-U1.000|4:48-U1.000|5:18-U1.000|4:47-U1.000|4:28-U1.000|5:39-U1.000|5:32-U1.000|4:54-U1.000|4:24-U1.000|4:09-U1.000|4:11-U1.000|4:22-U1.000|4:17-U0.438|1:58,,,,,wahoo_fitness-33,,518,7,,0,168070,250480,30378,,22093236,,,,,,,,,,,,,,,,,,,,,,,,,,,,,,,,,,,,,,,,"3,4,5",
36157459,c7d06928-17d4-44ea-b0d8-c118cf46cd1e,1638191025,60,1638190655,,0,0,9.73,3068,3157,290,289,,,4,3.8,0.75,1.06,0.99,502,657,142,174,,,,54.92,37.67,56.96,1,,,,,,,,,,,,,,55,80,12.34,11.92,12.64,-1.6,11.3,288,288,,1,299,299,,,,,,,,,"19,13,14,10,17,23,4,0,0","0,39,53,8,0","0,8,52,35,5",,,,,119,,,,,,,,,,,,,,,,,,,,,,,,,,,,,,,,,,,,44.7,2,10,294,98,,1007,0,330,0,6,3,Balve,1,0,U1.000|6:06-U1.000|6:24-U1.000|5:48-U1.000|6:42-U1.000|5:08-U1.000|4:27-U1.000|4:31-U1.000|4:27-U1.000|4:15-U0.709|3:19,,,,,wahoo_fitness-33,,518,7,,0,168070,250480,30378,,22145382,,,,,,,,,,,,,,,,,,,,,,,,,,,,,,,,,,,,,,,,3,
36227194,057de4ca-9799-48bf-9cad-a705ea71bb97,1638297208,60,1638298227,,0,0,4.05,1116,1116,24,36,,,0,0,0.25,1.16,1.37,,268,142,178,,,,64.87,41.79,65.11,1,57.3,1455,64,,2.9,0,,100,,,,7,3,26,80,13.04,13.16,13.14,-17.8,-13,319,319,,1,323,323,,,,,,,,,"2,0,3,9,42,40,4,0,0","12,20,38,30,0","0,0,28,67,5",,,,,136,,,,,,,,,,,,,,,,,,,,,,,,,,,,,,,,,,,,49.4,6,12,258,92,,1007,0,282,1,6,3,"Menden (Sauerland)",1,0,U1.000|4:36-U1.000|4:31-U1.000|4:38-U1.000|4:29-U0.054|0:21,,"Menden (Sauerland) Running",,,3113,,250,3,7895867168,0,168070,250480,30378,,22204030,,,,,,,,,,,,,,,,,,,,,,,,,,,,,,,,,,,,,,,,,
36227208,ab0cf72b-987b-488a-9ed8-868d382be587,1638298690,60,1638298250,,0,0,8.8,2198,2198,34,0,,,0,0,0.02,,,3497,639,,,,,,,49.17,,1,57.3,1417,18,,1.6,0,,100,,,,,,56,83,14.58,15.41,15.99,,,380,380,,1,422,422,,,,,,,,,"14,1,3,5,8,14,30,14,11",,"8,6,3,36,47",,,,,145,,,,,,,,,,,,,,,,,,,,,,,,,,,,,,,,,,,,,7,12,265,93,,1007,0,281,1,6,3,"Menden (Sauerland)",1,0,U0.980|3:47-U0.970|3:45-U1.030|3:43-U0.970|3:41-U1.030|3:42-U0.190|2:14-U1.020|3:38-U0.980|3:44-U0.210|2:03-U0.990|3:41-U0.030|1:20-U0.400|1:19,,"Menden (Sauerland) Track Running",,,3113,,250,3,7895869579,0,168070,250480,30378,,22204042,,,,,,,,,,,,,,,,,,,,,,,,,,,,,,,,,,,,,,,,5,
36227213,4a627c7d-4ce3-4636-b89f-9d49f5836819,1638301067,60,1638298253,,0,0,1.47,457,467,2,0,,,0,0,0,,,,101,,,,,,,33.11,,1,57.3,1408,6,,0.5,0,,100,,,,7,3,12,80,11.67,11.63,11.68,,,280,280,,1,281,281,,,,,,,,,"2,2,17,40,36,2,0,0,0",,"0,0,86,14,0",,,,,121,,,,,,,,,,,,,,,,,,,,,,,,,,,,,,,,,,,,,6,11,265,93,,1007,0,281,1,6,3,"Menden (Sauerland)",1,0,U1.000|5:12-U0.474|2:25,,"Menden (Sauerland) Running",,,3113,,250,3,7895870067,0,168070,250480,30378,,22204046,,,,,,,,,,,,,,,,,,,,,,,,,,,,,,,,,,,,,,,,,
36257383,ed70080a-979c-4507-a9bf-999992147d9c,1638365313,60,1638366394,,0,0,12.01,3945,4139,270,274,,,0,3.2,0.82,0.93,1,448,781,142,161,108,,,52.22,36.47,53.65,1,56.78,1991,110,,3.4,0,100,98,,,,7,3,99,79,11.5,11.36,11.59,-5.2,0.1,267,267,,1,274,274,,,,,,,,,"22,16,14,14,22,10,2,0,0","0,35,65,0,0","0,6,76,19,0",,,,,116,,,,,,,,,,,,,,,,,,,,,,,,,,,,,,,,,,,,35.7,7,26,243,88,,992,0,289,0,6,3,Balve,1,0,U1.000|6:02-U1.000|6:42-U1.000|6:08-U1.000|6:53-U1.000|5:31-U1.000|4:52-U1.000|4:47-U1.000|4:55-U1.000|4:58-U1.000|5:47-U1.000|4:36-U1.000|4:31-U0.008|0:02,,"Balve Running",,,3113,,250,3,7899309964,0,168070,250480,30378,,22231761,,,,,,,,,,,,,,,,,,,,,,,,,,,,,,,,,,,,,,,,4,
36295691,f8b3e817-b488-4fd8-b621-c1c2e06d13a0,1638448690,60,1638453162,,0,0,12.07,3791,3885,404,406,,,4,4.8,0.85,1.03,1.09,607,764,137,170,,,,57.82,38.45,60.2,1,,,,,,,,,,,,,,89,80,12.67,12.19,12.93,-20.2,-13.3,293,293,,1,306,306,,,,,,,,,"22,8,10,13,15,25,8,1,0","4,42,49,4,0","0,6,49,40,5",,,,,119,,,,,,,,,,,,,,,,,,,,,,,,,,,,,,,,,,,,45.4,2,12,290,95,,1000,0,351,0,7,3,Balve,1,0,U1.000|5:19-U1.000|4:25-U1.000|5:03-U1.000|5:44-U1.000|6:19-U1.000|7:45-U1.000|6:09-U1.000|4:30-U1.000|4:15-U1.000|4:19-U1.000|4:05-U1.000|5:02-U0.054|0:16,,,,,wahoo_fitness-33,,518,7,,0,168070,250480,30378,,22266391,,,,,,,,,,,,,,,,,,,,,,,,,,,,,,,,,,,,,,,,"3,5",
36331874,67ddb38b-4eaa-42b3-81ea-f26da306e7b5,1638532776,60,1638534182,,0,0,13.34,4426,4651,414,409,,,0,5,0.86,1.04,1.04,524,857,138,169,,,,53.54,36.35,55.62,1,56.49,1669,122,,3.5,0.5,100,99,,,,9,4,99,80,11.78,11.4,12.36,-6.4,-8.3,274,274,,1,297,297,,,,,,,,,"27,13,10,14,20,14,1,0,0","0,55,42,2,0","2,9,61,22,6",,,,,113,,,,,,,,,,,,,,,,,,,,,,,,,,,,,,,,,,,,36.2,2,21,219,93,,1009,1,300,0,4,3,Balve,1,0,U1.000|5:45-U1.000|4:48-U1.000|5:28-U1.000|6:54-U0.742|4:45-U1.000|6:34-U1.000|6:04-U1.000|6:29-U1.000|4:33-U1.000|4:29-U1.000|5:51-U1.000|4:26-U1.000|4:31-U0.596|3:10,,"Balve Running",,,3113,,250,3,7908107693,0,168070,250480,30378,,22297175,,,,,,,,,,,,,,,,,,,,,,,,,,,,,,,,,,,,,,,,"3,4,5",
36387734,1eb5c06d-a2c2-4184-8eb8-231de2f9ecb3,1638613791,60,1638644140,,0,0,16.16,5392,5575,426,398,,,0,4.6,0.79,1.07,1,463,1133,156,179,114,,,44.97,36.67,46.53,1,56.4,2939,196,,4.4,0,99,98,,,,7,3,182,81,11.48,11.23,11.94,9.5,11.4,267,267,,1,281,281,,,,,,,,,"24,16,14,15,20,11,1,0,0","0,8,55,37,0","0,6,74,16,3",,,,,111,,,,,,,,,,,,,,,,,,,,,,,,,,,,,,,,,,,,68.2,3,10,163,100,,998,0,314,0,4,3,Balve,1,0,U1.000|5:24-U1.000|5:38-U1.000|6:23-U1.000|6:12-U1.000|6:34-U1.000|5:12-U1.000|4:51-U1.000|4:33-U1.000|5:53-U1.000|7:11-U1.000|6:06-U1.000|5:47-U1.000|4:51-U1.000|4:38-U1.000|4:26-U1.000|5:15-U0.158|1:00,,"Balve Running",,,3113,,250,3,7914498312,0,168070,250480,30378,,22346990,,,,,,,,,,,,,,,,,,,,,,,,,,,,,,,,,,,,,,,,"4,4,4,5",
36415805,de83a06a-2979-4588-9b16-f275d3c9b5b3,1638702985,60,1638707086,,0,0,22.18,7053,7565,491,462,,,0,4.4,0.73,1.01,1.04,476,1399,137,166,,,,56.94,39.77,58.59,1,56.47,3744,178,,4.2,0,98,101,,,,15,3,156,80,11.88,11.71,12.1,-6.5,-3.7,279,279,,1,288,288,,,,,,,,,"15,10,15,24,20,12,4,0,0","1,64,34,1,0","0,2,71,25,1",,,,,118,,,,,,,,,,,,,,,,,,,,,,,,,,,,,,,,,,,,36.5,4,13,191,97,,1003,0,380,0,4,3,Balve,1,0,U1.000|5:33-U1.000|5:24-U1.000|5:28-U1.000|5:45-U1.000|5:21-U1.000|5:43-U1.000|6:38-U1.000|6:06-U1.000|5:36-U1.000|5:43-U1.000|5:35-U1.000|4:47-U1.000|5:47-U1.000|5:15-U1.000|5:15-U1.000|5:21-U1.000|4:19-U1.000|4:09-U1.000|4:16-U1.000|4:09-U1.000|4:33-U1.000|5:48-U0.181|1:02,,"Balve Running",,,3113,,250,3,7917578269,0,168070,250480,30378,,22372401,,,,,,,,,,,,,,,,,,,,,,,,,,,,,,,,,,,,,,,,"4,4,5,5",
36416390,beb20b2a-0d78-4635-a8dc-300879097dd6,1638712934,60,1638709486,,0,0,0.31,129,129,0,0,,,0,0,0,,,,12,97,110,,,,59.28,20.18,59.28,1,56.47,3705,1,,,0,,100,,,,7,3,1,85,8.62,8.66,8.68,6.6,2.4,198,198,,1,197,197,,,,,,,,,"60,33,7,0,0,0,0,0,0","30,70,0,0,0","4,14,82,0,0",,,,,85,,,,,,,,,,,,,,,,,,,,,,,,,,,,,,,,,,,,1.2,,,,,,,,,,1,,,1,0,,,Running,,,3113,,250,3,7917800173,0,168070,250480,30378,,22372855,,,,,,,,,,,,,,,,,,,,,,,,,,,,,,,,,,,,,,,,,
36502356,602519af-9bf5-4250-88cd-74790ba8969f,1638811532,60,1638811461,,0,0,9.96,3325,3404,180,164,,,0,3.1,0.6,1.15,0.99,503,657,135,153,,,,54.63,35.28,55.96,1,56.42,2330,100,,3.3,0,99,100,,,,7,3,71,78,11.11,10.9,11.82,-5.3,-24.2,264,264,,1,287,287,,,,,,,,,"11,9,27,40,11,1,0,0,0","1,86,13,0,0","0,6,80,10,4",,,,,115,,,,,,,,,,,,,,,,,,,,,,,,,,,,,,,,,,,,26,1,12,179,82,,1013,0,319,1,4,3,Balve,1,0,U1.000|5:48-U1.000|5:15-U1.000|5:50-U1.000|5:37-U1.000|5:35-U1.000|5:24-U1.000|5:34-U1.000|5:56-U1.000|5:40-U0.959|4:46,,"Balve Running",,,3113,,250,3,7923332727,0,168070,250480,30378,,22453517,,,,,,,,,,,,,,,,,,,,,,,,,,,,,,,,,,,,,,,,"4,5",
36531649,a8bea3f5-2652-4fcf-b1ce-bb1114e692d8,1638878149,60,1638879432,,0,0,15.26,4778,4811,344,344,,,0,4.1,0.74,0.97,0.99,548,1018,146,171,,,,53.38,39.31,54.87,1,55.98,4007,191,,4.4,0.8,99,98,,,,11,2,126,81,12.11,11.99,12.51,-8.6,-8.6,285,285,,1,300,300,,,,,,,,,"16,11,13,15,19,23,3,0,0","0,18,77,5,0","0,4,63,30,4",,,,,118,,,,,,,,,,,,,,,,,,,,,,,,,,,,,,,,,,,,44.7,4,13,224,83,,1010,0,318,0,3,3,Balve,1,0,U1.000|5:09-U1.000|5:10-U1.000|6:32-U1.000|6:19-U1.000|5:50-U1.000|6:47-U1.000|5:14-U1.000|4:27-U1.000|4:29-U1.000|4:18-U1.000|4:18-U1.000|4:14-U0.753|3:08-U1.000|5:54-U1.000|5:14-U0.502|2:36,,"Balve Running",,,3113,,250,3,7926635064,0,168070,250480,30378,,22480104,,,,,,,,,,,,,,,,,,,,,,,,,,,,,,,,,,,,,,,,"3,4",
36587651,3dfb3c34-dfbb-4cbc-87d3-cfa0d635c149,1638982981,60,1638983080,,0,0,3.22,1073,1194,36,61,,,0,0.8,0.5,1.18,0.94,,219,149,166,94,,,48.07,32.9,48.27,1,55.98,2320,53,,2.6,0,,100,,,,7,3,31,79,10.84,10.86,11.06,4.9,6.4,246,246,,1,256,256,,,,,,,,,"7,10,32,41,10,0,0,0,0","1,8,86,5,0","0,10,78,12,0",,,,,114,,,,,,,,,,,,,,,,,,,,,,,,,,,,,,,,,,,,42,3,9,187,80,,1002,0,352,1,4,3,Balve,1,0,U1.000|5:34-U1.000|5:45-U1.000|5:20-U0.223|1:15,,"Balve Running",,,3113,,250,3,7932593922,0,168070,250480,30378,,22530673,,,,,,,,,,,,,,,,,,,,,,,,,,,,,,,,,,,,,,,,,
36587653,234bc8ac-4074-414e-82fe-2cb99ba0c122,1638984499,60,1638983081,,0,0,1.03,238,238,0,0,,,0,0,0,,,,65,163,177,,,,66.31,44.45,66.31,1,55.98,2880,41,,2.3,0,,100,,,,7,1,9,85,15.65,15.8,15.8,14.4,12.9,402,402,,1,408,408,,,,,,,,,"0,0,0,0,5,35,39,16,4","0,10,13,78,0","0,0,0,57,43",,,,,153,,,,,,,,,,,,,,,,,,,,,,,,,,,,,,,,,,,,30.3,3,9,194,78,,1001,0,352,1,4,3,Balve,1,0,U0.390|1:32-U0.400|1:32-U0.240|0:55,,"Balve Track Running",,,3113,,250,3,7932594018,0,168070,250480,30378,,22530675,,,,,,,,,,,,,,,,,,,,,,,,,,,,,,,,,,,,,,,,,
36587658,b263f514-8e60-4129-818f-db7dda852ca3,1638984958,60,1638983088,,0,0,4.35,1568,1621,123,88,,,0,2.4,0.79,1.02,0.94,561,318,154,176,,,,41.64,30.52,43.52,1,55.98,4320,68,,2.9,0,,100,,,,20,1,50,79,10.68,10.22,10.99,-3.1,2.8,248,248,,1,262,262,,,,,,,,,"30,16,21,26,7,1,0,0,0","1,4,67,29,0","0,16,73,11,0",,,,,105,,,,,,,,,,,,,,,,,,,,,,,,,,,,,,,,,,,,55.6,3,9,194,78,,1001,0,352,1,4,3,Balve,1,0,U1.000|6:27-U1.000|6:32-U1.000|5:23-U1.000|5:41-U0.347|2:06,,"Balve Running",,,3113,,250,3,7932594450,0,168070,250480,30378,,22530679,,,,,,,,,,,,,,,,,,,,,,,,,,,,,,,,,,,,,,,,4,
36634599,34ec6cc0-ad89-49ca-970b-d38a487b7a78,1639059888,60,1639061946,,0,0,16.45,5353,5430,429,396,,,0,4.3,0.81,1.02,1.01,529,1108,144,162,98,,,51.86,37.81,53.66,1,55.94,4349,188,,4.3,0,98,100,,,,9,2,139,80,11.83,11.38,12.03,1.8,12.3,275,275,,1,285,285,,,,,,,,,"16,14,19,16,23,12,0,0,0","0,26,74,0,0","0,5,69,25,1",,,,,115,,,,,,,,,,,,,,,,,,,,,,,,,,,,,,,,,,,,38,3,10,199,86,,1005,0,388,0,3,3,Balve,1,0,U1.000|6:04-U1.000|6:13-U1.000|5:36-U1.000|6:18-U1.000|6:16-U1.000|4:53-U1.000|5:09-U1.000|5:55-U1.000|5:01-U1.000|5:26-U1.000|6:40-U1.000|4:53-U1.000|4:40-U1.000|4:38-U1.000|4:39-U1.000|4:36-U0.451|2:16,,"Balve Running",,,3113,,250,3,7936508984,0,168070,250480,30378,,22569159,,,,,,,,,,,,,,,,,,,,,,,,,,,,,,,,,,,,,,,,"4,4,5,5",
36668889,de11e13c-35f5-4249-9b95-cbce7248b86f,1639132760,60,1639132686,,0,0,4.01,3443,3443,246,8,,,0,3.9,0.85,,,295,303,100,137,,,,,,,1,55.94,3121,11,,0.9,0,,100,,,,,,27,57,,4.56,,37.3,,,,,,,,,,,,,,,,"64,34,0,0,0,1","53,47,0,0,0",,,,,,,,,,,,,,,,,,,,,,,,,,,,,,,,,,,,,,,,,,9,1,14,162,80,,995,0,357,0,4,3,Balve,1,0,,,"Balve Hiking",,,3113,,250,3,7939854176,0,168075,,30378,,22598652,,,,,,,,,,,,,,,,,,,,,,,,,,,,,,,,,,,,,,,,3,
36677602,4651586b-e846-4a96-a81a-d813df08085f,1639136897,60,1639140669,,0,0,17.99,6194,6569,675,863,,,0,6.9,0.88,1.13,1.1,818,1160,143,170,97,,,48.82,35.64,50.46,1,55.98,4320,158,,3.8,0.5,102,100,,,,15,4,154,80,11.88,11.47,12.96,-2.4,-24.3,264,264,,1,302,302,,,,,,,,,"34,8,6,9,22,19,2,0,0","0,46,42,12,0","5,14,58,16,8",,,,,109,,,,,,,,,,,,,,,,,,,,,,,,,,,,,,,,,,,,49.3,2,14,155,73,,994,0,356,0,4,3,Balve,1,0,U1.000|4:58-U1.000|4:36-U1.000|4:25-U1.000|6:10-U1.000|8:56-U1.000|7:39-U1.000|6:34-U1.000|6:05-U1.000|5:01-U1.000|7:12-U1.000|6:37-U1.000|4:56-U1.000|6:44-U1.000|5:08-U1.000|4:21-U1.000|4:17-U1.000|4:52-U0.990|4:42,,"Balve Running",,,3113,,250,3,7940349375,0,168070,250480,30378,,22606798,,,,,,,,,,,,,,,,,,,,,,,,,,,,,,,,,,,,,,,,"3,3,3,4,4",
36708099,616a6157-d213-4ab1-b127-c10a8c8256ed,1639220799,60,1639225012,,0,0,17.54,6035,6760,559,570,,,0,5.8,0.88,1,1.08,626,1149,144,172,,,,48.41,35.6,50.28,1,55.8,4423,169,,4,0.1,99,98,,,,15,4,152,79,11.64,11.28,11.76,-2.6,2.5,262,262,,1,272,272,,,,,,,,,"28,12,13,10,18,18,1,0,0","0,32,61,7,0","0,10,71,19,0",,,,,110,,,,,,,,,,,,,,,,,,,,,,,,,,,,,,,,,,,,45.9,2,8,248,93,,1015,0,339,0,3,3,Balve,1,0,U1.000|6:24-U1.000|6:03-U1.000|5:49-U1.000|6:00-U1.000|6:02-U1.000|4:59-U1.000|4:41-U1.000|10:12-U1.000|6:35-U1.000|6:28-U1.000|6:27-U1.000|5:26-U1.000|4:44-U1.000|4:33-U1.000|4:32-U1.000|4:21-U1.000|4:36-U0.536|2:44,,"Balve Running",,,3113,,250,3,7944606301,0,168070,250480,30378,,22634214,,,,,,,,,,,,,,,,,,,,,,,,,,,,,,,,,,,,,,,,"3,3,4",
36761713,ee033d00-9c9b-42cf-862f-61a847c16659,1639318685,60,1639320601,,0,0,13.44,4141,4523,339,334,,,0,3.7,0.84,0.87,1.01,544,864,140,164,101,,,57.57,39.66,59.4,1,55.91,4032,159,,3.8,0.3,101,101,,,,16,1,96,80,12.47,12.21,12.59,-13.5,-7.9,292,292,,1,301,301,,,,,,,,,"13,14,18,11,16,19,8,1,0","1,47,50,2,0","0,2,51,45,2",,,,,122,,,,,,,,,,,,,,,,,,,,,,,,,,,,,,,,,,,,45.4,5,17,210,100,,1023,0,281,0,6,3,Balve,1,0,U1.000|6:04-U1.000|6:05-U1.000|5:27-U1.000|6:07-U1.000|6:07-U1.000|4:55-U1.000|5:32-U1.000|4:34-U1.000|4:17-U1.000|4:29-U1.000|4:23-U1.000|5:35-U1.000|3:50-U0.437|1:34,,"Balve Running",,,3113,,250,3,7950319475,0,168070,250480,30378,,22680890,,,,,,,,,,,,,,,,,,,,,,,,,,,,,,,,,,,,,,,,3,
36804185,0c6cc30f-ae22-45a3-b75d-7efe91449a1b,1639401628,60,1639401081,,0,0,10.01,2995,3010,173,175,,,0,2.1,0.6,1.05,1.01,389,648,144,161,,,,57.52,40.14,58.73,1,56.19,3456,142,,3.6,0,104,100,,,,7,3,72,79,12.37,12.24,12.55,-1.5,-4,296,296,,1,303,303,,,,,,,,,"4,7,14,21,31,20,3,0,0","1,28,71,0,0","0,0,62,35,3",,,,,127,,,,,,,,,,,,,,,,,,,,,,,,,,,,,,,,,,,,35,8,8,207,95,,1028,0,277,0,3,3,Balve,1,0,U1.000|5:37-U1.000|4:49-U1.000|5:04-U1.000|5:12-U1.000|4:57-U1.000|5:15-U1.000|5:02-U1.000|4:20-U1.000|4:24-U1.000|5:14-U0.005|0:02,,"Balve Running",,,3113,,250,3,7954193177,0,168070,250480,30378,,22717507,,,,,,,,,,,,,,,,,,,,,,,,,,,,,,,,,,,,,,,,"5,5",
36851358,c65baa52-daed-4f4a-9d2f-277b31854621,1639507072,60,1639504861,,0,0,4.09,1170,1174,32,38,,,0,0.1,0.21,,0.95,318,240,135,156,,,,66.12,40.02,66.64,1,57.28,1454,59,,2.5,0,107,104,,,,7,3,22,80,12.69,12.72,12.82,4.9,1,310,310,,1,313,313,,,,,,,,,"2,2,5,16,47,27,1,0,0","3,72,25,0,0","0,2,41,54,3",,,,,131,,,,,,,,,,,,,,,,,,,,,,,,,,,,,,,,,,,,20.6,7,9,206,91,,1029,0,302,1,4,3,"Menden (Sauerland)",1,0,U1.000|4:52-U1.000|4:38-U1.000|4:41-U1.000|4:42-U0.094|0:38,,"Menden (Sauerland) Running",,,3113,,250,3,7960112881,0,168070,250480,30378,,22759131,,,,,,,,,,,,,,,,,,,,,,,,,,,,,,,,,,,,,,,,5,
36853383,f78b446a-4550-4816-9aac-f27a59511e84,1639508929,60,1639508086,,0,0,8.88,2307,2307,0,0,,,0,0,0,,,,524,158,185,,,,60.11,46.98,60.11,1,58.24,4320,263,,3.8,3.2,107,106,,,,18,4,82,84,13.86,15.21,15.21,-5.5,-6.8,353,353,,1,396,396,,,,,,,,,"19,4,6,2,2,8,34,23,3","2,21,11,62,3","8,8,15,16,53",,,,,137,,,,,,,,,,,,,,,,,,,,,,,,,,,,,,,,,,,,78.9,7,9,207,91,,1029,0,302,1,4,3,"Menden (Sauerland)",1,0,U0.400|1:28-U0.400|1:26-U0.400|1:28-U0.400|1:27-U0.400|2:19-U0.410|1:27-U0.400|1:27-U0.400|1:28-U0.210|1:19-U0.400|1:27-U0.400|1:26-U0.440|5:26-U0.400|1:29-U0.400|1:27-U0.400|1:28-U0.400|1:26-U0.400|2:28-U0.400|1:23-U0.400|1:22-U0.400|1:17-U0.210|1:14-U0.400|1:21-U0.400|1:16-U0.010|0:06,,"Menden (Sauerland) Track Running",,,3113,,250,3,7960397416,0,168070,250480,30378,,22760831,,,,,,,,,,,,,,,,,,,,,,,,,,,,,,,,,,,,,,,,,
36855485,b7b90ac7-e8e4-4357-9c56-37fa218d10ba,1639511726,60,1639509897,,0,0,3.36,1082,1100,29,31,,,4,0,0.16,0.9,0.86,,259,154,179,,,,47.86,34.36,48.34,1,,,,,,,,,,,,,,36,81,11.38,11.79,11.85,-2.9,-1.3,271,271,,1,287,287,,,,,,,,,"25,6,13,15,20,9,7,4,0","0,13,39,48,0","7,4,55,30,3",,,,,115,,,,,,,,,,,,,,,,,,,,,,,,,,,,,,,,,,,,51,7,9,207,91,,1029,0,302,1,4,3,"Menden (Sauerland)",1,0,U1.000|5:49-U1.000|5:01-U1.000|5:04-U0.359|2:08,,,,,wahoo_fitness-33,,518,7,,0,168070,250480,30378,,22762750,,,,,,,,,,,,,,,,,,,,,,,,,,,,,,,,,,,,,,,,,
36927951,16214cdd-51ee-4c1c-bca4-e6db2b8884f4,1639576195,60,1639592575,,0,0,12.62,4172,4251,355,358,,,4,4,0.73,1.05,0.96,489,965,151,175,,,,47.65,36.34,49.3,1,,,,,,,,,,,,,,123,80,11.72,11.33,11.95,2.8,9.6,271,271,,1,280,280,,,,,,,,,"26,13,12,14,22,12,2,0,0","0,14,63,23,0","0,10,62,27,1",,,,,113,,,,,,,,,,,,,,,,,,,,,,,,,,,,,,,,,,,,62.6,7,7,220,95,,1032,0,289,0,4,3,Balve,1,0,U1.000|6:05-U1.000|4:51-U1.000|5:29-U1.000|6:54-U1.000|6:17-U1.000|6:35-U1.000|6:14-U1.000|4:55-U1.000|4:50-U1.000|4:45-U1.000|4:24-U1.000|4:36-U0.607|3:37,,,,,wahoo_fitness-33,,518,7,,0,168070,250480,30378,,22830687,,,,,,,,,,,,,,,,,,,,,,,,,,,,,,,,,,,,,,,,"3,5",
36970726,b223f4e9-c870-415d-b982-40d5c9f50224,1639662027,60,1639661243,,0,0,7.15,2300,2667,151,152,,,4,2.6,0.69,1.02,0.96,543,548,153,166,,,,48.38,36.03,49.63,1,,,,,,,,,,,,,,70,79,11.77,11.5,11.97,6.4,4.9,275,275,,1,283,283,,,,,,,,,"15,11,15,24,22,11,2,0,0","0,6,80,14,0","0,5,67,28,1",,,,,118,,,,,,,,,,,,,,,,,,,,,,,,,,,,,,,,,,,,46.9,8,4,303,100,,1037,0,291,0,3,3,Balve,1,0,U1.000|5:42-U1.000|4:38-U1.000|5:48-U1.000|5:43-U1.000|5:09-U1.000|5:10-U1.000|5:21-U0.140|0:48,,,,,wahoo_fitness-33,,518,7,,0,168070,250480,30378,,22870355,,,,,,,,,,,,,,,,,,,,,,,,,,,,,,,,,,,,,,,,"4,5",
37032483,3cbb7ef3-6c17-458c-b635-ea80d1b65965,1639744840,60,1639754221,,0,0,15.42,4690,4725,407,405,,,4,4.3,0.8,1.07,1.13,574,1097,149,178,,,,53.8,40.7,55.57,1,,,,,,,,,,,,,,130,82,12.61,12.35,12.92,-9.1,0.3,298,298,,1,309,309,,,,,,,,,"11,10,17,18,16,17,9,1,0","0,17,75,8,0","0,3,50,41,6",,,,,120,,,,,,,,,,,,,,,,,,,,,,,,,,,,,,,,,,,,39.4,7,6,15,100,,1040,0,282,0,3,3,Balve,1,0,U1.000|5:52-U1.000|6:05-U1.000|5:43-U1.000|6:28-U1.000|5:01-U1.000|4:51-U1.000|5:19-U1.000|5:10-U1.000|4:48-U1.000|5:01-U1.000|5:42-U1.000|4:36-U1.000|3:50-U1.000|3:56-U1.000|4:05-U0.396|1:43,,,,,wahoo_fitness-33,,518,7,,0,168070,250480,30378,,22923813,,,,,,,,,,,,,,,,,,,,,,,,,,,,,,,,,,,,,,,,"3,4,5",
37061042,09d8fddf-705a-49ef-97be-b37abf3755c0,1639823450,60,1639828030,,0,0,13.79,4120,4371,282,284,,,4,2.9,0.57,1.06,1.03,458,921,145,168,,,,57.09,41.19,58.52,1,,,,,,,,,,,,,,104,80,12.49,12.22,12.76,0.1,-1.1,299,299,,1,309,309,,,,,,,,,"6,6,14,18,30,23,3,0,0","0,27,66,6,0","0,3,52,40,6",,,,,126,,,,,,,,,,,,,,,,,,,,,,,,,,,,,,,,,,,,36.8,6,5,2,100,,1039,0,291,0,3,3,Balve,1,0,U1.000|5:05-U1.000|5:10-U1.000|4:47-U1.000|4:29-U1.000|5:34-U1.000|4:56-U0.943|5:08-U1.000|4:54-U1.000|4:45-U1.000|4:28-U1.000|4:53-U1.000|5:24-U1.000|4:35-U0.821|4:33,,,,,wahoo_fitness-33,,518,7,,0,168070,250480,30378,,22949188,,,,,,,,,,,,,,,,,,,,,,,,,,,,,,,,,,,,,,,,"4,5,5",
37104673,48ff92f6-868f-4ada-8b88-f1336ce1ffda,1639917828,60,1639918818,,0,0,13.56,4276,4348,414,593,,,4,4.9,0.85,1.05,1.06,534,1022,153,174,,,,49.58,38.62,50.64,1,,,,,,,,,,,,,,141,79,12.63,12.76,12.83,-7.2,-4.6,279,279,,1,294,294,,,,,,,,,"27,6,5,6,18,19,15,3,0","7,6,41,46,0","0,10,54,31,5",,,,,120,,,,,,,,,,,,,,,,,,,,,,,,,,,,,,,,,,,,68,5,15,289,96,,1029,0,309,0,4,3,Balve,1,0,U1.000|6:24-U1.000|4:57-U1.000|4:26-U1.000|4:26-U1.000|6:02-U1.000|9:31-U1.000|6:32-U1.000|5:53-U1.000|5:21-U1.000|4:24-U1.000|3:51-U1.000|3:52-U1.000|3:44-U0.530|1:53,,,,,wahoo_fitness-33,,518,7,,0,168070,250480,30378,,22988492,,,,,,,,,,,,,,,,,,,,,,,,,,,,,,,,,,,,,,,,"3,4,5",
37134188,,1639909020,,1639991862,,0,0,4,1440,,,,,,0,,,,,,352,,,,,,,30.42,,1,,,,,,,,,,,,,,34,,,,,,,,,,,,,,,,,,,,,,,,,,,,,,,,,,,,,,,,,,,,,,,,,,,,,,,,,,,,,,,,,,,,,,,,,,1,,,0,0,,,,,,,,,0,,0,168070,250480,30378,,,,,,,,,,,,,,,,,,,,,,,,,,,,,,,,,,,,,,,,,,,
37152565,bd09df4d-42ea-4de2-a34f-24bcb52c4659,1640029612,60,1640028543,,0,0,7.47,2419,2431,103,103,,,4,1.6,0.54,1.01,1.02,344,479,134,155,,,,57.25,35.85,58.23,1,,,,,,,,,,,,,,47,78,11.38,11.27,11.52,1.5,3.7,268,268,,1,274,274,,,,,,,,,"12,8,20,34,20,5,1,0,0","0,77,23,0,0","0,2,79,19,1",,,,,119,,,,,,,,,,,,,,,,,,,,,,,,,,,,,,,,,,,,18.9,-1,4,86,82,,1029,0,326,1,2,3,Balve,1,0,U1.000|5:17-U1.000|5:04-U1.000|5:30-U1.000|5:14-U1.000|5:09-U1.000|5:58-U1.000|5:50-U0.458|2:17,,,,,wahoo_fitness-33,,518,7,,0,168070,250480,30378,,23030037,,,,,,,,,,,,,,,,,,,,,,,,,,,,,,,,,,,,,,,,5,
37201663,7833048d-c4bd-4d9a-b11d-e48f5b9a5909,1640111711,60,1640116944,,0,0,18.68,4975,5069,102,94,,,0,0,0.11,1.06,0.83,,1209,158,177,,,,58.29,48.21,58.71,1,58.41,5400,373,,5,2.2,101,101,,,,18,2,172,83,13.59,13.98,14.09,-0.3,-4,338,338,,1,358,358,,,,,,,,,"4,3,6,18,27,11,20,12,1","0,4,49,47,0","0,3,36,32,29",,,,,136,,,,,,,,,,,,,,,,,,,,,,,,,,,,,,,,,,,,71.8,-1,4,143,76,,1027,0,313,1,2,3,"Menden (Sauerland)",1,0,U3.456|16:47-U0.304|1:01-U0.440|2:01-U0.261|1:02-U0.408|2:00-U0.293|1:04-U0.424|2:00-U0.311|1:01-U0.402|2:06-U0.313|1:02-U0.372|1:58-U0.321|1:01-U0.398|2:01-U1.088|4:03-U0.584|2:59-U1.088|4:01-U0.622|3:01-U1.096|4:03-U0.654|3:17-U1.094|4:02-U0.545|3:00-U1.069|4:02-U0.538|3:01-U1.101|4:03-U1.495|8:21,,"Menden (Sauerland) Running",,,3113,,250,3,7992335343,0,168070,250480,30378,,23074279,,,,,,,,,,,,,,,,,,,,,,,,,,,,,,,,,,,,,,,,,
37241404,0ebf5527-003a-4579-a66b-76aacc25784e,1640193235,60,1640205840,,0,0,7.67,2721,2761,219,224,,,0,3.8,0.89,1.05,1,571,530,146,174,,,,45.76,32.22,47.34,1,58.39,4082,74,,2.9,0,97,100,,,,7,3,66,78,10.91,10.57,11.16,-0.7,13.3,247,247,,1,260,260,,,,,,,,,"23,11,21,31,13,1,0,0,0","1,33,53,13,0","0,17,73,11,0",,,,,108,,,,,,,,,,,,,,,,,,,,,,,,,,,,,,,,,,,,51.7,0,6,152,68,,1023,0,302,1,4,3,Balve,1,0,,,"Balve Running",,,3113,,250,3,7996868962,0,168070,250480,30378,,23109794,,,,,,,,,,,,,,,,,,,,,,,,,,,,,,,,,,,,,,,,3,
37263919,ad17da65-118e-49c3-ab2e-e49341d900d7,1640266597,60,1640267907,,0,0,15.32,4617,4722,426,431,,,4,4.3,0.76,1.15,1.05,585,1193,162,181,,,,48.22,41.12,49.86,1,,,,,,,,,,,,,,178,81,12.68,12.38,13.03,-3.4,6.2,300,300,,1,313,313,,,,,,,,,"9,9,16,20,19,17,9,2,0","0,2,31,66,0","0,3,50,41,6",,,,,123,,,,,,,,,,,,,,,,,,,,,,,,,,,,,,,,,,,,74.8,2,12,199,64,,1011,0,271,0,4,3,Balve,1,0,U0.824|5:06-U1.000|5:45-U1.000|5:21-U1.000|6:18-U1.000|4:50-U1.000|4:55-U1.000|5:31-U1.000|5:32-U1.000|4:55-U1.000|4:53-U1.000|5:13-U1.000|4:35-U1.000|4:06-U1.000|4:03-U1.000|3:51-U0.475|2:04,,,,,wahoo_fitness-33,,518,7,,0,168070,250480,30378,,23130047,,,,,,,,,,,,,,,,,,,,,,,,,,,,,,,,,,,,,,,,"3,4,5",
37300677,1e9dc492-1f15-4e86-ac3c-9c432b6c2bd9,1640338426,60,1640341617,,0,0,20.15,6208,6637,562,545,,,0,5.1,0.76,1.02,1.04,512,1390,158,180,,,,48.7,40.96,50.44,1,57.97,4284,254,,4.6,1,96,100,,,,13,4,202,82,12.58,12.27,12.94,-1.4,0.2,295,295,,1,310,310,,,,,,,,,"12,12,17,19,16,15,6,1,1","0,4,45,51,0","1,6,47,40,6",,,,,119,,,,,,,,,,,,,,,,,,,,,,,,,,,,,,,,,,,,68.1,6,18,249,97,,1005,0,287,0,4,3,Balve,1,0,,,"Balve Running",,,3113,,250,3,8002778807,0,168070,250480,30378,,23161017,,,,,,,,,,,,,,,,,,,,,,,,,,,,,,,,,,,,,,,,"4,4,5,5,5",
37331806,beef87c3-6d59-4884-a9b2-9685b9e7204b,1640424615,60,1640426291,,0,0,15.33,4844,5042,432,421,,,0,4.6,0.89,1.02,1.1,672,1058,148,170,98,,,51.81,38.91,53.66,1,57.9,4363,176,,3.9,0.1,97,100,,,,7,3,142,81,12.22,11.81,12.49,-13.1,-6.5,286,286,,1,297,297,,,,,,,,,"16,16,11,13,22,21,1,0,0","1,29,49,21,0","0,9,47,43,1",,,,,117,,,,,,,,,,,,,,,,,,,,,,,,,,,,,,,,,,,,59.6,0,14,72,87,,1008,0,308,0,4,3,Balve,1,0,,,"Balve Running",,,3113,,250,3,8006583314,0,168070,250480,30378,,23188018,,,,,,,,,,,,,,,,,,,,,,,,,,,,,,,,,,,,,,,,"3,4",
37562421,0942ce69-70e8-4ed3-8141-eaf1ca108e4a,1640772603,60,1640813998,,0,0,11.91,4003,4109,361,361,,,4,4.4,0.78,0.99,0.98,513,955,153,182,,,,45.83,35.48,47.55,1,,,,,,,,,,,,,,133,81,11.69,11.24,12.01,1.6,7.5,268,268,,1,282,282,,,,,,,,,"32,12,10,11,20,13,1,0,0","2,16,43,39,1","0,11,64,22,3",,,,,110,,,,,,,,,,,,,,,,,,,,,,,,,,,,,,,,,,,,70.3,7,15,248,96,,1009,0,293,0,4,3,Balve,1,0,U1.000|5:07-U1.000|5:18-U1.000|6:56-U1.000|6:42-U1.000|6:28-U1.000|6:30-U1.000|6:56-U1.000|4:47-U1.000|4:34-U1.000|4:28-U1.000|4:27-U0.892|4:31,,,,,wahoo_fitness-33,,518,7,,0,168070,250480,30378,,23389919,,,,,,,,,,,,,,,,,,,,,,,,,,,,,,,,,,,,,,,,3,
37562422,63636e37-8750-4fdd-93c8-6a99b8114f1c,1640715292,60,1640813999,,0,0,7.61,2398,2464,86,83,,,4,1.1,0.4,0.98,0.88,,504,145,178,,,,53.45,37.07,54.23,1,,,,,,,,,,,,,,68,78,11.62,11.59,11.73,-7.2,-9.5,276,276,,1,281,281,,,,,,,,,"8,7,15,29,32,7,1,0,0","2,42,35,21,0","0,2,70,28,0",,,,,122,,,,,,,,,,,,,,,,,,,,,,,,,,,,,,,,,,,,48.4,7,18,216,91,,994,0,363,1,6,3,Balve,1,0,U1.000|5:56-U1.000|5:07-U1.000|5:28-U1.000|5:08-U1.000|4:48-U1.000|4:50-U1.000|4:58-U0.599|3:43,,,,,wahoo_fitness-33,,518,7,,0,168070,250480,30378,,23389920,,,,,,,,,,,,,,,,,,,,,,,,,,,,,,,,,,,,,,,,,
37579290,764a7262-5262-4adf-80f3-9faa02289cea,1640604939,60,1640857476,,0,0,14.68,4572,5371,445,441,,,4,4.4,0.74,1.02,1.01,566,1101,153,177,,,,50.34,39.44,52.25,1,,,,,,,,,,,,,,151,81,12.42,11.84,12.78,-0.8,9.4,292,292,,1,308,308,,,,,,,,,"11,10,16,20,24,16,3,0,0","0,21,40,39,0","0,10,43,42,5",,,,,119,,,,,,,,,,,,,,,,,,,,,,,,,,,,,,,,,,,,71.9,6,11,165,91,,1001,0,297,0,4,3,Balve,1,0,U1.000|4:31-U1.000|5:12-U1.000|5:51-U1.000|5:35-U1.000|5:31-U1.000|5:43-U1.000|6:03-U1.000|5:21-U1.000|4:39-U1.000|4:26-U1.000|5:20-U1.000|4:37-U1.000|4:48-U1.000|4:47-U0.665|3:49,,,,,wahoo_fitness-33,,518,1,,0,168070,250480,30378,,23405687,,,,,,,,,,,,,,,,,,,,,,,,,,,,,,,,,,,,,,,,"3,5",
37613556,6f4a0e08-ef7f-431e-9898-f6afae088f7e,1640861882,60,1640892992,,0,0,13.64,4340,4365,337,336,,,0,4.1,0.78,0.98,1.03,496,923,148,163,,,,51.37,38.24,52.94,1,57.53,1809,147,,3.6,0,100,98,,,,7,3,125,80,11.95,11.72,12.28,-7.8,-0.2,280,280,,1,291,291,,,,,,,,,"14,18,14,14,22,17,2,0,0","0,13,84,2,0","0,2,77,17,3",,,,,118,,,,,,,,,,,,,,,,,,,,,,,,,,,,,,,,,,,,45.1,12,22,244,96,,1016,0,273,0,4,3,Balve,1,0,,,"Balve Running",,,3113,,250,3,8033608582,0,168070,250480,30378,,23436642,,,,,,,,,,,,,,,,,,,,,,,,,,,,,,,,,,,,,,,,"3,4",
37652879,23d982c1-9b9d-4ec6-81ee-45aac8094456,1640954451,60,1640956342,,0,0,4.44,1376,1490,48,60,,,0,0.4,0.41,1,1.03,,286,140,164,,,,57.16,36.6,57.73,1,57.49,1070,60,,2.6,0,100,100,,,,7,3,26,79,11.74,11.7,11.82,11.5,11.9,277,277,,1,283,283,,,,,,,,,"5,2,17,39,31,6,1,0,0","1,36,60,2,0","0,0,72,28,0",,,,,123,,,,,,,,,,,,,,,,,,,,,,,,,,,,,,,,,,,,33.6,11,18,225,80,,1019,1,281,0,3,3,Balve,1,0,,,"Balve Running",,,3113,,250,3,8036974801,0,168070,250480,30378,,23472090,,,,,,,,,,,,,,,,,,,,,,,,,,,,,,,,,,,,,,,,,
37652899,a8298cf3-340e-42ce-99a9-f1064a75603a,1640956170,60,1640956362,,0,0,3.6,996,996,198,0,,,0,3,0.78,1.15,,716,266,171,183,,,,49.28,41.25,56.05,1,57.41,2209,129,,3.4,0.5,97,99,,,,20,2,44,84,15.92,13.18,16.71,23.1,28.4,428,428,,1,450,450,,,,,,,,,"0,0,3,17,45,26,8,1,0","1,3,10,74,12","0,0,1,29,70",,,,,129,,,,,,,,,,,,,,,,,,,,,,,,,,,,,,,,,,,,100.1,12,22,230,78,,1018,0,288,0,4,3,Balve,1,0,,,"Balve Running",,,3113,,250,3,8036976870,0,168070,250480,30378,,23472103,,,,,,,,,,,,,,,,,,,,,,,,,,,,,,,,,,,,,,,,4,
37654335,b88d8b14-3b4a-4c5d-b36b-f6a53e86c83e,1640957809,60,1640956840,,0,0,5.67,1781,1933,60,241,,,0,2.2,0.93,1.15,1.06,1014,326,131,145,100,,,61.13,36.54,59.53,1,57.57,2736,42,,2.2,0,101,100,,,,7,3,31,78,11.04,11.7,11.55,-5.5,-18.4,241,241,,1,260,260,,,,,,,,,"13,5,7,31,35,8,0,0,0","1,88,11,0,0","0,14,75,8,3",,,,,122,,,,,,,,,,,,,,,,,,,,,,,,,,,,,,,,,,,,18.1,11,22,234,78,,1017,0,293,0,3,3,Balve,1,0,U1.466|7:48-U1.000|5:08-U1.000|4:52-U1.000|4:39-U1.000|5:54-U0.203|1:20,,"Balve Running",,,3113,,250,3,8037011739,0,168070,250480,30378,,23473519,,,,,,,,,,,,,,,,,,,,,,,,,,,,,,,,,,,,,,,,4,
37720146,a5132b39-934b-433c-9403-b1d81b8bf27c,1641034373,60,1641037031,,0,0,14.69,4405,4701,316,317,,,4,3.6,0.64,1,1.01,549,1049,151,168,,,,53.74,41.22,55.17,1,,,,,,,,,,,,,,126,81,12.57,12.35,12.81,-6.6,1.6,300,300,,1,309,309,,,,,,,,,"9,9,15,13,20,29,4,0,0","0,12,78,10,0","0,4,44,47,4",,,,,124,,,,,,,,,,,,,,,,,,,,,,,,,,,,,,,,,,,,52.7,11,8,190,86,,1025,,,0,4,1,Balve,1,0,U1.000|4:47-U1.000|5:25-U1.000|6:00-U1.000|5:50-U1.000|5:36-U1.000|5:56-U1.000|4:51-U1.000|4:22-U1.000|4:22-U1.000|4:22-U1.000|4:19-U1.000|4:25-U1.000|4:30-U1.000|4:39-U0.660|4:01,,,,,wahoo_fitness-33,,518,7,,0,168070,250480,30378,,23533356,,,,,,,,,,,,,,,,,,,,,,,,,,,,,,,,,,,,,,,,3,
37776397,de4fcb32-dce6-467a-bdcf-52a28740f1ec,1641115596,60,1641118575,,0,0,19.52,6221,6425,612,613,,,4,5.6,0.78,1.17,1.01,594,1573,161,213,,,,45.42,39.28,47.19,1,,,,,,,,,,,,,,243,81,12.27,11.74,12.77,-5,-7.8,287,286,,1,306,305,,,,,,,,,"19,14,11,13,22,18,3,0,0","0,7,36,52,5","1,9,50,33,7",,,,,116,,,,,,,,,,,,,,,,,,,,,,,,,,,,,,,,,,,,108.9,8,13,187,78,,1016,0,295,0,4,3,Balve,1,0,U1.000|5:15-U1.000|6:31-U1.000|6:21-U1.000|6:00-U1.000|5:37-U1.000|5:20-U1.000|4:31-U1.000|4:31-U1.000|4:42-U1.000|4:44-U1.000|5:18-U1.000|6:43-U1.000|5:53-U1.000|5:40-U1.000|4:41-U1.000|4:30-U1.000|4:22-U1.000|4:33-U1.000|5:01-U0.491|3:28,,,,,wahoo_fitness-33,,518,7,,0,168070,250480,30378,,23581484,,,,,,,,,,,,,,,,,,,,,,,,,,,,,,,,,,,,,,,,"3,3",
37855446,844acb09-ffe5-4de8-8c55-9d122adfa763,1641213732,60,1641213164,,0,0,1.4,1121,2474,26,18,,,0,0.9,0.58,,,,180,125,153,,,,,,,1,57.57,468,30,,1.8,0.4,,100,,,,,,16,64,,4.89,,16.3,,,,,,,,,,,,,,,,"58,41,1,0,0,0","5,89,6,0,0",,,,,,,,,,,,,,,,,,,,,,,,,,,,,,,,,,,,,,,,,,6.6,8,24,245,88,,1012,0,328,0,6,3,Balve,1,0,U0.770|9:17-U0.003|0:02-U0.002|0:01-U0.620|9:21,,"Balve Hiking",,,3113,,250,3,8053336746,0,168075,,30378,,23651761,,,,,,,,,,,,,,,,,,,,,,,,,,,,,,,,,,,,,,,,,
37855571,95fd3da7-fbb1-4c52-bfb6-d6d1f0927e39,1641213832,60,1641213448,,0,0,6.75,2168,2256,103,102,,,4,1.6,0.66,1.16,1.02,413,500,151,175,,,,49.38,35.96,50.32,1,,,,,,,,,,,,,,52,79,11.41,11.47,11.97,-13.8,-33.3,272,272,,1,297,297,,,,,,,,,"8,8,23,38,15,2,5,1,0","0,20,48,32,0","1,3,77,14,6",,,,,118,,,,,,,,,,,,,,,,,,,,,,,,,,,,,,,,,,,,38.1,7,23,245,88,,1012,0,328,0,6,3,Balve,1,0,U1.000|5:38-U1.000|5:13-U1.000|5:35-U1.000|5:13-U0.124|0:42-U0.038|0:10-U1.000|4:57-U1.000|5:41-U0.572|2:59,,,,,wahoo_fitness-33,,518,7,,0,168070,250480,30378,,23651870,,,,,,,,,,,,,,,,,,,,,,,,,,,,,,,,,,,,,,,,5,
37947340,afce3b71-88de-4733-9ac4-50f2c297d179,1641322628,60,1641321765,,0,0,4.71,1286,1286,13,19,,,0,0,0.1,0.93,0.29,,320,147,171,,,,62.62,42.66,62.74,1,57.57,1048,66,,2.8,0,,100,,,,7,3,19,80,13.45,14.99,15.17,30.8,13.5,340,339,,1,396,395,,,,,,,,,"20,1,2,2,2,11,45,16,1","3,24,42,31,0","19,2,6,15,59",,,,,137,,,,,,,,,,,,,,,,,,,,,,,,,,,,,,,,,,,,31.9,6,12,302,92,,998,0,355,1,6,3,"Menden (Sauerland)",1,0,U2.150|8:00-U0.198|1:01-U0.841|3:09-U0.319|3:53-U1.127|3:59-U0.080|1:23,,"Menden (Sauerland) Running",,,3113,,250,3,8061098819,0,168070,250480,30378,,23732446,,,,,,,,,,,,,,,,,,,,,,,,,,,,,,,,,,,,,,,,,
37947356,6da5ba0f-215e-4395-a559-5f3ccb2eacb6,1641324241,60,1641321783,,0,0,3.53,1016,1016,21,38,,,4,0.1,0.31,0.98,0.95,,226,144,186,,,,60.34,39.33,60.42,1,,,,,,,,,,,,,,22,79,12.51,12.95,12.91,-4.7,-0.5,302,302,,1,317,317,,,,,,,,,"18,7,11,16,16,12,9,5,7","2,40,44,11,3","1,7,45,35,11",,,,,132,,,,,,,,,,,,,,,,,,,,,,,,,,,,,,,,,,,,32,6,11,302,92,,998,0,355,1,6,3,"Menden (Sauerland)",1,0,U1.000|4:42-U1.000|4:43-U1.000|5:06-U0.511|2:26,,,,,wahoo_fitness-33,,518,7,,0,168070,250480,30378,,23732462,,,,,,,,,,,,,,,,,,,,,,,,,,,,,,,,,,,,,,,,,
37947370,3959eb0e-6d91-493a-8bc5-50cebc971a6b,1641321249,60,1641321800,,0,0,3.85,1032,1032,19,16,,,4,0,0.16,1.02,0.89,,250,153,168,,,,60.58,43,61.01,1,,,,,,,,,,,,,,27,81,13.52,13.58,13.63,3,1.8,335,335,,1,339,339,,,,,,,,,"5,1,3,10,21,40,16,4,0","0,3,89,8,0","0,2,16,79,3",,,,,138,,,,,,,,,,,,,,,,,,,,,,,,,,,,,,,,,,,,30.4,6,11,302,92,,998,0,355,1,6,3,"Menden (Sauerland)",1,0,U1.000|4:31-U1.000|4:24-U1.000|4:17-U0.839|3:59,,,,,wahoo_fitness-33,,518,7,,0,168070,250480,30378,,23732475,,,,,,,,,,,,,,,,,,,,,,,,,,,,,,,,,,,,,,,,,
37998295,52fe42d8-f88f-4200-a96d-105ee3277abe,1641386116,60,1641387491,,0,0,13.85,4803,4803,328,336,,,0,3.7,0.76,0.98,0.94,463,1025,158,178,,,,42.08,34.61,43.29,1,57.25,2210,153,,3.7,0,95,97,,,,7,3,147,79,10.96,10.73,11.16,3.2,10.1,251,251,,1,261,261,,,,,,,,,"30,11,15,17,24,3,0,0,0","0,3,54,42,0","1,14,73,13,0",,,,,110,,,,,,,,,,,,,,,,,,,,,,,,,,,,,,,,,,,,58.5,1,28,259,100,,1006,0,386,0,7,3,Balve,1,0,,,"Balve Running",,,3113,,250,3,8064914327,0,168070,250480,30378,,23777864,,,,,,,,,,,,,,,,,,,,,,,,,,,,,,,,,,,,,,,,"4,4",
38050091,e123ea46-3809-436b-8a42-15ca2c3396b1,1641466986,60,1641468338,,0,0,14.5,4406,4406,318,318,,,4,3.7,0.67,1.08,1.07,486,1150,160,187,,,,48.63,40.55,49.95,1,,,,,,,,,,,,,,161,81,12.44,13.17,13.53,-19.9,-6.1,309,300,,1,335,333,,,,,,,,,"14,7,11,14,13,14,14,8,5","4,3,26,63,3","6,2,40,37,15",,,,,122,,,,,,,,,,,,,,,,,,,,,,,,,,,,,,,,,,,,89.8,2,7,217,88,,1019,0,326,0,3,3,Balve,1,0,U1.000|4:55-U1.000|9:40-U1.000|5:45-U1.000|5:39-U1.000|5:22-U1.000|5:41-U1.000|4:33-U1.000|4:06-U1.000|3:56-U1.000|3:57-U1.000|3:50-U1.000|3:35-U1.000|3:40-U1.000|6:03-U0.468|2:43,,,,,wahoo_fitness-33,,518,7,,0,168070,250480,30378,,23822564,,,,,,,,,,,,,,,,,,,,,,,,,,,,,,,,,,,,,,,,3,
38103757,c7d762d0-b3ba-4588-955c-b1112c77721e,1641559719,60,1641559135,,0,0,9.83,2944,2944,153,154,,,4,2.4,0.67,1.01,1.09,651,633,145,177,,,,56.92,40.04,58,1,,,,,,,,,,,,,,76,80,12.45,12.59,12.64,-11.3,-13.2,297,297,,1,303,303,,,,,,,,,"14,9,15,18,16,11,11,4,1","1,26,58,15,0","0,1,56,41,3",,,,,125,,,,,,,,,,,,,,,,,,,,,,,,,,,,,,,,,,,,44.5,2,15,205,94,,1012,0,387,0,4,3,Balve,1,0,U1.000|5:49-U1.000|4:15-U1.000|4:43-U1.000|5:16-U1.000|5:04-U1.000|5:37-U1.000|5:05-U1.000|3:45-U1.000|4:34-U0.820|4:56,,,,,wahoo_fitness-33,,518,7,,0,168070,250480,30378,,23869889,,,,,,,,,,,,,,,,,,,,,,,,,,,,,,,,,,,,,,,,"5,5",
38156257,1f0286ab-e76b-48de-813b-88c94eeae4ea,1641640365,60,1641641612,,0,0,15.13,4185,4769,277,273,,,4,3.3,0.51,1.15,0.92,678,1092,163,187,,,,53.1,45.38,54.32,1,,,,,,,,,,,,,,162,83,13.49,13.76,14.37,0,3.6,332,332,,1,363,363,,,,,,,,,"12,6,10,10,12,25,13,12,0","0,10,24,58,7","0,7,33,34,25",,,,,131,,,,,,,,,,,,,,,,,,,,,,,,,,,,,,,,,,,,92.7,2,16,216,91,,1012,0,382,0,3,3,Balve,1,0,U1.000|5:49-U0.262|1:33-U0.116|0:32-U0.115|0:47-U0.239|1:08-U0.117|0:47-U0.347|1:32-U0.128|0:46-U0.132|0:32-U0.125|0:46-U0.254|1:02-U0.130|0:46-U0.368|1:32-U0.121|0:47-U0.126|0:32-U0.111|0:48-U0.226|1:03-U0.108|0:47-U0.314|1:32-U0.108|0:47-U0.136|0:32-U0.149|0:47-U0.456|1:50-U1.000|5:11-U1.000|4:14-U0.944|4:02-U0.557|2:02-U0.601|2:02-U0.502|2:01-U0.589|2:02-U0.518|2:03-U0.595|2:00-U0.450|2:01-U0.577|2:02-U0.470|2:03-U0.614|2:02-U1.000|6:32-U0.520|2:34,,,,,wahoo_fitness-33,,518,7,,0,168070,250480,30378,,23916317,,,,,,,,,,,,,,,,,,,,,,,,,,,,,,,,,,,,,,,,3,
38198209,50992cf7-2e9c-47a7-b917-6e2cd5361714,1641720627,60,1641723865,,0,0,0.59,301,301,5,0,,,4,0.1,0.31,0.82,,,59,133,165,,,,32.93,16.75,33.63,1,,,,,,,,,,,,,,6,80,7.29,10.26,10.43,55.1,22.3,257,176,,1,281,253,,,,,,,,,"13,5,6,19,15,6,1,0,35","22,27,26,26,0","37,3,41,18,0",,,,,74,,,,,,,,,,,,,,,,,,,,,,,,,,,,,,,,,,,,16.1,3,20,256,99,,999,0,415,0,6,3,Balve,1,0,,,,,,wahoo_fitness-33,,518,7,,0,168070,250480,30378,,23953325,,,,,,,,,,,,,,,,,,,,,,,,,,,,,,,,,,,,,,,,,
38198213,4ff7a015-c08a-488c-887f-3dc164d4f43d,1641721007,60,1641723866,,0,0,20.41,6119,6119,479,483,,,4,4.1,0.78,1.06,1.05,531,1437,149,174,,,,54.77,42.33,56.34,1,,,,,,,,,,,,,,170,81,12.58,12.33,12.97,-7,-5.7,301,301,,1,315,315,,,,,,,,,"5,7,14,20,27,24,3,0,0","0,25,47,28,0","1,5,44,42,8",,,,,124,,,,,,,,,,,,,,,,,,,,,,,,,,,,,,,,,,,,62.6,4,22,330,97,,1000,0,415,0,6,3,Balve,1,0,U1.000|5:37-U1.000|5:55-U1.000|5:31-U1.000|5:59-U1.000|5:18-U1.000|4:33-U1.000|5:23-U1.000|6:07-U1.000|4:15-U1.000|4:13-U1.000|4:24-U1.000|4:32-U1.000|4:38-U1.000|5:02-U1.000|4:25-U1.000|4:46-U1.000|5:06-U1.000|4:48-U1.000|4:41-U1.000|4:56-U0.376|1:50,,,,,wahoo_fitness-33,,518,7,,0,168070,250480,30378,,23953327,,,,,,,,,,,,,,,,,,,,,,,,,,,,,,,,,,,,,,,,"4,5,5",
38270841,6c85c5b7-c3cb-4e5f-bbd6-199b2518347b,1641819243,60,1641818949,,0,0,9.92,3118,3118,170,171,,,4,2.2,0.65,1.05,1.01,690,679,147,187,,,,52.63,37.86,53.74,1,,,,,,,,,,,,,,88,80,11.81,11.74,11.93,6.1,4.6,279,279,,1,284,284,,,,,,,,,"11,10,16,22,27,10,3,0,0","8,16,41,34,2","0,1,73,26,0",,,,,119,,,,,,,,,,,,,,,,,,,,,,,,,,,,,,,,,,,,23.9,4,2,248,94,,1023,0,361,0,3,3,Balve,1,0,U1.000|5:49-U1.000|5:04-U1.000|5:28-U1.000|5:24-U1.000|5:10-U1.000|5:39-U1.000|5:28-U1.000|4:16-U1.000|4:32-U0.904|5:09,,,,,wahoo_fitness-33,,518,7,,0,168070,250480,30378,,24018148,,,,,,,,,,,,,,,,,,,,,,,,,,,,,,,,,,,,,,,,5,
38339627,f968524e-6019-4002-81c5-3e949e84acdf,1641931153,60,1641929011,,0,0,3.35,1122,1122,10,20,,,4,0,0.09,1.18,0.86,,283,159,170,,,,43.53,32.79,43.53,1,,,,,,,,,,,,,,13,81,10.71,10.82,10.83,-2.5,-4.1,251,251,,1,256,256,,,,,,,,,"8,8,34,40,8,1,0,0,0","0,3,52,45,0","1,6,84,9,0",,,,,111,,,,,,,,,,,,,,,,,,,,,,,,,,,,,,,,,,,,8.8,0,6,172,84,,1036,0,317,1,3,3,"Menden (Sauerland)",1,0,U1.000|5:52-U1.000|5:29-U1.000|5:26-U0.341|1:55,,,,,wahoo_fitness-33,,518,7,,0,168070,250480,30378,,24076555,,,,,,,,,,,,,,,,,,,,,,,,,,,,,,,,,,,,,,,,,
38339629,2df50239-cfa2-43ab-940b-0fed4ecfb5d8,1641928653,60,1641929013,,0,0,7.94,2345,2345,112,119,,,4,1.3,0.57,1.14,0.81,,563,155,211,,,,52.76,40.12,53.62,1,,,,,,,,,,,,,,38,83,12.31,13.69,13.88,-20.1,-23,305,305,,1,357,357,,,,,,,,,"43,5,2,2,2,4,9,20,12","1,20,40,27,12","6,28,19,12,34",,,,,122,,,,,,,,,,,,,,,,,,,,,,,,,,,,,,,,,,,,45.8,0,6,168,86,,1036,0,317,1,3,3,"Menden (Sauerland)",1,0,U0.500|1:40-U0.100|0:49-U0.300|0:57-U0.100|0:56-U0.500|1:41-U0.100|0:46-U0.300|0:55-U0.427|3:43-U0.300|0:58-U0.100|0:38-U0.200|0:36-U0.127|0:50-U0.300|1:00-U0.100|0:46-U0.200|0:37-U0.607|5:24-U0.500|1:43-U0.100|0:42-U0.300|0:59-U0.140|1:02-U0.500|1:39-U0.100|0:47-U0.300|0:59-U0.431|3:18-U0.300|0:58-U0.100|0:52-U0.200|0:38-U0.100|0:44-U0.300|0:58-U0.100|0:47-U0.200|0:36-U0.020|0:07,,,,,wahoo_fitness-33,,518,7,,0,168070,250480,30378,,24076557,,,,,,,,,,,,,,,,,,,,,,,,,,,,,,,,,,,,,,,,,
38339630,2a88a7c1-82a8-4dcc-ab78-5383a981b2f9,1641927789,60,1641929014,,0,0,2.03,747,747,29,37,,,4,0,0.1,1.39,1.82,,191,165,193,,,,36.63,28.21,37.1,1,,,,,,,,,,,,,,16,81,10.03,10.96,11.04,2.4,-16.2,252,233,,1,267,261,,,,,,,,,"48,10,9,5,5,4,4,7,9","0,3,37,47,13","12,16,44,26,0",,,,,101,,,,,,,,,,,,,,,,,,,,,,,,,,,,,,,,,,,,26.8,0,6,168,86,,1036,0,317,1,3,3,"Menden (Sauerland)",1,0,U0.051|0:19-U0.179|1:26-U0.292|1:28-U0.096|0:21-U0.156|1:11-U0.100|0:20-U0.173|1:10-U0.101|0:20-U0.175|1:05-U0.101|0:20-U0.171|1:11-U0.119|0:21-U0.179|1:13-U0.104|0:21-U0.034|1:22,,,,,wahoo_fitness-33,,518,7,,0,168070,250480,30378,,24076558,,,,,,,,,,,,,,,,,,,,,,,,,,,,,,,,,,,,,,,,,
38339631,82f2691f-738f-4d3b-93e8-1636f35c4c30,1641926219,60,1641929015,,0,0,4.11,1139,1139,10,24,,,4,0,0.1,,0.94,,288,161,174,,,,53.97,41.55,53.91,1,,,,,,,,,,,,,,16,81,12.94,13.22,13.21,-5,-2.8,316,316,,1,327,327,,,,,,,,,"5,2,4,13,32,31,8,3,1","0,2,38,60,0","1,5,28,61,6",,,,,134,,,,,,,,,,,,,,,,,,,,,,,,,,,,,,,,,,,,12.1,0,6,173,89,,1035,0,317,1,3,3,"Menden (Sauerland)",1,0,U1.000|4:34-U1.000|4:50-U1.000|4:31-U1.000|4:33-U0.101|0:31,,,,,wahoo_fitness-33,,518,7,,0,168070,250480,30378,,24076559,,,,,,,,,,,,,,,,,,,,,,,,,,,,,,,,,,,,,,,,,
38365800,686ec458-86ed-49f7-a3f6-69d54f28e971,1641992104,60,1641991837,,0,0,9.11,3191,3191,147,151,,,4,1.9,0.64,1.1,1.07,247,781,154,169,,,,43.14,33.11,43.98,1,,,,,,,,,,,,,,31,79,10.58,10.49,10.78,8.1,10.7,245,245,,1,253,253,,,,,,,,,"18,24,22,23,11,2,0,0,0","1,12,59,29,0","2,12,78,9,0",,,,,108,,,,,,,,,,,,,,,,,,,,,,,,,,,,,,,,,,,,10.2,2,5,264,98,,1039,1,327,0,4,3,Balve,1,0,U1.000|5:29-U1.000|5:55-U1.000|6:01-U1.000|5:56-U1.000|5:51-U1.000|5:55-U1.000|5:37-U1.000|6:30-U1.000|5:27-U0.089|0:30,,,,,wahoo_fitness-33,,518,7,,0,168070,250480,30378,,24099909,,,,,,,,,,,,,,,,,,,,,,,,,,,,,,,,,,,,,,,,5,
38416397,fa4c6809-c222-4e52-b8a1-53c097826ad0,1642078538,60,1642080555,,0,0,15.6,4969,4984,400,398,,,4,4.3,0.8,1.11,1.01,551,1248,159,178,,,,46.31,38.6,47.79,1,,,,,,,,,,,,,,66,80,11.98,11.62,12.31,1.2,11.4,281,281,,1,293,293,,,,,,,,,"13,12,18,18,22,14,2,0,0","0,1,51,49,0","0,5,61,30,4",,,,,118,,,,,,,,,,,,,,,,,,,,,,,,,,,,,,,,,,,,21.8,4,7,238,83,,1041,1,286,0,2,3,Balve,1,0,U1.000|5:50-U1.000|6:06-U1.000|5:36-U1.000|6:27-U1.000|5:25-U1.000|5:00-U1.000|5:38-U1.000|5:39-U1.000|5:20-U1.000|5:23-U1.000|5:43-U1.000|4:57-U1.000|4:29-U1.000|4:28-U1.000|4:14-U0.577|2:34,,,,,wahoo_fitness-33,,518,7,,0,168070,250480,30378,,24143482,,,,,,,,,,,,,,,,,,,,,,,,,,,,,,,,,,,,,,,,"3,5,5",
38453286,19fda770-c1dd-41ce-93cf-dd594d2c56f8,1642163349,60,1642160425,,0,0,1.72,502,502,0,2,,,4,0,0,,,,126,157,170,,,,52.55,36.19,52.48,1,,,,,,,,,,,,,,6,79,12.3,12.37,12.39,2.2,0.9,300,300,,1,302,302,,,,,,,,,"2,0,0,18,68,12,0,0,0","0,10,44,46,0","0,3,45,52,0",,,,,130,,,,,,,,,,,,,,,,,,,,,,,,,,,,,,,,,,,,6.7,3,6,273,87,,1036,1,299,0,2,3,Balve,1,0,U1.000|4:59-U0.718|3:24,,,,,wahoo_fitness-33,,518,7,,0,168070,250480,30378,,24174930,,,,,,,,,,,,,,,,,,,,,,,,,,,,,,,,,,,,,,,,,
38453287,a45b47fc-6384-4e8a-85f7-cf5124b1c611,1642162747,60,1642160426,,0,0,1.91,558,558,0,0,,,4,0,0,,,,132,150,167,,,,56.02,36.57,56.02,1,,,,,,,,,,,,,,4,81,12.3,12.61,12.63,-4.2,-0.8,307,302,,1,313,311,,,,,,,,,"2,1,1,9,57,31,0,0,0","0,14,68,18,0","4,2,15,79,0",,,,,127,,,,,,,,,,,,,,,,,,,,,,,,,,,,,,,,,,,,4.1,2,6,273,87,,1036,1,299,0,2,3,Balve,1,0,U0.300|1:51-U0.400|1:52-U0.400|1:48-U0.400|1:51-U0.400|1:54-U0.006|0:02,,,,,wahoo_fitness-33,,518,7,,0,168070,250480,30378,,24174931,,,,,,,,,,,,,,,,,,,,,,,,,,,,,,,,,,,,,,,,,
38455680,19c54cd5-cb4f-415a-94c8-4e048cb2a310,1642165296,60,1642165064,,0,0,25.63,3309,3309,,,,,0,,,,,,488,118,127,,,,,,,1,,,,,,,,,,,,,,0,83,,28.44,,,,147,147,,0,171,170,,,,,,,,,"0,0,37,29,29,5,0","0,100,0,0,0","40,30,30,0,0",,,,,,,,,,,,,,,,,,,,,,,,,,,,,,,,,,,,,,,,,0,,,,,,,,,,1,,,1,0,U4.009|8:42-U1.225|3:00-U0.258|0:30-U0.635|1:30-U0.547|1:00-U0.632|1:30-U0.840|1:30-U0.633|1:30-U1.126|2:00-U0.640|1:30-U0.835|1:30-U0.638|1:30-U0.549|1:00-U0.638|1:30-U0.257|0:30-U2.499|6:00-U0.261|0:30-U0.633|1:30-U0.545|1:00-U0.639|1:30-U0.840|1:30-U0.636|1:30-U1.093|2:00-U0.642|1:30-U0.842|1:30-U0.637|1:30-U0.544|1:00-U0.641|1:30-U0.274|0:30-U1.437|3:27,,,,,,,252,7,,0,168072,,30378,,24177069,,,,,,,,,,,,,,,,,,,,,,,,,,,,,,,,,,,,,,,,,
38497543,fa7f939f-be7b-45a8-b958-4572b04ccfed,1642237208,60,1642240164,,0,0,17.16,5895,6136,605,605,,,4,5.5,0.81,1.05,0.94,535,1402,155,212,,,,43.78,35.6,45.7,1,,,,,,,,,,,,,,80,80,11.57,11.03,11.98,-4.9,-4.3,264,264,,1,282,282,,,,,,,,,"33,15,11,13,18,8,3,0,0","0,10,58,28,4","0,21,49,27,3",,,,,109,,,,,,,,,,,,,,,,,,,,,,,,,,,,,,,,,,,,175.3,1,5,128,88,,1030,,,0,4,1,Balve,1,0,U1.000|6:23-U1.000|6:42-U1.000|6:09-U1.000|6:35-U1.000|6:24-U1.000|6:12-U1.000|5:51-U1.000|5:02-U1.000|5:12-U1.000|7:07-U1.000|6:48-U1.000|6:07-U1.000|5:03-U1.000|4:44-U1.000|4:46-U1.000|4:32-U0.101|0:27-U1.000|3:57-U0.033|0:14,,,,,wahoo_fitness-33,,518,7,,0,168070,250480,30378,,24213920,,,,,,,,,,,,,,,,,,,,,,,,,,,,,,,,,,,,,,,,"3,4,5",
38554374,573fe83a-5925-4400-9244-5b05e5bb72c6,1642328961,60,1642329720,,0,0,13.46,4145,4209,38,37,,,4,0,0.03,,0.97,,880,140,172,,,,57.61,39.68,57.82,1,,,,,,,,,,,,,,11,80,11.72,11.72,11.77,-1.5,-1.3,281,281,,1,283,283,,,,,,,,,"2,2,9,52,30,5,0,0,0","0,64,31,4,0","0,0,82,18,0",,,,,122,,,,,,,,,,,,,,,,,,,,,,,,,,,,,,,,,,,,6.7,3,11,254,92,,1025,0,323,0,3,3,Porz,1,0,U1.000|5:02-U1.000|4:57-U1.000|5:10-U1.000|5:10-U1.000|5:09-U1.000|5:04-U1.000|5:03-U1.000|5:09-U1.000|5:09-U1.000|5:10-U1.000|5:10-U1.000|5:06-U1.000|5:25-U0.431|2:18-U0.005|0:03,,,,,wahoo_fitness-33,,518,7,,0,168070,250480,30378,,24264835,,,,,,,,,,,,,,,,,,,,,,,,,,,,,,,,,,,,,,,,,
38584778,c3c014c3-376f-408e-a444-51e1163850ee,1642362051,60,1642359202,,0,0,5.01,719,719,,,,,0,,,,,,81,,,,,,,,,1,,,,,,,,,,,,,,0,81,,25.3,,,,113,112,,0,118,118,,,,,,,,,"3,1,35,57,3,0,0",,"38,58,4,0,0",,,,,,,,,,,,,,,,,,,,,,,,,,,,,,,,,,,,,,,,,,,,,,,,,,,1,,,1,0,U2.554|6:09-U2.453|5:50,,,,,,,252,7,,0,168072,,30378,,24291694,,,,,,,,,,,,,,,,,,,,,,,,,,,,,,,,,,,,,,,,,
38586745,76b89e51-cf3a-460e-a064-b014113b012d,1642362870,60,1642361657,,0,0,12.92,1774,1774,,,,,0,,,,,,227,,,,,,,,,1,,,,,,,,,,,,,,0,80,,26.59,,,,129,128,,0,154,153,,,,,,,,,"1,1,40,48,5,3,2",,"38,54,1,5,2",,,,,,,,,,,,,,,,,,,,,,,,,,,,,,,,,,,,,,,,,,,,,,,,,,,1,,,1,0,U4.701|11:00-U0.945|2:10-U0.942|2:10-U0.937|2:10-U0.299|0:30-U2.108|5:00-U0.301|0:30-U2.082|5:00-U0.302|0:30-U0.300|0:34,,,,,,,252,7,,0,168072,,30378,,24293439,,,,,,,,,,,,,,,,,,,,,,,,,,,,,,,,,,,,,,,,,
38618616,bc7bbcd1-e2d2-46d6-b55c-771397b80c30,1642421561,60,1642423275,,0,0,14.01,4639,4680,442,443,,,4,4.7,0.82,1.17,0.99,439,1156,157,179,,,,44.97,36.57,46.73,1,,,,,,,,,,,,,,58,81,11.83,11.32,12.32,5.3,19.2,274,274,,1,292,292,,,,,,,,,"21,16,18,15,16,13,2,1,0","1,12,38,49,0","0,14,50,31,4",,,,,112,,,,,,,,,,,,,,,,,,,,,,,,,,,,,,,,,,,,18.1,3,19,281,99,,1031,1,295,0,4,3,Balve,1,0,U1.000|5:49-U1.000|6:04-U1.000|5:44-U1.000|6:16-U1.000|6:02-U1.000|6:18-U1.000|5:42-U1.000|6:12-U1.000|6:11-U1.000|5:20-U1.000|4:34-U1.000|4:30-U1.000|4:15-U0.988|4:22,,,,,wahoo_fitness-33,,518,7,,0,168070,250480,30378,,24323358,,,,,,,,,,,,,,,,,,,,,,,,,,,,,,,,,,,,,,,,"3,4",
38630215,7b93674a-bd01-4009-b89e-f61d6b39c950,1642443406,60,1642440601,,0,0,1.32,723,723,16,16,,,4,0.2,0.3,,,,98,122,134,,,,,,,1,,,,,,,,,,,,,,0,62,,6.66,,9.4,,,,,,,,,,,,,,,,"7,93,0,0,0,0","0,100,0,0,0",,,,,,,,,,,,,,,,,,,,,,,,,,,,,,,,,,,,,,,,,,0,6,16,309,92,,1033,0,287,1,6,3,Balve,1,0,U1.000|9:01-U0.322|3:01,,,,,wahoo_fitness-33,,518,7,,0,168075,,30378,,24333600,,,,,,,,,,,,,,,,,,,,,,,,,,,,,,,,,,,,,,,,,
38657160,d72ad8f2-af5c-4686-a7e6-79ee49e81d9e,1642492954,60,1642490282,,0,0,,914,914,,,,,0,,,,,,71,,,,,,,,,1,,,,,,,,,,,,,,0,,,,,,,,,,,,,,,,,,,,,,,,,,,,,,,,,,,,,,,,,,,,,,,,,,,,,,,,,,,,,,,,,,,,,,,,,,1,,,1,0,,,,,,,,252,7,,0,168073,,30378,,24358686,,,,,,,,,,,,,,,,,,,,,,,,,,,,,,,,,,,,,,,,,
38657493,7de2bb83-b1fe-4082-9595-1c7918b6a54e,1642493905,60,1642491192,,0,0,,865,865,,,,,0,,,,,,67,,,,,,,,,1,,,,,,,,,,,,,,0,,,,,,,,,,,,,,,,,,,,,,,,,,,,,,,,,,,,,,,,,,,,,,,,,,,,,,,,,,,,,,,,,,,,,,,,,,1,,,1,0,,,,,,,,252,7,,0,168073,,30378,,24358988,,,,,,,,,,,,,,,,,,,,,,,,,,,,,,,,,,,,,,,,,
38701481,988c6534-6812-4df2-bad2-1cc5469caec4,1642534248,60,1642532726,,0,0,3.18,1182,1182,10,12,,,4,0,0.06,1.08,0.91,,255,146,170,,,,43.2,28.86,43.33,1,,,,,,,,,,,,,,8,78,9.69,9.71,9.76,0.5,-0.9,223,223,,1,226,226,,,,,,,,,"30,33,23,10,3,1,0,0,0","2,29,53,15,0","0,21,78,1,0",,,,,103,,,,,,,,,,,,,,,,,,,,,,,,,,,,,,,,,,,,5.6,3,5,163,91,,1036,0,295,1,3,3,"Menden (Sauerland)",1,0,U1.000|6:19-U1.000|6:17-U1.000|6:01-U0.171|1:05,,,,,wahoo_fitness-33,,518,7,,0,168070,250480,30378,,24398497,,,,,,,,,,,,,,,,,,,,,,,,,,,,,,,,,,,,,,,,,
38701482,6cbcb3c6-c896-4d25-8bc6-741ce9912342,1642532825,60,1642532726,,0,0,3.47,1012,1012,65,64,,,4,0.9,0.47,1.09,0.74,,246,154,178,,,,54.09,38.68,55.36,1,,,,,,,,,,,,,,13,80,12.44,14.14,14.46,19.3,3.8,313,313,,1,375,375,,,,,,,,,"34,5,3,2,3,6,19,25,4","0,23,30,48,0","19,9,16,17,39",,,,,129,,,,,,,,,,,,,,,,,,,,,,,,,,,,,,,,,,,,10.1,2,4,163,91,,1036,0,295,1,3,3,"Menden (Sauerland)",1,0,U0.475|1:41-U0.100|0:40-U0.500|1:42-U0.100|0:37-U0.500|1:49-U0.300|2:11-U0.100|0:37-U0.500|1:45-U0.200|2:33-U0.400|1:23-U0.300|1:54,,,,,wahoo_fitness-33,,518,7,,0,168070,250480,30378,,24398498,,,,,,,,,,,,,,,,,,,,,,,,,,,,,,,,,,,,,,,,,
38701486,a058d4c6-35fd-4b52-bcf9-a14dec3fc246,1642532251,60,1642532728,,0,0,1.29,487,487,25,26,,,4,1.2,1,1.7,0.94,,97,137,177,,,,46.08,26.13,47.14,1,,,,,,,,,,,,,,2,71,9.51,10.59,11.49,17.7,12,234,234,,1,300,300,,,,,,,,,"60,1,1,2,2,3,5,14,11","2,54,35,9,0","34,19,14,11,22",,,,,112,,,,,,,,,,,,,,,,,,,,,,,,,,,,,,,,,,,,1.7,4,4,161,89,,1037,0,295,1,3,3,"Menden (Sauerland)",1,0,U1.000|6:43-U0.287|1:23,,,,,wahoo_fitness-33,,518,7,,0,168070,250480,30378,,24398501,,,,,,,,,,,,,,,,,,,,,,,,,,,,,,,,,,,,,,,,,
38701487,32bbb687-4202-45ee-96c7-4a8d7f7f0379,1642530719,60,1642532729,,0,0,4.18,1203,1203,32,32,,,4,0,0.13,1.12,1.03,375,312,160,171,,,,52,39.79,52.49,1,,,,,,,,,,,,,,16,80,12.69,12.68,12.78,-3.6,-9.5,309,309,,1,311,311,,,,,,,,,"5,2,4,19,41,25,3,0,1","0,3,43,53,0","0,3,37,58,3",,,,,130,,,,,,,,,,,,,,,,,,,,,,,,,,,,,,,,,,,,8.9,3,3,161,89,,1037,0,295,1,3,3,"Menden (Sauerland)",1,0,U1.000|4:46-U1.000|4:47-U1.000|4:48-U1.000|4:42-U0.168|0:59,,,,,wahoo_fitness-33,,518,7,,0,168070,250480,30378,,24398502,,,,,,,,,,,,,,,,,,,,,,,,,,,,,,,,,,,,,,,,5,
38727749,51afbf14-81bd-46e7-b032-6c6557e5314a,1642585675,60,1642582983,,0,0,,883,883,,,,,0,,,,,,68,,,,,,,,,1,,,,,,,,,,,,,,0,,,,,,,,,,,,,,,,,,,,,,,,,,,,,,,,,,,,,,,,,,,,,,,,,,,,,,,,,,,,,,,,,,,,,,,,,,1,,,1,0,,,,,,,,252,7,,0,168073,,30378,,24422536,,,,,,,,,,,,,,,,,,,,,,,,,,,,,,,,,,,,,,,,,
38734652,90752bd8-e8d7-4060-84a6-19307bbf66c4,1642595151,60,1642593752,,0,0,5.26,1855,2035,106,108,,,4,2.2,0.61,1.05,0.97,814,472,157,193,,,,41.6,31.69,42.62,1,,,,,,,,,,,,,,25,78,10.69,10.58,11.17,6.1,-6.1,248,248,,1,268,268,,,,,,,,,"24,15,18,30,8,2,2,0,0","1,8,54,33,4","3,10,76,5,6",,,,,109,,,,,,,,,,,,,,,,,,,,,,,,,,,,,,,,,,,,29.5,3,14,216,90,,1025,1,345,0,3,3,Balve,1,0,U1.000|6:21-U1.000|5:21-U0.468|2:56-U0.179|1:26-U0.246|1:34-U0.392|1:33-U1.000|6:40-U0.967|5:05,,,,,wahoo_fitness-33,,518,7,,0,168070,250480,30378,,24428976,,,,,,,,,,,,,,,,,,,,,,,,,,,,,,,,,,,,,,,,4,
38754653,3c947fb8-71f2-4daf-8225-c82392fbbf83,1642622827,60,1642619984,,0,0,3.53,527,527,,,,,0,,,,,,63,,,,,,,,,1,,,,,,,,,,,,,,0,80,,24.54,,,,119,118,,0,121,120,,,,,,,,,"4,8,31,58,0,0,0",,"20,77,3,0,0",,,,,,,,,,,,,,,,,,,,,,,,,,,,,,,,,,,,,,,,,,,,,,,,,,,1,,,1,0,,,,,,,,252,7,,0,168072,,30378,,24446218,,,,,,,,,,,,,,,,,,,,,,,,,,,,,,,,,,,,,,,,,
38755109,d98ae925-f473-4e31-94ac-c3512a36c2c8,1642623622,60,1642620686,,0,0,1.56,283,283,,,,,0,,,,,,26,,,,,,,,,1,,,,,,,,,,,,,,0,66,,20.5,,,,97,90,,0,101,97,,,,,,,,,"27,12,39,19,3,0,0",,"62,37,1,0,0",,,,,,,,,,,,,,,,,,,,,,,,,,,,,,,,,,,,,,,,,,,,,,,,,,,1,,,1,0,,,,,,,,252,7,,0,168072,,30378,,24446582,,,,,,,,,,,,,,,,,,,,,,,,,,,,,,,,,,,,,,,,,
38755728,7a6b01a8-bb74-49fe-b5e7-67b8a0a333c2,1642624796,60,1642621665,,0,0,,383,383,,,,,0,,,,,,29,,,,,,,,,1,,,,,,,,,,,,,,0,,,,,,,,,,,,,,,,,,,,,,,,,,,,,,,,,,,,,,,,,,,,,,,,,,,,,,,,,,,,,,,,,,,,,,,,,,1,,,1,0,,,,,,,,252,7,,0,168073,,30378,,24447101,,,,,,,,,,,,,,,,,,,,,,,,,,,,,,,,,,,,,,,,,
38755863,b1095e69-6439-4102-aa5e-c758b3810c03,1642624889,60,1642621887,,0,0,,376,376,,,,,0,,,,,,10,65,91,,,,,,,1,,,,,,,,,,,,,,0,,,,,,,,,,,,,,,,,,,,,,"100,0,0,0,0",,,,,,,,,,,,,,,,,,,,,,,,,,,,,,,,,,,,,,,,,,0,,,,,,,,,,1,,,1,0,,,,,,wahoo_fitness-33,,518,7,,0,168073,,30378,,24447221,,,,,,,,,,,,,,,,,,,,,,,,,,,,,,,,,,,,,,,,,
38792915,8bb73f69-54a2-4c97-bdc2-cf3f70e4024c,1642685893,60,1642685889,,0,0,9.69,3167,3275,326,326,320,385,4,4.3,0.85,1.15,1.02,546,771,158,179,,,,45.28,36.1,47.17,1,,,,,,,,,,,,,,40,80,12.09,11.59,12.39,3.9,19.9,279,279,,1,290,290,,,,,,,,,"22,19,15,8,14,17,5,0,0","0,4,57,39,0","0,11,55,33,1",,,,,115,,,,,,,,,,,,,,,,,,,,,,,,,,,,,,,,,,,,28.2,0,23,308,76,,1026,1,320,0,7,3,Balve,1,0,U1.000|6:13-U1.000|6:22-U1.000|5:55-U1.000|6:36-U1.000|6:32-U1.000|4:34-U1.000|4:19-U1.000|4:29-U1.000|4:24-U0.680|3:24,,,,,wahoo_fitness-33,,518,7,,0,168070,250480,30378,,24479083,,,,,,,,,,,,,,,,,,,,,,,,,,,,,,,,,,,,,,,,3,
38836826,e00ef5ec-2b04-42ec-881d-ca40663fe362,1642752748,60,1642753706,,0,0,14.21,4463,4472,341,341,351,351,4,3.6,0.7,1.08,0.98,454,1172,163,204,,,,45.4,38.95,46.75,1,,,,,,,,,,,,,,86,81,12.12,11.91,12.37,-2.4,3.4,285,285,,1,294,294,,,,,,,,,"17,14,13,14,20,18,5,0,0","0,1,41,53,5","0,5,56,37,2",,,,,118,,,,,,,,,,,,,,,,,,,,,,,,,,,,,,,,,,,,111.8,0,13,301,89,,1031,0,327,0,9,3,Balve,1,0,U1.000|5:09-U1.000|5:11-U1.000|6:32-U1.000|6:15-U1.000|6:15-U1.000|6:36-U1.000|5:04-U1.000|4:40-U1.000|4:29-U1.000|4:15-U1.000|4:09-U1.000|4:56-U1.000|4:51-U1.000|5:09-U0.182|0:53,,,,,wahoo_fitness-33,,518,7,,0,168070,250480,30378,,24516857,,,,,,,,,,,,,,,,,,,,,,,,,,,,,,,,,,,,,,,,"3,5",
38871630,49b41e65-b47b-41d7-8129-741d3ba2502b,1642800515,60,1642797324,,0,0,0.05,316,336,,,,,0,,,,,,1,120,124,,,,,,,1,,,,,,,,,,,,,,0,56,,2.81,,,,85,4,,0,86,34,,,,,,,,,"100,0,0,0,0,0,0","0,100,0,0,0","99,1,0,0,0",,,,,,,,,,,,,,,,,,,,,52,,,,,,,,,,,,,,,,,,,,1.2,,,,,,,,,,1,,,1,0,U0.050|0:26-U0.000|1:36-U0.000|0:04-U0.000|3:11,,,,,wahoo_fitness-33,,518,7,,0,168072,,30378,,24547866,,,,,,,,,,,,,,,,,,,,,,,,,,,,,,,,,,,,,,,,,
38897932,73cdce20-29a4-4419-9479-a0dcce84483c,1642843464,60,1642845688,,0,0,14.01,4479,4702,416,416,386,388,4,5,0.75,1,0.9,642,910,139,182,,,,55.52,38.11,57.57,1,,,,,,,,,,,,,,33,80,12.22,11.78,12.6,23.7,24.9,284,284,,1,299,299,,,,,,,,,"20,6,11,18,25,18,3,0,0","16,31,24,27,1","0,8,55,34,4",,,,,117,,,,,,,,,,,,,,,,,,,,,,,,,,,,,,,,,,,,67.5,4,12,304,90,,1032,0,333,0,4,3,Balve,1,0,U1.000|5:11-U1.000|5:26-U1.000|5:11-U1.000|4:40-U1.000|5:05-U1.000|4:45-U1.000|4:49-U1.000|5:29-U1.000|8:25-U1.000|6:46-U1.000|4:30-U1.000|4:26-U1.000|4:23-U0.996|5:33,,,,,wahoo_fitness-33,,518,7,,0,168070,250480,30378,,24572092,,,,,,,,,,,,,,,,,,,,,,,,,,,,,,,,,,,,,,,,"2,4",
38962493,948df0c0-326b-42fa-9d04-d7537cf2505c,1642965242,60,1642962669,,0,0,7.68,992,992,,,,,0,,,,,,146,116,142,,,,,,,1,,,,,,,,,,,,,,0,83,,28.54,,1.4,-16.2,147,147,,0,164,164,,,,,,,,,"1,1,24,33,41,0,0","7,90,3,0,0","26,53,21,0,0",,,,,,,,,,,,,,,,,,,,,,,,,,,,,,,,,,,,,,,,,8,,,,,,,,,,1,,,1,0,U1.810|4:31-U3.142|6:12-U0.867|2:02-U1.088|1:59-U0.777|1:48,,,,,,,252,7,,0,168072,,30378,,24627772,,,,,,,,,,,,,,,,,,,,,,,,,,,,,,,,,,,,,,,,,
38964292,b241c259-311b-4906-942f-c2d277894772,1642966356,60,1642965675,,0,0,22.49,2779,2779,,,,,0,,,,,,462,120,145,,,,,,,1,,,,,,,,,,,,,,0,87,,29.51,,4,-9.1,166,166,,0,177,177,,,,,,,,,"0,1,15,29,53,2,0","6,90,4,0,0","12,59,26,4,0",,,,,,,,,,,,,,,,,,,,,,,,,,,,,,,,,,,,,,,,,10.6,,,,,,,,,,1,,,1,0,U1.841|4:31-U3.077|6:12-U0.870|2:02-U1.088|1:59-U0.846|1:58-U4.124|7:59-U0.857|2:01-U2.160|4:01-U0.854|2:00-U0.350|0:40-U0.176|0:21-U0.346|0:39-U0.175|0:21-U0.345|0:39-U0.167|0:20-U0.373|0:42-U0.174|0:21-U0.351|0:40-U0.175|0:21-U0.433|0:49-U0.812|2:01-U0.190|0:21-U0.328|0:41-U0.191|0:21-U0.322|0:40-U0.191|0:21-U0.323|0:40-U0.212|0:23-U0.323|0:40-U0.193|0:21-U0.328|0:41-U0.180|0:20-U0.115|0:13,,,,,,,252,7,,0,168072,,30378,,24629376,,,,,,,,,,,,,,,,,,,,,,,,,,,,,,,,,,,,,,,,,
38985004,fbbb02d7-657f-4a49-9d48-131fc75143c5,1643027090,60,1643028198,,0,0,15.03,4142,4142,123,124,163,170,4,0.4,0.27,0.99,0.99,,992,151,175,,,,59.65,45.55,60.24,1,,,,,,,,,,,,,,32,81,13.2,13.21,13.32,-1.8,-4.8,324,324,,1,330,330,,,,,,,,,"0,2,4,12,42,32,8,1,0","1,9,79,12,0","0,0,24,72,4",,,,,134,,,,,,,,,,,,,,,,,,,,,,,,,,,,,,,,,,,,59.8,5,6,200,89,,1035,1,326,0,2,3,Balve,1,0,U1.000|5:11-U1.000|4:37-U1.000|4:54-U1.000|4:50-U1.000|4:56-U1.000|4:53-U1.000|4:32-U1.000|4:27-U1.000|4:31-U1.000|4:37-U1.000|4:25-U1.000|4:25-U1.000|4:05-U1.000|3:56-U1.000|4:40-U0.010|0:03,,,,,wahoo_fitness-33,,518,7,,0,168070,250480,30378,,24648001,,,,,,,,,,,,,,,,,,,,,,,,,,,,,,,,,,,,,,,,,
39057424,5c8c3ddf-5794-42fd-9963-89aa279db329,1643139452,60,1643137087,,0,0,3.36,1015,1015,13,25,5,8,4,0,0.22,1.17,0.84,,240,149,169,,,,54.26,37.04,54.28,1,,,,,,,,,,,,,,8,81,11.86,12.01,12.01,5.5,6.2,284,284,,1,290,290,,,,,,,,,"4,3,12,29,35,13,3,0,0","0,13,62,25,0","0,6,63,30,1",,,,,123,,,,,,,,,,,,,,,,,,,,,,,,,,,,,,,,,,,,40.3,0,3,158,81,,1034,0,326,1,3,3,"Menden (Sauerland)",1,0,U1.000|5:09-U1.000|4:56-U1.000|4:59-U0.356|1:51,,,,,wahoo_fitness-33,,518,7,,0,168070,250480,30378,,24712241,,,,,,,,,,,,,,,,,,,,,,,,,,,,,,,,,,,,,,,,,
39057425,de544e69-974f-4fe0-ae55-fea15512b1d9,1643137423,60,1643137089,,0,0,6.73,1770,1770,98,98,0,0,4,0.2,0.25,1.52,1.14,,451,160,183,,,,58.11,45.54,59.16,1,,,,,,,,,,,,,,33,84,13.78,15.56,15.83,-13.5,-3.9,374,357,,1,419,414,,,,,,,,,"14,0,0,1,2,11,27,42,3","0,20,11,65,4","17,5,3,21,54",,,,,136,,,,,,,,,,,,,,,,,,,,,,,,,,,,,,,,,,,,71.1,0,3,158,81,,1034,0,326,1,3,3,"Menden (Sauerland)",1,0,U0.400|1:29-U0.400|1:21-U0.400|1:30-U0.400|1:25-U0.066|2:15-U0.400|1:26-U0.400|1:21-U0.400|1:30-U0.400|1:23-U0.100|2:08-U0.400|1:27-U0.400|1:22-U0.400|1:29-U0.400|1:23-U0.136|2:07-U0.400|1:28-U0.400|1:22-U0.400|1:29-U0.400|1:15-U0.026|0:20,,,,,wahoo_fitness-33,,518,7,,0,168070,250480,30378,,24712242,,,,,,,,,,,,,,,,,,,,,,,,,,,,,,,,,,,,,,,,,
39057427,fa8a5722-b995-4857-9a8e-e3e63054dce4,1643135510,60,1643137090,,0,0,5.88,1697,1862,58,60,24,13,4,0.3,0.28,0.96,0.86,262,418,157,183,,,,53.28,40.49,53.91,1,,,,,,,,,,,,,,21,81,12.66,12.82,13.01,-1.4,-12.2,308,308,,1,321,321,,,,,,,,,"11,4,10,14,30,17,6,7,2","1,5,58,35,1","1,7,34,48,9",,,,,128,,,,,,,,,,,,,,,,,,,,,,,,,,,,,,,,,,,,55.9,0,3,155,81,,1034,0,324,1,3,3,"Menden (Sauerland)",1,0,U1.000|4:53-U1.000|4:48-U1.000|4:42-U1.000|4:39-U0.124|1:17-U0.278|1:22-U0.312|1:19-U0.320|1:27-U0.773|3:17-U0.069|0:34,,,,,wahoo_fitness-33,,518,7,,0,168070,250480,30378,,24712244,,,,,,,,,,,,,,,,,,,,,,,,,,,,,,,,,,,,,,,,5,
39106065,5f1ef1d7-67e2-4c58-8408-90425581db3a,1643206859,60,1643216614,,0,0,10.02,3249,3933,163,163,207,202,4,2.3,0.62,1.08,1.01,327,750,151,173,,,,48.8,36.53,49.78,1,,,,,,,,,,,,,,27,79,11.42,11.31,11.55,-6,-7.3,268,268,,1,273,273,,,,,,,,,"16,10,15,23,28,8,1,0,0","1,17,59,23,0","0,3,79,19,0",,,,,117,,,,,,,,,,,,,,,,,,,,,,,,,,,,,,,,,,,,49.5,1,12,256,78,,1032,0,335,0,4,3,Balve,1,0,U1.000|5:38-U1.000|5:09-U1.000|5:28-U1.000|5:31-U1.000|5:09-U1.000|5:51-U1.000|5:59-U1.000|4:41-U1.000|4:44-U0.999|5:59,,,,,wahoo_fitness-33,,518,7,,0,168070,250480,30378,,24754833,,,,,,,,,,,,,,,,,,,,,,,,,,,,,,,,,,,,,,,,4,
39134966,1cb52b7c-f112-44fa-b6ed-f09ca28ae08a,1632846536,120,1643270773,,0,0,46.08,6781,6781,224,222,197,198,4,0,0.15,,,,1450,,,,,,,,,1,,,,,,,,,,,,,,94,,,26.72,,,,86,80,,1,108,106,,,,,,,,,"9,9,27,38,12,1,3",,"69,29,2,0,0",,,,,,,,,,,,,,,,,,,,,,,,,,,,,,,,,,,,,,,,,,17,4,183,58,,1022,1,284,0,4,3,"Menden (Sauerland)",1,0,,,,,,wahoo_fitness-43,,258,7,,0,168072,,30378,,24780694,,,,,,,,,,,,,,,,,,,,,,,,,,,,,,,,,,,,,,,,,
39134968,380add5f-03df-4173-818b-40432f51da5f,1632310953,120,1643270775,,0,0,28.58,9945,9945,801,798,810,803,4,5.4,0.77,,,361,2127,,,,,,,,,1,,,,,,,,,,,,,,137,,,15.27,,,,90,60,,1,112,100,,,,,,,,,"79,8,6,4,1,1,1",,"76,21,3,0,0",,,,,,,,,,,,,,,,,,,,,,,,,,,,,,,,,,,,,,,,,,17,7,332,62,,1029,3,272,0,4,3,"Menden (Sauerland)",1,0,,,,,,wahoo_fitness-43,,258,7,,0,168072,,30378,,24780695,,,,,,,,,,,,,,,,,,,,,,,,,,,,,,,,,,,,,,,,"3,4,4,4,5",
39134969,8fec80e7-a913-4551-b577-e9a43af3669b,1632656710,120,1643270775,,0,0,90.91,18479,19755,656,654,966,830,4,0.6,0.22,,,382,3952,,,,,,,,,1,,,,,,,,,,,,,,233,,,22.12,,,,73,58,,1,122,114,,,,,,,,,"27,22,30,15,4,1,2",,"83,12,3,1,0",,,,,,,,,,,,,,,,,,,,,,,,,,,,,,,,,,,,,,,,,,23,14,221,61,,1015,3,277,0,3,3,"Menden (Sauerland)",1,0,,,,,,wahoo_fitness-43,,258,7,,0,168072,,30378,,24780697,,,,,,,,,,,,,,,,,,,,,,,,,,,,,,,,,,,,,,,,"4,5,5,5",
39134971,06bd5713-b544-4eda-8095-f321f48a65de,1631460039,120,1643270779,,0,0,37.7,9584,9584,618,618,726,735,4,3.6,0.57,,,400,2049,,,,,,,,,1,,,,,,,,,,,,,,95,,,19.59,,,,82,58,,1,108,98,,,,,,,,,"59,14,11,9,5,2,1",,"78,20,2,0,0",,,,,,,,,,,,,,,,,,,,,,,,,,,,,,,,,,,,,,,,,,21,11,278,58,,1017,2,286,0,3,3,"Menden (Sauerland)",1,0,,,,,,wahoo_fitness-43,,258,7,,0,168072,,30378,,24780698,,,,,,,,,,,,,,,,,,,,,,,,,,,,,,,,,,,,,,,,"4,4,4,5,5,5",
39134972,082a36f3-fb82-4671-a430-d85d44dd6e24,1630859187,120,1643270779,,0,0,31.79,8701,8701,591,594,599,577,4,3.9,0.61,,,348,1861,,,,,,,,,1,,,,,,,,,,,,,,126,,,18.35,,,,81,54,,1,104,92,,,,,,,,,"66,12,11,6,3,2,1",,"77,21,1,0,0",,,,,,,,,,,,,,,,,,,,,,,,,,,,,,,,,,,,,,,,,,22,8,32,62,,1021,1,289,0,2,3,"Menden (Sauerland)",1,0,,,,,,wahoo_fitness-43,,258,7,,0,168072,,30378,,24780699,,,,,,,,,,,,,,,,,,,,,,,,,,,,,,,,,,,,,,,,"4,4,4,5,5,5,5",
39134973,7d1258d4-9e5b-4767-a370-b9d84fb7dac8,1631033193,120,1643270780,,0,0,14.69,4461,4461,308,309,320,321,4,3.3,0.53,,,308,954,,,,,,,,,1,,,,,,,,,,,,,,65,,,16.72,,,,80,51,,1,113,100,,,,,,,,,"68,16,7,5,3,1,0",,"83,14,3,0,0",,,,,,,,,,,,,,,,,,,,,,,,,,,,,,,,,,,,,,,,,,23,8,44,60,,1022,1,281,0,3,3,"Menden (Sauerland)",1,0,,,,,,wahoo_fitness-43,,258,7,,0,168072,,30378,,24780700,,,,,,,,,,,,,,,,,,,,,,,,,,,,,,,,,,,,,,,,"4,4",
39134974,cf128e10-482c-41fe-a5c0-ddf672593867,1632062405,120,1643270780,,0,0,53.92,19416,19554,858,847,1183,1002,4,3.9,0.51,,,386,4152,,,,,,,,,1,,,,,,,,,,,,,,230,,,16.26,,,,60,42,,1,122,111,,,,,,,,,"74,10,6,5,3,1,1",,"85,9,4,1,0",,,,,,,,,,,,,,,,,,,,,,,,,,,,,,,,,,,,,,,,,,16,9,51,67,,1015,1,289,0,4,3,"Menden (Sauerland)",1,0,U53.915|5:23:33-U0.000|0:03,,,,,wahoo_fitness-43,,258,7,,0,168072,,30378,,24780701,,,,,,,,,,,,,,,,,,,,,,,,,,,,,,,,,,,,,,,,"4,4,4,4,5,5,5,5",
39134976,7e42fe13-792e-49f3-816f-a411044ceb74,1629364423,360,1643270784,,0,0,43.96,9765,21547,595,2312,498,2291,4,4.8,0.82,,,515,2088,,,,,,,,,1,,,,,,,,,,,,,,59,,,22.29,,,,73,35,,1,119,99,,,,,,,,,"55,11,10,11,8,4,1",,"91,8,0,0,0",,,,,,,,,,,,,,,,,,,,,,,,,,,,,,,,,,,,,,,,,,11,10,212,38,,1012,7,286,0,3,3,"Issyk-Kul Region",1,0,,,,,,wahoo_fitness-43,,258,7,,0,168072,,30378,,24780703,,,,,,,,,,,,,,,,,,,,,,,,,,,,,,,,,,,,,,,,"2,4,5",
39134977,1b8cf832-5c08-4b79-b209-a00fab7df725,1629204956,360,1643270786,,0,0,35.98,10470,13485,732,567,645,546,4,4.5,0.39,,,528,2239,,,,,,,,,1,,,,,,,,,,,,,,130,,,17.4,,,,96,60,,1,199,172,,,,,,,,,"62,19,10,4,3,2,1",,"80,14,4,1,1",,,,,,,,,,,,,,,,,,,,,,,,,,,,,,,,,,,,,,,,,,17,11,263,14,,1014,7,310,0,2,3,"Naryn Region",1,0,,,,,,wahoo_fitness-43,,258,7,,0,168072,,30378,,24780704,,,,,,,,,,,,,,,,,,,,,,,,,,,,,,,,,,,,,,,,"4,4,4,4,4,4,4,5",
39134978,21393e1b-d443-410c-99ab-237d2a87ca46,1629119815,360,1643270787,,0,0,10.62,3263,8097,215,335,114,279,4,3.9,0.55,,,533,697,,,,,,,,,1,,,,,,,,,,,,,,40,,,15.46,,,,83,44,,1,180,153,,,,,,,,,"74,14,6,5,1,0,0",,"87,9,1,1,2",,,,,,,,,,,,,,,,,,,,,,,,,,,,,,,,,,,,,,,,,,16,14,237,28,,1012,6,326,0,3,3,"Naryn Region",1,0,,,,,,wahoo_fitness-43,,258,7,,0,168072,,30378,,24780705,,,,,,,,,,,,,,,,,,,,,,,,,,,,,,,,,,,,,,,,"4,4,5",
39134981,e465dded-ff2f-47ea-84e7-cafa501aa106,1629034369,360,1643270789,,0,0,28.07,7843,18157,606,818,874,1036,4,5.9,0.69,,,493,1677,,,,,,,,,1,,,,,,,,,,,,,,97,,,22.97,,,,81,55,,1,179,162,,,,,,,,,"70,8,6,5,6,2,3",,"90,7,1,1,2",,,,,,,,,,,,,,,,,,,,,,,,,,,,,,,,,,,,,,,,,,12,25,280,22,,1008,3,327,0,4,3,"Naryn Region",1,0,,,,,,wahoo_fitness-43,,258,7,,0,168072,,30378,,24780708,,,,,,,,,,,,,,,,,,,,,,,,,,,,,,,,,,,,,,,,"2,2",
39134982,43d8e792-d20e-4db0-835a-db7ae88ce338,1629278259,360,1643270790,,0,0,20.94,13815,27300,755,101,525,207,4,3.3,0.4,,,205,2954,,,,,,,,,1,,,,,,,,,,,,,,147,,,11.72,,,,63,25,,1,102,81,,,,,,,,,"79,13,4,2,1,0,0",,"92,7,1,0,0",,,,,,,,,,,,,,,,,,,,,,,,,,,,,,,,,,,,,,,,,,18,11,245,18,,1011,9,297,0,2,3,"Issyk-Kul Region",1,0,,,,,,wahoo_fitness-43,,258,7,,0,168072,,30378,,24780709,,,,,,,,,,,,,,,,,,,,,,,,,,,,,,,,,,,,,,,,"4,4,4,5,5",
39134983,6feacddb-9c67-426f-888e-afa8f76753fd,1628691737,360,1643270792,,0,0,33.64,9249,15537,526,512,494,546,4,4.3,0.46,,,528,1978,,,,,,,,,1,,,,,,,,,,,,,,86,,,18.75,,,,68,43,,1,185,165,,,,,,,,,"61,15,11,7,4,2,1",,"88,10,0,0,1",,,,,,,,,,,,,,,,,,,,,,,,,,,,,,,,,,,,,,,,,,20,9,284,12,,1008,4,291,0,2,3,"Naryn Region",1,0,,,,,,wahoo_fitness-43,,258,7,,0,168072,,30378,,24780710,,,,,,,,,,,,,,,,,,,,,,,,,,,,,,,,,,,,,,,,"3,4,4",
39134984,5ed34ca2-c90f-48f9-906a-a2d113429433,1628760565,360,1643270793,,0,0,50.53,12141,31758,328,1607,643,1920,4,2.8,0.63,,,181,2596,,,,,,,,,1,,,,,,,,,,,,,,112,,,20.87,,,,50,26,,1,86,72,,,,,,,,,"63,9,8,9,8,3,0",,"94,5,1,0,0",,,,,,,,,,,,,,,,,,,,,,,,,,,,,,,,,,,,,,,,,,18,18,233,24,,1009,7,295,0,3,3,"Naryn Region",1,0,,,,,,wahoo_fitness-43,,258,7,,0,168072,,30378,,24780711,,,,,,,,,,,,,,,,,,,,,,,,,,,,,,,,,,,,,,,,"4,5,5",
39134986,33c81e14-4453-4854-af08-e57fe6276252,1628587513,360,1643270795,,0,0,88.23,15064,28693,103,1029,278,1114,4,0,0.12,,,,3222,,,,,,,,,1,,,,,,,,,,,,,,140,,,22.6,,,,47,31,,1,68,58,,,,,,,,,"13,21,44,16,4,1,0",,"95,5,0,0,0",,,,,,,,,,,,,,,,,,,,,,,,,,,,,,,,,,,,,,,,,,17,8,267,26,,1013,8,307,0,3,3,"Panfilov District",1,0,,,,,,wahoo_fitness-43,,258,7,,0,168072,,30378,,24780713,,,,,,,,,,,,,,,,,,,,,,,,,,,,,,,,,,,,,,,,,
39134987,628ff3c3-de2c-4fe3-a713-04fc6c12181c,1628503267,360,1643270796,,0,0,55.78,15814,25637,707,1190,1906,2390,4,4.9,0.54,,,394,3382,,,,,,,,,1,,,,,,,,,,,,,,146,,,16.05,,,,60,38,,1,144,128,,,,,,,,,"64,22,8,3,1,0,0",,"88,9,1,0,1",,,,,,,,,,,,,,,,,,,,,,,,,,,,,,,,,,,,,,,,,,15,11,260,31,,1011,6,296,0,3,3,"Naryn Region",1,0,U55.776|4:22:25-U0.000|0:44-U0.000|0:12-U0.000|0:13,,,,,wahoo_fitness-43,,258,7,,0,168072,,30378,,24780714,,,,,,,,,,,,,,,,,,,,,,,,,,,,,,,,,,,,,,,,"0,4,4",
39147814,a6b04165-5131-42a8-9aa1-29b74caf4e3a,1643287151,60,1643288372,,0,0,14.1,4646,4703,318,316,39,0,4,3.9,0.7,1.08,1.03,535,1032,145,178,,,,50.59,36.8,52.01,1,,,,,,,,,,,,,,24,79,11.56,11.35,11.76,-2.6,4.8,268,268,,1,276,276,,,,,,,,,"27,12,9,14,27,10,1,0,0","1,31,60,8,0","0,8,69,22,1",,,,,115,,,,,,,,,,,,,,,,,,,,,,,,,,,,,,,,,,,,44.2,3,20,249,99,,1023,1,319,0,6,3,Balve,1,0,U1.000|5:01-U1.000|5:13-U1.000|6:51-U1.000|6:37-U1.000|6:36-U1.000|6:44-U1.000|5:21-U1.000|4:39-U1.000|4:34-U1.000|4:31-U1.000|4:38-U1.000|5:29-U1.000|5:14-U1.000|5:37-U0.075|0:21,,,,,wahoo_fitness-33,,518,7,,0,168070,250480,30378,,24792165,,,,,,,,,,,,,,,,,,,,,,,,,,,,,,,,,,,,,,,,3,
39195022,b06b7dc4-a2f7-4ba1-ad9f-3af6c833321d,1643115079,60,1643368985,,0,0,,638,638,,,,,0,,,,,,49,,,,,,,,,1,,,,,,,,,,,,,,0,,,,,,,,,,,,,,,,,,,,,,,,,,,,,,,,,,,,,,,,,,,,,,,,,,,,,,,,,,,,,,,,,,,,,,,,,,1,,,1,0,,,,,,,,252,7,,0,168073,,30378,,24835249,,,,,,,,,,,,,,,,,,,,,,,,,,,,,,,,,,,,,,,,,
39212200,054530e0-244a-4201-89e4-283458cf933c,1643375732,60,1643389000,,0,0,4.28,1374,1376,114,115,98,91,4,2.2,0.76,1.08,0.98,307,320,150,168,,,,49.87,35.02,51.5,1,,,,,,,,,,,,,,10,81,11.96,11.32,12.28,-1.5,5.8,280,280,,1,294,294,,,,,,,,,"9,14,20,29,20,8,1,1,0","0,20,67,13,0","0,14,48,36,3",,,,,115,,,,,,,,,,,,,,,,,,,,,,,,,,,,,,,,,,,,34.4,4,14,309,82,,1033,1,344,0,3,3,Balve,1,0,U1.000|5:28-U1.000|5:36-U1.000|5:15-U1.000|5:11-U0.268|1:24,,,,,wahoo_fitness-33,,518,7,,0,168070,250480,30378,,24850304,,,,,,,,,,,,,,,,,,,,,,,,,,,,,,,,,,,,,,,,4,
39266223,6874e5df-f5bb-4478-a524-b73382302c76,1643450526,60,1643492007,,0,0,15,4582,5423,344,326,360,345,0,4.1,0.77,0.89,0.99,569,994,151,178,,,,52.53,40.41,54.1,1,56.81,3742,159,,4.2,0,101,96,,,,15,2,34,80,12.49,12.41,12.8,-12.9,-7.9,296,296,,1,309,309,,,,,,,,,"17,12,11,12,13,23,9,1,0","0,12,78,10,0","0,2,62,33,3",,,,,123,,,,,,,,,,,,,,,,,,,,,,,,,,,,,,,,,,,,53.4,5,23,238,96,,1025,1,332,0,4,3,Balve,1,0,U1.809|9:21-U0.004|0:01-U0.003|0:01-U1.000|6:25-U1.000|6:30-U1.000|6:01-U1.000|6:54-U1.000|5:05-U1.000|4:32-U1.000|4:10-U1.000|4:11-U1.000|4:13-U1.000|4:08-U1.000|4:09-U1.000|4:02-U1.000|5:38-U0.188|1:00,,"Balve Running",,,3113,,250,3,8204573787,0,168070,250480,30378,,24898601,,,,,,,,,,,,,,,,,,,,,,,,,,,,,,,,,,,,,,,,"3,4",
39294925,48f66391-1abf-4f0c-aca8-6644456b58c7,1643538610,60,1643540082,,0,0,14.04,4599,4921,329,328,351,365,4,4.3,0.63,1.05,0.94,672,955,140,177,,,,53.38,37.05,54.94,1,,,,,,,,,,,,,,93,79,11.58,11.32,12,21.7,25.4,272,272,,1,288,288,,,,,,,,,"17,7,14,27,28,5,2,0,0","13,19,49,19,0","0,7,71,19,4",,,,,116,,,,,,,,,,,,,,,,,,,,,,,,,,,,,,,,,,,,44.9,3,21,297,90,,1029,1,316,0,3,3,Balve,1,0,U1.000|5:18-U1.000|5:18-U1.000|5:15-U1.000|5:22-U1.000|5:14-U1.000|5:23-U1.000|7:14-U1.000|4:59-U1.000|4:59-U1.000|5:35-U1.000|6:59-U1.000|4:39-U1.000|4:52-U1.000|5:28-U0.018|0:04,,,,,wahoo_fitness-33,,518,7,,0,168070,250480,30378,,24924005,,,,,,,,,,,,,,,,,,,,,,,,,,,,,,,,,,,,,,,,"3,4",
39317377,90bec0a4-2aac-4a0e-8eea-67b3602fd967,1643547077,60,1643553303,,0,0,10.69,9735,9735,393,393,481,431,4,4.8,0.74,,,243,1143,113,190,,,,,,,1,,,,,,,,,,,,,,127,55,,4.44,,-11.7,,,,,,,,,,,,,,,,"65,27,0,0,0,7","34,52,2,12,0",,,,,,,,,,,,,,,,,,,,,,,,,,,,,,,,,,,,,,,,,,65.7,4,19,284,79,,1029,1,316,0,3,3,Balve,1,0,U1.000|12:41-U1.000|17:49-U1.000|14:15-U1.000|14:07-U1.000|26:53-U1.000|15:10-U1.000|12:28-U1.000|14:02-U1.000|13:13-U1.000|11:51-U0.684|9:47,,,,,wahoo_fitness-33,,518,7,,0,168075,,30378,,24944810,,,,,,,,,,,,,,,,,,,,,,,,,,,,,,,,,,,,,,,,"3,4,5",
39466043,5100b36d-4449-40f0-9e6b-6060328dde49,1643635868,60,1643638948,,0,0,12.12,3513,3598,102,102,153,158,4,0.9,0.33,1.01,0.95,,835,153,173,,,,55.01,42.24,55.58,1,,,,,,,,,,,,,,93,81,12.57,12.58,12.67,-1.7,-4.8,305,305,,1,309,309,,,,,,,,,"4,3,7,19,41,23,3,0,0","1,14,48,37,0","0,0,49,50,1",,,,,128,,,,,,,,,,,,,,,,,,,,,,,,,,,,,,,,,,,,52.4,3,23,274,95,,1007,1,371,0,6,3,Balve,1,0,U1.000|5:25-U1.000|4:50-U1.000|5:08-U1.000|4:55-U1.000|5:14-U1.000|4:40-U1.000|4:55-U1.000|4:46-U1.000|4:43-U1.000|4:16-U1.000|4:15-U1.000|5:02-U0.091|0:26,,,,,wahoo_fitness-33,,518,7,,0,168070,250480,30378,,25083208,,,,,,,,,,,,,,,,,,,,,,,,,,,,,,,,,,,,,,,,,
39588442,5413a5d4-d796-4da0-9ad6-3b286a9550ce,1643745316,60,1643742967,,0,0,3.31,1035,1035,9,25,7,24,4,0,0.14,,0.86,,284,168,186,,,,43.57,35.53,43.46,1,,,,,,,,,,,,,,43,82,11.41,11.56,11.53,-0.6,-4.3,270,270,,1,275,275,,,,,,,,,"5,8,16,36,25,10,0,0,0","0,3,11,79,7","0,4,72,24,0",,,,,117,,,,,,,,,,,,,,,,,,,,,,,,,,,,,,,,,,,,84.5,8,28,272,85,,1011,0,299,1,6,3,"Menden (Sauerland)",1,0,U1.000|5:27-U1.000|5:13-U1.000|5:02-U0.301|1:33,,,,,wahoo_fitness-33,,518,7,,0,168070,250480,30378,,25184425,,,,,,,,,,,,,,,,,,,,,,,,,,,,,,,,,,,,,,,,,
39588451,965a3cba-dcee-4106-b249-2e4629c4d200,1643742547,60,1643742970,,0,0,9.28,2521,2521,136,136,21,0,4,0.6,0.3,1.16,0.91,,636,160,195,,,,55.83,44.71,56.84,1,,,,,,,,,,,,,,93,84,13.42,15.07,15.31,13.1,-2.5,361,340,,1,404,398,,,,,,,,,"17,5,6,6,3,7,20,33,3","1,13,29,51,6","10,8,25,9,49",,,,,131,,,,,,,,,,,,,,,,,,,,,,,,,,,,,,,,,,,,84.3,7,29,275,85,,1010,0,299,1,6,3,"Menden (Sauerland)",1,0,U0.100|0:21-U0.200|0:43-U0.400|1:24-U0.400|1:24-U0.400|1:25-U0.400|2:25-U0.400|1:25-U0.400|1:23-U0.400|1:24-U0.400|2:18-U0.400|1:22-U0.400|1:25-U0.551|4:58-U0.400|1:24-U0.400|1:24-U0.400|1:24-U0.400|1:20-U0.400|2:40-U0.400|1:24-U0.400|1:23-U0.400|1:22-U0.400|3:03-U0.400|1:24-U0.400|1:13-U0.021|2:03,,,,,wahoo_fitness-33,,518,7,,0,168070,250480,30378,,25184432,,,,,,,,,,,,,,,,,,,,,,,,,,,,,,,,,,,,,,,,,
39588453,8d5c43b3-18fd-4c06-9616-73f989e22ceb,1643740399,60,1643742972,,0,0,5.61,1714,1873,56,56,45,47,4,0,0.11,1.34,0.71,311,423,159,184,,,,48.75,37.74,49.35,1,,,,,,,,,,,,,,58,80,11.88,12.12,12.39,8.3,-5.5,289,289,,1,304,304,,,,,,,,,"19,6,8,14,25,17,7,3,1","0,4,48,46,1","2,18,24,46,10",,,,,123,,,,,,,,,,,,,,,,,,,,,,,,,,,,,,,,,,,,52.3,7,29,299,84,,1010,0,297,1,6,3,"Menden (Sauerland)",1,0,U1.000|4:40-U1.000|4:53-U1.000|4:39-U1.000|4:52-U1.000|5:43-U0.607|3:48,,,,,wahoo_fitness-33,,518,7,,0,168070,250480,30378,,25184434,,,,,,,,,,,,,,,,,,,,,,,,,,,,,,,,,,,,,,,,5,
39643009,a8a2a758-2128-4606-9efb-5e71affa0f2e,1643811176,60,1643810665,,0,0,9.01,2939,3006,104,102,142,134,4,1.3,0.45,1.02,0.99,334,751,162,186,,,,43.73,35.99,44.37,1,,,,,,,,,,,,,,108,79,11.26,11.24,11.38,4.7,-2.5,266,266,,1,271,271,,,,,,,,,"17,9,17,27,20,3,2,3,0","0,6,28,64,3","0,6,81,9,4",,,,,116,,,,,,,,,,,,,,,,,,,,,,,,,,,,,,,,,,,,77.5,6,17,298,79,,1019,1,297,0,3,3,Balve,1,0,U1.000|6:01-U1.000|5:13-U1.000|5:23-U1.000|5:17-U0.699|3:52-U0.100|0:21-U0.128|0:43-U0.113|0:24-U0.118|0:43-U0.101|0:21-U0.068|0:30-U0.128|0:27-U0.096|0:40-U0.090|0:22-U0.694|3:55-U0.110|0:22-U0.100|0:44-U0.103|0:23-U0.088|0:43-U0.099|0:22-U0.084|0:43-U0.103|0:24-U1.000|6:09-U0.985|4:59,,,,,wahoo_fitness-33,,518,7,,0,168070,250480,30378,,25232622,,,,,,,,,,,,,,,,,,,,,,,,,,,,,,,,,,,,,,,,5,
39728875,0b34824b-db3a-4aa1-ae38-f9df64a47492,1643896344,60,1643918363,,0,0,14.02,3933,3933,330,329,339,344,4,3.9,0.63,1.12,1.07,548,985,161,202,,,,53.17,44.38,54.72,1,,,,,,,,,,,,,,149,81,13.57,13.62,13.89,-16.6,-8.7,327,327,,1,336,336,,,,,,,,,"7,11,14,14,11,15,19,9,0","0,12,38,38,13","0,1,33,55,10",,,,,132,,,,,,,,,,,,,,,,,,,,,,,,,,,,,,,,,,,,141.3,6,13,230,86,,1015,1,301,0,4,3,Balve,1,0,U1.000|4:50-U1.000|4:56-U1.000|6:06-U1.000|5:47-U1.000|5:52-U1.000|5:45-U1.000|4:29-U1.000|3:50-U1.000|3:38-U1.000|3:25-U1.000|3:44-U1.000|4:29-U1.000|4:32-U1.000|4:10,,,,,wahoo_fitness-33,,518,7,,0,168070,250480,30378,,25302557,,,,,,,,,,,,,,,,,,,,,,,,,,,,,,,,,,,,,,,,"3,5",
39767621,224c9f92-a71e-493d-90a6-3044547a4985,1643965109,60,1643961528,,0,0,,3,3,,,,,0,,,,,,0,,,,,,,,,1,,,,,,,,,,,,,,0,,,,,,,,,,,,,,,,,,,,,,,,,,,,,,,,,,,,,,,,,,,,,,,,,,,,,,,,,,,,,,,,,,,,,,,,,,1,,,1,0,,,,,,wahoo_fitness-47,,329,7,,0,168072,,30378,,25335545,,,,,,,,,,,,,,,,,,,,,,,,,,,,,,,,,,,,,,,,,
39797669,16ad3b15-6636-48b7-ba86-90a66e3f44b4,1643982905,60,1643981946,,0,0,7.52,2334,2525,110,108,144,144,4,1.6,0.59,1.24,1.01,,537,148,183,,,,52.96,37.71,53.94,1,,,,,,,,,,,,,,62,79,11.7,12.19,12.9,2.3,-8.8,285,285,,1,332,332,,,,,,,,,"14,6,12,30,14,6,15,3,0","0,31,49,19,2","2,10,58,12,18",,,,,122,,,,,,,,,,,,,,,,,,,,,,,,,,,,,,,,,,,,58,7,24,225,85,,1008,1,325,0,4,3,Balve,1,0,U1.000|5:26-U1.000|5:12-U1.000|5:36-U0.044|0:20-U0.992|3:49-U1.000|5:34-U0.108|1:11-U0.993|3:39-U1.000|6:09-U0.376|1:58,,,,,wahoo_fitness-33,,518,7,,0,168070,250480,30378,,25357681,,,,,,,,,,,,,,,,,,,,,,,,,,,,,,,,,,,,,,,,,
39825754,e9b4f94f-d013-4f7a-aa59-468489101e12,1644001104,60,1644000003,,0,0,17.75,2402,2402,,,,,0,,,,,,300,,,,,,,,,1,,,,,,,,,,,,,,27,83,,26.67,,,,124,124,,0,126,126,,,,,,,,,"0,0,3,96,0,0,0",,"4,96,0,0,0",,,,,,,,,,,,,,,,,,,,,,,,,,,,,,,,,,,,,,,,,,,,,,,,,,,1,,,1,0,U4.269|10:00-U4.649|10:20-U6.005|13:30-U2.830|6:11,,,,,,,252,7,,0,168072,,30378,,25375685,,,,,,,,,,,,,,,,,,,,,,,,,,,,,,,,,,,,,,,,,
39852647,5046128f-fdfe-4f1e-a67c-fcde4514c5b4,1644053820,60,1644054634,,0,0,10.47,3570,4307,300,301,252,304,4,2.7,0.63,1.16,0.93,345,827,151,186,,,,45.87,34.54,47.49,1,,,,,,,,,,,,,,98,79,11.12,10.89,11.71,13.1,2.2,261,260,,1,280,280,,,,,,,,,"21,9,16,26,20,7,1,0,0","0,16,65,17,1","5,14,54,20,6",,,,,111,,,,,,,,,,,,,,,,,,,,,,,,,,,,,,,,,,,,50.8,2,18,253,92,,1021,0,363,0,4,3,Balve,1,0,U1.000|5:17-U1.000|5:51-U1.000|5:25-U1.000|4:50-U1.000|5:22-U1.000|5:01-U1.000|5:15-U0.368|2:08-U0.133|0:41-U0.155|1:20-U0.128|0:41-U0.165|1:24-U0.118|0:42-U0.164|1:20-U0.137|0:40-U0.151|1:31-U0.129|0:41-U1.000|6:25-U0.815|4:58,,,,,wahoo_fitness-33,,518,7,,0,168070,250480,30378,,25398236,,,,,,,,,,,,,,,,,,,,,,,,,,,,,,,,,,,,,,,,"4,4,5",
39925756,335223b3-dc51-4d28-8526-263176066121,1644148766,60,1644151710,,0,0,18.62,6172,6396,538,537,748,600,4,4.9,0.78,1.13,1.01,546,1430,151,176,,,,47.49,37.37,49.2,1,,,,,,,,,,,,,,175,80,11.67,11.26,12.06,7.8,12.6,270,270,,1,284,284,,,,,,,,,"22,15,16,15,18,11,2,0,0","2,16,48,34,0","0,11,60,25,4",,,,,113,,,,,,,,,,,,,,,,,,,,,,,,,,,,,,,,,,,,60.6,5,32,222,94,,1005,1,368,0,6,3,Balve,1,0,U1.000|5:04-U1.000|5:12-U1.000|6:22-U1.000|6:24-U1.000|6:04-U1.000|6:02-U1.000|6:16-U1.000|5:31-U1.000|5:47-U1.000|5:41-U1.000|5:02-U1.000|5:54-U1.000|6:30-U1.000|5:05-U1.000|4:21-U1.000|4:27-U1.000|4:23-U1.000|4:59-U0.593|3:48,,,,,wahoo_fitness-33,,518,7,,0,168070,250480,30378,,25461292,,,,,,,,,,,,,,,,,,,,,,,,,,,,,,,,,,,,,,,,"3,4,5",
39988332,bc5a8db9-a2e9-4c23-893f-5c9188024ce1,1644241204,60,1644241100,,0,0,10.1,3261,3290,218,216,227,237,4,3.1,0.6,0.98,1,456,742,147,172,,,,50.92,36.73,52.29,1,,,,,,,,,,,,,,83,79,11.74,11.64,12.08,-6.2,-6.6,277,275,,1,285,285,,,,,,,,,"18,8,12,21,24,14,2,1,0","1,25,57,17,0","1,5,71,21,3",,,,,118,,,,,,,,,,,,,,,,,,,,,,,,,,,,,,,,,,,,40.7,5,19,283,85,,1024,1,335,0,6,3,Balve,1,0,U1.000|6:15-U1.000|5:00-U1.000|5:21-U1.000|5:52-U1.000|6:32-U1.000|6:19-U1.000|4:45-U1.000|4:35-U0.710|3:28-U1.000|4:20-U0.372|1:55,,,,,wahoo_fitness-33,,518,7,,0,168070,250480,30378,,25511404,,,,,,,,,,,,,,,,,,,,,,,,,,,,,,,,,,,,,,,,"4,4",
40071633,ae1c9d82-db37-4db9-8089-5fa4cdc2aa34,1644345083,60,1644342936,,0,0,4.08,1186,1186,34,34,23,30,4,0,0.21,1.03,0.9,386,277,150,166,,,,56.37,39.27,56.95,1,,,,,,,,,,,,,,31,80,12.54,12.59,12.73,-8.4,-13.3,306,306,,1,312,312,,,,,,,,,"8,2,4,14,36,33,2,0,0","1,9,82,8,0","0,7,26,63,3",,,,,129,,,,,,,,,,,,,,,,,,,,,,,,,,,,,,,,,,,,33.3,9,17,244,88,,1027,0,325,1,4,3,"Menden (Sauerland)",1,0,U1.000|5:07-U1.000|5:01-U1.000|4:30-U1.000|4:39-U0.076|0:30,,,,,wahoo_fitness-33,,518,7,,0,168070,250480,30378,,25580755,,,,,,,,,,,,,,,,,,,,,,,,,,,,,,,,,,,,,,,,5,
40077346,39870925-2f5c-4c0b-adca-6851d02204c1,1644349822,60,1644347496,,0,0,3.35,1006,1006,10,26,10,26,4,0,0.12,,0.87,,233,148,161,,,,55.17,37.29,55.04,1,,,,,,,,,,,,,,25,82,11.89,12.05,12.03,-0.2,0,284,284,,1,290,290,,,,,,,,,"1,3,10,32,44,10,0,0,0","0,5,94,1,0","0,4,72,22,1",,,,,122,,,,,,,,,,,,,,,,,,,,,,,,,,,,,,,,,,,,25.3,9,16,241,88,,1027,0,324,1,4,3,"Menden (Sauerland)",1,0,U1.000|4:58-U1.000|4:55-U1.000|5:05-U0.342|1:48,,,,,wahoo_fitness-33,,518,7,,0,168070,250480,30378,,25585650,,,,,,,,,,,,,,,,,,,,,,,,,,,,,,,,,,,,,,,,,
40077348,cdb66254-00ed-4581-8b03-d1d842caa29a,1644347068,60,1644347498,,0,0,7.4,2247,2247,96,90,0,0,4,0.9,0.4,1.6,1.08,,567,157,190,,,,50.05,38.66,50.9,1,,,,,,,,,,,,,,78,81,11.96,14.62,14.93,18.5,-7.1,345,307,,1,402,390,,,,,,,,,"18,0,1,2,6,12,22,18,21","0,25,12,59,3","25,6,4,26,38",,,,,122,,,,,,,,,,,,,,,,,,,,,,,,,,,,,,,,,,,,62.2,9,17,242,88,,1027,0,325,1,4,3,"Menden (Sauerland)",1,0,U0.200|0:35-U0.200|0:47-U0.200|0:38-U0.200|0:50-U0.200|0:39-U0.200|0:50-U0.200|0:42-U0.200|0:53-U0.200|0:41-U0.200|0:53-U0.099|1:25-U1.000|3:43-U0.200|1:57-U1.000|3:49-U0.100|6:41-U0.200|0:35-U0.200|0:46-U0.200|0:37-U0.200|0:48-U0.200|0:37-U0.200|0:52-U0.200|0:38-U0.200|0:52-U0.200|0:38-U0.200|1:52-U1.000|3:18-U0.029|0:51,,,,,wahoo_fitness-33,,518,7,,0,168070,250480,30378,,25585651,,,,,,,,,,,,,,,,,,,,,,,,,,,,,,,,,,,,,,,,,
40077352,ddf3a1a3-c51e-4e67-a728-fe479cac597a,1644346655,60,1644347499,,0,0,0.98,342,342,13,12,8,3,4,0.9,0.59,2.63,1.02,,77,152,189,,,,44.16,27.72,44.94,1,,,,,,,,,,,,,,10,79,10.44,11.05,11.57,-14.5,-46.3,254,251,,1,288,287,,,,,,,,,"50,13,8,2,2,3,4,9,8","0,26,48,19,8","5,49,16,11,19",,,,,109,,,,,,,,,,,,,,,,,,,,,,,,,,,,,,,,,,,,23.2,8,16,242,88,,1027,0,325,1,4,3,"Menden (Sauerland)",1,0,,,,,,wahoo_fitness-33,,518,7,,0,168070,250480,30378,,25585655,,,,,,,,,,,,,,,,,,,,,,,,,,,,,,,,,,,,,,,,,
40103096,9d66799c-6ece-493c-a455-7fb9583d1e5b,1644396260,60,1644396664,,0,0,9.14,3183,3889,207,207,203,201,4,3.2,0.75,1,1.03,509,688,143,172,,,,48.14,33.35,49.49,1,,,,,,,,,,,,,,72,79,10.95,10.62,11.13,-6.9,0.6,251,251,,1,258,258,,,,,,,,,"25,14,18,26,15,2,0,0,0","0,41,54,4,0","0,12,74,14,0",,,,,109,,,,,,,,,,,,,,,,,,,,,,,,,,,,,,,,,,,,34.7,6,18,231,100,,1026,0,328,0,4,3,Balve,1,0,U1.000|5:37-U1.000|5:36-U1.000|6:31-U1.000|6:35-U1.000|6:33-U1.000|5:20-U1.000|4:56-U1.000|5:07-U1.000|6:08-U0.126|0:42,,,,,wahoo_fitness-33,,518,7,,0,168070,250480,30378,,25608574,,,,,,,,,,,,,,,,,,,,,,,,,,,,,,,,,,,,,,,,4,
40173427,ed3bcf0c-8b48-4342-8ab3-51750a266dbe,1644499461,60,1644499352,,0,0,10.04,3278,3352,252,245,237,245,4,3.4,0.7,1.11,1.01,537,816,158,179,,,,45.34,36.24,46.79,1,,,,,,,,,,,,,,108,79,11.7,11.35,12,6.1,17.7,272,272,,1,283,283,,,,,,,,,"20,12,13,19,25,9,2,0,0","0,5,55,40,0","0,8,64,26,2",,,,,116,,,,,,,,,,,,,,,,,,,,,,,,,,,,,,,,,,,,63,5,11,192,100,,1020,1,339,0,6,3,Balve,1,0,U1.000|5:22-U1.000|5:13-U1.000|6:35-U1.000|6:01-U1.000|6:21-U1.000|4:53-U1.000|4:30-U1.000|4:45-U1.000|4:59-U1.000|5:51-U0.027|0:08,,,,,wahoo_fitness-33,,518,7,,0,168070,250480,30378,,25669796,,,,,,,,,,,,,,,,,,,,,,,,,,,,,,,,,,,,,,,,4,
40243680,b18e7246-5fd0-4ea9-b10b-3f971acb9dcd,1644597772,60,1644599123,,0,0,13.31,3764,4797,98,99,120,127,4,0.4,0.29,1.01,1.07,,916,155,219,,,,55.66,43.79,56.16,1,,,,,,,,,,,,,,128,81,12.87,13.12,13.22,6.4,4.8,315,315,,1,330,330,,,,,,,,,"5,4,13,21,28,10,9,9,1","1,16,45,29,9","0,2,50,33,15",,,,,131,,,,,,,,,,,,,,,,,,,,,,,,,,,,,,,,,,,,115.8,2,12,317,91,,1032,0,366,0,3,3,Balve,1,0,U1.000|4:54-U1.000|4:55-U1.000|4:38-U0.213|0:48-U0.109|0:21-U0.202|0:57-U0.205|0:43-U0.106|0:21-U0.200|0:59-U0.204|0:45-U0.104|0:20-U0.205|1:01-U0.201|0:43-U0.104|0:21-U0.201|1:01-U0.201|0:44-U0.129|0:24-U0.198|1:00-U0.201|0:44-U0.103|0:21-U1.000|5:12-U0.677|3:21-U0.436|2:18-U0.107|0:22-U0.106|0:21-U0.299|1:31-U0.101|0:23-U0.101|0:19-U0.308|1:34-U0.103|0:23-U0.107|0:20-U0.300|1:37-U0.110|0:23-U0.109|0:21-U0.301|1:41-U0.102|0:22-U0.102|0:19-U0.302|1:33-U0.122|0:25-U0.101|0:20-U1.000|5:32-U1.000|5:17-U0.525|2:50,,,,,wahoo_fitness-33,,518,7,,0,168070,250480,30378,,25733618,,,,,,,,,,,,,,,,,,,,,,,,,,,,,,,,,,,,,,,,,
40270798,7fac030f-1447-4504-96ac-ccf9262044a4,1644655112,60,1644656448,,0,0,12.9,4603,4773,315,315,369,370,4,3.6,0.7,1.08,0.8,763,1046,150,217,,,,43.77,33.28,45.09,1,,,,,,,,,,,,,,143,78,10.54,10.6,11.53,4.7,4.6,249,248,,1,280,280,,,,,,,,,"27,9,15,25,15,4,2,2,1","2,28,38,28,4","11,16,52,14,8",,,,,108,,,,,,,,,,,,,,,,,,,,,,,,,,,,,,,,,,,,107.2,-1,6,160,95,,1033,0,341,0,3,3,Balve,1,0,U1.000|5:11-U1.000|5:18-U1.000|6:07-U0.113|0:40-U0.220|1:11-U0.211|0:59-U0.251|1:45-U0.216|0:58-U0.237|1:44-U0.216|1:00-U0.241|1:51-U0.214|0:59-U0.235|1:46-U0.212|1:01-U0.228|1:37-U0.214|0:58-U1.000|5:45-U1.000|5:13-U0.136|0:49-U0.131|0:50-U0.138|1:17-U0.128|0:32-U0.166|1:41-U0.125|0:33-U0.163|1:46-U0.132|0:32-U0.168|1:34-U0.126|0:32-U0.166|1:34-U0.124|0:31-U0.161|1:40-U0.129|0:33-U1.000|6:27-U1.000|5:18-U1.000|6:04-U0.085|0:27,,,,,wahoo_fitness-33,,518,7,,0,168070,250480,30378,,25757605,,,,,,,,,,,,,,,,,,,,,,,,,,,,,,,,,,,,,,,,"4,4,5,5",
40329727,c28f969d-da85-4b15-93fe-d6fec5bba041,1644749245,60,1644751101,,0,0,13.6,4253,4304,434,434,420,421,4,4.6,0.79,1.04,1.1,585,1007,149,170,,,,51.99,39.01,54.04,1,,,,,,,,,,,,,,113,81,12.49,11.96,12.8,-7.5,6.2,291,291,,1,304,304,,,,,,,,,"15,12,15,15,17,21,4,0,0","0,24,54,21,0","0,4,56,36,4",,,,,118,,,,,,,,,,,,,,,,,,,,,,,,,,,,,,,,,,,,50,4,22,198,68,,1015,1,347,0,3,3,Balve,1,0,U1.000|5:46-U1.000|6:02-U1.000|5:25-U1.000|6:09-U1.000|5:50-U1.000|4:56-U1.000|5:16-U1.000|6:31-U1.000|4:53-U1.000|4:19-U1.000|4:20-U1.000|4:05-U1.000|4:32-U0.570|2:49,,,,,wahoo_fitness-33,,518,7,,0,168070,250480,30378,,25809052,,,,,,,,,,,,,,,,,,,,,,,,,,,,,,,,,,,,,,,,"3,4",
40415498,388f753c-bb0e-4d99-a9c8-65395e929569,1644842161,60,1644843188,1645200116,0,0,13.17,4052,4482,407,412,384,398,1,5,0.78,1.15,1.06,588,1022,159,189,,,,48.33,39.66,50.16,1,,,,,,,,,,,,,,136,80,12.63,12.22,13.17,-2.5,10.8,298,298,,1,315,315,,,,,,,,,"16,11,13,15,15,22,9,0,0","0,5,53,38,3","0,5,53,34,8",,,,,122,,,,,,,,,,,,,,,,,,,,,,,,,,,,,,,,,,,,86.4,9,21,214,82,,1002,1,343,0,4,3,Balve,1,0,U1.000|4:59-U1.000|4:58-U1.000|6:04-U1.000|5:51-U1.000|5:38-U1.000|5:54-U1.000|6:09-U1.000|5:25-U1.000|4:19-U1.000|4:10-U1.000|4:05-U1.000|4:00-U1.000|5:17-U0.144|0:43,,,,,wahoo_fitness-33,,518,7,,0,168070,250480,30378,,25868121,,,,,,,,,,,,,,,,,,,,,,,,,,,,,,,,,,,,,,,,"2,5",
40481714,3ae57134-eb80-4bcf-b554-ba8b28145b7e,1644950019,60,1644947676,,0,0,4.08,1171,1171,31,31,28,275,4,0,0.11,1.13,0.85,,309,161,174,,,,51.69,39.86,52.17,1,,,,,,,,,,,,,,41,80,12.69,12.71,12.84,-3.6,-5.7,309,309,,1,315,315,,,,,,,,,"5,4,7,16,36,25,8,0,0","0,3,39,58,0","0,4,31,61,4",,,,,131,,,,,,,,,,,,,,,,,,,,,,,,,,,,,,,,,,,,54.5,6,25,203,69,,1010,0,372,1,3,3,"Menden (Sauerland)",1,0,U1.000|4:58-U1.000|4:47-U1.000|4:37-U1.000|4:42-U0.065|0:27,,,,,wahoo_fitness-33,,518,7,,0,168070,250480,30378,,25925574,,,,,,,,,,,,,,,,,,,,,,,,,,,,,,,,,,,,,,,,,
40487192,5ebc8be3-c755-466a-a331-72dd92f1b6f2,1644955510,60,1644952734,,0,0,1.66,600,600,16,26,12,20,4,0,0.15,0.94,0.86,,157,161,171,,,,38.88,28.24,39.05,1,,,,,,,,,,,,,,21,80,10.1,10.35,10.31,2,-6.2,229,229,,1,239,239,,,,,,,,,"19,12,33,24,11,1,0,0,0","0,0,46,54,0","3,21,70,6,0",,,,,104,,,,,,,,,,,,,,,,,,,,,,,,,,,,,,,,,,,,38.9,6,27,203,71,,1010,0,364,1,4,3,"Menden (Sauerland)",1,0,U1.000|5:43-U0.659|4:17,,,,,wahoo_fitness-33,,518,7,,0,168070,250480,30378,,25930475,,,,,,,,,,,,,,,,,,,,,,,,,,,,,,,,,,,,,,,,,
40487198,c066e33f-05ff-4951-8618-e1681fc5c56b,1644951494,60,1644952737,,0,0,1.42,697,697,24,25,42,41,4,0,0.14,2.24,0.87,,145,156,187,,,,27.8,19.33,28.37,1,,,,,,,,,,,,,,22,70,7.3,8.28,8.93,29.3,39.1,168,168,,1,221,221,,,,,,,,,"81,2,2,2,2,3,2,2,5","0,19,43,32,6","41,35,9,8,6",,,,,87,,,,,,,,,,,,,,,,,,,,,,,,,,,,,,,,,,,,37.4,6,23,200,69,,1011,0,370,1,3,3,"Menden (Sauerland)",1,0,U0.984|7:19-U0.034|0:14-U0.080|0:52-U0.044|0:14-U0.280|2:59,,,,,wahoo_fitness-33,,518,7,,0,168070,250480,30378,,25930481,,,,,,,,,,,,,,,,,,,,,,,,,,,,,,,,,,,,,,,,,
40487199,4fa090a1-2ba6-4aa4-87f9-81d2e6e39aa7,1644952548,60,1644952737,,0,0,8.53,2591,2591,118,112,7,0,4,0,0.05,1,0.71,,654,165,217,,,,46.44,39,47.27,1,,,,,,,,,,,,,,112,79,12.02,13.91,14.24,9,-6.2,307,302,,1,371,370,,,,,,,,,"41,2,2,2,3,4,12,26,7","0,14,20,47,19","19,19,10,10,41",,,,,125,,,,,,,,,,,,,,,,,,,,,,,,,,,,,,,,,,,,90.7,6,23,200,69,,1011,0,370,1,3,3,"Menden (Sauerland)",1,0,U0.400|1:23-U0.100|0:35-U0.400|1:23-U0.400|1:24-U0.100|0:40-U0.400|1:22-U0.200|1:21-U0.200|0:34-U0.200|1:30-U0.200|0:33-U0.300|3:56-U0.400|1:21-U0.100|0:40-U0.400|1:24-U0.400|1:22-U0.100|0:39-U0.400|1:22-U0.200|1:44-U0.200|0:34-U0.200|1:34-U0.200|0:33-U0.400|4:15-U0.400|1:21-U0.100|0:51-U0.400|1:24-U0.400|1:23-U0.100|0:45-U0.400|1:21-U0.200|2:43-U0.200|0:33-U0.200|1:46-U0.200|0:36-U0.029|0:19,,,,,wahoo_fitness-33,,518,7,,0,168070,250480,30378,,25930480,,,,,,,,,,,,,,,,,,,,,,,,,,,,,,,,,,,,,,,,,
40515340,4743ddbb-abd8-45d5-98bf-e7e1728f3b0f,1645017541,60,1645017476,,0,0,8.09,2963,3327,193,193,390,164,4,2.9,0.7,1.22,1.03,415,708,152,182,,,,41.6,31.14,42.83,1,,,,,,,,,,,,,,88,78,10.28,10.45,11.07,19.7,14.1,247,238,,1,264,261,,,,,,,,,"23,14,21,21,10,3,2,1,4","0,25,38,37,1","6,19,54,20,2",,,,,105,,,,,,,,,,,,,,,,,,,,,,,,,,,,,,,,,,,,69.6,8,25,229,98,,1000,1,317,0,6,3,Balve,1,0,U1.000|5:43-U1.000|5:50-U1.000|5:30-U1.000|5:03-U1.000|5:44-U1.000|8:19-U1.000|6:24-U1.000|6:21-U0.077|0:30,,,,,wahoo_fitness-33,,518,7,,0,168070,250480,30378,,25955491,,,,,,,,,,,,,,,,,,,,,,,,,,,,,,,,,,,,,,,,"4,5,5",
40574418,e9ff4717-58c3-4a3d-a06f-6587d2540509,1645102517,60,1645103543,1645199300,0,0,14,4263,4547,135,136,221,219,1,0.7,0.29,1.03,0.95,,1065,159,181,,,,48.95,40.33,49.53,1,,,,,,,,,,,,,,146,81,11.99,11.98,12.08,1,1.4,287,287,,1,291,291,,,,,,,,,"5,8,9,25,41,11,1,0,0","0,9,34,56,1","0,1,64,34,0",,,,,122,,,,,,,,,,,,,,,,,,,,,,,,,,,,,,,,,,,,71.1,6,28,271,79,,1007,1,324,0,6,3,Balve,1,0,U1.000|5:55-U1.000|4:48-U1.000|5:17-U1.000|5:06-U1.000|5:20-U1.000|5:17-U1.000|4:48-U1.000|4:36-U1.000|4:40-U1.000|5:01-U1.000|4:49-U1.000|5:22-U1.000|4:53-U0.978|5:12,,,,,wahoo_fitness-33,,518,7,,0,168070,250480,30378,,26003225,,,,,,,,,,,,,,,,,,,,,,,,,,,,,,,,,,,,,,,,,
40577337,efdf8463-c5d1-462c-8787-db3a4244fa1f,1645110376,60,1645106838,,0,0,0.03,42,42,0,0,0,0,0,0,0,,,,4,91,99,,,,,,,1,,,,,,,,,,,,,,0,47,2.24,2.66,2.66,55.8,40.8,44,44,,1,51,51,,,,,,,,,"100,0,0,0,0,0,0,0,0","100,0,0,0,0","100,0,0,0,0",,,,,46,,,,,,,,,,,,,,,,,,,,,,,,,,,,,,,,,,,,0.1,,,,,,,,,,1,,,1,0,,,,,,wahoo_fitness-33,,518,7,,0,168070,250480,30378,,26005506,,,,,,,,,,,,,,,,,,,,,,,,,,,,,,,,,,,,,,,,,
40577375,b01a4962-d623-4f22-8766-9498dd9889c8,1645110474,60,1645106917,,0,0,0.01,24,24,0,0,0,0,0,0,0,,,,3,111,114,,,,,,,1,,,,,,,,,,,,,,0,35,0.67,0.63,0.63,,-47.9,11,10,,1,11,11,,,,,,,,,"100,0,0,0,0,0,0,0,0","0,100,0,0,0","100,0,0,0,0",,,,,36,,,,,,,,,,,,,,,,,,,,,,,,,,,,,,,,,,,,,,,,,,,,,,1,,,1,0,,,,,,wahoo_fitness-33,,518,7,,0,168070,250480,30378,,26005538,,,,,,,,,,,,,,,,,,,,,,,,,,,,,,,,,,,,,,,,,
40577855,07b44dfd-8965-46d7-a737-76d92591bad0,1645110810,60,1645107259,,0,0,0.01,27,27,0,0,0,0,0,0,0,,,,10,114,115,,,,,,,1,,,,,,,,,,,,,,0,59,1.45,1.39,1.39,,-56.7,25,22,,1,25,25,,,,,,,,,"100,0,0,0,0,0,0,0,0","0,100,0,0,0","100,0,0,0,0",,,,,19,,,,,,,,,,,,,,,,,,,,,,,,,,,,,,,,,,,,,,,,,,,,,,1,,,1,0,,,,,,wahoo_fitness-33,,518,7,,0,168070,250480,30378,,26006004,,,,,,,,,,,,,,,,,,,,,,,,,,,,,,,,,,,,,,,,,
40623790,e19ba66b-b102-459d-b51f-e61e11b45b21,1645189767,60,1645187241,,0,0,7.48,1003,1003,,,,,0,,,,,,139,124,147,,,,,,,1,,,,,,,,,,,,,,12,88,,27.24,,-3.2,-23,138,137,,0,152,152,,,,,,,,,"1,2,31,38,27,0,0","1,97,3,0,0","38,45,17,0,0",,,,,,,,,,,,,,,,,,,,,,,,,,,,,,,,,,,,,,,,,8.4,,,,,,,,,,1,,,1,0,U3.977|8:42-U1.221|3:00-U0.260|0:30-U0.630|1:30-U0.546|1:00-U0.569|1:30-U0.275|0:32,,,,,,,252,7,,0,168072,,30378,,26045322,,,,,,,,,,,,,,,,,,,,,,,,,,,,,,,,,,,,,,,,,
40633416,24f333de-a1e2-490c-855f-2332361464e5,1645188638,60,1645200359,,0,0,0.91,328,333,16,17,17,17,4,1.3,0.78,1.23,1.18,,46,114,137,,,,60.43,26.49,61.66,1,,,,,,,,,,,,,,3,79,10.26,9.96,10.52,-15.4,-40.4,235,235,,1,245,245,,,,,,,,,"30,14,20,17,16,2,1,0,0","8,92,0,0,0","0,39,48,13,0",,,,,105,,,,,,,,,,,,,,,,,,,,,,,,,,,,,,,,,,,,2.8,9,26,208,86,,999,1,315,0,6,3,Balve,1,0,,,,,,wahoo_fitness-33,,518,7,,0,168070,250480,30378,,26053787,,,,,,,,,,,,,,,,,,,,,,,,,,,,,,,,,,,,,,,,,
40637605,9c73168b-1504-41f2-9008-46380180ed1b,1645209271,60,1645206641,,0,0,,908,908,,,,,0,,,,,,70,,,,,,,,,1,,,,,,,,,,,,,,5,,,,,,,,,,,,,,,,,,,,,,,,,,,,,,,,,,,,,,,,,,,,,,,,,,,,,,,,,,,,,,,,,,,,,,,,,,1,,,1,0,,,,,,,,252,7,,0,168073,,30378,,26057199,,,,,,,,,,,,,,,,,,,,,,,,,,,,,,,,,,,,,,,,,
40638705,e0d144c2-d557-4b7d-b7be-f1e190317d1d,1645210265,60,1645207698,,0,0,,966,966,,,,,0,,,,,,75,,,,,,,,,1,,,,,,,,,,,,,,5,,,,,,,,,,,,,,,,,,,,,,,,,,,,,,,,,,,,,,,,,,,,,,,,,,,,,,,,,,,,,,,,,,,,,,,,,,1,,,1,0,,,,,,,,252,7,,0,168073,,30378,,26058224,,,,,,,,,,,,,,,,,,,,,,,,,,,,,,,,,,,,,,,,,
40639669,cdb39382-6c2a-4a84-a4b9-e650c0185d7b,1645209380,60,1645208718,,0,0,21.52,2910,2910,,,,,0,,,,,,372,116,139,,,,,,,1,,,,,,,,,,,,,,29,82,,26.92,,2.9,-3.1,128,128,,0,139,139,,,,,,,,,"1,0,26,57,16,0,0","5,95,0,0,0","34,52,13,0,0",,,,,,,,,,,,,,,,,,,,,,,,,,,,,,,,,,,,,,,,,7.6,,,,,,,,,,1,,,1,0,U6.078|14:00-U0.258|0:30-U0.665|1:30-U0.263|0:30-U0.667|1:30-U0.262|0:30-U0.670|1:30-U0.261|0:30-U0.669|1:30-U0.261|0:30-U0.671|1:30-U0.261|0:30-U1.675|4:00-U0.255|0:30-U0.671|1:30-U0.261|0:30-U0.671|1:30-U0.260|0:30-U0.671|1:30-U0.259|0:30-U0.670|1:30-U0.261|0:30-U0.673|1:30-U0.261|0:30-U0.671|1:30-U3.275|8:00,,,,,,,252,7,,0,168072,,30378,,26059112,,,,,,,,,,,,,,,,,,,,,,,,,,,,,,,,,,,,,,,,,
40639969,04340873-e3b8-434b-b80e-79d56a127dc9,1645211338,60,1645208779,,0,0,,873,873,,,,,0,,,,,,67,,,,,,,,,1,,,,,,,,,,,,,,5,,,,,,,,,,,,,,,,,,,,,,,,,,,,,,,,,,,,,,,,,,,,,,,,,,,,,,,,,,,,,,,,,,,,,,,,,,1,,,1,0,,,,,,,,252,7,,0,168073,,30378,,26059411,,,,,,,,,,,,,,,,,,,,,,,,,,,,,,,,,,,,,,,,,
40665087,a2e54e5a-c5a6-419d-91e7-8bb9f308a35f,1645267874,60,1645269276,1645276937,0,0,16.92,4512,4926,170,167,138,137,4,0.8,0.28,1.14,0.92,,1187,161,178,,,,56.6,47.76,57.31,1,,,,,,,,,,,,,,161,82,13.63,13.97,14.22,4.2,0.7,339,339,,1,360,360,,,,,,,,,"4,2,6,14,21,18,28,5,0","0,5,37,58,0","1,2,30,45,22",,,,,137,,,,,,,,,,,,,,,,,,,,,,,,,,,,,,,,,,,,81.2,3,25,246,79,,1014,1,431,0,3,3,Sundern,1,0,U1.000|4:46-U1.000|4:36-U1.000|4:25-U1.000|4:39-U1.000|3:54-U1.000|3:43-U0.507|2:45-U1.000|3:48-U1.000|3:48-U0.501|2:55-U1.000|3:52-U1.000|3:51-U0.331|2:36-U1.000|3:36-U1.000|3:47-U1.000|5:24-U1.000|5:02-U0.642|3:16-U0.915|4:28,,,,,wahoo_fitness-33,,518,7,,0,168070,250480,30378,,26081621,,,,,,,,,,,,,,,,,,,,,,,,,,,,,,,,,,,,,,,,,
40720031,8198c05b-3a94-4ac9-8f96-cf39b702a323,1645348939,60,1645355685,,0,0,19.28,5669,5858,466,465,485,487,4,4.4,0.71,1.11,1.03,589,1461,160,177,,,,50.64,43.1,52.16,1,,,,,,,,,,,,,,192,82,12.89,12.63,13.26,-3.8,2.1,308,308,,1,323,323,,,,,,,,,"8,8,13,19,20,22,9,1,0","0,2,43,55,0","0,2,48,40,9",,,,,124,,,,,,,,,,,,,,,,,,,,,,,,,,,,,,,,,,,,72.6,6,28,223,100,,1009,1,392,0,6,3,Balve,1,0,U1.000|5:12-U1.000|5:18-U1.000|5:52-U1.000|5:34-U1.000|5:16-U1.000|5:43-U1.000|4:43-U1.000|4:46-U1.000|5:09-U1.000|5:00-U1.000|4:25-U1.000|5:11-U1.000|4:45-U1.000|4:10-U1.000|4:01-U1.000|3:50-U1.000|4:13-U0.557|2:24-U0.104|0:18-U0.090|0:27-U0.514|2:20-U0.989|5:53,,,,,wahoo_fitness-33,,518,7,,0,168070,250480,30378,,26129437,,,,,,,,,,,,,,,,,,,,,,,,,,,,,,,,,,,,,,,,"3,5,5",
40782682,fce6ac8e-4f2c-4a8c-9845-00b1817b70c2,1645448722,60,1645445558,,0,0,0.82,281,281,37,1,42,1,4,1.5,1,,,,64,151,169,,,,45.58,27.74,50.64,1,,,,,,,,,,,,,,8,83,12.39,10.53,12.49,14.3,15.4,312,312,,1,315,315,,,,,,,,,"16,8,26,41,6,2,0,0,0","0,13,63,24,0","0,0,35,65,0",,,,,105,,,,,,,,,,,,,,,,,,,,,,,,,,,,,,,,,,,,20.1,2,31,229,100,,999,1,424,0,6,3,Balve,1,0,,,,,,wahoo_fitness-33,,518,7,,0,168070,250480,30378,,26180531,,,,,,,,,,,,,,,,,,,,,,,,,,,,,,,,,,,,,,,,,
40782683,5a1287d0-4426-4343-ba64-77f22088e269,1645444731,60,1645445560,1645450164,0,0,12.47,3552,3552,547,586,295,327,2,5.1,0.78,1.08,1.02,643,827,148,167,,,,58.88,43.2,61.86,1,,,,,,,,,,,,,,92,82,13.6,13.14,14.53,-10.6,4.3,325,325,,1,351,351,,,,,,,,,"5,7,11,14,22,27,13,2,0","0,22,68,10,0","1,5,40,35,19",,,,,128,,,,,,,,,,,,,,,,,,,,,,,,,,,,,,,,,,,,48.7,2,30,229,99,,999,1,425,0,7,3,Balve,1,0,U1.000|4:13-U1.000|6:33-U1.000|5:42-U1.000|4:57-U1.000|5:10-U1.000|4:53-U1.000|4:20-U1.000|3:57-U1.000|3:51-U1.000|4:36-U1.000|4:07-U1.000|4:36-U0.449|2:16,,,,,wahoo_fitness-33,,518,7,,0,168070,250480,30378,,26180532,,,,,,,,,,,,,,,,,,,,,,,,,,,,,,,,,,,,,,,,"2,5",
40846082,c4f3a3fd-5a11-4013-b50d-1b031acfac6f,1645549647,60,1645550234,,0,0,1.91,380,380,,,,,0,,,,,,22,,,,,,,,,1,,,,,,,,,,,,,,4,68,,18.22,,,,65,59,,0,66,67,,,,,,,,,"12,62,27,0,0,0,0",,"95,5,0,0,0",,,,,,,,,,,,,,,,,,,,,,,,,,,,,,,,,,,,,,,,,,,,,,,,,,,1,,,1,0,U1.903|6:19-U0.003|0:01,,,,,,,252,7,,0,168072,,30378,,26235153,,,,,,,,,,,,,,,,,,,,,,,,,,,,,,,,,,,,,,,,,
40855191,4c8efdc1-e05f-41cd-8096-732dcb303ea8,1645559209,60,1645561520,,0,0,3.29,1006,1006,8,24,21,22,4,0,0.12,,0.83,,281,171,190,,,,43.56,36.46,43.43,1,,,,,,,,,,,,,,45,81,11.68,11.83,11.81,-1.5,-3.7,278,278,,1,284,284,,,,,,,,,"2,1,13,38,38,8,1,0,0","0,1,6,76,18","2,2,74,23,0",,,,,121,,,,,,,,,,,,,,,,,,,,,,,,,,,,,,,,,,,,91.5,9,26,185,96,,1014,0,337,1,6,3,"Menden (Sauerland)",1,0,U1.000|5:20-U1.000|5:04-U1.000|4:57-U0.284|1:26,,,,,wahoo_fitness-33,,518,7,,0,168070,250480,30378,,26242930,,,,,,,,,,,,,,,,,,,,,,,,,,,,,,,,,,,,,,,,,
40855193,048cb0c3-c85a-41f6-aae9-06ba1b970b60,1645556982,60,1645561521,,0,0,6.64,1857,1875,93,87,11,11,4,0.9,0.42,1.2,0.81,,491,167,209,,,,50.47,42.32,51.4,1,,,,,,,,,,,,,,79,82,13.05,15.04,15.42,19.3,5.5,332,332,,1,407,407,,,,,,,,,"39,3,3,2,3,2,6,28,14","0,7,32,41,20","11,22,16,6,44",,,,,131,,,,,,,,,,,,,,,,,,,,,,,,,,,,,,,,,,,,103.5,8,25,185,96,,1014,0,337,1,6,3,"Menden (Sauerland)",1,0,U0.101|0:23-U0.204|0:41-U0.414|1:23-U0.425|1:16-U0.435|2:31-U0.416|1:22-U0.212|0:36-U0.220|1:33-U0.422|1:22-U0.216|0:35-U0.201|1:41-U0.419|1:22-U0.212|0:36-U0.497|4:11-U0.306|0:53-U0.119|0:58-U0.312|0:54-U0.099|1:05-U0.300|0:54-U0.400|3:31-U0.417|1:23-U0.211|0:43-U0.085|1:01,,,,,wahoo_fitness-33,,518,7,,0,168070,250480,30378,,26242932,,,,,,,,,,,,,,,,,,,,,,,,,,,,,,,,,,,,,,,,,
40855196,057e20d7-cd9c-4e46-ad36-480ebe548158,1645554891,60,1645561522,,0,0,5.38,1556,1787,67,52,32,19,4,0.4,0.25,1.27,0.64,364,385,154,181,,,,54.65,40.18,55.68,1,,,,,,,,,,,,,,46,80,12.66,13,13.4,11.6,-8,315,315,,1,336,336,,,,,,,,,"19,4,5,8,17,24,15,6,3","0,8,71,21,1","6,10,14,58,12",,,,,130,,,,,,,,,,,,,,,,,,,,,,,,,,,,,,,,,,,,40.5,8,26,228,94,,1013,0,337,1,6,3,"Menden (Sauerland)",1,0,U1.000|4:36-U1.000|4:29-U1.000|4:14-U1.000|4:39-U1.000|6:18-U0.367|1:39,,,,,wahoo_fitness-33,,518,7,,0,168070,250480,30378,,26242935,,,,,,,,,,,,,,,,,,,,,,,,,,,,,,,,,,,,,,,,5,
40896772,d2cc0290-e892-4a6f-a940-58bbd4101323,1645553875,60,1645634420,,0,0,1.23,273,273,,,,,0,,,,,,13,,,,,,,,,1,,,,,,,,,,,,,,3,83,,16.48,,,,51,47,,0,51,47,,,,,,,,,"14,86,0,0,0,0,0",,"99,1,0,0,0",,,,,,,,,,,,,,,,,,,,,,,,,,,,,,,,,,,,,,,,,,,,,,,,,,,1,,,1,0,,,,,,,,252,7,,0,168072,,30378,,26279885,,,,,,,,,,,,,,,,,,,,,,,,,,,,,,,,,,,,,,,,,
40897247,b576ef8b-3344-4ab1-a88c-57b5c8800b1e,1645634019,60,1645635092,,0,0,13.89,4442,4523,326,325,339,332,4,3.9,0.7,1.09,0.94,512,1042,153,182,,,,48.73,38.07,50.15,1,,,,,,,,,,,,,,132,80,11.86,11.61,12.17,3.2,11.2,279,279,,1,291,291,,,,,,,,,"15,13,15,20,19,14,3,0,0","1,10,61,28,1","0,8,58,31,3",,,,,117,,,,,,,,,,,,,,,,,,,,,,,,,,,,,,,,,,,,69.9,8,12,199,73,,1024,0,311,0,2,3,Balve,1,0,U1.000|4:56-U1.000|5:09-U1.000|6:03-U1.000|6:03-U1.000|6:09-U1.000|6:29-U1.000|5:12-U1.000|5:10-U1.000|4:42-U1.000|4:35-U1.000|4:12-U1.000|4:56-U1.000|5:34-U0.874|4:51,,,,,wahoo_fitness-33,,518,7,,0,168070,250480,30378,,26280296,,,,,,,,,,,,,,,,,,,,,,,,,,,,,,,,,,,,,,,,"3,5",
40933451,9f1fe22b-f711-42d8-a467-34fe445e2b24,1645710556,60,1645710227,,0,0,9.22,2943,2943,207,208,254,238,4,2.6,0.58,1.1,0.99,450,666,145,160,,,,52.61,36.99,54.07,1,,,,,,,,,,,,,,69,79,11.69,11.41,11.99,6.7,9.4,276,276,,1,287,287,,,,,,,,,"9,11,20,28,22,7,2,0,0","0,17,83,0,0","0,8,64,25,3",,,,,119,,,,,,,,,,,,,,,,,,,,,,,,,,,,,,,,,,,,27.5,9,25,231,81,,1008,1,350,0,4,3,Balve,1,0,U1.000|5:05-U1.000|5:28-U1.000|5:09-U1.000|4:53-U1.000|5:26-U1.000|4:57-U1.000|5:11-U1.000|5:33-U1.000|6:10-U0.203|1:11,,,,,wahoo_fitness-33,,518,7,,0,168070,250480,30378,,26312128,,,,,,,,,,,,,,,,,,,,,,,,,,,,,,,,,,,,,,,,"4,5",
40984092,dd4c88ce-ca03-4b65-a97d-9fad38a337b3,1645776784,60,1645812441,,0,0,15.59,5530,5820,468,423,0,38,4,4.7,0.79,1.06,1,467,1337,156,183,,,,41.69,34.02,43.4,1,,,,,,,,,,,,,,177,80,11.05,10.79,11.44,-3.9,7.9,253,253,,1,268,268,,,,,,,,,"33,14,11,12,21,8,1,0,0","0,12,44,43,1","1,20,55,22,1",,,,,106,,,,,,,,,,,,,,,,,,,,,,,,,,,,,,,,,,,,70.1,2,22,229,91,,1019,0,414,0,3,3,Balve,1,0,U1.000|5:07-U1.000|5:59-U1.000|6:30-U1.000|7:07-U1.000|6:53-U1.000|5:41-U1.000|8:40-U1.000|6:45-U1.000|6:38-U1.000|5:33-U1.000|4:35-U1.000|4:40-U1.000|4:39-U1.000|4:38-U1.000|5:04-U0.560|3:42,,,,,wahoo_fitness-33,,518,7,,0,168070,250480,30378,,26356410,,,,,,,,,,,,,,,,,,,,,,,,,,,,,,,,,,,,,,,,"3,4",
41013873,ce140d72-1ea5-4efc-a277-a6fcc5d9e193,1645867313,60,1645875268,,0,0,15.23,4182,4671,215,212,68,67,4,1.3,0.37,1.12,0.82,,1105,165,214,,,,52.6,45.79,53.53,1,,,,,,,,,,,,,,172,83,13.28,13.79,14.14,8.9,6.1,331,331,,1,359,359,,,,,,,,,"11,5,11,10,11,16,22,13,1","0,8,27,47,19","4,7,26,37,26",,,,,132,,,,,,,,,,,,,,,,,,,,,,,,,,,,,,,,,,,,124.7,0,3,342,92,,1036,1,352,0,3,3,Sundern,1,0,U1.000|4:45-U1.000|4:24-U1.000|4:04-U1.000|4:03-U0.070|0:19-U0.134|0:31-U0.162|0:54-U0.146|0:31-U0.147|1:42-U0.140|0:33-U0.110|1:25-U0.157|0:35-U0.096|0:33-U0.307|1:03-U0.118|0:32-U0.446|1:34-U0.158|0:47-U0.565|2:02-U0.173|1:02-U0.420|1:32-U0.135|0:47-U0.306|1:05-U0.477|3:01-U0.555|3:01-U0.302|1:02-U0.167|0:47-U0.410|1:32-U0.169|0:52-U0.535|2:02-U0.220|1:07-U0.409|1:33-U0.145|0:49-U0.297|1:02-U0.545|3:02-U0.296|1:02-U0.095|0:32-U0.419|1:33-U0.155|0:51-U0.546|2:03-U0.154|1:01-U0.390|1:32-U0.122|0:46-U0.312|1:02-U0.708|4:47,,,,,wahoo_fitness-33,,518,7,,0,168070,250480,30378,,26383051,,,,,,,,,,,,,,,,,,,,,,,,,,,,,,,,,,,,,,,,,
41059444,7f2cd09d-3e46-4384-b4b7-b95941cafc45,1645958427,60,1645960187,,0,0,15.78,5068,5273,501,500,523,521,4,5.4,0.86,1.07,1.08,646,1382,168,194,,,,42.15,38.27,43.82,1,,,,,,,,,,,,,,211,82,12.29,11.87,12.61,1.7,9.3,284,284,,1,297,297,,,,,,,,,"24,13,12,9,13,24,4,0,0","0,1,12,83,4","0,6,53,37,4",,,,,114,,,,,,,,,,,,,,,,,,,,,,,,,,,,,,,,,,,,79.3,4,15,142,62,,1034,2,348,0,2,3,Balve,1,0,U1.000|6:03-U1.000|6:01-U1.000|5:48-U1.000|6:15-U1.000|4:56-U1.000|4:28-U1.000|4:21-U1.000|6:28-U1.000|6:52-U1.000|6:35-U1.000|5:57-U1.000|4:20-U1.000|4:17-U1.000|4:12-U1.000|4:18-U0.763|3:39,,,,,wahoo_fitness-33,,518,7,,0,168070,250480,30378,,26422040,,,,,,,,,,,,,,,,,,,,,,,,,,,,,,,,,,,,,,,,"3,3,4",
41072387,d2db04d0-d4fe-4e30-a7af-5be189b0a82d,1645975916,60,1645974888,,0,0,16.05,2442,2547,317,321,328,317,4,3.5,0.66,,,767,368,,,,,,,,,1,,,,,,,,,,,,,,27,78,,29.21,,,,180,151,,0,197,186,,,,,,,,,"21,28,16,9,7,9,12",,"27,40,29,3,0",,,,,,,,,,,,,,,,,,,,,51,,,,,,,,,,,,,,,,,,,,,8,14,134,50,,1033,1,352,0,2,3,Balve,1,0,,,,,,wahoo_fitness-43,,258,7,,0,168072,,30378,,26433244,,,,,,,,,,,,,,,,,,,,,,,,,,,,,,,,,,,,,,,,4,
41165552,41b5a9b0-1d97-4163-8603-a5808b43e1bf,1646053957,60,1646133051,,0,0,4.51,1485,1686,59,60,64,62,4,1.4,0.55,0.99,1.03,399,367,156,175,,,,45.71,34.09,46.44,1,,,,,,,,,,,,,,47,77,11.2,11.76,11.97,10.4,4,268,266,,1,289,289,,,,,,,,,"20,2,7,22,26,18,3,2,0","1,14,30,54,0","10,4,44,41,1",,,,,118,,,,,,,,,,,,,,,,,,,,,,,,,,,,,,,,,,,,51.2,9,11,158,48,,1032,2,351,0,2,3,Balve,1,0,U1.000|5:23-U1.000|5:10-U1.000|4:34-U0.910|4:13-U0.591|5:26,,,,,wahoo_fitness-33,,518,7,,0,168070,250480,30378,,26498708,,,,,,,,,,,,,,,,,,,,,,,,,,,,,,,,,,,,,,,,5,
41165553,677133c6-9ebc-44a6-b893-bd906842317e,1646070263,60,1646133050,,0,0,5.15,1906,2325,62,63,60,56,4,0.9,0.35,1.15,1.34,427,495,164,216,,,,36.71,29.86,37.25,1,,,,,,,,,,,,,,83,76,9.95,11.2,11.44,25.8,0.9,245,236,,1,280,277,,,,,,,,,"36,6,5,19,16,8,4,3,5","0,21,18,29,32","18,16,31,29,6",,,,,107,,,,,,,,,,,,,,,,,,,,,,,,,,,,,,,,,,,,141.4,6,9,150,57,,1031,0,342,0,2,3,Balve,1,0,U1.000|5:14-U1.000|5:09-U1.000|4:41-U0.488|3:09-U0.105|0:18-U0.187|1:24-U0.107|0:20-U0.097|1:07-U0.237|1:33-U0.470|3:57-U0.458|4:54,,,,,wahoo_fitness-33,,518,7,,0,168070,250480,30378,,26498709,,,,,,,,,,,,,,,,,,,,,,,,,,,,,,,,,,,,,,,,5,
41190281,96c9d8de-a98d-49e7-8788-957b223e9d1f,1646163643,60,1646161424,,0,0,3.3,1119,1119,12,27,3,22,4,0,0.08,1.07,0.88,,303,164,176,,,,40.91,32.28,40.87,1,,,,,,,,,,,,,,42,81,10.59,10.66,10.71,1,-0.8,246,246,,1,252,252,,,,,,,,,"7,14,41,31,7,0,0,0,0","0,3,15,82,0","0,8,90,2,0",,,,,109,,,,,,,,,,,,,,,,,,,,,,,,,,,,,,,,,,,,59.5,4,6,155,64,,1029,0,365,1,4,3,"Menden (Sauerland)",1,0,U1.000|5:36-U1.000|5:41-U1.000|5:38-U0.299|1:44,,,,,wahoo_fitness-33,,518,7,,0,168070,250480,30378,,26517125,,,,,,,,,,,,,,,,,,,,,,,,,,,,,,,,,,,,,,,,,
41190285,b3f53582-36a0-4a17-be66-3efbcb46e3a7,1646161038,60,1646161426,,0,0,0.22,116,116,0,2,1,1,4,0,0.08,4.85,1.56,,10,92,111,,,,46.37,,45.85,1,,,,,,,,,,,,,,0,71,6.58,7.32,7.48,29.1,-5.2,146,146,,1,169,169,,,,,,,,,"85,1,1,1,1,2,3,3,4","82,18,0,0,0","46,29,14,11,0",,,,,80,,,,,,,,,,,,,,,,,,,,,,,,,,,,,,,,,,,,0.3,4,6,151,63,,1029,0,363,1,4,3,"Menden (Sauerland)",1,0,,,,,,wahoo_fitness-33,,518,7,,0,168070,250480,30378,,26517130,,,,,,,,,,,,,,,,,,,,,,,,,,,,,,,,,,,,,,,,,
41190286,09dd0aa6-8e65-4d1d-a083-d6caeb1b8e26,1646161333,60,1646161426,,0,0,7.2,2056,2056,99,99,1,0,4,1.3,0.58,0.94,0.62,,574,170,211,,,,47.84,41.49,48.65,1,,,,,,,,,,,,,,98,83,12.77,14.83,15.07,10.7,1.3,324,323,,1,396,395,,,,,,,,,"39,2,2,2,2,3,11,28,12","0,8,24,30,38","14,21,12,8,45",,,,,127,,,,,,,,,,,,,,,,,,,,,,,,,,,,,,,,,,,,137.1,5,6,151,63,,1029,0,363,1,4,3,"Menden (Sauerland)",1,0,U1.200|3:55-U0.200|1:23-U0.400|1:14-U0.100|0:55-U0.400|1:12-U0.100|0:54-U0.400|1:13-U0.400|3:57-U1.200|4:08-U0.200|1:16-U0.400|1:13-U0.100|1:02-U0.400|1:13-U0.100|0:55-U0.400|1:16-U0.400|3:35-U0.800|4:55,,,,,wahoo_fitness-33,,518,7,,0,168070,250480,30378,,26517131,,,,,,,,,,,,,,,,,,,,,,,,,,,,,,,,,,,,,,,,,
41190290,9ab7520d-fb04-42a3-974c-c779f7918a53,1646159501,60,1646161429,,0,0,4.02,1093,1093,18,28,9,121,4,0,0.09,1.18,1.02,,260,157,178,,,,57.35,42.43,57.49,1,,,,,,,,,,,,,,36,82,13.21,13.28,13.26,9.5,8,324,324,,1,326,326,,,,,,,,,"0,0,2,14,35,43,7,0,0","1,11,33,55,0","0,2,13,83,2",,,,,135,,,,,,,,,,,,,,,,,,,,,,,,,,,,,,,,,,,,55.3,5,6,152,61,,1029,0,362,1,4,3,"Menden (Sauerland)",1,0,U1.000|4:35-U1.000|4:28-U1.000|4:26-U1.000|4:41-U0.011|0:03,,,,,wahoo_fitness-33,,518,7,,0,168070,250480,30378,,26517134,,,,,,,,,,,,,,,,,,,,,,,,,,,,,,,,,,,,,,,,,
41227364,d853f215-fe96-45e4-b047-ea3e5769e45b,1646227619,60,1646228464,,0,0,14.15,4217,4399,375,375,687,304,4,4.2,0.74,1.01,1.04,573,986,150,176,,,,54.66,41.39,56.45,1,,,,,,,,,,,,,,111,81,12.86,12.62,13.16,-1.8,-2.2,305,305,,1,317,317,,,,,,,,,"12,10,16,14,11,23,12,1,0","0,14,77,9,0","0,3,42,47,7",,,,,124,,,,,,,,,,,,,,,,,,,,,,,,,,,,,,,,,,,,38.8,9,6,90,46,,1024,2,367,0,2,3,Balve,1,0,U1.000|6:04-U1.000|6:07-U1.000|5:37-U1.000|6:28-U1.000|4:45-U1.000|4:12-U1.000|4:07-U1.000|4:19-U1.000|4:36-U1.000|5:48-U1.000|5:12-U1.000|3:57-U1.000|4:12-U1.000|4:22-U0.124|0:32,,,,,wahoo_fitness-33,,518,7,,0,168070,250480,30378,,26547866,,,,,,,,,,,,,,,,,,,,,,,,,,,,,,,,,,,,,,,,"3,4",
41284408,3670e7de-6cde-449e-b88e-7b80f8cdf2a1,1646328518,60,1646328776,,0,0,10.49,3172,3717,313,306,0,0,4,4.1,0.69,1.16,1.07,602,707,147,174,,,,55.21,39.78,57.29,1,,,,,,,,,,,,,,81,81,12.86,12.42,13.53,-9.1,-7.1,305,305,,1,326,326,,,,,,,,,"15,8,9,14,24,18,9,2,0","1,27,56,16,0","1,4,50,36,10",,,,,122,,,,,,,,,,,,,,,,,,,,,,,,,,,,,,,,,,,,40.1,5,8,80,53,,1019,0,360,0,2,3,Balve,1,0,U1.000|5:02-U1.000|4:58-U1.000|5:10-U1.000|6:06-U1.000|4:47-U1.000|5:45-U1.000|4:24-U1.000|4:13-U1.000|3:59-U1.000|5:41-U0.469|2:47,,,,,wahoo_fitness-33,,518,7,,0,168070,250480,30378,,26593734,,,,,,,,,,,,,,,,,,,,,,,,,,,,,,,,,,,,,,,,"4,4,5",
41323552,02b91043-d40f-4bd1-b362-cbaa5f2aecaf,1646399342,60,1646400299,,0,0,13.67,4122,4396,321,320,680,430,4,3.8,0.69,1.03,1.05,521,971,149,171,,,,54.38,40.72,55.96,1,,,,,,,,,,,,,,107,81,12.65,12.47,12.86,-11.4,-2.9,299,299,,1,307,307,,,,,,,,,"13,10,15,14,15,19,12,1,0","0,16,74,10,0","0,1,52,42,5",,,,,123,,,,,,,,,,,,,,,,,,,,,,,,,,,,,,,,,,,,40.9,8,6,89,39,,1021,2,339,0,2,3,Balve,1,0,U1.000|4:52-U1.000|5:02-U1.000|6:19-U1.000|5:48-U1.000|5:54-U1.000|6:05-U1.000|4:37-U1.000|4:09-U1.000|4:09-U1.000|4:05-U1.000|3:57-U1.000|5:25-U1.000|5:21-U0.638|2:58,,,,,wahoo_fitness-33,,518,7,,0,168070,250480,30378,,26627518,,,,,,,,,,,,,,,,,,,,,,,,,,,,,,,,,,,,,,,,"3,5",
41360974,6cd74865-7472-4cfb-ac0a-341fcbeb4447,1646469561,60,1646472765,,0,0,11.01,3384,3725,193,189,171,181,4,2.5,0.62,1.06,0.99,384,781,151,176,,,,52.13,39.17,53.28,1,,,,,,,,,,,,,,97,81,12.19,12.1,12.49,-2.3,-0.4,290,290,,1,303,303,,,,,,,,,"17,6,10,15,24,24,3,1,0","1,16,52,31,0","0,6,54,35,5",,,,,121,,,,,,,,,,,,,,,,,,,,,,,,,,,,,,,,,,,,54.3,0,8,135,77,,1022,0,376,0,2,3,Sundern,1,0,U1.000|4:58-U1.000|5:00-U1.000|4:32-U1.000|4:23-U0.607|3:36-U1.000|6:26-U1.000|6:19-U1.000|5:29-U1.000|5:00-U1.000|4:39-U1.000|4:21-U0.385|1:40,,,,,wahoo_fitness-33,,518,7,,0,168070,250480,30378,,26659274,,,,,,,,,,,,,,,,,,,,,,,,,,,,,,,,,,,,,,,,"4,5",
41438810,efa89a40-7bf8-4460-ace1-63f5b5bf7ddb,1646574722,60,1646577748,,0,0,18.55,5593,6225,460,436,493,467,0,4.4,0.75,1.03,1.06,533,1189,143,161,,,,57.51,41.73,59.36,1,59.26,3237,165,,4.1,0,104,97,,,,13,4,124,81,12.66,12.39,12.89,-4.3,-0.4,300,300,,1,310,310,,,,,,,,,"11,9,16,19,17,18,10,0,0","0,32,67,0,0","0,3,46,48,3",,,,,123,,,,,,,,,,,,,,,,,,,,,,,,,,,,,,,,,,,,32.8,5,14,22,61,,1024,1,367,0,3,3,Balve,1,0,U1.000|4:52-U1.000|4:58-U1.000|5:56-U1.000|5:41-U1.000|5:28-U1.000|5:26-U1.000|5:47-U1.000|4:43-U1.000|5:15-U1.000|6:09-U1.000|5:14-U1.000|5:09-U1.000|4:26-U1.000|3:56-U1.000|3:57-U1.000|3:57-U1.000|4:24-U1.000|4:41-U0.547|3:12,,"Balve Running",,,3113,,250,3,8409648524,0,168070,250480,30378,,26722787,,,,,,,,,,,,,,,,,,,,,,,,,,,,,,,,,,,,,,,,"3,4",
41492060,0d9cd8e3-d955-4d9a-95da-3134bddbe9fd,1646671114,60,1646670568,,0,0,10.01,2972,3000,163,164,536,286,4,2.3,0.6,0.99,1.04,365,653,143,172,,,,58.61,40.5,59.78,1,,,,,,,,,,,,,,66,81,12.51,12.55,12.7,-1.2,-3.4,300,300,,1,306,306,,,,,,,,,"8,7,14,20,27,15,8,2,0","1,41,54,5,0","0,0,55,43,1",,,,,125,,,,,,,,,,,,,,,,,,,,,,,,,,,,,,,,,,,,38.8,5,11,80,57,,1026,0,343,0,2,3,Balve,1,0,U1.000|5:29-U1.000|4:45-U1.000|5:04-U1.000|5:10-U1.000|4:54-U1.000|5:25-U1.000|5:22-U1.000|3:42-U1.000|4:03-U0.999|5:37,,,,,wahoo_fitness-33,,518,7,,0,168070,250480,30378,,26762650,,,,,,,,,,,,,,,,,,,,,,,,,,,,,,,,,,,,,,,,4,
41566199,94eb0195-fb49-47a0-9dca-9cb3ff86d053,1646764466,60,1646768340,,0,0,3.18,997,997,5,8,0,0,4,0,0,1.07,0.96,,235,156,170,,,,48.56,35.31,48.6,1,,,,,,,,,,,,,,31,80,11.49,11.54,11.55,2,0.7,274,274,,1,276,276,,,,,,,,,"1,4,11,54,29,1,0,0,0","0,4,65,31,0","0,0,89,11,0",,,,,120,,,,,,,,,,,,,,,,,,,,,,,,,,,,,,,,,,,,39.5,4,10,125,57,,1023,0,340,1,2,3,"Menden (Sauerland)",1,0,U1.000|5:16-U1.000|5:14-U1.000|5:11-U0.176|0:57,,,,,wahoo_fitness-33,,518,7,,0,168070,250480,30378,,26823616,,,,,,,,,,,,,,,,,,,,,,,,,,,,,,,,,,,,,,,,,
41566252,c0885cf3-9db3-478a-b061-ae632fe10757,1646761589,60,1646768350,,0,0,8,2261,2261,112,112,0,0,4,1.6,0.9,1.04,0.8,,546,155,191,,,,55.7,42.28,56.67,1,,,,,,,,,,,,,,75,80,12.96,14.75,14.96,1.2,-5.3,327,325,,1,391,390,,,,,,,,,"32,5,4,3,3,7,15,23,9","0,38,16,35,12","10,22,12,9,47",,,,,133,,,,,,,,,,,,,,,,,,,,,,,,,,,,,,,,,,,,73.5,6,10,127,54,,1023,0,335,0,2,3,"Menden (Sauerland)",1,0,U0.976|3:31-U0.400|3:09-U1.000|3:27-U0.400|3:17-U1.000|3:24-U0.400|3:18-U1.000|3:22-U0.400|3:18-U1.000|3:24-U0.400|3:31-U1.000|3:18-U0.024|0:41,,,,,wahoo_fitness-33,,518,7,,0,168070,250480,30378,,26823671,,,,,,,,,,,,,,,,,,,,,,,,,,,,,,,,,,,,,,,,,
41566256,318e1bc0-9b99-401c-a31f-62b5f461b502,1646760553,60,1646768350,,0,0,3.25,925,929,34,16,15,6,4,0,0.13,0.93,1,,229,157,176,,,,54.21,39.6,55.28,1,,,,,,,,,,,,,,29,80,13.04,13.07,13.23,-17.1,-16.3,321,321,,1,328,328,,,,,,,,,"12,2,6,11,23,36,8,1,2","0,0,65,35,0","0,4,16,77,3",,,,,132,,,,,,,,,,,,,,,,,,,,,,,,,,,,,,,,,,,,47.4,5,10,127,54,,1023,0,335,0,2,3,"Menden (Sauerland)",1,0,U1.000|5:04-U1.000|4:28-U1.000|4:27-U0.245|1:27,,,,,wahoo_fitness-33,,518,7,,0,168070,250480,30378,,26823673,,,,,,,,,,,,,,,,,,,,,,,,,,,,,,,,,,,,,,,,,
41597456,6ad0429e-01d5-4fcd-a633-8efb13e8c865,1646832910,60,1646834339,,0,0,14.1,4173,4299,371,370,337,337,4,3.8,0.67,1.04,1.05,521,956,147,163,,,,56.69,41.72,58.54,1,,,,,,,,,,,,,,102,80,12.9,12.82,13.33,-15.1,-11.6,308,308,,1,323,323,,,,,,,,,"15,9,11,15,18,15,11,5,1","0,22,76,2,0","0,4,47,36,13",,,,,127,,,,,,,,,,,,,,,,,,,,,,,,,,,,,,,,,,,,33.9,11,12,152,37,,1024,2,368,0,2,3,Balve,1,0,U1.000|4:55-U1.000|5:02-U1.000|6:04-U1.000|5:45-U1.000|5:31-U1.000|6:16-U1.000|4:56-U1.000|4:21-U1.000|4:08-U1.000|4:01-U1.000|3:35-U1.000|3:50-U1.000|5:31-U1.000|5:16-U0.073|0:24,,,,,wahoo_fitness-33,,518,7,,0,168070,250480,30378,,26850146,,,,,,,,,,,,,,,,,,,,,,,,,,,,,,,,,,,,,,,,"3,5",
41688678,99783484-1401-4e88-a7bd-b2ac42b8cf8d,1646989899,60,1646990928,,0,0,14.34,4376,4443,334,334,344,351,0,3.9,0.68,1.01,1.05,581,939,148,166,,,,54.08,40.31,55.64,1,58.17,2361,145,,3.8,0,102,98,,,,11,4,110,81,12.43,12.27,12.66,-4.9,1.6,294,294,,1,304,304,,,,,,,,,"12,12,17,13,15,26,6,0,0","1,18,76,5,0","0,2,56,39,3",,,,,121,,,,,,,,,,,,,,,,,,,,,,,,,,,,,,,,,,,,42.9,5,22,151,51,,1020,1,385,0,2,3,Balve,1,0,U1.000|5:03-U1.000|5:13-U1.000|6:22-U1.000|5:48-U1.000|6:02-U1.000|6:05-U1.000|4:53-U1.000|4:22-U1.000|4:17-U1.000|4:13-U1.000|4:13-U1.000|4:06-U1.000|5:20-U1.000|5:25-U0.341|1:34,,"Balve Running",,,3113,,250,3,8436968187,0,168070,250480,30378,,26928558,,,,,,,,,,,,,,,,,,,,,,,,,,,,,,,,,,,,,,,,"3,4",
41793724,87b7b620-0ae7-411b-ac6d-15e21255dd3d,1647167564,60,1647178742,,0,0,4.83,2073,2357,94,253,87,233,4,2.5,0.83,0.84,1.01,347,381,131,170,,,,41.58,24.84,40.89,1,,,,,,,,,,,,,,38,70,8.92,10.31,9.93,-10.4,17.2,174,173,,1,210,210,,,,,,,,,"42,4,7,22,17,7,0,0,0","8,54,20,18,0","21,41,33,5,1",,,,,100,,,,,,,,,,,,,,,,,,,,,,,,,,,,,,,,,,,,42.7,9,14,169,49,,1016,1,383,0,3,3,Balve,1,0,U1.000|14:52-U1.000|5:34-U1.000|5:16-U1.000|5:05-U0.823|3:48,,,,,wahoo_fitness-33,,518,7,,0,168070,250480,30378,,27021399,,,,,,,,,,,,,,,,,,,,,,,,,,,,,,,,,,,,,,,,4,
41793726,ce39b01e-6038-4f79-9982-e878b517888a,1647165354,60,1647178744,,0,0,6.46,2068,2160,303,143,237,80,4,3.9,0.87,1.15,0.99,596,481,151,166,,,,49.58,36.01,54,1,,,,,,,,,,,,,,57,81,12.85,11.61,13.29,6.1,11.5,316,316,,1,328,328,,,,,,,,,"18,12,16,16,21,13,4,0,0","1,13,67,19,0","0,3,39,47,12",,,,,116,,,,,,,,,,,,,,,,,,,,,,,,,,,,,,,,,,,,45.2,9,14,169,49,,1016,1,383,0,3,3,Balve,1,0,U1.000|5:48-U1.000|5:51-U1.000|5:31-U1.000|6:14-U1.000|4:42-U1.000|4:29-U0.447|1:54,,,,,wahoo_fitness-33,,518,7,,0,168070,250480,30378,,27021401,,,,,,,,,,,,,,,,,,,,,,,,,,,,,,,,,,,,,,,,3,
41793729,8e8cced4-877d-4aef-82a7-4c8a66baee91,1647095204,60,1647178747,,0,0,7.77,2235,2743,81,85,42,38,4,0,0.25,1.12,0.96,216,541,155,199,,,,54.51,41.33,55.17,1,,,,,,,,,,,,,,73,81,12.62,12.59,12.8,-8,-11.9,308,308,,1,315,315,,,,,,,,,"1,3,7,21,44,19,3,2,0","0,10,62,18,9","0,0,45,50,5",,,,,129,,,,,,,,,,,,,,,,,,,,,,,,,,,,,,,,,,,,72.9,13,13,167,45,,1019,1,393,0,4,3,Sundern,1,0,U1.000|4:51-U1.000|4:54-U1.000|4:45-U1.000|4:55-U1.000|4:56-U1.000|4:29-U1.000|4:51-U0.749|3:32,,,,,wahoo_fitness-33,,518,7,,0,168070,250480,30378,,27021405,,,,,,,,,,,,,,,,,,,,,,,,,,,,,,,,,,,,,,,,5,
41881680,c4912ee4-3fa6-4775-94be-9995ace13e9b,1647281941,60,1647329835,,0,0,1.45,907,907,102,75,87,71,4,3.3,0.98,9.42,2.75,588,153,129,214,,,,26.46,,29.47,1,,,,,,,,,,,,,,16,68,6.41,8.06,13.78,1.2,-6.8,181,178,,1,371,370,,,,,,,,,"78,1,1,1,3,8,5,3,0","0,75,13,10,2","70,5,3,3,19",,,,,71,,,,,,,,,,,,,,,,,,,,,,,,,,,,,,,,,,,,19.8,8,10,216,81,,1027,0,436,0,3,3,Balve,1,0,U0.190|0:48-U0.221|3:41-U0.181|0:49-U0.227|3:33-U0.180|0:49-U0.224|3:59-U0.184|0:48-U0.037|0:40,,,,,wahoo_fitness-33,,518,7,,0,168070,250480,30378,,27099076,,,,,,,,,,,,,,,,,,,,,,,,,,,,,,,,,,,,,,,,"4,5,5",
41903687,94cc4c8b-00ac-454c-97b4-a12cbda400b6,1647261201,60,1647360540,,0,0,7.78,2456,2517,118,138,134,157,0,1.9,0.6,1.01,0.99,330,520,146,161,108,,,52.84,37.04,53.66,1,57.59,1745,90,,3.3,0,97,98,,,,7,3,58,79,11.64,11.51,11.77,2.6,2,274,274,,1,280,280,,,,,,,,,"8,7,14,34,36,1,0,0,0","1,20,79,1,0","0,1,78,20,0",,,,,120,,,,,,,,,,,,,,,,,,,,,,,,,,,,,,,,,,,,29.8,8,14,242,88,,1026,2,421,0,4,3,Balve,1,0,U1.000|5:26-U1.000|4:54-U1.000|5:17-U1.000|5:17-U1.000|4:59-U1.000|5:38-U1.000|5:35-U0.782|3:51,,"Balve Running",,,3113,,250,3,8462558990,0,168070,250480,30378,,27119201,,,,,,,,,,,,,,,,,,,,,,,,,,,,,,,,,,,,,,,,5,
41916250,e3a9bfc5-f55a-4d4b-bbf1-0d06a2e2bf76,1647371147,60,1647368868,,0,0,2.57,818,818,45,45,45,202,4,1.3,0.69,1.16,0.88,,162,134,148,,,,58.49,34.11,59.75,1,,,,,,,,,,,,,,14,79,11.54,11.4,11.87,2.7,1.4,275,275,,1,286,286,,,,,,,,,"3,8,18,46,22,3,0,0,0","0,93,7,0,0","0,9,55,36,0",,,,,119,,,,,,,,,,,,,,,,,,,,,,,,,,,,,,,,,,,,14,8,5,136,90,,1024,0,402,1,4,3,"Menden (Sauerland)",1,0,U1.000|5:26-U1.000|5:11-U0.571|3:00,,,,,wahoo_fitness-33,,518,7,,0,168070,250480,30378,,27130993,,,,,,,,,,,,,,,,,,,,,,,,,,,,,,,,,,,,,,,,,
41916251,52f8d822-6d3e-4e8d-b65a-3846728bb231,1647369031,60,1647368869,,0,0,7.53,1950,1950,115,115,41,21,4,0.1,0.19,1.21,0.96,,499,158,199,,,,60.34,46.68,61.48,1,,,,,,,,,,,,,,66,84,14.07,14.89,15.17,-0.1,-6.4,355,355,,1,392,392,,,,,,,,,"16,7,9,5,3,7,22,25,6","0,20,27,48,5","3,10,28,15,44",,,,,138,,,,,,,,,,,,,,,,,,,,,,,,,,,,,,,,,,,,74,7,4,136,90,,1024,0,402,1,4,3,"Menden (Sauerland)",1,0,U0.349|1:25-U0.400|1:26-U0.400|1:26-U0.343|2:30-U0.600|2:06-U0.200|1:07-U0.400|1:21-U0.400|2:25-U0.600|2:06-U0.200|1:13-U0.400|1:20-U0.400|2:29-U0.600|2:06-U0.200|1:15-U0.400|1:22-U0.400|2:32-U0.400|1:26-U0.400|1:22-U0.400|1:10-U0.032|0:23,,,,,wahoo_fitness-33,,518,7,,0,168070,250480,30378,,27130994,,,,,,,,,,,,,,,,,,,,,,,,,,,,,,,,,,,,,,,,,
41916253,7ed1e97d-640a-492a-9e9d-af757d8b91ad,1647368818,60,1647368870,,0,0,0.34,134,134,11,4,14,1,4,0.5,0.4,3.49,1.07,,31,164,189,,,,33.94,21.69,36.2,1,,,,,,,,,,,,,,6,68,9.27,9.98,11.14,23.7,27.6,245,245,,1,291,291,,,,,,,,,"65,2,2,3,3,4,5,10,6","0,12,2,79,7","38,17,8,11,26",,,,,112,,,,,,,,,,,,,,,,,,,,,,,,,,,,,,,,,,,,12.8,8,5,125,90,,1024,0,404,0,6,3,"Menden (Sauerland)",1,0,,,,,,wahoo_fitness-33,,518,7,,0,168070,250480,30378,,27130996,,,,,,,,,,,,,,,,,,,,,,,,,,,,,,,,,,,,,,,,,
41916255,88678f94-631c-45c0-b947-d69983ac63ed,1647367477,60,1647368872,,0,0,3.84,1048,1058,30,19,222,10,4,0,0.1,1.16,0.87,,246,149,163,,,,61.5,42.1,62.31,1,,,,,,,,,,,,,,27,80,13.42,13.32,13.51,-12.6,-16.3,333,333,,1,336,336,,,,,,,,,"3,3,5,13,24,35,16,1,0","0,14,72,14,0","0,0,18,74,8",,,,,137,,,,,,,,,,,,,,,,,,,,,,,,,,,,,,,,,,,,29,8,4,125,90,,1024,0,404,0,6,3,"Menden (Sauerland)",1,0,U1.000|4:37-U1.000|4:31-U1.000|4:30-U0.833|3:50,,,,,wahoo_fitness-33,,518,7,,0,168070,250480,30378,,27130998,,,,,,,,,,,,,,,,,,,,,,,,,,,,,,,,,,,,,,,,,
41963091,7fe3058b-3736-4421-9cbd-2fdf69b1d518,1647444025,60,1647442866,,0,0,8.47,2212,2316,114,115,259,117,4,1.3,0.5,0.97,0.91,,538,152,179,,,,63.15,46.56,64.2,1,,,,,,,,,,,,,,65,82,14.14,14.44,14.62,-2.5,-5.3,350,350,,1,372,372,,,,,,,,,"6,5,8,10,18,19,18,14,3","0,19,45,36,0","0,2,29,40,29",,,,,140,,,,,,,,,,,,,,,,,,,,,,,,,,,,,,,,,,,,62.1,14,16,135,52,,1024,1,355,0,2,3,Balve,1,0,U1.000|4:36-U1.000|4:25-U1.000|4:00-U1.000|5:01-U0.671|3:18-U1.000|3:24-U1.000|3:31-U0.222|1:01-U0.419|1:21-U1.000|5:28-U0.145|0:48,,,,,wahoo_fitness-33,,518,7,,0,168070,250480,30378,,27172741,,,,,,,,,,,,,,,,,,,,,,,,,,,,,,,,,,,,,,,,,
42013200,3b0f61ad-a113-4604-9445-8e0470165916,1647521504,60,1647520060,,0,0,7.48,1949,2125,86,89,101,98,4,1.2,0.46,0.95,1.02,,486,155,179,,,,61.58,46.33,62.43,1,,,,,,,,,,,,,,61,83,14.08,14.68,14.58,-6.5,-15.3,350,350,,1,369,369,,,,,,,,,"8,4,8,8,19,17,11,24,1","0,14,47,39,0","0,1,30,41,28",,,,,139,,,,,,,,,,,,,,,,,,,,,,,,,,,,,,,,,,,,64.5,9,13,316,70,,1029,2,402,0,4,3,Balve,1,0,U1.000|5:04-U1.000|3:48-U1.000|4:28-U1.000|4:30-U0.267|1:15-U1.000|3:19-U1.000|3:23-U0.158|0:34-U1.000|5:57-U0.034|0:11,,,,,wahoo_fitness-33,,518,7,,0,168070,250480,30378,,27216899,,,,,,,,,,,,,,,,,,,,,,,,,,,,,,,,,,,,,,,,,
42042372,deaecc5b-1fcf-4426-aff2-40cf710d082e,1647556371,60,1647552842,,0,0,,2,2,,,,,0,,,,,,0,117,117,,,,,,,1,,,,,,,,,,,,,,0,,,,,,,,,,,,,,,,,,,,,,"0,100,0,0,0",,,,,,,,,,,,,,,,,,,,,,,,,,,,,,,,,,,,,,,,,,,,,,,,,,,,1,,,1,0,,,,,,wahoo_fitness-33,,518,7,,0,168070,250480,30378,,27242315,,,,,,,,,,,,,,,,,,,,,,,,,,,,,,,,,,,,,,,,,
42054682,d1674145-439b-4746-8279-47cd3fd3797d,1647592030,60,1647591967,,0,0,9.85,3132,3430,164,163,201,237,4,2.2,0.67,1.08,1.03,338,785,156,171,,,,47.72,37.33,48.71,1,,,,,,,,,,,,,,97,80,11.65,11.57,11.81,-6.9,-9.9,275,275,,1,280,280,,,,,,,,,"12,10,17,31,20,6,3,1,0","0,9,53,38,0","0,1,76,23,0",,,,,118,,,,,,,,,,,,,,,,,,,,,,,,,,,,,,,,,,,,49.4,4,9,68,71,,1041,1,380,0,2,3,Balve,1,0,U1.000|5:43-U1.000|5:16-U1.000|5:30-U1.000|5:36-U1.000|5:19-U1.000|5:43-U1.000|5:17-U1.000|4:24-U1.000|4:35-U0.831|4:49,,,,,wahoo_fitness-33,,518,7,,0,168070,250480,30378,,27253490,,,,,,,,,,,,,,,,,,,,,,,,,,,,,,,,,,,,,,,,4,
42124206,8be4a9f4-10d5-4570-9f50-9bb06ee94481,1647705204,60,1647704964,,0,0,1.79,612,612,4,2,13,10,4,0,0,1.12,,,117,133,140,,,,54.04,30.35,54.27,1,,,,,,,,,,,,,,10,81,10.61,10.7,10.78,-1.4,-0.2,251,251,,1,256,256,,,,,,,,,"14,8,25,40,7,3,1,1,0","0,100,0,0,0","0,9,86,5,0",,,,,108,,,,,,,,,,,,,,,,,,,,,,,,,,,,,,,,,,,,11.6,10,28,74,44,,1039,1,388,0,2,3,"Sentruper Höhe",1,0,U1.000|5:53-U0.791|4:20,,,,,wahoo_fitness-33,,518,7,,0,168070,250480,30378,,27314162,,,,,,,,,,,,,,,,,,,,,,,,,,,,,,,,,,,,,,,,,
42124207,fa752045-1048-4bbb-ac46-43161b43e1e9,1647702060,60,1647704965,1652262097,0,0,10,2167,2167,59,60,67,67,4,0,0.16,1.07,0.92,,666,179,185,,,,61.84,58.54,62.29,1,,,,,,,,,,,,,,114,86,16.76,16.82,16.94,5.8,7.8,437,437,,1,444,444,,,,,,,,,"0,0,0,0,3,10,48,35,4","0,0,1,56,42","0,0,1,20,79",,,,,161,,,,,,,,,,,,,,,,,,,,,,,,,,,,,,,,,,,,122.8,11,28,74,43,,1039,1,382,0,2,3,Redigerstraße,1,0,U1.000|3:31-U1.000|3:53-U1.000|3:04-U1.000|3:37-U1.000|3:39-U1.000|3:29-U1.000|3:31-U1.000|3:43-U1.000|3:47-U1.000|3:46-U0.028|0:07,,,,,wahoo_fitness-33,,518,7,,0,168070,250484,30378,,27314163,,,,,,,,,,,,,,,,,,,,,,10,2167,,,0,,,,,,,,0,0,30378,42124207,,,,
42124208,4584075a-1209-4c13-acac-8aa7f06d2360,1647699550,60,1647704966,,0,0,2.68,785,799,8,7,22,16,4,0,0,1.1,0.96,,187,156,169,,,,52.81,37.7,53.03,1,,,,,,,,,,,,,,24,81,12.33,12.44,12.49,-6.7,-7.6,303,301,,1,307,306,,,,,,,,,"3,2,5,16,47,22,4,1,0","0,10,50,40,0","2,1,37,59,0",,,,,126,,,,,,,,,,,,,,,,,,,,,,,,,,,,,,,,,,,,38.8,11,28,72,42,,1040,2,376,0,2,3,Redigerstraße,1,0,U1.000|5:11-U1.000|4:45-U0.674|3:10,,,,,wahoo_fitness-33,,518,7,,0,168070,250480,30378,,27314164,,,,,,,,,,,,,,,,,,,,,,,,,,,,,,,,,,,,,,,,,
42158401,c1855fc7-491c-4954-aa9d-cf3ed5323997,1647778256,60,1647775301,,0,0,1.51,525,525,0,2,3,2,4,0,0,,,,130,159,175,,,,41.56,29.23,41.49,1,,,,,,,,,,,,,,18,82,10.35,10.53,10.54,-2.9,-1,243,243,,1,248,248,,,,,,,,,"4,13,45,36,2,0,0,0,0","0,13,17,70,0","3,2,94,0,0",,,,,105,,,,,,,,,,,,,,,,,,,,,,,,,,,,,,,,,,,,40.9,10,22,138,60,,1029,2,378,0,3,3,Balve,1,0,U1.000|5:53-U0.511|2:52,,,,,wahoo_fitness-33,,518,7,,0,168070,250480,30378,,27343949,,,,,,,,,,,,,,,,,,,,,,,,,,,,,,,,,,,,,,,,,
42158403,bea83e68-4d06-47a4-a777-7461d9a0c0bb,1647773015,60,1647775304,,0,0,16.05,4881,5038,499,494,443,444,4,5.1,0.81,1.13,1.06,526,1258,160,183,,,,48.58,40.84,50.47,1,,,,,,,,,,,,,,170,81,12.82,12.54,13.14,-7.1,-4.6,300,300,,1,312,312,,,,,,,,,"15,14,14,13,14,15,11,3,0","0,8,38,53,1","0,5,47,41,6",,,,,122,,,,,,,,,,,,,,,,,,,,,,,,,,,,,,,,,,,,73.3,9,22,133,59,,1030,2,375,0,3,3,Balve,1,0,U1.000|6:04-U1.000|6:23-U1.000|5:54-U1.000|6:14-U1.000|6:12-U1.000|5:33-U1.000|4:43-U1.000|4:10-U1.000|4:47-U1.000|5:04-U1.000|5:26-U1.000|5:16-U1.000|3:48-U1.000|3:47-U1.000|3:56-U1.000|3:58-U0.020|0:06,,,,,wahoo_fitness-33,,518,7,,0,168070,250480,30378,,27343951,,,,,,,,,,,,,,,,,,,,,,,,,,,,,,,,,,,,,,,,"3,4,5",
42210551,3e87cec6-b64a-4f57-b0b3-b3e7c31477a7,1647843007,60,1647858289,,0,0,10.14,3192,3192,170,170,195,197,4,2.3,0.66,1.12,0.96,354,803,160,182,,,,46.55,37.85,47.52,1,,,,,,,,,,,,,,109,81,11.8,11.62,12.01,-11.3,-14.4,279,279,,1,288,288,,,,,,,,,"15,8,14,21,24,12,4,0,0","0,3,49,48,0","0,2,68,27,3",,,,,118,,,,,,,,,,,,,,,,,,,,,,,,,,,,,,,,,,,,62.4,4,8,151,67,,1032,0,368,0,2,3,Balve,1,0,U1.000|5:47-U1.000|5:09-U1.000|5:27-U1.000|5:16-U1.000|5:15-U1.000|5:29-U1.000|5:55-U1.000|4:40-U1.000|4:38-U1.000|5:09-U0.114|0:27,,,,,wahoo_fitness-33,,518,7,,0,168070,250480,30378,,27390688,,,,,,,,,,,,,,,,,,,,,,,,,,,,,,,,,,,,,,,,4,
42215734,98abf636-0f25-4488-8aad-dc04c1c3461f,1647863979,60,1647866307,,0,0,44.8,5581,5671,169,171,108,121,4,0,0.1,,,592,730,,,,,,,,,1,,,,,,,,,,,,,,62,87,,29.65,,,,143,132,,0,155,149,,,,,,,,,"2,7,6,25,58,1,1",,"28,59,12,1,0",,,,,,,,,,,,,,,,,,,,,52,,,,,,,,,,,,,,,,,,,,,15,9,168,61,,1031,3,370,0,2,3,Beek,1,0,,,,,,wahoo_fitness-43,,258,7,,0,168072,,30378,,27395243,,,,,,,,,,,,,,,,,,,,,,,,,,,,,,,,,,,,,,,,5,
42287114,36f9d8ea-ac9f-43bc-ad80-361ff63a0772,1647967347,60,1647969244,,0,0,41.81,5258,5378,314,314,279,294,4,0.4,0.19,,,745,668,,,,,,,,,1,,,,,,,,,,,,,,58,82,,30.06,,,,160,127,,0,197,177,,,,,,,,,"5,6,14,28,36,9,3",,"43,37,13,5,2",,,,,,,,,,,,,,,,,,,,,55,,,,,,,,,,,,,,,,,,,,,18,9,84,39,,1030,0,362,0,2,3,Beek,1,0,,,,,,wahoo_fitness-43,,258,7,,0,168072,,30378,,27456221,,,,,,,,,,,,,,,,,,,,,,,,,,,,,,,,,,,,,,,,4,
42323139,33a65111-ab08-47aa-94b0-b1459fedfeea,1648035856,60,1648036996,,0,0,36.27,4621,4670,362,364,379,373,4,1.2,0.32,,,587,640,,,,,,,,,1,,,,,,,,,,,,,,51,84,,30.03,,,,169,142,,0,193,180,,,,,,,,,"8,6,14,25,33,9,5",,"34,39,20,6,1",,,,,,,,,,,,,,,,,,,,,54,,,,,,,,,,,,,,,,,,,,,17,4,161,39,,1031,3,357,0,2,3,Beek,1,0,U12.839|29:53-U23.433|47:08,,,,,wahoo_fitness-43,,258,7,,0,168072,,30378,,27485896,,,,,,,,,,,,,,,,,,,,,,,,,,,,,,,,,,,,,,,,"4,5",
42339977,dbbc6738-6776-4d8c-9aa3-ea1832aa4019,1648056088,60,1648055892,,0,0,9.71,2548,2920,69,68,57,59,4,0,0.19,1.03,0.98,,622,152,164,,,,62.78,46.7,63.34,1,,,,,,,,,,,,,,71,81,13.83,13.82,13.92,3.4,1.8,344,344,,1,347,347,,,,,,,,,"2,1,2,6,21,46,21,1,0","0,6,91,3,0","0,1,8,84,8",,,,,141,,,,,,,,,,,,,,,,,,,,,,,,,,,,,,,,,,,,36.6,17,5,336,34,,1029,0,350,0,2,3,Geldenberg,1,0,U1.000|4:25-U1.000|4:05-U1.000|4:12-U1.000|4:16-U1.000|4:13-U1.000|4:20-U1.000|4:21-U1.000|4:32-U1.000|4:56-U0.689|3:07,,,,,wahoo_fitness-33,,518,7,,0,168070,250480,30378,,27501314,,,,,,,,,,,,,,,,,,,,,,,,,,,,,,,,,,,,,,,,,
42379190,0f0333ea-2701-4c8b-a0cd-8b9803f78dfe,1648128864,60,1648129492,,0,0,13.28,4037,4162,322,321,512,528,4,3.8,0.73,1.02,1.02,524,987,153,170,,,,51.87,40.25,53.43,1,,,,,,,,,,,,,,114,81,12.57,12.28,12.87,-7,3.1,297,297,,1,309,309,,,,,,,,,"13,12,12,15,18,21,8,1,0","0,3,87,10,0","0,4,49,39,7",,,,,122,,,,,,,,,,,,,,,,,,,,,,,,,,,,,,,,,,,,42.3,17,8,350,36,,1029,3,346,0,2,3,Balve,1,0,U1.000|4:45-U1.000|4:57-U1.000|5:58-U1.000|5:59-U1.000|5:48-U1.000|6:05-U1.000|4:42-U1.000|4:19-U1.000|4:05-U1.000|4:12-U1.000|4:20-U1.000|5:35-U1.000|5:22-U0.263|1:11,,,,,wahoo_fitness-33,,518,7,,0,168070,250480,30378,,27534211,,,,,,,,,,,,,,,,,,,,,,,,,,,,,,,,,,,,,,,,"3,5",
42443921,8ae72af7-894b-4aa6-b25f-3418e9c5d140,1648230256,60,1648230200,,0,0,9.78,3081,3228,336,337,396,212,4,4.3,0.76,1.08,1.05,566,741,153,175,,,,49.64,37.72,51.74,1,,,,,,,,,,,,,,89,80,12.58,12.2,12.94,-2.4,13.5,292,292,,1,305,305,,,,,,,,,"22,16,13,9,12,16,11,1,0","0,13,65,22,0","1,4,53,37,6",,,,,119,,,,,,,,,,,,,,,,,,,,,,,,,,,,,,,,,,,,56,13,10,43,50,,1029,0,315,0,2,3,Balve,1,0,U1.000|6:24-U1.000|6:24-U1.000|5:58-U1.000|6:07-U1.000|6:18-U1.000|4:27-U1.000|4:15-U1.000|4:11-U1.000|3:46-U0.763|3:30,,,,,wahoo_fitness-33,,518,7,,0,168070,250480,30378,,27588774,,,,,,,,,,,,,,,,,,,,,,,,,,,,,,,,,,,,,,,,3,
42469000,c0113868-5018-485d-be79-8f516b2fc325,1648283531,60,1648284462,,0,0,14.05,3342,3516,99,100,427,248,4,0,0.13,1.11,0.96,,943,168,188,,,,61.06,53.74,61.59,1,,,,,,,,,,,,,,139,84,15.19,15.16,15.26,0.1,-0.4,387,387,,1,389,389,,,,,,,,,"0,0,0,1,3,35,56,5,0","0,1,4,92,3","0,0,1,70,29",,,,,150,,,,,,,,,,,,,,,,,,,,,,,,,,,,,,,,,,,,83,9,4,41,67,,1032,1,320,0,2,3,Sundern,1,0,U1.000|4:08-U1.000|4:03-U1.000|3:56-U1.000|3:58-U1.000|4:00-U1.000|3:58-U1.000|4:01-U1.000|3:54-U1.000|4:02-U1.000|4:00-U1.000|3:54-U1.000|3:56-U1.000|3:56-U1.000|3:51-U0.014|0:05,,,,,wahoo_fitness-33,,518,7,,0,168070,250480,30378,,27611208,,,,,,,,,,,,,,,,,,,,,,,,,,,,,,,,,,,,,,,,,
42537238,480bf48d-40b6-43a7-973f-98dc9ebaf7e9,1648398892,120,1648395394,,0,0,26.39,3335,3341,408,407,469,285,4,2.4,0.58,1.43,0.59,1053,753,145,168,,,,,,,1,,,,,,,,,,,,,,80,,,31.6,,-0.6,1.9,147,131,,1,171,165,,,,,,,,,"6,16,19,12,18,13,15","1,25,66,7,0","38,40,21,1,0",,,,,,,,,,,,,,,,,,,,,,,,,,,,,,,,,,,,,,,,,36.6,17,9,9,48,,1029,1,359,0,2,3,Balve,1,0,,,,,,wahoo_fitness-33,,518,7,,0,168072,,30378,,27672222,,,,,,,,,,,,,,,,,,,,,,,,,,,,,,,,,,,,,,,,5,
42576886,b133d16a-0cde-4270-8e1e-85c5d4c0ed71,1648484952,120,1648481508,,0,0,9.62,3052,3120,253,237,261,249,0,3.3,0.85,0.92,1,485,628,144,160,97,,,53.5,37.36,55.36,1,57.06,2212,99,,3.5,0,96,98,,,,7,1,69,80,12.14,11.95,12.21,-10.3,-0.1,283,283,,1,287,287,,,,,,,,,"23,18,9,8,15,23,5,0,0","1,20,79,0,0","0,1,72,27,0",,,,,118,,,,,,,,,,,,,,,,,,,,,,,,,,,,,,,,,,,,26.2,16,13,290,56,,1018,1,372,0,3,3,Balve,1,0,U1.000|6:16-U1.000|6:32-U1.000|6:18-U1.000|6:37-U1.000|4:50-U1.000|4:23-U1.000|4:22-U1.000|4:27-U1.000|4:08-U0.621|2:58,,"Balve Running",,,3113,,250,3,8540858918,0,168070,250480,30378,,27706855,,,,,,,,,,,,,,,,,,,,,,,,,,,,,,,,,,,,,,,,4,
42646742,62ff4984-f958-4b99-9795-84f02d5ee3e1,1648578785,120,1648580089,,0,0,4.86,1295,1573,45,53,45,54,0,0,0.17,1.04,1,666,291,144,158,,,,66.37,43.98,67,1,58.13,1396,78,,3.2,0,108,101,,,,7,3,29,82,13.61,13.66,13.79,6.4,-5.3,344,344,,1,360,360,,,,,,,,,"6,4,3,5,16,48,16,1,1","3,11,86,0,0","0,2,13,77,7",,,,,137,,,,,,,,,,,,,,,,,,,,,,,,,,,,,,,,,,,,27.7,11,9,36,69,,1009,0,391,0,3,3,"Menden (Sauerland)",1,0,U1.000|4:28-U1.000|4:13-U1.000|4:18-U1.000|4:09-U0.856|4:27,,"Menden (Sauerland) Running",,,3113,,250,3,8548353646,0,168070,250480,30378,,27767126,,,,,,,,,,,,,,,,,,,,,,,,,,,,,,,,,,,,,,,,,
42646758,bb7fea5f-2402-46ae-a423-0758d357b6e2,1648580471,120,1648580095,,0,0,9.7,2446,2447,0,0,9,0,0,0,0,,,,600,162,184,101,,,60.08,48.93,60.08,1,58.48,5074,326,,4.9,3.6,104,107,,,,7,3,91,85,14.27,15.81,15.81,17.9,2.2,369,369,,1,414,414,,,,,,,,,"16,2,2,4,7,12,17,32,9","0,9,27,62,2","10,3,13,17,57",,,,,140,,,,,,,,,,,,,,,,,,,,,,,,,,,,,,,,,,,,85,10,9,44,69,,1009,0,393,0,3,3,"Menden (Sauerland)",1,0,U1.010|3:31-U0.180|0:58-U1.010|3:28-U0.410|2:02-U0.980|3:27-U0.220|1:09-U0.980|3:28-U0.400|2:17-U1.020|3:27-U0.180|1:07-U1.010|3:25-U0.060|1:54-U1.000|3:22-U0.210|1:03-U0.980|3:17-U0.050|2:52,,"Menden (Sauerland) Track Running",,,3113,,250,3,8548357021,0,168070,250480,30378,,27767145,,,,,,,,,,,,,,,,,,,,,,,,,,,,,,,,,,,,,,,,,
42646767,7490607a-cd3e-405d-8485-b4d6a64f817b,1648583102,120,1648580097,,0,0,1.45,487,487,33,0,37,4,0,0.4,0.28,1.32,,573,104,138,145,94,,,52.73,30.28,55.71,1,58.47,5064,27,,2.1,0,99,99,,,,15,3,9,83,11.58,10.74,12.62,15.4,28.4,290,290,,1,315,315,,,,,,,,,"9,13,28,40,10,0,0,0,0","0,83,17,0,0","0,0,80,8,12",,,,,108,,,,,,,,,,,,,,,,,,,,,,,,,,,,,,,,,,,,12.5,10,9,44,69,,1009,0,393,0,3,3,"Menden (Sauerland)",1,0,U1.000|5:36-U0.454|2:31,,"Menden (Sauerland) Running",,,3113,,250,3,8548357824,0,168070,250480,30378,,27767154,,,,,,,,,,,,,,,,,,,,,,,,,,,,,,,,,,,,,,,,5,
42676915,ce72ea45-75e2-4634-bf53-8c5b7a81e596,1648648964,120,1648643237,,0,0,4.64,1438,1438,147,147,250,3,4,3,0.87,1.05,1.11,652,321,144,164,,,,55.07,36.7,57.23,1,,,,,,,,,,,,,,33,81,12.65,12.06,13.08,-9.2,12.8,297,297,,1,313,313,,,,,,,,,"13,14,18,14,12,21,7,1,0","1,39,59,2,0","0,6,46,41,7",,,,,120,,,,,,,,,,,,,,,,,,,,,,,,,,,,,,,,,,,,30.4,11,11,20,63,,1003,2,391,0,3,3,Balve,1,0,U1.000|5:45-U1.000|6:06-U1.000|5:08-U1.000|4:16-U0.633|2:42,,,,,wahoo_fitness-33,,518,7,,0,168070,250480,30378,,27793853,,,,,,,,,,,,,,,,,,,,,,,,,,,,,,,,,,,,,,,,4,
42697263,c198b77c-1e37-4a56-a334-f0b47fc82226,1648667077,120,1648662610,,0,0,9.77,2598,2652,155,177,177,203,0,2.2,0.59,0.99,0.98,368,613,153,180,,,,61.19,46,62.22,1,58.78,4320,168,,4.3,0.4,101,99,,,,13,4,77,82,13.88,14.13,14.22,-1.5,-8.3,340,340,,1,356,356,,,,,,,,,"3,1,4,18,31,20,9,12,2","1,9,63,27,0","0,0,30,54,16",,,,,138,,,,,,,,,,,,,,,,,,,,,,,,,,,,,,,,,,,,75.6,8,12,29,72,,1003,,,0,4,1,Balve,1,0,U1.000|4:55-U1.000|4:46-U1.000|4:37-U1.000|4:41-U1.000|4:30-U0.275|1:17-U0.655|2:16-U1.000|3:34-U1.000|4:41-U1.000|5:01-U0.840|2:59,,"Balve Running",,,3113,,250,3,8553678948,0,168070,250480,30378,,27812453,,,,,,,,,,,,,,,,,,,,,,,,,,,,,,,,,,,,,,,,"5,5",
42735879,049ccac9-0f52-49ad-8996-49aaa49fac3a,1643805169,60,1648734698,,0,0,0.01,5,5,0,0,,,4,0,0,,,,1,,,,,,,,,1,,,,,,,,,,,,,,0,,,3.64,,,,3,3,,1,3,3,,,,,,,,,"100,0,0,0,0,0,0",,"100,0,0,0,0",,,,,,,,,,,,,,,,,,,,,,,,,,,,,,,,,,,,,,,,,,6,19,305,88,,1018,1,302,0,6,3,Balve,1,0,,,,,,wahoo_fitness-43,,258,7,,0,168072,,30378,,27843840,,,,,,,,,,,,,,,,,,,,,,,,,,,,,,,,,,,,,,,,,
42735882,a5ef5d88-4979-493a-b1d7-76e9f50b28b3,1644754243,60,1648734700,,0,0,71.05,20009,21946,1309,1311,1728,1737,4,4.8,0.57,,,431,4279,,,,,,,,,1,,,,,,,,,,,,,,221,,,16.65,,,,76,58,,1,147,138,,,,,,,,,"65,18,10,4,2,1,0",,"80,11,6,2,1",,,,,,,,,,,,,,,,,,,,,,,,,,,,,,,,,,,,,,,,,,8,22,190,57,,1011,1,331,0,3,3,Balve,1,0,,,,,,wahoo_fitness-43,,258,7,,0,168072,,30378,,27843842,,,,,,,,,,,,,,,,,,,,,,,,,,,,,,,,,,,,,,,,"2,4,4,5,5,5,5,5,5,5",
42746755,2da4b779-059c-4408-bf71-82dcc1a415b5,1648748571,120,1648745657,,0,0,13.06,3694,3928,138,139,154,157,0,1.3,0.4,0.91,0.87,297,827,150,169,,,,58.3,43.71,59.06,1,58.9,4320,179,,4,2,105,97,,,,11,3,99,79,12.98,13.25,13.3,-2.8,-0.5,316,316,,1,328,328,,,,,,,,,"8,5,9,13,17,31,14,3,1","1,14,75,11,0","2,4,24,66,4",,,,,134,,,,,,,,,,,,,,,,,,,,,,,,,,,,,,,,,,,,40.5,5,13,82,84,,998,0,403,0,6,3,Balve,1,0,U1.000|4:11-U1.000|3:58-U1.000|4:04-U1.000|4:47-U1.000|4:20-U0.296|1:21-U1.000|5:24-U1.000|6:07-U1.000|5:24-U1.000|4:56-U1.000|4:26-U1.000|4:04-U1.000|4:12-U0.759|4:20,,"Balve Running",,,3113,,250,3,8558637686,0,168070,250480,30378,,27853248,,,,,,,,,,,,,,,,,,,,,,,,,,,,,,,,,,,,,,,,"5,5",
42833516,c8424adc-cb88-40f4-b1ec-202f5c6811bc,1648889868,120,1648892919,,0,0,23.97,9535,10079,719,725,753,750,4,5.6,0.82,1.19,1.1,480,2313,155,175,,,,36.51,30.62,37.87,1,,,,,,,,,,,,,,284,78,9.89,9.64,10.54,-3.9,8.9,221,221,,1,242,242,,,,,,,,,"54,11,10,14,10,1,0,0,0","0,5,74,22,0","3,37,48,11,1",,,,,97,,,,,,,,,,,,,,,,,,,,,,,,,,,,,,,,,,,,50.8,-1,18,29,93,,1016,1,400,0,4,3,Balve,1,0,U1.000|5:52-U1.000|6:34-U1.000|6:26-U1.000|7:25-U1.000|7:09-U1.000|7:00-U1.000|7:11-U1.000|7:21-U1.000|7:41-U1.000|6:02-U1.000|8:37-U1.000|6:22-U1.000|5:29-U1.000|5:09-U1.000|5:10-U1.000|8:53-U1.000|8:15-U1.000|6:51-U1.000|7:45-U1.000|7:05-U1.000|5:36-U1.000|5:31-U1.000|5:03-U0.939|4:32,,,,,wahoo_fitness-33,,518,7,,0,168070,250480,30378,,27931495,,,,,,,,,,,,,,,,,,,,,,,,,,,,,,,,,,,,,,,,"3,4,4,4,5",
42858874,5e377ccf-d2c1-4fb8-b468-9d10392a9eaf,1648833206,120,1648929384,,0,0,11.03,3647,4036,320,321,319,322,0,4,0.79,1.02,1.04,486,721,139,159,99,,,53.27,35.96,55.17,1,58.6,3061,101,,3.3,0,102,96,,,,7,3,73,80,11.73,11.23,11.92,-2.7,13.7,269,269,,1,281,281,,,,,,,,,"22,13,15,14,28,8,0,0,0","1,53,46,0,0","0,10,61,29,0",,,,,113,,,,,,,,,,,,,,,,,,,,,,,,,,,,,,,,,,,,28.1,0,21,28,88,,1009,1,406,0,7,3,Balve,1,0,U1.000|5:52-U1.000|6:20-U1.000|5:52-U1.000|6:28-U1.000|6:33-U1.000|5:42-U1.000|4:56-U1.000|4:42-U1.000|4:42-U1.000|4:40-U1.000|4:53-U0.028|0:08,,"Balve Running",,,3113,,250,3,8570100575,0,168070,250480,30378,,27954446,,,,,,,,,,,,,,,,,,,,,,,,,,,,,,,,,,,,,,,,"4,4",
42904651,580a8061-6444-44b0-a0c6-edd0ea6bb485,1649008004,120,1649004848,,0,0,5.23,1738,2139,103,115,106,116,0,1.9,0.54,1.21,0.9,268,357,143,166,,,,51,34.01,52.1,1,58.55,1788,69,,3,0,102,100,,,,7,1,39,77,11.12,11.73,12.23,16.7,-5.2,269,269,,1,305,305,,,,,,,,,"20,3,5,26,30,10,3,1,1","1,39,58,2,0","13,7,32,41,7",,,,,117,,,,,,,,,,,,,,,,,,,,,,,,,,,,,,,,,,,,29.1,5,9,325,70,,1020,0,417,0,3,3,Balve,1,0,U1.000|4:48-U1.000|4:47-U0.999|5:28-U0.148|0:34-U0.179|1:36-U0.147|0:36-U0.176|2:16-U0.144|0:37-U0.629|4:39-U0.805|3:39,,"Balve Running",,,3113,,250,3,8575551083,0,168070,250480,30378,,27994987,,,,,,,,,,,,,,,,,,,,,,,,,,,,,,,,,,,,,,,,4,
42947052,7ecc6463-7d54-4d03-842f-988ef82c559f,1649092269,120,1649088312,,0,0,9.62,2925,3088,245,238,258,253,0,3.1,0.77,0.99,1.07,528,620,144,157,,,,56.39,39.28,58.21,1,57.84,2731,104,,3.4,0,100,97,,,,7,3,66,81,12.68,12.42,12.81,-18,-12.1,299,299,,1,309,309,,,,,,,,,"16,13,16,9,10,27,9,0,0","1,25,74,0,0","0,1,51,43,5",,,,,122,,,,,,,,,,,,,,,,,,,,,,,,,,,,,,,,,,,,31.3,2,27,235,88,,1007,1,370,0,6,3,Balve,1,0,U1.000|5:52-U1.000|6:35-U1.000|5:49-U1.000|6:13-U1.000|4:40-U1.000|4:22-U1.000|4:11-U1.000|4:10-U1.000|4:04-U0.619|2:50,,"Balve Running",,,3113,,250,3,8580142671,0,168070,250480,30378,,28030048,,,,,,,,,,,,,,,,,,,,,,,,,,,,,,,,,,,,,,,,4,
42970275,081780fe-81ff-4368-babf-19e7d5604371,1649145469,120,1649138309,,0,0,,69,69,,,,,0,,,,,,14,,,,,,,,,1,,,,,,,,,,,,,,1,,,,,,,,,,,,,,,,,,,,,,,,,,,,,,,,,,,,,,,,,,,,,,,,,,,,,,,,,,,,,,,,,,,,,,,,,,1,,,1,0,,,,,,wahoo_fitness-33,,518,7,,0,168071,,30378,,28050446,,,,,,,,,,,,,,,,,,,,,,,,,,,,,,,,,,,,,,,,,
43006703,f735a454-898c-4e8a-8dd6-28df5bb1af32,1649183647,120,1649177597,,0,0,4.07,1112,1112,37,37,23,31,4,0,0.11,,0.99,,260,152,170,,,,59.73,42.22,60.4,1,,,,,,,,,,,,,,33,81,13.31,13.29,13.41,4.3,1.7,328,328,,1,332,332,,,,,,,,,"0,3,4,10,28,50,5,0,0","4,16,22,58,0","0,4,16,76,4",,,,,136,,,,,,,,,,,,,,,,,,,,,,,,,,,,,,,,,,,,50.4,10,20,253,86,,1005,,,0,4,1,"Menden (Sauerland)",1,0,U1.000|4:48-U1.000|4:24-U1.000|4:26-U1.000|4:31-U0.061|0:23,,,,,wahoo_fitness-33,,518,7,,0,168070,250480,30378,,28082673,,,,,,,,,,,,,,,,,,,,,,,,,,,,,,,,,,,,,,,,,
43010091,557df707-30f8-4db2-be67-73b52f738f07,1649187788,120,1649181546,,0,0,0.86,317,317,8,8,0,0,4,0,0.06,1.19,0.98,,83,163,176,,,,37.24,25.65,37.67,1,,,,,,,,,,,,,,12,79,9.83,9.74,9.89,6.2,4.6,227,227,,1,230,230,,,,,,,,,"23,26,32,18,2,0,0,0,0","0,9,18,73,0","0,18,82,0,0",,,,,103,,,,,,,,,,,,,,,,,,,,,,,,,,,,,,,,,,,,37.5,10,20,260,87,,1004,0,365,0,6,3,"Menden (Sauerland)",1,0,,,,,,wahoo_fitness-33,,518,7,,0,168070,250480,30378,,28085612,,,,,,,,,,,,,,,,,,,,,,,,,,,,,,,,,,,,,,,,,
43010093,d9f2219c-d1de-434d-8a8d-2c459e3c15bc,1649185289,120,1649181548,,0,0,8.49,2216,2216,123,123,0,1,4,0,0.12,1.24,1,,578,161,194,,,,58.11,46.59,59.16,1,,,,,,,,,,,,,,85,83,13.96,15.44,15.69,-7.5,-1.3,358,356,,1,409,408,,,,,,,,,"19,1,2,1,4,8,23,40,1","0,16,23,47,14","11,11,7,23,49",,,,,138,,,,,,,,,,,,,,,,,,,,,,,,,,,,,,,,,,,,90.9,9,19,260,87,,1004,0,365,0,6,3,"Menden (Sauerland)",1,0,U1.200|4:16-U0.200|1:06-U1.200|4:14-U0.200|1:10-U1.200|4:15-U0.468|6:19-U1.200|4:12-U0.200|1:12-U1.200|4:10-U0.200|1:12-U1.200|4:12-U0.021|0:39,,,,,wahoo_fitness-33,,518,7,,0,168070,250480,30378,,28085613,,,,,,,,,,,,,,,,,,,,,,,,,,,,,,,,,,,,,,,,,
43010095,60abbad8-dc26-4fed-8142-676a94b1f0f6,1649185097,120,1649181548,,0,0,0.33,123,123,7,4,2,2,4,0,0,1.55,0.43,,20,131,148,,,,49.5,23.14,51.35,1,,,,,,,,,,,,,,2,71,9.51,10.59,12.21,26.9,44,245,245,,1,326,326,,,,,,,,,"52,5,8,7,3,3,3,6,12","0,76,24,0,0","35,17,10,15,23",,,,,113,,,,,,,,,,,,,,,,,,,,,,,,,,,,,,,,,,,,2.7,10,20,262,89,,1004,0,369,0,6,3,"Menden (Sauerland)",1,0,,,,,,wahoo_fitness-33,,518,7,,0,168070,250480,30378,,28085615,,,,,,,,,,,,,,,,,,,,,,,,,,,,,,,,,,,,,,,,,
43062755,d6ae0be2-b21b-430e-8b56-ee7aea8331cb,1649268576,120,1649265402,,0,0,13.01,3823,4020,121,122,173,173,4,0.3,0.29,0.98,0.93,,860,145,170,,,,58.27,41.8,58.93,1,,,,,,,,,,,,,,92,79,12.43,12.61,12.71,-7.2,-13.7,301,301,,1,312,312,,,,,,,,,"3,4,11,32,29,7,11,1,0","2,25,64,9,0","0,2,56,35,7",,,,,129,,,,,,,,,,,,,,,,,,,,,,,,,,,,,,,,,,,,44.7,9,22,222,84,,999,0,362,0,4,3,Balve,1,0,U1.000|5:18-U1.000|5:24-U1.000|5:13-U1.000|5:13-U1.000|5:05-U1.000|5:23-U1.000|4:51-U1.000|5:06-U1.000|5:00-U1.000|4:05-U1.000|3:44-U1.000|4:20-U0.987|5:01,,,,,wahoo_fitness-33,,518,7,,0,168070,250480,30378,,28130974,,,,,,,,,,,,,,,,,,,,,,,,,,,,,,,,,,,,,,,,,
43124927,a8a9be58-0270-4957-bac3-fa2fd368aa01,1649356795,120,1649398764,,0,0,11.63,3491,3648,273,250,279,265,0,3.3,0.71,0.94,0.99,523,724,141,153,92,,,58.91,40.43,60.77,1,57.91,1454,112,,3.5,0,101,100,,,,7,3,72,80,12.67,12.38,12.8,-7.8,-2.6,303,303,,1,310,310,,,,,,,,,"10,9,13,13,22,27,5,0,0","1,41,58,0,0","0,1,45,51,3",,,,,125,,,,,,,,,,,,,,,,,,,,,,,,,,,,,,,,,,,,26.7,6,33,254,93,,989,0,382,0,6,3,Balve,1,0,U1.000|5:33-U1.000|6:16-U1.000|5:26-U1.000|6:17-U1.000|5:09-U1.000|4:25-U1.000|4:26-U1.000|4:25-U1.000|4:16-U1.000|4:33-U1.000|4:17-U0.631|3:07,,"Balve Running",,,3113,,250,3,8600179562,0,168070,250480,30378,,28185414,,,,,,,,,,,,,,,,,,,,,,,,,,,,,,,,,,,,,,,,4,
43168501,b5eaa0b1-1d3a-42ce-9394-596b4e964427,1649446004,120,1649487128,,0,0,3.04,905,1009,15,16,4,7,4,0,0.07,1.11,1.02,,214,153,177,,,,53.23,37.39,53.53,1,,,,,,,,,,,,,,27,80,12.09,12.19,12.24,-3.1,-8.5,292,292,,1,299,299,,,,,,,,,"4,1,8,37,28,16,5,0,0","0,14,70,17,0","0,1,72,24,3",,,,,126,,,,,,,,,,,,,,,,,,,,,,,,,,,,,,,,,,,,44.9,6,8,277,85,,998,0,375,0,4,3,"Menden (Sauerland)",1,0,U1.000|5:04-U1.000|5:14-U1.000|4:37-U0.033|0:11,,,,,wahoo_fitness-33,,518,7,,0,168070,250480,30378,,28222940,,,,,,,,,,,,,,,,,,,,,,,,,,,,,,,,,,,,,,,,,
43168502,8011bb34-eae3-41b9-9cc8-a6802df08308,1649444264,120,1649487128,,0,0,3.44,925,925,54,47,0,1,4,1.7,0.76,1,0.98,,226,157,182,,,,58.14,42.49,59.42,1,,,,,,,,,,,,,,30,84,13.75,14.46,14.75,-2.5,0.8,344,344,,1,381,381,,,,,,,,,"22,8,9,9,6,3,7,24,11","0,4,62,32,2","0,16,25,20,38",,,,,133,,,,,,,,,,,,,,,,,,,,,,,,,,,,,,,,,,,,47.1,6,8,288,80,,998,0,375,0,4,3,"Menden (Sauerland)",1,0,U0.400|1:18-U0.200|1:17-U0.200|0:37-U0.200|1:10-U0.400|1:13-U0.600|3:42-U0.400|1:19-U0.200|1:17-U0.200|0:37-U0.200|1:17-U0.400|1:19-U0.035|0:19,,,,,wahoo_fitness-33,,518,7,,0,168070,250480,30378,,28222941,,,,,,,,,,,,,,,,,,,,,,,,,,,,,,,,,,,,,,,,,
43168503,841e609b-a4cb-44c2-8e25-f8ba8663776e,1649443286,120,1649487129,,0,0,1.72,518,518,37,38,0,0,4,0.3,0.29,1.05,1.21,,112,143,165,,,,57.59,34.93,59.08,1,,,,,,,,,,,,,,12,77,12.37,13.08,13.24,17.7,13.9,299,299,,1,332,332,,,,,,,,,"38,5,5,10,7,11,5,5,15","0,47,47,6,0","1,24,26,24,25",,,,,129,,,,,,,,,,,,,,,,,,,,,,,,,,,,,,,,,,,,18,7,10,269,60,,997,,,0,4,1,"Menden (Sauerland)",1,0,U0.254|0:59-U0.200|0:40-U0.200|1:32-U0.200|0:42-U0.229|1:37-U0.200|0:41-U0.200|1:26-U0.200|0:39-U0.039|0:22,,,,,wahoo_fitness-33,,518,7,,0,168070,250480,30378,,28222942,,,,,,,,,,,,,,,,,,,,,,,,,,,,,,,,,,,,,,,,,
43168505,ad9c0752-6d95-46f4-a1d7-b543d6c79bb6,1649441978,120,1649487130,,0,0,4,976,976,13,16,7,10,4,0,0,,,,233,150,162,,,,69.99,48.1,70.21,1,,,,,,,,,,,,,,27,82,14.73,14.78,14.78,5.5,4.6,373,373,,1,375,375,,,,,,,,,"0,0,1,5,16,33,32,12,0","2,10,85,4,0","0,0,2,72,26",,,,,150,,,,,,,,,,,,,,,,,,,,,,,,,,,,,,,,,,,,36.4,7,10,269,60,,997,,,0,4,1,"Menden (Sauerland)",1,0,U1.000|4:17-U1.000|3:57-U1.000|4:04-U0.989|3:58,,,,,wahoo_fitness-33,,518,7,,0,168070,250480,30378,,28222944,,,,,,,,,,,,,,,,,,,,,,,,,,,,,,,,,,,,,,,,,
43173831,c1a66707-a40b-419b-9c91-730709f540ee,1649501092,120,1649496943,,0,0,9.97,2755,2975,91,92,64,65,4,0.1,0.22,1.1,0.94,,692,159,178,,,,55.18,44.04,55.8,1,,,,,,,,,,,,,,94,81,13.14,13.08,13.25,5.2,6.5,323,323,,1,327,327,,,,,,,,,"1,1,3,10,42,37,5,0,0","1,11,28,60,0","0,0,28,67,5",,,,,134,,,,,,,,,,,,,,,,,,,,,,,,,,,,,,,,,,,,67.3,4,18,263,89,,1010,2,384,0,3,3,Sundern,1,0,U1.000|4:27-U1.000|4:34-U1.000|4:34-U1.000|4:48-U1.000|4:45-U1.000|4:30-U1.000|4:27-U1.000|4:44-U1.000|4:38-U0.957|4:29,,,,,wahoo_fitness-33,,518,7,,0,168070,250480,30378,,28227633,,,,,,,,,,,,,,,,,,,,,,,,,,,,,,,,,,,,,,,,,
43234018,bf807d46-a603-4524-a5e1-10cf79c784d0,1649599712,120,1649596877,,0,0,14.71,3721,3917,137,132,622,205,4,0.2,0.32,1.1,0.94,,1010,164,174,,,,58.74,50.22,59.44,1,,,,,,,,,,,,,,140,83,14.34,14.32,14.54,5.9,6.5,360,360,,1,368,368,,,,,,,,,"2,1,2,6,16,39,30,4,0","0,2,20,78,0","0,0,11,66,22",,,,,143,,,,,,,,,,,,,,,,,,,,,,,,,,,,,,,,,,,,75.7,9,10,307,52,,1021,3,349,0,4,3,Venusberg,1,0,U1.000|4:34-U1.000|4:05-U1.000|4:12-U1.000|3:59-U1.000|4:10-U1.000|4:02-U1.000|4:06-U1.000|4:01-U1.000|4:04-U1.000|4:04-U1.000|4:11-U1.000|4:20-U1.000|4:21-U1.000|4:33-U0.677|3:20,,,,,wahoo_fitness-33,,518,7,,0,168070,250480,30378,,28281278,,,,,,,,,,,,,,,,,,,,,,,,,,,,,,,,,,,,,,,,,
43287298,d5c69276-cd21-4636-80e1-aa174c4f52cc,1649698689,120,1649694618,,0,0,10.01,2751,3077,72,74,524,140,4,0.5,0.32,0.99,0.99,,649,150,179,,,,60.41,44.34,60.93,1,,,,,,,,,,,,,,74,81,13.26,13.44,13.56,4.4,5,326,326,,1,338,338,,,,,,,,,"1,1,2,19,47,14,9,7,0","1,16,62,21,0","0,1,31,57,12",,,,,135,,,,,,,,,,,,,,,,,,,,,,,,,,,,,,,,,,,,56,12,10,123,49,,1016,1,344,0,3,3,Balve,1,0,U1.000|4:55-U1.000|4:49-U1.000|4:47-U0.389|1:52-U1.000|3:38-U1.000|3:38-U1.000|4:34-U1.000|5:02-U1.000|4:51-U1.000|4:52-U0.609|2:54,,,,,wahoo_fitness-33,,518,7,,0,168070,250480,30378,,28328499,,,,,,,,,,,,,,,,,,,,,,,,,,,,,,,,,,,,,,,,,
43291295,a5ceb2b6-8e12-4cb1-b41f-53b92741d60e,1649702006,120,1649698688,,0,0,6.39,3904,3913,192,192,341,64,4,3.3,0.82,1.42,0.81,316,806,141,205,,,,24.3,16.21,25.23,1,,,,,,,,,,,,,,127,63,6.42,6.16,6.9,40.7,52.5,133,133,,1,150,150,,,,,,,,,"100,0,0,0,0,0,0,0,0","11,54,1,2,33","29,60,10,0,0",,,,,78,,,,,,,,,,,,,,,,,,,,,,,,,,,,,,,,,,,,205.9,13,8,132,56,,1015,,,0,4,1,Balve,1,0,U1.000|9:10-U1.000|9:38-U1.000|12:58-U1.000|11:39-U1.000|8:55-U1.000|9:04-U0.383|3:40,,,,,wahoo_fitness-33,,518,7,,0,168070,250480,30378,,28332027,,,,,,,,,,,,,,,,,,,,,,,,,,,,,,,,,,,,,,,,4,
43344056,200702eb-1438-42c2-8347-5de00f09594c,1649792377,120,1649789679,,0,0,3.27,1023,1023,8,23,152,12,4,0,0.07,1.08,0.81,,242,151,168,,,,51.01,35.48,50.87,1,,,,,,,,,,,,,,28,80,11.48,11.58,11.62,-2.2,-2.2,272,272,,1,279,279,,,,,,,,,"3,3,18,42,29,4,0,0,0","0,17,62,21,0","0,6,69,25,0",,,,,120,,,,,,,,,,,,,,,,,,,,,,,,,,,,,,,,,,,,31.4,19,14,161,63,,1011,,,0,4,1,"Menden (Sauerland)",1,0,U1.000|5:12-U1.000|5:07-U1.000|5:20-U0.265|1:23,,,,,wahoo_fitness-33,,518,7,,0,168070,250480,30378,,28378272,,,,,,,,,,,,,,,,,,,,,,,,,,,,,,,,,,,,,,,,,
43344060,b38a062a-d5a9-4e01-a38d-e543b486f6ab,1649790128,120,1649789681,,0,0,5.53,1700,1815,86,74,19,11,4,0.7,0.34,1.14,0.79,,419,155,198,,,,50.22,37.44,51.32,1,,,,,,,,,,,,,,58,80,11.9,13.94,14.29,11.4,-3.5,300,300,,1,373,373,,,,,,,,,"43,4,3,4,4,4,5,14,19","0,32,17,36,15","22,14,16,13,35",,,,,122,,,,,,,,,,,,,,,,,,,,,,,,,,,,,,,,,,,,78.5,19,14,161,63,,1011,,,0,4,1,"Menden (Sauerland)",1,0,U0.200|0:35-U0.100|0:32-U0.200|0:36-U0.100|0:29-U0.200|0:35-U0.200|1:06-U0.400|1:17-U0.300|3:42-U0.200|0:34-U0.100|0:37-U0.200|0:37-U0.100|0:32-U0.200|0:37-U0.200|1:10-U0.400|1:16-U0.316|2:58-U0.200|0:35-U0.100|0:38-U0.200|0:37-U0.100|0:37-U0.200|0:36-U0.200|1:15-U0.400|1:15-U0.176|1:54-U0.200|0:35-U0.100|2:15-U0.200|0:33-U0.034|0:17,,,,,wahoo_fitness-33,,518,7,,0,168070,250480,30378,,28378276,,,,,,,,,,,,,,,,,,,,,,,,,,,,,,,,,,,,,,,,,
43344061,e93b107c-13f6-475d-a8a6-ab70c208f300,1649788497,120,1649789682,,0,0,3.88,1057,1060,16,17,57,20,4,0,0.06,,0.85,,260,155,170,,,,58.29,42.22,58.57,1,,,,,,,,,,,,,,32,80,13.23,13.32,13.35,-17.5,-18.6,327,327,,1,331,331,,,,,,,,,"5,3,7,10,23,31,20,2,0","0,0,68,32,0","0,2,22,70,6",,,,,138,,,,,,,,,,,,,,,,,,,,,,,,,,,,,,,,,,,,42.6,18,12,148,50,,1011,0,339,0,4,3,"Menden (Sauerland)",1,0,U1.000|4:48-U1.000|4:32-U1.000|4:23-U0.869|3:54,,,,,wahoo_fitness-33,,518,7,,0,168070,250480,30378,,28378277,,,,,,,,,,,,,,,,,,,,,,,,,,,,,,,,,,,,,,,,,
43384743,ccba461d-e03a-420a-a3b8-60a78cc897be,1649869466,120,1649866502,,0,0,12.61,3879,4081,120,124,318,237,4,1,0.34,0.98,1.01,351,855,144,168,,,,55.58,39.53,56.21,1,,,,,,,,,,,,,,87,78,11.9,11.82,11.96,2.8,4.4,284,284,,1,288,288,,,,,,,,,"7,5,11,26,42,8,1,0,0","0,28,70,2,0","0,2,68,30,0",,,,,125,,,,,,,,,,,,,,,,,,,,,,,,,,,,,,,,,,,,26.2,20,6,3,59,,1016,1,353,0,3,3,Balve,1,0,U1.000|5:17-U1.000|4:38-U1.000|4:55-U1.000|4:55-U1.000|5:08-U1.000|5:04-U1.000|4:56-U1.000|4:59-U1.000|5:08-U1.000|5:07-U1.000|5:51-U1.000|5:44-U0.590|2:57,,,,,wahoo_fitness-33,,518,7,,0,168070,250480,30378,,28415345,,,,,,,,,,,,,,,,,,,,,,,,,,,,,,,,,,,,,,,,5,
43450993,6f1b663b-dcb4-4471-b9c8-759586577885,1649962864,120,1649959968,,0,0,13,4091,4231,270,273,250,243,4,3.3,0.65,1.04,0.95,554,1029,158,182,,,,47.45,38.59,48.65,1,,,,,,,,,,,,,,134,79,12.05,11.99,12.41,-6.3,-5,284,284,,1,297,297,,,,,,,,,"20,15,9,9,22,17,4,3,0","0,7,52,41,0","0,8,54,32,5",,,,,121,,,,,,,,,,,,,,,,,,,,,,,,,,,,,,,,,,,,61.8,14,11,338,70,,1020,0,371,0,4,3,Balve,1,0,U1.000|5:55-U1.000|6:35-U1.000|6:06-U1.000|6:55-U1.000|5:23-U1.000|4:50-U1.000|4:33-U1.000|4:30-U1.000|4:33-U0.779|3:36-U1.000|4:05-U0.844|3:53-U0.201|0:40-U0.214|1:17-U0.200|0:40-U0.207|1:25-U0.203|0:41-U0.335|2:33,,,,,wahoo_fitness-33,,518,7,,0,168070,250480,30378,,28470157,,,,,,,,,,,,,,,,,,,,,,,,,,,,,,,,,,,,,,,,3,
43505138,c4726fd0-b074-4cce-9687-3635bc62ebb8,1650036775,120,1650038495,,0,0,18.97,5808,6208,438,434,541,317,4,4,0.67,1.05,0.98,498,1346,148,171,,,,53.86,41.07,55.42,1,,,,,,,,,,,,,,148,79,12.39,11.98,12.6,2,10.1,293,293,,1,303,303,,,,,,,,,"9,7,12,19,35,17,1,0,0","0,21,71,8,0","0,3,51,43,3",,,,,124,,,,,,,,,,,,,,,,,,,,,,,,,,,,,,,,,,,,40.7,13,11,5,61,,1027,2,367,0,3,3,Balve,1,0,U1.000|5:06-U1.000|4:57-U1.000|5:08-U1.000|6:00-U1.000|6:11-U1.000|5:15-U1.000|5:57-U1.000|4:55-U1.000|4:59-U1.000|5:28-U1.000|5:03-U1.000|5:18-U1.000|4:58-U1.000|4:52-U1.000|4:29-U1.000|4:28-U1.000|4:22-U1.000|4:55-U0.940|4:28,,,,,wahoo_fitness-33,,518,7,,0,168070,250480,30378,,28517562,,,,,,,,,,,,,,,,,,,,,,,,,,,,,,,,,,,,,,,,"4,4,5",
43534355,57354195-8c5f-4c19-b5f2-e595fc22bcf7,1650111187,120,1650105893,,0,0,7.65,1777,1815,148,142,447,112,4,1.9,0.69,1.15,0.9,334,477,163,174,,,,65.88,53.09,67.53,1,,,,,,,,,,,,,,66,83,15.83,15.56,16.08,0.1,-3.2,405,405,,1,414,414,,,,,,,,,"1,0,0,0,5,24,59,11,0","1,3,21,76,0","0,0,7,40,53",,,,,156,,,,,,,,,,,,,,,,,,,,,,,,,,,,,,,,,,,,68.7,11,12,78,47,,1032,4,360,0,2,3,Sundern,1,0,U1.000|4:14-U1.000|4:04-U1.000|3:53-U1.000|3:50-U1.000|3:48-U1.000|3:53-U0.507|1:54-U1.000|3:34-U0.128|0:26,,,,,wahoo_fitness-33,,518,7,,0,168070,250480,30378,,28543402,,,,,,,,,,,,,,,,,,,,,,,,,,,,,,,,,,,,,,,,"5,5",
43536242,e47ece1d-3390-4738-adba-434310a5d196,1650113142,120,1650108090,,0,0,7.51,1926,1986,143,147,209,262,4,1.7,0.49,1.25,0.96,275,495,160,186,,,,59.95,47.21,61.32,1,,,,,,,,,,,,,,66,82,14.29,14.22,14.75,4.5,-2.4,357,357,,1,374,374,,,,,,,,,"3,2,4,8,21,35,17,9,2","0,3,54,42,1","0,1,27,50,22",,,,,143,,,,,,,,,,,,,,,,,,,,,,,,,,,,,,,,,,,,63.6,11,13,76,45,,1032,5,361,0,2,3,Sundern,1,0,U1.000|4:42-U1.000|4:16-U1.000|4:20-U0.130|0:34-U0.221|0:42-U0.292|1:19-U0.212|0:42-U0.268|1:20-U0.222|0:42-U0.266|1:18-U0.223|0:43-U0.298|1:22-U0.209|0:42-U0.270|1:20-U0.212|0:42-U1.000|4:22-U0.686|2:59,,,,,wahoo_fitness-33,,518,7,,0,168070,250480,30378,,28544854,,,,,,,,,,,,,,,,,,,,,,,,,,,,,,,,,,,,,,,,5,
43587196,ec5f4c12-bacb-4971-bd5d-3a3fe567853a,1650210522,120,1650207708,,0,0,9.9,3062,3177,329,329,443,208,4,4.3,0.82,1.12,1.14,570,725,150,166,,,,52.21,38.58,54.36,1,,,,,,,,,,,,,,80,79,12.71,12.18,13.14,-5.3,14.6,298,298,,1,314,314,,,,,,,,,"18,12,12,13,15,20,9,0,0","0,12,83,5,0","0,8,48,35,9",,,,,123,,,,,,,,,,,,,,,,,,,,,,,,,,,,,,,,,,,,41.1,16,10,99,31,,1025,3,375,0,2,3,Balve,1,0,U1.000|5:24-U1.000|6:04-U1.000|5:32-U1.000|6:22-U1.000|5:57-U1.000|5:03-U1.000|4:13-U1.000|4:11-U1.000|4:12-U0.883|4:04,,,,,wahoo_fitness-33,,518,7,,0,168070,250480,30378,,28589722,,,,,,,,,,,,,,,,,,,,,,,,,,,,,,,,,,,,,,,,3,
43643786,bd9ffb53-a927-41c6-8b57-072be03d3dcd,1650307397,120,1650303279,,0,0,9.94,2916,2945,152,153,378,229,4,2.3,0.63,0.97,1.08,795,642,144,173,,,,58.93,41.06,60.04,1,,,,,,,,,,,,,,67,79,12.67,12.79,12.89,-4.3,-7,304,304,,1,312,312,,,,,,,,,"8,7,11,22,27,10,11,3,0","0,35,59,6,0","0,1,50,47,2",,,,,129,,,,,,,,,,,,,,,,,,,,,,,,,,,,,,,,,,,,29.4,14,10,32,45,,1016,0,386,0,2,3,Balve,1,0,U1.000|5:09-U1.000|4:48-U1.000|5:05-U1.000|5:08-U1.000|4:48-U1.000|5:28-U1.000|5:32-U1.000|3:41-U1.000|3:44-U0.925|5:13,,,,,wahoo_fitness-33,,518,7,,0,168070,250480,30378,,28639214,,,,,,,,,,,,,,,,,,,,,,,,,,,,,,,,,,,,,,,,5,
43686852,e950a4f2-f5b8-43a1-9c97-26568438d874,1650393081,120,1650387228,,0,0,3.99,1111,1113,26,25,250,22,4,0,0.09,1.04,0.79,,268,155,175,,,,56.74,41.24,57.21,1,,,,,,,,,,,,,,34,80,13.23,13.2,13.34,-4.8,-5.9,327,325,,1,331,330,,,,,,,,,"5,1,1,6,34,45,9,0,0","1,4,69,26,0","3,1,10,84,2",,,,,135,,,,,,,,,,,,,,,,,,,,,,,,,,,,,,,,,,,,38.3,14,15,62,50,,1014,0,376,0,2,3,"Menden (Sauerland)",1,0,U1.000|4:51-U1.000|4:27-U1.000|4:31-U0.983|4:42,,,,,wahoo_fitness-33,,518,7,,0,168070,250480,30378,,28677606,,,,,,,,,,,,,,,,,,,,,,,,,,,,,,,,,,,,,,,,,
43690573,4e361c71-1032-48ab-861a-8c87b8c16ae2,1650394713,120,1650390182,,0,0,8.42,2238,2238,116,116,24,0,4,1.7,0.88,1.08,0.89,,564,160,192,,,,57.36,45.59,58.33,1,,,,,,,,,,,,,,79,83,13.73,14.41,14.7,5.8,-4.1,345,345,,1,378,378,,,,,,,,,"24,7,6,8,5,4,12,22,12","0,14,34,45,7","3,16,20,22,39",,,,,136,,,,,,,,,,,,,,,,,,,,,,,,,,,,,,,,,,,,70.7,14,14,64,52,,1014,0,377,0,2,3,"Menden (Sauerland)",1,0,U1.000|3:31-U0.400|2:09-U0.200|0:38-U0.100|0:32-U0.200|0:38-U0.100|0:35-U0.200|0:38-U0.100|0:34-U0.200|0:37-U0.100|0:36-U0.200|0:37-U0.400|2:29-U0.200|0:36-U0.100|0:37-U0.200|0:36-U0.100|0:35-U0.200|0:36-U0.100|0:38-U0.200|0:36-U0.100|0:37-U0.200|0:37-U0.400|2:48-U1.000|3:28-U0.400|2:38-U0.200|0:37-U0.100|0:41-U0.200|0:37-U0.100|0:36-U0.200|0:36-U0.400|3:07-U0.200|0:36-U0.100|0:39-U0.200|0:36-U0.100|0:36-U0.200|0:35-U0.030|0:06,,,,,wahoo_fitness-33,,518,7,,0,168070,250480,30378,,28680983,,,,,,,,,,,,,,,,,,,,,,,,,,,,,,,,,,,,,,,,,
43691584,43da3872-fd70-4ea9-8035-eac38eae41bb,1650397483,120,1650391341,,0,0,1.56,494,527,7,18,58,2,4,0,0.26,1.01,0.85,,116,155,169,,,,48.41,32.64,48.26,1,,,,,,,,,,,,,,15,80,11.38,11.51,11.49,-2.6,-5.6,267,267,,1,272,272,,,,,,,,,"11,12,15,19,25,15,4,0,0","0,11,51,38,0","4,2,71,24,0",,,,,118,,,,,,,,,,,,,,,,,,,,,,,,,,,,,,,,,,,,30.4,13,14,65,55,,1015,0,379,0,2,3,"Menden (Sauerland)",1,0,U1.000|5:19-U0.555|2:56,,,,,wahoo_fitness-33,,518,7,,0,168070,250480,30378,,28681853,,,,,,,,,,,,,,,,,,,,,,,,,,,,,,,,,,,,,,,,,
43731741,2510444d-7d55-4ed7-88bb-7f211438bb08,1650477971,120,1650471197,,0,0,1.9,320,342,38,28,45,36,4,1.5,0.86,,,,50,,,,,,,,,1,,,,,,,,,,,,,,4,69,,29.19,,,,193,156,,0,207,190,,,,,,,,,"42,27,9,2,2,3,16",,"27,34,35,4,0",,,,,,,,,,,,,,,,,,,,,54,,,,,,,,,,,,,,,,,,,,,14,15,51,53,,1014,1,393,0,3,3,Balve,1,0,,,,,,wahoo_fitness-43,,258,7,,0,168072,,30378,,28717129,,,,,,,,,,,,,,,,,,,,,,,,,,,,,,,,,,,,,,,,,
43817264,144bceb6-7d41-4b9a-80b1-ac981438053c,1650632164,120,1650642158,,0,0,14.02,3941,4123,121,121,525,352,4,0.7,0.29,1.01,0.98,434,982,155,167,,,,56.08,44.27,56.68,1,,,,,,,,,,,,,,118,79,12.96,12.92,13.03,-1.3,-2.3,316,316,,1,320,320,,,,,,,,,"2,2,4,12,45,30,4,0,0","0,3,78,19,0","0,0,30,69,1",,,,,135,,,,,,,,,,,,,,,,,,,,,,,,,,,,,,,,,,,,48.3,12,17,75,77,,1007,3,387,0,3,3,Balve,1,0,U1.000|5:06-U1.000|4:36-U1.000|4:51-U1.000|4:43-U1.000|4:48-U1.000|4:39-U1.000|4:45-U1.000|4:35-U1.000|4:45-U1.000|4:33-U1.000|4:14-U1.000|4:15-U1.000|4:46-U1.004|5:07,,,,,wahoo_fitness-33,,518,7,,0,168070,250480,30378,,28792093,,,,,,,,,,,,,,,,,,,,,,,,,,,,,,,,,,,,,,,,5,
43846201,71e1cc5d-0c61-4f1b-a1f8-4a20d0df7784,1650711097,120,1650708196,,0,0,14.17,3984,4162,127,129,514,226,4,0.5,0.27,0.98,0.9,,942,152,176,,,,57.65,44.3,58.28,1,,,,,,,,,,,,,,112,79,12.96,13.17,13.23,-12.4,-18.9,317,317,,1,328,328,,,,,,,,,"4,4,10,19,30,18,11,5,0","0,11,66,23,0","0,0,41,49,9",,,,,135,,,,,,,,,,,,,,,,,,,,,,,,,,,,,,,,,,,,49.9,13,18,109,77,,1006,3,378,0,3,3,Balve,1,0,U1.000|5:33-U1.000|4:41-U1.000|5:02-U1.000|4:54-U1.000|4:50-U1.000|4:51-U1.000|4:39-U1.000|4:42-U1.000|4:30-U1.000|4:46-U0.918|4:10-U1.000|3:31-U1.000|3:39-U0.151|0:31-U1.000|5:40-U0.079|0:27,,,,,wahoo_fitness-33,,518,7,,0,168070,250480,30378,,28816569,,,,,,,,,,,,,,,,,,,,,,,,,,,,,,,,,,,,,,,,,
43889875,f0587082-c110-4cd2-903c-b3cdf83c4a57,1650803213,120,1650798616,,0,0,0.27,103,103,4,8,0,70,4,0,0.25,0.44,0.84,,22,140,145,,,,44.24,22.2,44.24,1,,,,,,,,,,,,,,2,78,10.05,9.34,9.13,-28.8,-21.6,233,213,,1,228,219,,,,,,,,,"10,1,16,31,20,10,12,0,0","0,50,50,0,0","14,12,65,10,0",,,,,101,,,,,,,,,,,,,,,,,,,,,,,,,,,,,,,,,,,,4,14,18,51,46,,1003,4,387,0,3,3,Sundern,1,0,,,,,,wahoo_fitness-33,,518,7,,0,168070,250480,30378,,28854697,,,,,,,,,,,,,,,,,,,,,,,,,,,,,,,,,,,,,,,,,
43889876,e1853b4c-e91b-400c-b562-54780d08f9ed,1650799322,120,1650798616,,0,0,14.41,3389,3846,258,260,491,212,4,2.1,0.51,1.14,0.91,1029,891,164,177,,,,64.28,54.55,65.69,1,,,,,,,,,,,,,,127,83,15.57,15.37,15.82,1.5,-0.9,396,396,,1,405,405,,,,,,,,,"0,0,0,1,5,34,49,11,0","0,1,28,71,0","0,0,6,49,45",,,,,154,,,,,,,,,,,,,,,,,,,,,,,,,,,,,,,,,,,,77.1,14,18,53,48,,1003,4,385,0,2,3,Sundern,1,0,U1.000|4:07-U1.000|4:07-U1.000|4:03-U1.000|4:02-U1.000|3:47-U1.000|3:56-U1.000|3:51-U1.000|4:04-U1.000|3:48-U1.000|3:55-U1.000|3:52-U1.000|4:05-U1.000|3:48-U0.352|1:23-U1.000|3:33-U0.031|0:08,,,,,wahoo_fitness-33,,518,7,,0,168070,250480,30378,,28854698,,,,,,,,,,,,,,,,,,,,,,,,,,,,,,,,,,,,,,,,5,
43952013,4400d5a3-69f2-459c-82be-572eb0f63e2a,1650905887,120,1650902553,,0,0,13.22,3717,3730,126,126,648,336,4,0.8,0.31,1.02,1.03,,804,142,161,,,,63.28,44.06,64.02,1,,,,,,,,,,,,,,80,79,13.01,12.94,13.1,0.3,0.4,317,317,,1,321,321,,,,,,,,,"2,3,5,12,41,31,4,1,0","1,31,69,0,0","0,0,28,71,1",,,,,135,,,,,,,,,,,,,,,,,,,,,,,,,,,,,,,,,,,,29.6,10,5,82,77,,1011,1,393,0,6,3,Balve,1,0,U1.000|5:26-U1.000|4:33-U1.000|4:56-U1.000|4:44-U1.000|4:43-U1.000|4:42-U1.000|4:32-U1.000|4:33-U1.000|4:38-U1.000|4:25-U1.000|4:41-U1.000|5:04-U1.000|4:10-U0.194|0:51,,,,,wahoo_fitness-33,,518,7,,0,168070,250480,30378,,28906764,,,,,,,,,,,,,,,,,,,,,,,,,,,,,,,,,,,,,,,,,
43958698,3be57767-e377-413e-b074-466a883a8be8,1650911971,120,1650910208,,0,0,5.77,3847,3847,241,242,448,185,4,4.5,0.86,0.89,0.98,410,683,127,156,,,,24.87,,26.2,1,,,,,,,,,,,,,,60,61,6.27,5.96,6.89,2.1,20,126,126,,1,147,147,,,,,,,,,"99,0,0,0,0,0,0,0,0","11,56,33,0,0","33,60,6,1,0",,,,,74,,,,,,,,,,,,,,,,,,,,,,,,,,,,,,,,,,,,30.4,10,7,57,78,,1012,0,394,0,6,3,Balve,1,0,U1.000|8:57-U1.000|10:38-U1.000|17:17-U1.000|11:18-U1.000|9:00-U0.767|6:56,,,,,wahoo_fitness-33,,518,7,,0,168070,250480,30378,,28912694,,,,,,,,,,,,,,,,,,,,,,,,,,,,,,,,,,,,,,,,3,
44010175,a433cc3d-d686-475b-b1ae-2c41101b2b84,1651003078,120,1651004915,,0,0,0.85,356,356,12,9,29,4,4,0,0.28,1.27,1.02,,84,149,162,,,,36.23,22.08,37.02,1,,,,,,,,,,,,,,9,78,8.76,8.88,9.12,13.6,8,200,200,,1,209,209,,,,,,,,,"63,27,10,0,0,0,0,0,0","1,13,72,15,0","3,51,46,0,0",,,,,92,,,,,,,,,,,,,,,,,,,,,,,,,,,,,,,,,,,,21.3,10,8,357,74,,1018,0,382,0,6,3,"Menden (Sauerland)",1,0,,,,,,wahoo_fitness-33,,518,7,,0,168070,250480,30378,,28953266,,,,,,,,,,,,,,,,,,,,,,,,,,,,,,,,,,,,,,,,,
44010176,6525595b-721a-4ab7-a5f4-6fa5ab88d839,1651000365,120,1651004917,,0,0,8.17,2587,2587,115,115,4,1,4,0.8,0.33,1.37,1.07,,617,155,201,,,,48.42,37.03,49.26,1,,,,,,,,,,,,,,95,81,11.48,14.06,14.33,-7.8,-15.9,328,290,,1,383,371,,,,,,,,,"28,6,6,4,2,3,13,36,3","7,18,28,25,22","20,15,14,14,38",,,,,117,,,,,,,,,,,,,,,,,,,,,,,,,,,,,,,,,,,,99.1,10,8,357,74,,1018,0,382,0,6,3,"Menden (Sauerland)",1,0,U0.400|1:20-U0.200|1:05-U0.600|2:03-U0.200|1:09-U0.400|1:22-U0.400|2:37-U0.400|1:21-U0.200|1:13-U0.600|2:06-U0.200|1:14-U0.400|1:22-U0.138|5:00-U0.400|1:22-U0.200|1:15-U0.600|2:01-U0.200|1:08-U0.400|1:15-U0.400|2:51-U0.400|1:22-U0.200|1:20-U0.600|2:00-U0.200|1:16-U0.400|1:14-U0.036|4:12,,,,,wahoo_fitness-33,,518,7,,0,168070,250480,30378,,28953267,,,,,,,,,,,,,,,,,,,,,,,,,,,,,,,,,,,,,,,,,
44010177,ad18cd15-4162-42b6-b16d-867f177b527a,1650998128,120,1651004917,,0,0,,4,1089,0,0,0,0,4,0,0,,,,1,129,139,,,,,,,1,,,,,,,,,,,,,,0,71,,2.21,2.21,-21.5,14.7,41,41,,1,41,41,,,,,,,,,"100,0,0,0,0,0,0,0,0","25,75,0,0,0","100,0,0,0,0",,,,,,,,,,,,,,,,,,,,,,,,,,,,,,,,,,,,,,,,,,11,9,0,72,,1017,0,387,0,6,3,"Menden (Sauerland)",1,0,,,,,,wahoo_fitness-33,,518,7,,0,168070,250480,30378,,28953268,,,,,,,,,,,,,,,,,,,,,,,,,,,,,,,,,,,,,,,,,
44058045,b214a51c-1107-437d-b8a5-672a92a8e340,1651081559,120,1651093439,,0,0,9.59,3167,3332,270,286,229,250,4,3.7,0.8,1.06,1.03,505,587,129,147,,,,58.55,35.63,60.47,1,,,,,,,,,,,,,,48,78,11.68,11.28,12.02,-3.8,8.7,270,270,,1,284,284,,,,,,,,,"21,15,13,13,26,12,0,0,0","3,87,10,0,0","0,15,54,29,2",,,,,116,,,,,,,,,,,,,,,,,,,,,,,,,,,,,,,,,,,,16.2,13,7,355,59,,1024,1,367,0,3,3,Balve,1,0,U1.000|6:38-U1.000|6:12-U1.000|6:31-U1.000|6:07-U1.000|4:57-U1.000|4:41-U1.000|4:52-U1.000|4:53-U1.000|4:52-U0.576|3:03,,,,,wahoo_fitness-33,,518,7,,0,168070,250480,30378,,28993871,,,,,,,,,,,,,,,,,,,,,,,,,,,,,,,,,,,,,,,,3,
44099101,8217b77e-860f-4a51-9afa-186172aaf658,1651173742,120,1651170441,,0,0,11.69,3589,3763,115,115,509,52,4,0.8,0.34,0.97,0.96,,736,139,163,,,,58.37,39.39,59.08,1,,,,,,,,,,,,,,74,77,11.89,11.8,11.96,7.9,9,284,284,,1,288,288,,,,,,,,,"3,5,13,36,35,7,0,0,0","2,51,47,1,0","0,0,74,26,0",,,,,127,,,,,,,,,,,,,,,,,,,,,,,,,,,,,,,,,,,,34.4,13,8,24,63,,1029,0,366,0,2,3,Balve,1,0,U1.000|5:17-U1.000|4:41-U1.000|5:03-U1.000|4:56-U1.000|5:18-U1.000|5:07-U1.000|5:03-U1.000|5:00-U1.000|5:18-U1.000|5:38-U1.000|5:13-U0.672|3:15,,,,,wahoo_fitness-33,,518,7,,0,168070,250480,30378,,29030232,,,,,,,,,,,,,,,,,,,,,,,,,,,,,,,,,,,,,,,,,
44137055,99df79df-a10c-4942-afb2-99ad3330d0d5,1651252569,120,1651249939,,0,0,13.58,4273,4526,503,504,561,172,2,4.8,0.71,1.17,0.98,589,983,148,178,,,,52.08,38.73,54.46,1,,,,,,,,,,,,,,111,79,12.31,11.96,12.86,5.7,8.5,289,289,,1,307,307,,,,,,,,,"19,15,13,9,19,21,4,1,0","2,20,63,15,0","0,11,49,30,10",,,,,121,,,,,,,,,,,,,,,,,,,,,,,,,,,,,,,,,,,,61,12,11,5,65,,1026,1,371,0,4,3,Balve,1,0,U1.000|6:09-U1.000|6:26-U1.000|6:16-U1.000|6:56-U1.000|5:09-U1.000|4:42-U1.000|4:34-U1.000|5:48-U1.000|5:18-U1.000|4:30-U1.000|4:24-U0.966|4:14-U1.000|3:58-U0.584|2:48,,,,,wahoo_fitness-33,,518,7,,0,168070,250480,30378,,29064461,,,,,,,,,,,,,,,,,,,,,,,,,,,,,,,,,,,,,,,,"2,4",
44159133,e13fd0d3-b033-4661-802e-0bff7f389347,1651308189,120,1651303779,,0,0,7.86,2536,2828,190,186,434,18,2,2.6,0.56,1.14,0.98,540,542,143,171,,,,52.89,36.12,54.51,1,,,,,,,,,,,,,,57,79,11.48,11.31,11.72,8.7,5.7,272,272,,1,281,281,,,,,,,,,"9,7,23,29,29,2,1,0,0","1,45,44,9,0","0,5,72,20,3",,,,,118,,,,,,,,,,,,,,,,,,,,,,,,,,,,,,,,,,,,37.5,5,11,17,83,,1027,1,377,0,3,3,Balve,1,0,U1.000|5:26-U1.000|4:56-U1.000|5:41-U1.000|5:22-U0.908|4:54-U1.000|4:46-U1.000|6:04-U0.936|5:07,,,,,wahoo_fitness-33,,518,7,,0,168070,250480,30378,,29083725,,,,,,,,,,,,,,,,,,,,,,,,,,,,,,,,,,,,,,,,"4,5",
44236619,acee0ff1-688d-4eb6-9db6-0e76ccfd9f59,1651422013,120,1651419428,,0,0,13.54,4116,4532,177,170,597,327,2,1,0.25,1.01,0.89,352,848,138,165,,,,59.64,40.31,60.64,1,,,,,,,,,,,,,,84,77,12.13,12.34,12.53,5.1,0.2,290,290,,1,305,305,,,,,,,,,"14,5,5,16,35,21,5,0,0","4,40,54,2,0","2,7,37,53,1",,,,,128,,,,,,,,,,,,,,,,,,,,,,,,,,,,,,,,,,,,39.4,12,9,26,60,,1022,2,361,0,4,3,Balve,1,0,U1.000|5:13-U1.000|4:47-U1.000|5:12-U1.000|4:59-U1.000|5:07-U1.000|4:53-U1.000|4:34-U1.000|4:06-U1.000|4:08-U1.000|4:22-U1.000|4:41-U1.000|5:41-U1.000|6:20-U0.520|4:32,,,,,wahoo_fitness-33,,518,7,,0,168070,250480,30378,,29150457,,,,,,,,,,,,,,,,,,,,,,,,,,,,,,,,,,,,,,,,"4,5",
44283593,f574c482-5afb-4be0-bf7e-85ea025fb23f,1651515466,120,1651513158,,0,0,3.36,2264,2386,220,3,221,2,0,3.9,0.88,,,356,218,102,132,,,,,,,1,57.91,,9,,0.9,0,,100,,,,,,14,58,,5.73,,32.1,,,,,,,,,,,,,,,,"35,65,0,0,0,0","50,50,0,0,0",,,,,,,,,,,,,,,,,,,,,,,,,,,,,,,,,,,,,,,,,,4.1,15,10,15,72,,1017,1,359,0,3,3,Balve,1,0,,,"Balve Hiking",,,3113,,250,3,8747705066,0,168075,,30378,,29192597,,,,,,,,,,,,,,,,,,,,,,,,,,,,,,,,,,,,,,,,3,
44297428,ad346f72-60f2-4b8e-a794-9d75f7c99f2f,1651517906,120,1651542019,,0,0,7.66,2223,2423,103,312,114,324,0,2.8,0.79,0.96,1.08,617,440,137,162,98,,,63.75,40.87,62.66,1,57.89,1234,69,,3.1,0,104,98,,,,13,2,42,79,12.51,12.98,12.61,-12.2,-3.9,275,275,,1,283,283,,,,,,,,,"13,5,7,7,19,39,9,0,0","1,60,38,2,0","0,3,75,21,0",,,,,131,,,,,,,,,,,,,,,,,,,,,,,,,,,,,,,,,,,,22.6,13,8,21,74,,1017,0,359,0,3,3,Balve,1,0,U1.000|5:01-U1.000|6:01-U1.000|6:02-U1.000|4:31-U1.000|4:14-U1.000|4:13-U1.000|4:00-U0.656|3:02,,"Balve Running",,,3113,,250,3,8749614791,0,168070,250480,30378,,29204498,,,,,,,,,,,,,,,,,,,,,,,,,,,,,,,,,,,,,,,,4,
44332794,456e2f05-34ab-4495-a6c0-04f63394aeab,1651603019,120,1651601321,,0,0,3.85,1016,1016,16,28,15,27,0,0,0.06,,0.93,,243,149,158,,,,64.11,43.79,64.19,1,58.85,1920,76,,3.2,0,105,101,,,,13,1,26,79,13.54,13.68,13.59,6,7.8,335,335,,1,337,337,,,,,,,,,"0,0,1,3,27,65,5,0,0","0,6,94,0,0","0,0,7,92,1",,,,,144,,,,,,,,,,,,,,,,,,,,,,,,,,,,,,,,,,,,29.2,14,7,5,64,,1017,0,348,0,3,3,"Menden (Sauerland)",1,0,U1.000|4:25-U1.000|4:25-U1.000|4:26-U0.849|3:40,,"Menden (Sauerland) Running",,,3113,,250,3,8754282771,0,168070,250480,30378,,29235429,,,,,,,,,,,,,,,,,,,,,,,,,,,,,,,,,,,,,,,,,
44332803,8d0bafc2-8312-402c-a6f3-d968596e8a9b,1651604531,120,1651601330,,0,0,1.54,697,697,20,21,30,31,0,0,0.26,1.79,0.6,,117,128,153,,,,40.05,21.5,40.66,1,58.85,1902,15,,1.5,0,,100,,,,7,3,10,67,7.84,9.05,9.55,2.8,-8.4,186,186,,1,239,239,,,,,,,,,"78,1,1,1,2,2,2,4,9","0,89,11,0,0","45,24,8,8,15",,,,,99,,,,,,,,,,,,,,,,,,,,,,,,,,,,,,,,,,,,9.3,14,7,5,64,,1017,0,348,0,3,3,"Menden (Sauerland)",1,0,U0.133|0:31-U0.141|1:44-U0.548|4:02-U0.241|1:45-U0.480|3:36,,"Menden (Sauerland) Running",,,3113,,250,3,8754284243,0,168070,250480,30378,,29235438,,,,,,,,,,,,,,,,,,,,,,,,,,,,,,,,,,,,,,,,,
44332829,76cf5321-aba4-4225-9fed-4a610b9d5a1e,1651605277,120,1651601362,,0,0,6.95,2010,2010,8,0,7,0,0,0,0.03,,,,457,156,181,,,,53.64,40.79,53.8,1,58.85,5240,190,,3.7,3.1,,100,,,,20,3,65,81,12.46,14.21,14.31,16.2,-4.6,317,317,,1,375,375,,,,,,,,,"37,4,3,3,4,3,9,23,15","0,17,33,51,0","17,13,17,12,41",,,,,128,,,,,,,,,,,,,,,,,,,,,,,,,,,,,,,,,,,,58.8,14,7,5,64,,1017,0,348,0,3,3,"Menden (Sauerland)",1,0,U0.390|1:17-U0.200|1:09-U0.400|1:16-U0.190|1:08-U0.400|1:16-U0.120|0:49-U0.280|1:29-U0.210|0:36-U0.080|0:35-U0.210|0:37-U0.100|0:37-U0.190|0:36-U0.100|0:35-U0.190|0:36-U0.100|0:43-U0.210|0:36-U0.090|0:49-U0.210|0:37-U0.190|2:18-U0.300|0:55-U0.110|1:12-U0.300|0:55-U0.100|1:09-U0.300|0:55-U0.100|1:20-U0.300|0:54-U0.110|2:25-U0.610|1:59-U0.250|2:04-U0.600|1:56-U0.010|0:05,,"Menden (Sauerland) Track Running",,,3113,,250,3,8754288425,0,168070,250480,30378,,29235461,,,,,,,,,,,,,,,,,,,,,,,,,,,,,,,,,,,,,,,,,
44332832,a5633a81-6827-4f6e-9f63-5dfe9f391a45,1651607910,120,1651601364,,0,0,0.63,289,289,20,2,20,1,0,0.6,0.36,0.96,,,51,134,160,,,,37.24,19.18,40.04,1,58.85,5227,8,,0.7,0,,100,,,,7,3,5,79,8.93,8.03,9.33,-4,4.9,208,208,,1,215,215,,,,,,,,,"90,7,3,0,0,0,0,0,0","2,57,41,0,0","0,49,51,0,0",,,,,83,,,,,,,,,,,,,,,,,,,,,,,,,,,,,,,,,,,,9.3,14,7,7,68,,1017,0,347,0,3,3,"Menden (Sauerland)",1,0,,,"Menden (Sauerland) Running",,,3113,,250,3,8754288910,0,168070,250480,30378,,29235465,,,,,,,,,,,,,,,,,,,,,,,,,,,,,,,,,,,,,,,,,
44379895,d33c4dd1-c0d0-4220-9af9-a0b227730e21,1651689314,120,1651685483,,0,0,10.08,3006,3215,180,179,453,281,4,2.1,0.42,0.97,0.95,706,689,150,211,,,,54.62,40.31,55.83,1,,,,,,,,,,,,,,95,79,12.47,12.9,13.05,-9.4,-17.8,300,300,,1,319,319,,,,,,,,,"12,11,10,17,27,10,3,8,1","0,30,47,14,8","0,6,50,33,11",,,,,127,,,,,,,,,,,,,,,,,,,,,,,,,,,,,,,,,,,,96.5,14,8,353,64,,1017,0,371,0,3,3,Balve,1,0,U1.000|5:41-U1.000|4:54-U1.000|4:51-U0.754|3:39-U1.000|4:06-U0.549|2:24-U1.000|4:00-U1.000|6:43-U1.000|5:28-U0.488|2:39-U0.785|2:29-U0.485|3:10,,,,,wahoo_fitness-33,,518,7,,0,168070,250480,30378,,29275336,,,,,,,,,,,,,,,,,,,,,,,,,,,,,,,,,,,,,,,,4,
44426889,bf76f4da-6af7-4508-8fa3-58e12f382cb3,1651772148,120,1651770661,,0,0,9.53,3013,4166,234,214,240,223,0,3.1,0.85,0.97,1.07,556,620,143,156,,,,54.24,37.49,56.02,1,58.43,2427,90,,3.3,0,98,96,,,,9,2,67,78,12.1,11.87,12.18,-9.3,3.8,282,282,,1,288,288,,,,,,,,,"20,15,11,11,16,26,2,0,0","1,28,71,0,0","0,2,73,24,0",,,,,122,,,,,,,,,,,,,,,,,,,,,,,,,,,,,,,,,,,,27.9,16,8,4,57,,1022,1,375,0,3,3,Balve,1,0,U1.000|5:45-U1.000|6:20-U1.000|6:07-U1.000|6:36-U1.000|5:06-U1.000|4:26-U1.000|4:25-U1.000|4:24-U1.000|4:23-U0.534|2:40,,"Balve Running",,,3113,,250,3,8766484574,0,168070,250480,30378,,29313471,,,,,,,,,,,,,,,,,,,,,,,,,,,,,,,,,,,,,,,,4,
44461352,517655b9-3a7b-47f1-a3db-753f29773214,1651845659,120,1651841672,,0,0,1.84,566,585,22,14,27,18,0,0.8,0.45,1.15,0.97,,117,132,149,,,,62.15,34.35,63.41,1,58.71,1106,25,,2.1,0,103,102,,,,7,3,9,77,12.01,11.78,12.24,12.7,19.7,289,289,,1,297,297,,,,,,,,,"2,3,9,47,34,5,0,0,0","4,75,20,0,0","0,4,64,32,0",,,,,127,,,,,,,,,,,,,,,,,,,,,,,,,,,,,,,,,,,,11.2,18,8,333,49,,1024,4,368,0,3,3,Balve,1,0,U1.000|5:02-U0.844|4:24,,"Balve Running",,,3113,,250,3,8770986125,0,168070,250480,30378,,29344566,,,,,,,,,,,,,,,,,,,,,,,,,,,,,,,,,,,,,,,,,
44461366,d30c7a66-7b25-4dda-8c19-09800462f8aa,1651846417,120,1651841694,,0,0,4.83,1303,1303,0,0,0,0,0,0,0,,,,316,157,185,,,,57.91,43.33,57.91,1,59.06,3798,235,,3.7,3.7,103,104,,,,16,4,45,78,13.35,14.96,14.96,8.1,5.9,340,340,,1,390,390,,,,,,,,,"27,0,2,3,2,5,26,32,2","0,25,22,42,11","18,8,6,9,59",,,,,143,,,,,,,,,,,,,,,,,,,,,,,,,,,,,,,,,,,,70.3,18,7,333,49,,1024,4,368,0,3,3,Balve,1,0,U0.400|1:25-U0.390|1:21-U0.200|1:54-U0.400|1:26-U0.410|1:22-U0.210|2:04-U0.400|1:26-U0.400|1:21-U0.210|1:55-U0.400|1:25-U0.400|1:22-U0.190|1:49-U0.400|1:26-U0.400|1:20-U0.020|0:07,,"Balve Track Running",,,3113,,250,3,8770988102,0,168070,250480,30378,,29344580,,,,,,,,,,,,,,,,,,,,,,,,,,,,,,,,,,,,,,,,,
44461372,946bdc6b-418c-4201-8fa2-79674b79da5e,1651847985,120,1651841703,,0,0,1.27,382,382,20,12,21,12,0,1.2,0.68,1.02,0.98,,85,146,161,,,,56.09,33.8,57.62,1,59.05,3788,23,,2,0,100,100,,,,7,3,9,78,12.39,12.09,12.51,3.1,9.2,303,303,,1,307,307,,,,,,,,,"3,4,10,24,48,10,0,0,0","0,14,85,2,0","0,0,53,47,0",,,,,128,,,,,,,,,,,,,,,,,,,,,,,,,,,,,,,,,,,,16.5,19,8,333,48,,1024,4,368,0,3,3,Balve,1,0,U1.000|4:59-U0.267|1:23,,"Balve Running",,,3113,,250,3,8770988824,0,168070,250480,30378,,29344586,,,,,,,,,,,,,,,,,,,,,,,,,,,,,,,,,,,,,,,,,
44502112,c9f34ed5-a3c5-4945-af94-a702885b9fc3,1651919630,120,1651916375,,0,0,14.88,3642,3778,58,41,114,104,0,0,0.08,1.1,,,924,163,175,,,,61.76,52.22,62.14,1,59.46,4320,281,,5,0.6,101,100,,,,16,4,135,80,14.8,14.81,14.92,0.9,-1.6,374,374,,1,378,378,,,,,,,,,"0,1,2,3,11,39,40,5,0","0,1,21,78,0","0,0,4,73,23",,,,,153,,,,,,,,,,,,,,,,,,,,,,,,,,,,,,,,,,,,76,17,5,304,63,,1023,3,366,0,4,3,Sundern,1,0,U1.000|4:36-U1.000|4:06-U1.000|3:59-U1.000|4:11-U1.000|4:00-U1.000|4:02-U1.000|3:58-U1.000|4:00-U1.000|4:10-U1.000|4:03-U1.000|3:54-U1.000|3:51-U1.000|4:01-U1.000|3:55-U0.883|3:55,,"Sundern (Sauerland) Running",,,3113,,250,3,8775711777,0,168070,250480,30378,,29379532,,,,,,,,,,,,,,,,,,,,,,,,,,,,,,,,,,,,,,,,,
44609315,a97121f4-4754-4dff-8f8c-8f68dbb72d31,1652017337,120,1652118487,,0,0,11.98,3598,5280,257,214,272,232,0,3.5,0.61,0.91,0.96,537,776,146,184,,,,56.19,40.49,57.93,1,59.43,3759,122,,3.8,0,95,98,,,,15,3,88,78,12.76,13.04,13.37,-12.6,-24.2,299,299,,1,325,325,,,,,,,,,"18,4,10,17,17,19,4,10,0","0,28,66,4,1","0,5,57,23,14",,,,,128,,,,,,,,,,,,,,,,,,,,,,,,,,,,,,,,,,,,58.5,15,14,21,57,,1027,5,357,0,2,3,Balve,1,0,U1.000|5:25-U1.000|5:55-U1.000|7:22-U1.000|6:20-U1.000|4:42-U1.000|4:21-U1.000|4:11-U1.000|4:48-U1.000|4:40-U1.000|3:23-U1.000|3:22-U0.982|5:29,,"Balve Running",,,3113,,250,3,8791139759,0,168070,250480,30378,,29472458,,,,,,,,,,,,,,,,,,,,,,,,,,,,,,,,,,,,,,,,3,
44609355,a11d63cc-2180-4dd6-b101-68943222fd0a,1652119400,120,1652118523,,0,0,3.55,2998,2998,68,96,77,98,0,1.3,0.66,1.59,1.2,,303,107,139,,,,22.28,,22.6,1,59.43,2097,13,,1.2,0,,100,,,,7,3,23,63,4.75,5.68,5.9,24.6,7.6,107,92,,1,131,126,,,,,,,,,"100,0,0,0,0,0,0,0,0","34,66,0,0,0","46,51,3,0,0",,,,,56,,,,,,,,,,,,,,,,,,,,,,,,,,,,,,,,,,,,7.9,20,5,102,57,,1024,1,346,0,3,3,Balve,1,0,U0.898|8:36-U0.109|1:03-U0.048|0:34-U0.096|0:58-U0.055|0:35-U0.326|4:42-U0.073|0:47-U0.023|0:33-U0.063|0:45-U0.003|0:02-U0.039|0:33-U0.080|0:46-U0.010|0:07-U0.036|0:32-U1.000|9:38-U0.690|19:45,,"Balve Running",,,3113,,250,3,8791144512,0,168070,250480,30378,,29472485,,,,,,,,,,,,,,,,,,,,,,,,,,,,,,,,,,,,,,,,,
44609376,e8b81ac1-dcc0-4744-844c-38ed688923ea,1652122657,120,1652118558,,0,0,8.45,2482,2556,88,90,113,114,0,0.7,0.41,0.97,0.9,,533,144,177,,,,58.84,40.55,59.58,1,59.37,4358,115,,3.4,1,100,100,,,,13,4,58,78,12.45,12.86,12.99,-3.1,-13.7,301,301,,1,323,323,,,,,,,,,"2,8,13,40,17,1,13,6,0","1,47,35,17,0","0,2,51,34,12",,,,,131,,,,,,,,,,,,,,,,,,,,,,,,,,,,,,,,,,,,53.1,20,4,129,61,,1024,0,344,0,3,3,Balve,1,0,U1.000|5:07-U1.000|5:19-U1.000|5:11-U1.000|5:32-U1.000|5:10-U1.000|4:07-U1.000|3:41-U1.000|4:50-U0.445|2:25,,"Balve Running",,,3113,,250,3,8791148994,0,168070,250480,30378,,29472505,,,,,,,,,,,,,,,,,,,,,,,,,,,,,,,,,,,,,,,,,
44654890,153fdcae-e469-43ff-9280-786ad71710bc,1652207582,120,1652206306,,0,0,4.06,1097,1097,10,20,21,32,0,0,0.05,,,,258,151,160,,,,61.12,42.77,61.12,1,59.92,4320,72,,3.1,0,102,101,,,,7,3,30,78,13.29,13.44,13.37,4.1,5.3,326,326,,1,330,330,,,,,,,,,"2,1,1,4,26,64,2,0,0","1,5,94,0,0","0,2,11,87,0",,,,,142,,,,,,,,,,,,,,,,,,,,,,,,,,,,,,,,,,,,33.6,23,14,244,56,,1015,,,0,4,1,"Menden (Sauerland)",1,0,U1.000|4:32-U1.000|4:27-U1.000|4:24-U1.000|4:32-U0.058|0:23,,"Menden (Sauerland) Running",,,3113,,250,3,8797969091,0,168070,250480,30378,,29512973,,,,,,,,,,,,,,,,,,,,,,,,,,,,,,,,,,,,,,,,,
44654895,1f0c6de6-a8ea-413b-a0bf-c08ccd871232,1652209295,120,1652206314,,0,0,1.27,512,512,16,10,29,21,0,0,0.2,0.81,0.51,,104,140,162,,,,41.32,24.17,42.2,1,59.92,4303,41,,1.9,1.6,,100,,,,7,3,11,68,9.11,10.51,10.96,25.1,19.8,217,217,,1,278,278,,,,,,,,,"68,6,3,1,2,2,2,6,11","0,48,48,4,0","23,32,17,14,14",,,,,109,,,,,,,,,,,,,,,,,,,,,,,,,,,,,,,,,,,,16,23,14,244,56,,1015,,,0,4,1,"Menden (Sauerland)",1,0,U0.204|1:03-U0.114|0:22-U0.709|5:09-U0.243|1:58,,"Menden (Sauerland) Running",,,3113,,250,3,8797970342,0,168070,250480,30378,,29512978,,,,,,,,,,,,,,,,,,,,,,,,,,,,,,,,,,,,,,,,,
44654950,a219dc44-fcb2-4f47-a988-6bf521d5da0b,1652210090,120,1652206342,,0,0,5.56,1895,1895,0,0,0,0,0,0,0,,,,417,155,184,,,,44.21,33.12,44.21,1,60.09,5760,224,,3.5,3.4,105,106,,,,19,3,64,78,10.57,13.75,13.75,34.8,7.9,267,267,,1,359,359,,,,,,,,,"46,1,1,2,1,2,11,30,5","1,27,15,54,3","34,10,7,7,41",,,,,113,,,,,,,,,,,,,,,,,,,,,,,,,,,,,,,,,,,,72,23,14,244,56,,1015,,,0,4,1,"Menden (Sauerland)",1,0,U1.490|5:10-U0.210|2:27-U0.500|1:41-U0.100|0:52-U0.500|1:40-U0.100|0:57-U0.500|1:42-U0.230|6:37-U0.300|0:55-U0.100|1:07-U0.300|0:56-U0.100|1:23-U0.300|0:56-U0.110|1:18-U0.300|0:57-U0.100|1:36-U0.300|0:54-U0.020|0:28,,"Menden (Sauerland) Track Running",,,3113,,250,3,8797974268,0,168070,250480,30378,,29513011,,,,,,,,,,,,,,,,,,,,,,,,,,,,,,,,,,,,,,,,,
44655040,9a8eb839-e540-424f-8a2f-4b42398bdb4e,1652212257,120,1652206445,,0,0,3.24,1062,1062,12,8,19,15,0,0,0.06,1.28,,,222,138,144,127,,,54.34,33.56,54.67,1,59.85,5735,39,,2.3,0,95,96,,,,7,3,20,78,11.02,10.99,11.1,3.5,6.1,262,262,,1,265,265,,,,,,,,,"1,8,38,44,9,1,0,0,0","0,76,24,0,0","0,0,95,5,0",,,,,117,,,,,,,,,,,,,,,,,,,,,,,,,,,,,,,,,,,,16.9,21,14,224,54,,1015,0,333,0,4,3,"Menden (Sauerland)",1,0,U1.000|5:22-U1.000|5:29-U1.000|5:32-U0.240|1:19,,"Menden (Sauerland) Running",,,3113,,250,3,8797989741,0,168070,250480,30378,,29513097,,,,,,,,,,,,,,,,,,,,,,,,,,,,,,,,,,,,,,,,,
44700043,676507ff-b91e-4b35-9962-1c649a96dd18,1652290011,120,1652285424,,0,0,6.8,2295,2449,93,97,115,115,0,0.9,0.41,0.99,0.97,385,446,137,155,,,,52.91,33.92,53.76,1,59.79,4419,53,,2.6,0,96,95,,,,7,1,44,77,10.87,10.8,11.05,-5.3,-7.1,255,255,,1,264,264,,,,,,,,,"11,17,33,27,9,2,1,0,0","1,57,42,0,0","0,10,76,12,1",,,,,115,,,,,,,,,,,,,,,,,,,,,,,,,,,,,,,,,,,,20.5,24,20,247,47,,1009,2,344,0,3,3,Balve,1,0,U1.000|5:58-U1.000|5:49-U1.000|5:46-U1.000|5:55-U1.000|5:43-U1.000|4:55-U0.795|4:09,,"Balve Running",,,3113,,250,3,8803602681,0,168070,250480,30378,,29550350,,,,,,,,,,,,,,,,,,,,,,,,,,,,,,,,,,,,,,,,5,
44739462,3cbd2fba-49e7-4cfc-8f27-34549742bf57,1652373441,120,1652369344,,0,0,7.17,2237,2865,117,66,129,72,0,1.3,0.39,1.02,0.83,460,456,136,169,,,,58.84,37.36,60.55,1,59.76,2970,96,,3.1,1.6,100,100,,,,11,3,42,77,12.03,12.1,12.51,5.4,-3.1,285,285,,1,304,304,,,,,,,,,"13,9,14,32,18,4,4,6,1","2,70,23,5,0","3,6,60,23,9",,,,,125,,,,,,,,,,,,,,,,,,,,,,,,,,,,,,,,,,,,27.5,19,16,256,42,,1018,2,356,0,4,3,Balve,1,0,U1.000|5:53-U1.000|5:22-U0.954|4:48-U1.000|3:57-U0.698|3:25-U0.204|0:38-U0.209|1:48-U0.202|0:39-U1.000|5:30-U0.899|5:17,,"Balve Running",,,3113,,250,3,8809674189,0,168070,250480,30378,,29584850,,,,,,,,,,,,,,,,,,,,,,,,,,,,,,,,,,,,,,,,"5,5",
44788071,07a64904-1c10-4521-a984-f0022364244c,1652464499,120,1652459505,,0,0,6.76,1988,2022,76,100,90,115,0,1.3,0.51,0.92,0.91,458,428,142,181,,,,59.86,39.93,60.43,1,59.89,1728,116,,3.1,2.1,100,100,,,,7,3,44,78,12.33,12.87,12.9,0.8,-11.9,296,296,,1,320,320,,,,,,,,,"9,5,9,20,35,13,4,6,0","2,46,42,10,0","0,0,63,30,7",,,,,131,,,,,,,,,,,,,,,,,,,,,,,,,,,,,,,,,,,,47.5,18,16,255,49,,1019,1,363,0,3,3,Balve,1,0,U1.000|5:15-U1.000|4:52-U1.000|5:10-U1.000|4:43-U1.000|4:13-U0.044|0:11-U0.607|1:58-U1.000|6:10-U0.110|0:36,,"Balve Running",,,3113,,250,3,8816042101,0,168070,250480,30378,,29625880,,,,,,,,,,,,,,,,,,,,,,,,,,,,,,,,,,,,,,,,5,
44831884,419c516c-67cc-47b9-a251-b26ba681e922,1652546107,120,1652540086,,0,0,3.11,844,888,22,23,30,30,0,0.1,0.33,0.97,0.87,,203,154,171,112,,,59.11,41.7,59.61,1,59.98,990,61,,2.7,0,100,100,,,,7,3,25,80,13.31,13.63,13.7,5.4,2.7,327,327,,1,342,342,,,,,,,,,"3,5,10,13,13,30,23,2,0","0,6,64,29,0","0,2,28,56,14",,,,,138,,,,,,,,,,,,,,,,,,,,,,,,,,,,,,,,,,,,43.3,21,8,307,47,,1021,3,368,0,3,3,Brücherhof,1,0,U1.000|4:59-U1.000|4:13-U1.000|4:19-U0.106|0:34,,"Dortmund Running",,,3113,,250,3,8821869467,0,168070,250480,30378,,29665035,,,,,,,,,,,,,,,,,,,,,,,,,,,,,,,,,,,,,,,,,
44832472,c8456a88-7147-452d-a34f-cfcab71fcb12,1652547700,120,1652540899,,0,0,0.52,242,295,33,10,39,12,0,2,1,1.17,0.33,992,48,137,164,,,,35.56,18.46,40.37,1,59.98,977,16,,1.1,0.2,,100,,,,7,3,5,76,9.92,10.76,15.74,55.7,57.7,248,248,,1,415,415,,,,,,,,,"49,3,3,8,14,9,6,6,2","0,51,38,11,0","36,13,7,19,25",,,,,85,,,,,,,,,,,,,,,,,,,,,,,,,,,,,,,,,,,,11.3,21,8,307,47,,1021,3,368,0,3,3,Brücherhof,1,0,,,"Dortmund Running",,,3113,,250,3,8821974415,0,168070,250480,30378,,29665544,,,,,,,,,,,,,,,,,,,,,,,,,,,,,,,,,,,,,,,,4,
44833732,dece5da4-ca0b-4921-b75d-58fda16fdf17,1652548737,120,1652542819,,0,0,1.49,294,294,27,0,26,0,0,0.4,0.41,1.23,,,82,174,183,,,,72.77,55.25,76.06,1,59.95,2027,99,,2.3,2.7,,104,,,,20,3,14,88,19.27,18.31,19.8,18.9,25.9,532,532,,1,548,548,,,,,,,,,"1,0,0,0,0,0,10,79,9","0,9,3,37,51","0,0,0,0,100",,,,,173,,,,,,,,,,,,,,,,,,,,,,,,,,,,,,,,,,,,54.5,21,8,312,46,,1021,2,367,0,3,3,Brücherhof,1,0,U0.990|3:15-U0.500|1:38,,"Dortmund Track Running",,,3113,,250,3,8822210947,0,168070,250480,30378,,29666621,,,,,,,,,,,,,,,,,,,,,,,,,,,,,,,,,,,,,,,,,
44833755,142ea323-5e0e-4940-aec5-91030cc762f3,1652549541,120,1652542859,,0,0,0.76,285,285,36,5,39,7,0,2.2,0.79,1.31,0.99,1086,56,134,145,104,,,47.78,24.8,53.02,1,59.95,2012,11,,0.8,0,,95,,,,7,3,5,77,10.87,9.66,15.12,25.8,55.1,291,291,,1,388,388,,,,,,,,,"25,34,37,5,0,0,0,0,0","0,87,13,0,0","0,8,75,4,13",,,,,104,,,,,,,,,,,,,,,,,,,,,,,,,,,,,,,,,,,,8,21,8,312,46,,1021,2,367,0,3,3,Brücherhof,1,0,,,"Dortmund Running",,,3113,,250,3,8822215810,0,168070,250480,30378,,29666640,,,,,,,,,,,,,,,,,,,,,,,,,,,,,,,,,,,,,,,,4,
44859180,2922ab63-dc16-4f88-9a57-24fd098bf270,1652609127,120,1652606416,,0,0,14.92,3964,4240,136,92,211,166,0,0.7,0.26,1.14,0.96,933,974,161,181,127,,,56.86,47.49,57.7,1,59.74,3891,222,,4.5,0.6,99,97,,,,17,3,141,79,13.74,13.68,14.04,-1.2,-6.7,340,340,,1,349,349,,,,,,,,,"1,1,2,10,29,39,15,2,0","1,3,46,50,1","0,1,18,70,11",,,,,143,,,,,,,,,,,,,,,,,,,,,,,,,,,,,,,,,,,,87.8,18,6,101,60,,1021,3,364,0,3,3,Sundern,1,0,U1.000|5:02-U1.000|4:35-U1.000|4:33-U1.000|4:43-U1.000|4:28-U1.000|4:34-U1.000|4:23-U1.000|4:22-U1.000|4:05-U1.000|4:11-U1.000|4:20-U1.000|4:30-U1.000|4:17-U1.000|4:06-U0.923|3:55,,"Sundern (Sauerland) Running",,,3113,,250,3,8826128674,0,168070,250480,30378,,29689196,,,,,,,,,,,,,,,,,,,,,,,,,,,,,,,,,,,,,,,,5,
44918043,b779e808-c78c-421f-8495-08d921efaa9d,1652725063,120,1652722029,,0,0,11.33,3688,3981,278,282,280,290,0,3.5,0.78,0.97,1.04,425,766,147,174,,,,50.41,36.7,51.92,1,59.47,2322,99,,3.2,0,100,94,,,,7,3,92,78,11.86,11.75,11.94,-4.3,7.7,272,272,,1,277,277,,,,,,,,,"31,11,12,7,14,21,5,0,0","0,16,70,14,0","0,2,76,23,0",,,,,118,,,,,,,,,,,,,,,,,,,,,,,,,,,,,,,,,,,,56.7,19,13,10,72,,1017,1,356,0,6,3,Balve,1,0,U1.000|6:02-U1.000|6:34-U1.000|6:02-U1.000|6:49-U1.000|6:37-U1.000|5:58-U1.000|4:47-U1.000|4:12-U1.000|4:19-U1.000|4:03-U1.000|4:27-U0.333|1:38,,"Balve Running",,,3113,,250,3,8835390185,0,168070,250480,30378,,29738874,,,,,,,,,,,,,,,,,,,,,,,,,,,,,,,,,,,,,,,,4,
44966263,e3d51bb0-75e1-4f7f-92c8-838cef6f42a9,1652812364,120,1652810188,,0,0,3.99,1055,1070,14,38,18,43,0,0,0.19,,0.94,,246,148,163,,,,64.56,43.81,64.36,1,59.94,1280,69,,2.8,0,104,101,,,,7,3,27,79,13.49,13.8,13.6,3.2,3.2,330,330,,1,334,334,,,,,,,,,"1,0,3,4,23,57,11,0,0","2,11,86,1,0","0,3,10,88,0",,,,,144,,,,,,,,,,,,,,,,,,,,,,,,,,,,,,,,,,,,34.7,21,5,46,67,,1020,1,340,0,4,3,"Menden (Sauerland)",1,0,U1.000|4:46-U1.000|4:23-U1.000|4:06-U0.991|4:20,,"Menden (Sauerland) Running",,,3113,,250,3,8842036526,0,168070,250480,30378,,29778786,,,,,,,,,,,,,,,,,,,,,,,,,,,,,,,,,,,,,,,,,
44966282,75baa3b6-0ea5-4c67-8e96-4fad05a0da04,1652813845,120,1652810209,,0,0,1.86,712,712,15,25,18,26,0,0,0.13,1.26,0.51,,131,134,153,,,,46.58,26.71,46.73,1,59.94,1263,26,,1.7,0.3,,100,,,,7,3,12,72,9.3,10.84,10.92,18.4,-0.7,220,220,,1,271,271,,,,,,,,,"59,7,7,4,2,1,2,6,12","0,80,20,0,0","19,30,26,12,13",,,,,109,,,,,,,,,,,,,,,,,,,,,,,,,,,,,,,,,,,,11.9,21,5,46,67,,1020,1,340,0,4,3,"Menden (Sauerland)",1,0,U0.112|0:22-U0.189|1:14-U0.143|0:28-U0.214|1:25-U0.159|0:31-U0.160|1:51-U0.108|0:21-U0.197|1:28-U0.139|0:28-U0.215|2:05-U0.166|0:32-U0.062|1:09,,"Menden (Sauerland) Running",,,3113,,250,3,8842039824,0,168070,250480,30378,,29778805,,,,,,,,,,,,,,,,,,,,,,,,,,,,,,,,,,,,,,,,,
44966327,628b213b-edbc-40f4-97c6-c7deb95b61c2,1652814595,120,1652810249,,0,0,6.29,1987,1987,0,0,0,0,0,0,0,,,,452,154,183,,,,49.01,36.52,49.01,1,59.98,4512,224,,3.4,3.2,102,110,,,,7,3,64,80,11.39,14.32,14.32,26.3,3.1,289,289,,1,377,377,,,,,,,,,"42,2,2,3,3,2,4,33,8","0,30,19,48,2","28,11,12,8,41",,,,,119,,,,,,,,,,,,,,,,,,,,,,,,,,,,,,,,,,,,64.5,21,7,78,70,,1020,0,338,0,3,3,"Menden (Sauerland)",1,0,U0.600|1:54-U0.200|1:07-U0.400|1:16-U0.280|2:16-U0.610|1:56-U0.190|1:10-U0.400|1:16-U0.260|2:19-U0.610|1:58-U0.190|1:21-U0.400|1:17-U0.120|2:22-U0.400|1:18-U0.130|1:50-U0.400|1:15-U0.100|2:26-U0.410|1:16-U0.150|1:57-U0.410|1:14-U0.030|1:39,,"Menden (Sauerland) Track Running",,,3113,,250,3,8842045353,0,168070,250480,30378,,29778847,,,,,,,,,,,,,,,,,,,,,,,,,,,,,,,,,,,,,,,,,
44987282,72d87949-88e1-496b-bd8f-10814ddb80ba,1652816720,120,1652839124,,0,0,0.98,352,352,30,5,34,10,0,0.1,0.21,1.21,0.92,514,68,131,137,110,,,51.81,26.82,55.42,1,59.95,4501,13,,1,0,,97,,,,7,3,6,80,10.95,10.11,12.47,17.6,35.1,274,274,,1,307,307,,,,,,,,,"4,30,58,9,0,0,0,0,0","0,100,0,0,0","0,0,87,4,9",,,,,104,,,,,,,,,,,,,,,,,,,,,,,,,,,,,,,,,,,,7.8,20,8,97,77,,1020,0,338,0,3,3,"Menden (Sauerland)",1,0,,,"Menden (Sauerland) Running",,,3113,,250,3,8844213359,0,168070,250480,30378,,29795605,,,,,,,,,,,,,,,,,,,,,,,,,,,,,,,,,,,,,,,,5,
45027158,9880ddcc-9968-4039-9aef-0088a6e78c80,1652894850,120,1652900153,,0,0,9.29,2838,2886,248,238,259,249,0,3.7,0.76,0.96,1.03,518,629,150,166,,,,53.02,38.97,54.84,1,59.95,3162,113,,3.3,0,97,99,,,,7,3,75,78,12.82,12.66,12.95,-7.7,0.4,298,298,,1,306,306,,,,,,,,,"20,4,12,13,12,23,16,0,0","0,10,85,5,0","0,4,48,45,3",,,,,126,,,,,,,,,,,,,,,,,,,,,,,,,,,,,,,,,,,,36.6,26,9,160,50,,1021,2,333,0,3,3,Balve,1,0,U1.000|5:24-U1.000|5:51-U1.000|7:10-U1.000|6:40-U1.000|4:13-U1.000|4:03-U1.000|4:05-U1.000|4:19-U1.000|4:13-U0.294|1:20,,"Balve Running",,,3113,,250,3,8849181394,0,168070,250480,30378,,29828800,,,,,,,,,,,,,,,,,,,,,,,,,,,,,,,,,,,,,,,,3,
45060091,df9f74c4-df8e-46d4-b9ee-d2051ca8b85d,1652967903,120,1652965083,,0,0,11.29,3650,4221,308,270,342,308,0,4.4,0.71,0.98,1.08,520,766,146,163,,,,51.31,36.98,53.26,1,59.8,2252,106,,3.2,0.1,99,97,,,,7,3,88,77,12.05,11.9,12.52,-13,-4.8,278,278,,1,290,290,,,,,,,,,"22,10,15,13,14,19,7,0,0","0,19,79,3,0","0,6,69,22,3",,,,,121,,,,,,,,,,,,,,,,,,,,,,,,,,,,,,,,,,,,32.8,26,15,209,47,,1018,4,332,0,4,3,Balve,1,0,U1.000|5:15-U1.000|5:15-U1.000|5:52-U1.000|6:26-U1.000|8:50-U1.000|5:28-U1.000|4:19-U1.000|4:25-U1.000|4:17-U1.000|4:01-U1.000|5:07-U0.285|1:36,,"Balve Running",,,3113,,250,3,8853184148,0,168070,250480,30378,,29857898,,,,,,,,,,,,,,,,,,,,,,,,,,,,,,,,,,,,,,,,"3,4,5",
45104548,2179b983-258e-4b34-a5ec-4ff8112ddcd3,1653032021,120,1653027732,,0,0,8.4,2674,2689,114,129,126,141,0,2.1,0.58,1.01,0.97,579,546,137,161,,,,56.87,36.87,57.69,1,59.81,1396,83,,3,0,97,100,,,,7,1,52,78,11.55,11.72,11.92,-6.4,-11.7,273,273,,1,286,286,,,,,,,,,"11,11,20,33,7,14,4,0,0","0,61,38,0,0","0,7,62,30,1",,,,,121,,,,,,,,,,,,,,,,,,,,,,,,,,,,,,,,,,,,31.5,16,3,141,85,,1022,1,336,0,4,3,Balve,1,0,U1.000|6:17-U1.000|5:24-U1.000|5:46-U1.000|5:37-U1.000|5:30-U1.000|4:23-U1.000|4:14-U1.000|4:57-U0.402|2:27,,"Balve Running",,,3113,,250,3,8857539192,0,168070,250480,30378,,29896387,,,,,,,,,,,,,,,,,,,,,,,,,,,,,,,,,,,,,,,,5,
45148907,e3dbf2ac-4b8b-44f8-a99d-fdcc4f32846e,1653076661,120,1653117504,,0,0,,27,27,0,0,0,0,0,,,,,,5,,,,,,,,,1,,,,,,,,,,,,,,0,,,,,,,,,,,,,,,,,,,,,,,,,,,,,,,,,,,,,,,,,,,,,,,,,,,,,,,,,,,,,,,,,,,,,,,,,,1,,,1,0,,,,,,wahoo_fitness-47,,329,7,,0,168072,,30378,,29935308,,,,,,,,,,,,,,,,,,,,,,,,,,,,,,,,,,,,,,,,,
45161179,d5489e46-425f-40f2-b6f0-1ff9d4af0c1d,1653127867,120,1653137970,,0,0,58.52,11129,17029,892,891,1116,952,4,4.4,0.3,,,637,2380,,,,,,,,,1,,,,,,,,,,,,,,123,,,25.43,,,,104,84,,1,149,141,,,,,,,,,"51,8,10,14,10,2,5",,"66,26,6,1,1",,,,,,,,,,,,,,,,,,,,,,,,,,,,,,,,,,,,,,,,,,20,11,268,48,,1023,5,339,0,3,3,Rohrbach,1,0,,,,,,wahoo_fitness-43,,258,7,,0,168072,,30378,,29946141,,,,,,,,,,,,,,,,,,,,,,,,,,,,,,,,,,,,,,,,"1,3,4,4",
45291590,aa010356-02cb-49de-8479-2da275497b5e,1653217146,120,1653385079,,0,0,14.35,12873,12873,575,590,629,641,0,5.5,0.68,,,351,940,93,150,,,,,,,1,59.81,584,30,,2,0,,100,,,,,,60,57,,4.59,,-47.6,,,,,,,,,,,,,,,,"65,35,0,0,0,0","68,31,1,0,0",,,,,,,,,,,,,,,,,,,,,,,,,,,,,,,,,,,,,,,,,,11.1,21,4,70,52,,1015,4,345,0,3,3,Rohrbach,1,0,,,"Heidelberg Hiking",,,3113,,250,3,8882808732,0,168075,,30378,,30061789,,,,,,,,,,,,,,,,,,,,,,,,,,,,,,,,,,,,,,,,"1,5",
45291594,f28423a7-f42d-4566-8b5e-07ebae518b01,1653246900,120,1653385100,,0,0,5.86,2030,2095,89,79,102,90,0,1.5,0.48,0.99,0.97,336,389,134,152,,,,52.68,32.58,53.78,1,59.61,1112,46,,2.3,0,98,97,,,,7,3,34,76,10.73,10.56,10.87,7,7.6,248,248,,1,254,254,,,,,,,,,"20,13,23,37,8,0,0,0,0","0,86,13,0,0","0,10,83,7,0",,,,,114,,,,,,,,,,,,,,,,,,,,,,,,,,,,,,,,,,,,15,19,7,55,58,,1013,0,341,0,3,3,Balve,1,0,U1.000|5:54-U1.000|5:09-U1.000|5:17-U1.000|5:59-U1.000|6:14-U0.859|5:17,,"Balve Running",,,3113,,250,3,8882810396,0,168070,250480,30378,,30061794,,,,,,,,,,,,,,,,,,,,,,,,,,,,,,,,,,,,,,,,5,
45291606,2ad37591-b15c-4c73-82f1-5d8ccf3e9bfc,1653334328,120,1653385149,,0,0,10.02,3322,3518,182,174,198,197,0,2.7,0.7,0.97,1,566,640,134,151,,,,55.62,35.58,56.92,1,59.43,1152,70,,2.8,0,102,97,,,,7,3,58,77,11.27,11.11,11.36,1.7,2.5,262,262,,1,268,268,,,,,,,,,"20,10,16,23,27,4,0,0,0","0,78,22,0,0","0,4,85,10,0",,,,,118,,,,,,,,,,,,,,,,,,,,,,,,,,,,,,,,,,,,17.9,17,14,197,95,,999,0,347,0,6,3,Balve,1,0,U1.000|5:46-U1.000|4:52-U1.000|5:41-U1.000|5:36-U1.000|5:27-U1.000|6:14-U1.000|5:12-U1.000|4:50-U1.000|5:45-U1.000|5:54-U0.015|0:05,,"Balve Running",,,3113,,250,3,8882813806,0,168070,250480,30378,,30061806,,,,,,,,,,,,,,,,,,,,,,,,,,,,,,,,,,,,,,,,"5,5",
45325012,93b3148c-7cff-43b8-a878-88c49c518a04,1653417215,120,1653422579,,0,0,4.57,1426,1927,46,41,61,57,0,1,0.35,1.11,0.92,230,283,130,148,,,,62.21,36.37,63.07,1,59.69,832,53,,2.4,0,103,101,,,,7,3,23,76,11.81,12.13,12.63,11.4,-1.4,282,282,,1,303,303,,,,,,,,,"16,1,3,11,49,16,2,2,0","8,82,10,0,0","8,6,36,46,3",,,,,127,,,,,,,,,,,,,,,,,,,,,,,,,,,,,,,,,,,,16.2,15,14,248,69,,1009,1,368,0,4,3,"Menden (Sauerland)",1,0,U1.000|4:49-U1.000|4:43-U1.000|4:44-U1.000|4:45-U0.570|4:45,,"Menden (Sauerland) Running",,,3113,,250,3,8886475261,0,168070,250480,30378,,30092012,,,,,,,,,,,,,,,,,,,,,,,,,,,,,,,,,,,,,,,,4,
45325028,c41e0d89-68be-435f-98fa-3582d5c9c13f,1653419208,120,1653422613,,0,0,7.65,2577,2577,0,0,0,0,0,0,0,,,,513,140,180,,,,51.57,34.26,51.57,1,59.7,2160,197,,3.6,2.5,106,104,,,,7,3,60,80,10.68,14.28,14.28,34.1,2.8,273,272,,1,374,374,,,,,,,,,"42,1,2,1,1,1,20,30,2","11,31,36,21,0","33,8,7,4,48",,,,,111,,,,,,,,,,,,,,,,,,,,,,,,,,,,,,,,,,,,58.1,15,13,249,68,,1009,0,368,0,4,3,"Menden (Sauerland)",1,0,U1.190|4:09-U0.180|1:31-U0.800|2:42-U0.400|2:59-U1.200|4:10-U0.210|1:46-U0.800|2:43-U0.210|4:15-U1.200|4:12-U0.110|1:06-U0.800|2:48-U0.070|3:15-U0.410|1:14-U0.070|6:08,,"Menden (Sauerland) Track Running",,,3113,,250,3,8886477984,0,168070,250480,30378,,30092028,,,,,,,,,,,,,,,,,,,,,,,,,,,,,,,,,,,,,,,,,
45372046,a1eda244-ae86-45c5-9c5f-9c5a6de266f6,1653502785,120,1653500483,,0,0,14.38,4564,4635,323,325,357,365,0,4,0.7,0.92,1.03,490,930,139,159,,,,56.02,38.51,57.57,1,59.6,1459,108,,3.2,0,99,99,,,,15,4,90,78,12.09,12.18,12.26,-8.4,-7.7,281,281,,1,290,290,,,,,,,,,"22,8,12,16,15,11,15,0,0","0,56,43,0,0","0,3,65,31,1",,,,,121,,,,,,,,,,,,,,,,,,,,,,,,,,,,,,,,,,,,27.6,16,17,247,57,,1015,1,350,0,4,3,Balve,1,0,U1.000|5:50-U1.000|4:56-U1.000|5:27-U1.000|5:33-U1.000|5:19-U1.000|5:51-U1.000|5:52-U1.000|6:43-U1.000|7:37-U1.000|3:58-U1.000|4:06-U1.000|4:00-U1.000|3:58-U1.000|4:42-U0.379|2:13,,"Balve Running",,,3113,,250,3,8891616313,0,168070,250480,30378,,30134560,,,,,,,,,,,,,,,,,,,,,,,,,,,,,,,,,,,,,,,,"3,5",
45423073,6b4cdcb0-2268-437c-9889-d969ed0b345b,1653586767,120,1653586325,,0,0,12.01,3995,4208,281,251,297,271,0,3.1,0.67,0.98,1.02,458,803,143,155,,,,50.94,35.94,52.57,1,59.42,1328,96,,3.1,0,97,97,,,,7,3,87,78,11.48,11.24,11.54,-2.2,3.9,267,267,,1,272,272,,,,,,,,,"30,9,6,15,35,6,0,0,0","0,31,68,0,0","0,3,82,15,0",,,,,116,,,,,,,,,,,,,,,,,,,,,,,,,,,,,,,,,,,,27.5,18,17,251,61,,1020,1,342,0,3,3,Balve,1,0,U1.000|6:25-U1.000|6:54-U1.000|6:40-U1.000|7:18-U1.000|5:13-U1.000|4:49-U1.000|4:46-U1.000|4:47-U1.000|4:46-U1.000|4:48-U1.000|4:52-U1.000|5:13-U0.012|0:03,,"Balve Running",,,3113,,250,3,8898068460,0,168070,250480,30378,,30179896,,,,,,,,,,,,,,,,,,,,,,,,,,,,,,,,,,,,,,,,4,
45448556,bf591211-61ab-4090-a371-9dca901f92e9,1653645938,120,1653643311,,0,0,13.69,4156,4284,212,215,246,249,0,2.2,0.51,0.96,1,812,899,147,165,,,,54.94,40.41,55.98,1,59.33,1508,132,,3.4,0,100,98,,,,13,3,102,79,12.21,12.12,12.39,-3.5,-7.7,291,291,,1,300,300,,,,,,,,,"7,7,15,21,31,14,4,0,0","0,24,67,8,0","0,2,60,36,2",,,,,125,,,,,,,,,,,,,,,,,,,,,,,,,,,,,,,,,,,,43.2,13,17,280,92,,1019,3,350,0,4,3,Balve,1,0,U1.000|5:18-U1.000|5:35-U1.000|5:20-U1.000|4:51-U1.000|5:47-U1.000|5:05-U1.000|5:32-U1.000|5:02-U1.000|4:32-U1.000|4:31-U1.000|4:01-U1.000|4:42-U1.000|4:51-U0.694|4:09,,"Balve Running",,,3113,,250,3,8901254881,0,168070,250480,30378,,30202371,,,,,,,,,,,,,,,,,,,,,,,,,,,,,,,,,,,,,,,,5,
45487144,169d2329-2670-476c-9227-e60704a68db1,1653724917,120,1653721790,,0,0,13.17,3741,3982,128,93,161,130,0,0.2,0.21,1.07,0.93,,841,152,171,,,,56.93,43.52,57.8,1,59.33,1729,163,,3.6,0.9,102,99,,,,7,3,103,81,12.87,12.8,13.03,-0.7,-4,316,316,,1,323,323,,,,,,,,,"3,2,4,14,49,23,4,1,0","0,6,89,5,0","0,1,32,62,6",,,,,130,,,,,,,,,,,,,,,,,,,,,,,,,,,,,,,,,,,,38.6,11,36,300,72,,1011,1,411,0,3,3,Vorstadt,1,0,U1.000|4:41-U1.000|4:39-U1.000|4:37-U1.000|4:33-U1.000|4:48-U1.000|4:53-U1.000|4:45-U1.000|5:24-U1.000|4:55-U1.000|4:52-U1.000|4:43-U1.000|4:38-U1.000|4:07-U0.168|0:44,,"Kiel Running",,,3113,,250,3,8906350504,0,168070,250480,30378,,30236614,,,,,,,,,,,,,,,,,,,,,,,,,,,,,,,,,,,,,,,,,
45562403,11e6d065-8c21-43a8-baac-d530a9fc0105,1653857482,120,1653853822,,0,0,6.94,2261,2452,108,98,117,106,0,1.9,0.52,1.06,0.94,,454,134,150,,,,56.83,35.42,58.02,1,59.33,874,61,,2.5,0,100,100,,,,7,3,39,77,11.39,11.35,11.74,4.6,-2.1,269,269,,1,283,283,,,,,,,,,"14,8,12,32,29,5,0,0,0","1,83,16,0,0","3,2,77,15,4",,,,,120,,,,,,,,,,,,,,,,,,,,,,,,,,,,,,,,,,,,17,9,8,333,81,,1014,0,399,0,3,3,Balve,1,0,U1.000|5:54-U1.000|4:54-U1.000|5:05-U0.875|5:12-U1.000|4:35-U1.000|5:13-U1.000|6:19-U0.068|0:29,,"Balve Running",,,3113,,250,3,8917036507,0,168070,250480,30378,,30302294,,,,,,,,,,,,,,,,,,,,,,,,,,,,,,,,,,,,,,,,,
45583779,f26ac6a7-d9a6-4701-b3d1-50c9ba91445e,1653914308,120,1653911442,,0,0,13.21,4032,4123,317,311,331,330,0,3.8,0.69,0.99,1.05,768,878,148,170,,,,54.07,40.04,55.7,1,59.32,1462,139,,3.5,0,100,100,,,,13,4,101,80,12.59,12.48,12.83,-5.9,2.5,296,296,,1,305,305,,,,,,,,,"18,7,9,19,15,20,12,0,0","1,14,79,6,0","0,2,54,41,2",,,,,123,,,,,,,,,,,,,,,,,,,,,,,,,,,,,,,,,,,,43.8,11,7,308,61,,1013,3,397,0,4,3,Balve,1,0,U1.000|5:08-U1.000|5:01-U1.000|5:18-U1.000|6:06-U1.000|7:47-U1.000|5:15-U1.000|4:19-U1.000|4:05-U1.000|4:02-U1.000|3:59-U1.000|4:04-U1.000|5:48-U1.000|5:16-U0.214|1:02,,"Balve Running",,,3113,,250,3,8919998926,0,168070,250480,30378,,30321630,,,,,,,,,,,,,,,,,,,,,,,,,,,,,,,,,,,,,,,,3,
45649206,831c82f0-96f2-4334-b925-eb48cc171e52,1654022032,120,1654020506,,0,0,3.97,1085,1119,17,29,20,32,0,0,0.19,1.08,0.97,,246,143,153,,,,64.93,42.13,65.03,1,59.5,932,61,,2.6,0,104,101,,,,7,3,24,79,13.12,13.2,13.15,3.7,4.5,322,322,,1,323,323,,,,,,,,,"0,0,2,5,49,42,3,0,0","1,13,86,0,0","0,1,13,85,0",,,,,139,,,,,,,,,,,,,,,,,,,,,,,,,,,,,,,,,,,,24.9,16,7,199,70,,1012,1,383,0,6,3,"Menden (Sauerland)",1,0,U1.000|4:45-U1.000|4:27-U1.000|4:32-U0.973|4:21,,"Menden (Sauerland) Running",,,3113,,250,3,8928594913,0,168070,250480,30378,,30378290,,,,,,,,,,,,,,,,,,,,,,,,,,,,,,,,,,,,,,,,,
45649238,3f9a682b-dac7-4c6b-8065-fb68e5741b31,1654023578,120,1654020538,,0,0,8.62,2516,2516,0,0,7,0,0,0,0,,,,558,157,187,,,,52.55,40.9,52.55,1,59.55,2592,269,,3.8,3,104,105,,,,19,4,88,80,12.33,14.85,14.85,25.3,1.6,320,314,,1,389,387,,,,,,,,,"28,2,4,4,3,5,18,32,4","0,26,14,55,5","22,6,12,11,50",,,,,128,,,,,,,,,,,,,,,,,,,,,,,,,,,,,,,,,,,,78.8,17,6,260,63,,1012,0,385,0,3,3,"Menden (Sauerland)",1,0,U0.410|1:27-U0.400|1:22-U0.400|1:24-U0.390|1:24-U0.400|2:14-U0.390|1:20-U0.100|0:29-U0.400|1:20-U0.100|0:30-U0.400|1:22-U0.210|1:54-U0.400|1:19-U0.100|0:34-U0.390|1:21-U0.100|0:32-U0.400|1:18-U0.210|2:12-U0.200|0:40-U0.200|0:41-U0.100|0:38-U0.400|1:20-U0.110|0:32-U0.390|1:21-U0.350|5:17-U0.410|1:26-U0.400|1:22-U0.400|1:21-U0.400|1:21-U0.050|3:56,,"Menden (Sauerland) Track Running",,,3113,,250,3,8928599441,0,168070,250480,30378,,30378322,,,,,,,,,,,,,,,,,,,,,,,,,,,,,,,,,,,,,,,,,
45649250,3e54e8a3-68d3-4151-b8ed-5669f6353e43,1654026283,120,1654020553,,0,0,3.18,931,931,15,12,22,19,0,0,0.06,1.08,,,207,144,148,,,,59.08,38.26,59.49,1,59.58,3168,47,,2.3,0,100,102,,,,7,3,21,80,12.39,12.41,12.48,-1.3,-1.6,301,301,,1,304,304,,,,,,,,,"3,2,5,18,57,16,0,0,0","0,7,93,0,0","0,0,49,51,0",,,,,128,,,,,,,,,,,,,,,,,,,,,,,,,,,,,,,,,,,,21.5,15,2,287,74,,1012,,,0,4,1,"Menden (Sauerland)",1,0,U1.000|5:04-U1.000|4:49-U1.000|4:39-U0.177|0:59,,"Menden (Sauerland) Running",,,3113,,250,3,8928601090,0,168070,250480,30378,,30378335,,,,,,,,,,,,,,,,,,,,,,,,,,,,,,,,,,,,,,,,,
45683349,b0bdaf82-b871-4e4f-ba67-2179a13c4883,1654093437,120,1654089622,,0,0,6.78,2202,3267,99,99,261,128,4,1.5,0.55,0.98,0.99,,442,136,165,,,,56,35.5,57.01,1,,,,,,,,,,,,,,41,77,11.37,11.24,11.49,-4.4,-7.9,267,267,,1,273,273,,,,,,,,,"12,12,17,32,21,4,1,0,0","2,66,31,1,0","0,2,76,21,0",,,,,120,,,,,,,,,,,,,,,,,,,,,,,,,,,,,,,,,,,,21.3,17,16,214,55,,1015,4,374,0,3,3,Balve,1,0,U1.000|5:58-U1.000|4:58-U1.000|5:35-U1.000|5:29-U0.728|3:49-U1.000|4:53-U1.000|5:46-U0.040|0:12,,,,,wahoo_fitness-33,,518,7,,0,168070,250480,30378,,30408960,,,,,,,,,,,,,,,,,,,,,,,,,,,,,,,,,,,,,,,,,
45733969,d7fef900-badb-40aa-b08c-f2062dd10eaf,1654175904,120,1654173718,,0,0,12.48,3933,4332,319,276,340,300,0,3.9,0.74,0.94,1.05,540,841,148,172,128,,,51.98,38.4,53.84,1,59.51,1435,133,,3.3,0.7,101,98,,,,7,3,100,78,12.23,12.1,12.53,-10,1.3,288,288,,1,298,298,,,,,,,,,"27,13,8,9,18,15,8,2,0","0,15,78,7,0","0,1,65,31,3",,,,,122,,,,,,,,,,,,,,,,,,,,,,,,,,,,,,,,,,,,38.8,17,6,9,50,,1022,5,368,0,3,3,Balve,1,0,U1.000|5:05-U1.000|5:09-U1.000|6:19-U1.000|6:40-U1.000|6:33-U1.000|5:37-U1.000|4:59-U1.000|4:39-U1.000|4:34-U1.000|3:45-U1.000|4:23-U1.000|4:58-U0.476|2:53,,"Balve Running",,,3113,,250,3,8939416100,0,168070,250480,30378,,30454554,,,,,,,,,,,,,,,,,,,,,,,,,,,,,,,,,,,,,,,,"3,5",
45794626,56687ee5-aa68-4109-a2d4-83532b45d696,1654280480,120,1654275895,,0,0,7.34,2317,2426,140,143,154,160,0,2.1,0.66,1.1,1,655,494,144,175,,,,53.84,36.91,55.08,1,59.45,1203,89,,3,0,98,98,,,,7,3,54,78,11.76,11.71,12.48,-3.7,-24.2,279,279,,1,310,310,,,,,,,,,"9,9,16,25,28,8,3,0,0","0,37,54,9,0","2,3,68,19,8",,,,,122,,,,,,,,,,,,,,,,,,,,,,,,,,,,,,,,,,,,41.8,23,8,29,60,,1015,1,333,0,4,3,Balve,1,0,U1.000|5:35-U1.000|4:53-U1.000|5:33-U1.000|5:29-U1.000|4:28-U1.000|6:00-U1.000|4:36-U0.344|2:04,,"Balve Running",,,3113,,250,3,8947034483,0,168070,250480,30378,,30510315,,,,,,,,,,,,,,,,,,,,,,,,,,,,,,,,,,,,,,,,5,
45832604,e3cc2bcc-a7f7-44e2-8819-d88c691935a5,1654343255,120,1654357083,,0,0,2.59,861,1195,48,45,54,50,0,1.3,0.69,1.04,0.98,,191,149,167,,,,48.21,32.45,49.39,1,59.43,826,51,,2.2,0.4,96,100,,,,11,3,23,76,11.14,11.3,11.72,12.5,16.1,265,265,,1,284,284,,,,,,,,,"20,3,8,32,27,5,2,3,0","0,16,74,10,0","7,4,56,33,0",,,,,119,,,,,,,,,,,,,,,,,,,,,,,,,,,,,,,,,,,,29,20,11,25,67,,1019,4,334,0,4,3,Balve,1,0,U1.000|5:24-U1.000|4:50-U0.586|4:07,,"Balve Running",,,3113,,250,3,8952900360,0,168070,250480,30378,,30545126,,,,,,,,,,,,,,,,,,,,,,,,,,,,,,,,,,,,,,,,,
45832621,a6c92d7a-8299-49c5-ac34-f4114326f08d,1654345063,120,1654357121,,0,0,10.5,2533,2533,239,245,259,265,0,3.1,0.79,0.99,1.01,671,705,178,187,142,,,54.68,51.8,56.18,1,59.33,4378,375,,5,2.6,100,98,,,,7,3,133,83,15.68,15.4,15.81,-2.2,10.1,390,390,,1,400,400,,,,,,,,,"0,1,3,12,16,13,34,19,2","0,1,1,50,48","0,0,3,58,39",,,,,150,,,,,,,,,,,,,,,,,,,,,,,,,,,,,,,,,,,,120.2,20,13,33,64,,1019,4,335,0,4,3,Balve,1,0,U1.000|3:55-U1.000|4:43-U1.000|4:44-U1.000|4:53-U1.000|4:28-U1.000|3:30-U1.000|3:37-U1.000|3:36-U1.000|3:32-U1.000|3:26-U0.500|1:48,,"Balve Running",,,3113,,250,3,8952904797,0,168070,250480,30378,,30545141,,,,,,,,,,,,,,,,,,,,,,,,,,,,,,,,,,,,,,,,4,
45832624,dc0bf0b6-a408-4a89-bf1f-88093191202b,1654347959,120,1654357126,,0,0,1.01,339,348,36,27,40,29,0,0,0.2,1.13,0.91,,73,146,161,,,,48.99,29.08,51.7,1,59.42,4372,17,,1.2,0,,97,,,,9,3,8,79,11.08,10.69,11.24,-1.5,-3.6,264,264,,1,270,270,,,,,,,,,"6,7,43,43,2,0,0,0,0","0,7,92,1,0","0,7,72,21,0",,,,,113,,,,,,,,,,,,,,,,,,,,,,,,,,,,,,,,,,,,14.5,22,12,27,59,,1019,4,334,0,4,3,Balve,1,0,U1.000|5:37-U0.006|0:02,,"Balve Running",,,3113,,250,3,8952905477,0,168070,250480,30378,,30545144,,,,,,,,,,,,,,,,,,,,,,,,,,,,,,,,,,,,,,,,,
45867822,af2647d2-8130-4a85-a590-9073bdb8fb76,1654424828,120,1654424142,,0,0,15.58,5003,5493,485,412,499,429,0,5,0.82,0.99,1.09,582,1040,145,168,107,,,52.22,38.24,54.54,1,59.42,3463,144,,3.5,0.1,99,98,,,,13,3,116,79,12.22,11.72,12.86,-7.7,7.3,288,288,,1,309,309,,,,,,,,,"24,12,13,13,15,19,4,0,0","1,29,68,3,0","0,5,61,31,3",,,,,118,,,,,,,,,,,,,,,,,,,,,,,,,,,,,,,,,,,,46.3,18,13,123,80,,1014,3,313,0,4,3,Balve,1,0,U1.000|5:39-U1.000|6:31-U1.000|6:00-U1.000|6:41-U1.000|5:58-U1.000|4:56-U1.000|5:00-U1.000|6:55-U1.000|5:04-U1.000|4:12-U1.000|4:07-U1.000|4:41-U1.000|5:02-U1.000|5:37-U1.000|4:29-U0.581|2:30,,"Balve Running",,,3113,,250,3,8957247579,0,168070,250480,30378,,30577012,,,,,,,,,,,,,,,,,,,,,,,,,,,,,,,,,,,,,,,,"4,4,4,5,5",
45919208,7b2d6cc9-e2b0-479f-a0d6-c4978b56af74,1654514605,120,1654514803,,0,0,20.19,6553,7168,575,551,600,577,0,5.8,0.79,1.02,1.07,628,1314,142,167,,,,53,38.55,54.95,1,59.41,2884,159,,3.6,0,100,100,,,,15,3,167,78,12.02,11.84,12.35,-2.2,7.3,280,280,,1,293,293,,,,,,,,,"26,6,7,13,21,25,2,0,0","0,45,53,2,0","1,5,63,28,3",,,,,119,,,,,,,,,,,,,,,,,,,,,,,,,,,,,,,,,,,,43.2,17,20,228,71,,1015,4,334,0,3,3,Balve,1,0,U1.000|5:03-U1.000|5:28-U1.000|6:55-U1.000|6:47-U1.000|4:33-U1.000|4:25-U1.000|4:22-U1.000|9:28-U1.000|6:47-U1.000|5:39-U1.000|6:10-U1.000|5:08-U1.000|5:02-U1.000|4:24-U1.000|4:45-U1.000|4:21-U1.000|4:32-U1.000|4:28-U1.000|5:46-U1.000|4:22-U0.190|0:50,,"Balve Running",,,3113,,250,3,8963875248,0,168070,250480,30378,,30623699,,,,,,,,,,,,,,,,,,,,,,,,,,,,,,,,,,,,,,,,"4,4,4,4,5,5",
45956832,0feeecd1-27bb-453d-bdf8-05b194fb458c,1654589873,120,1654584673,,0,0,5.97,1956,1956,92,104,108,119,0,1.9,0.7,0.99,0.99,395,395,137,155,,,,54.88,34.86,55.79,1,59.4,1478,56,,2.5,0,98,100,,,,7,1,44,78,11.24,11.1,11.34,0.6,-1,262,262,,1,268,268,,,,,,,,,"10,13,13,46,17,1,0,0,0","1,71,28,0,0","0,2,83,15,0",,,,,117,,,,,,,,,,,,,,,,,,,,,,,,,,,,,,,,,,,,26.9,14,14,219,82,,1014,2,347,0,3,3,Balve,1,0,U1.000|5:52-U1.000|5:07-U1.000|5:09-U1.000|5:32-U1.000|5:46-U0.966|5:10,,"Balve Running",,,3113,,250,3,8969102052,0,168070,250480,30378,,30658692,,,,,,,,,,,,,,,,,,,,,,,,,,,,,,,,,,,,,,,,5,
46024426,62bd32b5-408f-4188-98fe-1e476c66e454,1654691391,120,1654688589,,0,0,13.76,4321,4360,314,307,339,337,0,3.5,0.76,0.98,1.07,476,889,141,160,,,,55.72,38.86,57.33,1,59.37,1299,109,,3.2,0,100,99,,,,11,4,105,79,12.1,11.98,12.19,-8.9,-4.6,283,283,,1,289,289,,,,,,,,,"19,14,13,12,14,24,4,0,0","0,41,59,0,0","0,2,68,29,1",,,,,121,,,,,,,,,,,,,,,,,,,,,,,,,,,,,,,,,,,,29.9,20,15,200,55,,1008,4,331,0,4,3,Balve,1,0,U1.000|5:16-U1.000|4:56-U1.000|6:30-U1.000|6:18-U1.000|6:11-U1.000|6:30-U1.000|4:53-U1.000|4:17-U1.000|4:18-U1.000|4:12-U1.000|4:15-U1.000|5:14-U1.000|5:30-U0.759|3:42,,"Balve Running",,,3113,,250,3,8976689899,0,168070,250480,30378,,30716797,,,,,,,,,,,,,,,,,,,,,,,,,,,,,,,,,,,,,,,,"4,5",
46105607,359f6ad8-7139-4d5b-92fd-9bd241cff063,1654800774,120,1654799418,,0,0,15.07,4814,5088,415,392,417,398,0,4.3,0.85,0.93,1.07,575,975,140,161,103,,,55.06,38.37,57.05,1,59.31,1375,131,,3.3,0.5,99,98,,,,15,4,116,79,12.21,12.03,12.36,-6.6,-0.2,284,284,,1,291,291,,,,,,,,,"24,16,14,10,9,14,10,2,0","0,46,54,0,0","0,6,58,35,1",,,,,119,,,,,,,,,,,,,,,,,,,,,,,,,,,,,,,,,,,,36.5,16,7,247,76,,1018,0,339,0,3,3,Balve,1,0,U1.000|6:02-U1.000|6:25-U1.000|6:01-U1.000|6:34-U1.000|4:39-U1.000|4:27-U1.000|6:23-U1.000|6:15-U1.000|4:01-U1.000|3:57-U1.000|4:12-U1.000|5:20-U1.000|6:06-U1.000|5:38-U1.000|3:54-U0.073|0:19,,"Balve Running",,,3113,,250,3,8985208975,0,168070,250480,30378,,30787837,,,,,,,,,,,,,,,,,,,,,,,,,,,,,,,,,,,,,,,,"4,4",
46140650,8ed93a98-e826-42c6-991b-7bc57559b93b,1654864069,120,1654859819,,0,0,8.43,2584,2701,112,109,140,139,0,1.8,0.57,0.93,0.95,368,551,143,165,,,,56.35,38.56,57.3,1,59.32,1280,97,,3.1,0,98,101,,,,11,1,69,78,11.99,12.1,12.26,-7.9,-15.9,287,287,,1,298,298,,,,,,,,,"9,11,13,19,27,14,5,1,0","1,39,55,5,0","0,2,62,35,1",,,,,125,,,,,,,,,,,,,,,,,,,,,,,,,,,,,,,,,,,,48.6,17,14,221,74,,1023,5,316,0,3,3,Balve,1,0,U1.000|5:59-U1.000|4:58-U1.000|5:40-U1.000|5:20-U1.000|4:53-U1.000|4:30-U1.000|4:21-U1.000|4:45-U0.432|2:40,,"Balve Running",,,3113,,250,3,8988688947,0,168070,250480,30378,,30819966,,,,,,,,,,,,,,,,,,,,,,,,,,,,,,,,,,,,,,,,5,
46184614,9968ce09-e59e-4bda-8604-1c26e4508d34,1654944342,120,1654943775,,0,0,13.38,4060,4199,401,386,432,420,0,4.3,0.83,0.99,1.05,623,908,154,173,,,,51.51,40.35,53.49,1,59.28,1897,170,,3.8,0,100,98,,,,13,3,136,80,12.76,12.22,12.97,-2.1,3.9,302,302,,1,312,312,,,,,,,,,"9,10,14,18,19,26,3,0,0","1,18,43,39,0","0,2,44,52,2",,,,,124,,,,,,,,,,,,,,,,,,,,,,,,,,,,,,,,,,,,71.1,20,11,251,73,,1023,5,317,0,3,3,Balve,1,0,U1.000|5:29-U1.000|5:40-U1.000|5:14-U1.000|5:44-U1.000|5:49-U1.000|4:52-U1.000|5:04-U1.000|6:07-U1.000|4:29-U1.000|4:17-U1.000|4:15-U1.000|4:13-U1.000|4:36-U0.381|1:52,,"Balve Running",,,3113,,250,3,8994533975,0,168070,250480,30378,,30860651,,,,,,,,,,,,,,,,,,,,,,,,,,,,,,,,,,,,,,,,"3,4",
46233713,c39e7a4e-36a0-4c35-8347-6f65e7ac047a,1655029126,120,1655029855,,0,0,14.56,4767,5006,426,377,435,383,0,4.9,0.88,0.95,1.09,587,978,146,169,130,,,50.52,37.18,52.56,1,59.23,1488,134,,3.4,0,98,98,,,,7,3,131,77,12,11.87,12.3,4.1,2.9,278,278,,1,291,291,,,,,,,,,"27,9,10,11,13,24,5,0,0","0,21,77,2,0","0,8,61,27,3",,,,,119,,,,,,,,,,,,,,,,,,,,,,,,,,,,,,,,,,,,44.8,19,11,265,64,,1023,5,316,0,2,3,Balve,1,0,U1.000|5:49-U1.000|6:18-U1.000|5:50-U1.000|6:41-U1.000|4:41-U1.000|4:36-U1.000|4:22-U1.000|6:29-U1.000|8:49-U1.000|6:01-U1.000|4:51-U1.000|4:15-U1.000|4:18-U1.000|4:11-U0.564|2:15,,"Balve Running",,,3113,,250,3,9001225664,0,168070,250480,30378,,30906702,,,,,,,,,,,,,,,,,,,,,,,,,,,,,,,,,,,,,,,,"3,4",
46282904,f7b58e65-4307-486f-9da6-71bc7d6448eb,1655121884,120,1655119306,,0,0,13.59,4238,4322,314,305,347,339,0,3.7,0.76,0.93,1.02,430,860,135,152,,,,59.43,39.14,61.18,1,59.2,1235,105,,3.1,0,104,96,,,,13,3,91,79,12.22,12.02,12.3,-9.5,-3.9,287,287,,1,292,292,,,,,,,,,"17,13,13,16,16,21,5,0,0","1,76,23,0,0","0,2,58,40,0",,,,,122,,,,,,,,,,,,,,,,,,,,,,,,,,,,,,,,,,,,26.2,17,16,291,52,,1021,5,345,0,3,3,Balve,1,0,U1.000|5:12-U1.000|4:57-U1.000|6:23-U1.000|5:56-U1.000|6:05-U1.000|6:28-U1.000|5:01-U1.000|4:21-U1.000|4:13-U1.000|4:18-U1.000|4:12-U1.000|5:09-U1.000|5:33-U0.585|2:50,,"Balve Running",,,3113,,250,3,9007811275,0,168070,250480,30378,,30951858,,,,,,,,,,,,,,,,,,,,,,,,,,,,,,,,,,,,,,,,"4,4",
46352719,bf52cd3e-4da7-4c32-a367-96d97918a4b0,1655231590,120,1655229457,,0,0,3.95,1078,1078,16,24,20,29,0,0,0.13,1.01,0.95,,251,148,159,,,,62.08,42.19,62.23,1,59.28,932,66,,2.6,0,103,102,,,,9,3,32,79,13.16,13.25,13.2,4.4,6.1,323,323,,1,325,325,,,,,,,,,"1,1,3,6,35,49,4,0,0","0,6,94,0,0","0,0,17,83,0",,,,,139,,,,,,,,,,,,,,,,,,,,,,,,,,,,,,,,,,,,38,19,8,22,50,,1021,1,337,0,2,3,"Menden (Sauerland)",1,0,U1.000|4:46-U1.000|4:26-U1.000|4:28-U0.954|4:19,,"Menden (Sauerland) Running",,,3113,,250,3,9016494730,0,168070,250480,30378,,31016516,,,,,,,,,,,,,,,,,,,,,,,,,,,,,,,,,,,,,,,,,
46352748,30b6aae2-9202-4a5c-bc20-3ee9e18ad194,1655233002,120,1655229492,,0,0,7.71,1860,2044,0,0,0,0,0,0,0,,,,497,164,185,,,,62.29,50.81,62.29,1,59.33,2880,289,,4,3.1,98,103,,,,15,4,79,83,14.93,15.58,15.58,15.7,11.4,383,383,,1,406,406,,,,,,,,,"12,2,4,6,13,10,23,19,11","1,3,42,37,17","1,6,15,36,42",,,,,150,,,,,,,,,,,,,,,,,,,,,,,,,,,,,,,,,,,,101,19,8,22,50,,1021,1,337,0,2,3,"Menden (Sauerland)",1,0,U1.030|3:36-U0.420|2:02-U0.970|3:32-U0.420|2:14-U1.030|3:29-U0.410|2:18-U0.980|3:31-U0.400|2:18-U1.020|3:32-U0.120|0:59-U0.900|3:22-U0.010|0:07,,"Menden (Sauerland) Track Running",,,3113,,250,3,9016499588,0,168070,250480,30378,,31016545,,,,,,,,,,,,,,,,,,,,,,,,,,,,,,,,,,,,,,,,,
46352762,464248a8-427e-4d18-8750-a8f5e15ec9d3,1655235279,120,1655229508,,0,0,3.23,898,898,35,37,53,55,0,0.3,0.31,1.18,0.96,,208,150,163,,,,59.55,40.67,60.31,1,59.33,4032,55,,2.4,0,102,100,,,,7,3,27,80,13.04,13.01,13.23,3.6,3.8,320,320,,1,326,326,,,,,,,,,"0,1,3,9,47,40,0,0,0","0,7,92,1,0","0,0,35,59,6",,,,,135,,,,,,,,,,,,,,,,,,,,,,,,,,,,,,,,,,,,38,20,8,38,54,,1021,0,338,0,2,3,"Menden (Sauerland)",1,0,U1.000|4:50-U1.000|4:27-U1.000|4:35-U0.229|1:06,,"Menden (Sauerland) Running",,,3113,,250,3,9016501930,0,168070,250480,30378,,31016559,,,,,,,,,,,,,,,,,,,,,,,,,,,,,,,,,,,,,,,,,
46396729,297c0fdb-d018-4777-83fa-dcbfb381c548,1655299399,120,1655303087,,0,0,12.47,4004,4297,373,321,372,329,0,4,0.89,0.96,1.09,543,820,143,164,,,,53.21,37.57,55.46,1,59.32,2910,114,,3.2,0,98,97,,,,7,3,105,79,12.22,11.87,12.31,-7.2,-3.1,285,285,,1,291,291,,,,,,,,,"25,16,11,9,14,17,7,0,0","0,32,67,1,0","0,3,61,36,0",,,,,118,,,,,,,,,,,,,,,,,,,,,,,,,,,,,,,,,,,,36.8,24,9,3,47,,1018,7,327,0,2,3,Balve,1,0,U1.000|5:27-U1.000|6:29-U1.000|6:00-U1.000|6:42-U1.000|5:22-U1.000|4:34-U1.000|5:22-U1.000|7:00-U1.000|5:18-U1.000|4:09-U1.000|4:10-U1.000|4:08-U0.465|2:02,,"Balve Running",,,3113,,250,3,9021678155,0,168070,250480,30378,,31057003,,,,,,,,,,,,,,,,,,,,,,,,,,,,,,,,,,,,,,,,"4,4",
46410578,c48f512a-22c7-4f09-b8e5-e3a09b39aafb,1655323549,120,1655319651,,0,0,22.05,3241,3256,366,367,371,381,4,3.4,0.59,1.2,0.83,720,501,133,161,,,,,,,1,,,,,,,,,,,,,,70,83,,31.29,,-18.9,-8,184,156,,0,196,184,,,,,,,,,"25,23,11,13,9,10,9","4,58,38,0,0","23,46,29,1,1",,,,,,,,,,,,,,,,,,,,,51,,,,,,,,,,,,,,,,,,,,33.8,21,7,18,58,,1018,0,318,0,2,3,Balve,1,0,,,,,,wahoo_fitness-43,,258,7,,0,168072,,30378,,31069493,,,,,,,,,,,,,,,,,,,,,,,,,,,,,,,,,,,,,,,,"4,5",
46436106,5d7efbf0-77fa-4659-997f-50652686be24,1655378311,120,1655377666,,0,0,15.02,4743,5039,421,392,442,414,0,4.9,0.9,0.95,1.08,564,1002,148,166,124,,,51.85,38.88,53.77,1,59.3,2460,145,,3.5,0,97,99,,,,7,3,125,78,12.36,12.32,12.55,-0.2,1,288,288,,1,295,295,,,,,,,,,"24,12,11,10,7,23,11,1,0","1,10,86,4,0","0,4,60,33,3",,,,,122,,,,,,,,,,,,,,,,,,,,,,,,,,,,,,,,,,,,37.6,20,12,355,51,,1022,7,326,0,2,3,Balve,1,0,U1.000|5:36-U1.000|6:27-U1.000|5:59-U1.000|6:42-U1.000|4:39-U1.000|4:22-U1.000|4:07-U1.000|5:46-U1.000|8:17-U1.000|5:58-U1.000|4:50-U1.000|3:58-U1.000|4:12-U1.000|4:17-U1.000|3:48-U0.023|0:05,,"Balve Running",,,3113,,250,3,9027014134,0,168070,250480,30378,,31093088,,,,,,,,,,,,,,,,,,,,,,,,,,,,,,,,,,,,,,,,"4,4,4",
46454645,cfd7ec13-195e-4b96-9f73-bb2e83569c88,1655409405,120,1655403716,,0,0,,1226,1226,,,,,0,,,,,,153,,,,,,,,,1,,,,,,,,,,,,,,13,,,,,,,,,,,,,,,,,,,,,,,,,,,,,,,,,,,,,,,,,,,,,,,,,,,,,,,,,,,,,,,,,,,,,,,,,,1,,,1,0,,,,,,,,252,7,,0,168074,,30378,,31110226,,,,,,,,,,,,,,,,,,,,,,,,,,,,,,,,,,,,,,,,,
46455463,c4d63b2d-2522-41c3-b8b6-00cc0078678a,1655410966,120,1655404774,,0,0,,875,875,,,,,0,,,,,,68,,,,,,,,,1,,,,,,,,,,,,,,7,,,,,,,,,,,,,,,,,,,,,,,,,,,,,,,,,,,,,,,,,,,,,,,,,,,,,,,,,,,,,,,,,,,,,,,,,,1,,,1,0,,,,,,,,252,7,,0,168073,,30378,,31111007,,,,,,,,,,,,,,,,,,,,,,,,,,,,,,,,,,,,,,,,,
46456353,7bdc4e47-3324-4197-8f2b-c5d677013224,1655409735,120,1655406080,,0,0,23.99,3422,3529,374,372,323,328,4,2.8,0.48,1.18,1.15,697,531,125,164,,,,,,,1,,,,,,,,,,,,,,58,84,,30.25,,-15,-23.6,177,133,,0,183,176,,,,,,,,,"16,26,11,15,11,9,11","9,74,16,0,0","21,47,30,1,1",,,,,,,,,,,,,,,,,,,,,51,,,,,,,,,,,,,,,,,,,,25.7,20,8,10,55,,1023,0,329,0,3,3,Balve,1,0,,,,,,wahoo_fitness-43,,258,7,,0,168072,,30378,,31111831,,,,,,,,,,,,,,,,,,,,,,,,,,,,,,,,,,,,,,,,"4,5,5",
46483043,b1d83810-9850-4a79-a5e7-0dd432736122,1655468551,120,1655464982,,0,0,9,3041,3495,284,216,302,219,0,3.8,0.9,1.01,1.12,512,624,146,164,,,,48.59,34.52,50.95,1,59.24,1430,97,,3.1,0,98,97,,,,7,3,83,78,11.75,11.44,12.02,-4.7,10.1,274,274,,1,287,287,,,,,,,,,"32,12,10,9,15,17,4,0,0","0,27,71,1,0","2,6,63,27,2",,,,,114,,,,,,,,,,,,,,,,,,,,,,,,,,,,,,,,,,,,38.7,24,6,204,42,,1024,4,316,0,4,3,Balve,1,0,U1.000|5:26-U1.000|6:27-U1.000|6:00-U1.000|7:02-U1.000|7:07-U1.000|5:23-U1.000|4:37-U1.000|4:29-U0.997|4:11,,"Balve Running",,,3113,,250,3,9033313590,0,168070,250480,30378,,31136442,,,,,,,,,,,,,,,,,,,,,,,,,,,,,,,,,,,,,,,,3,
46519052,a63c2dec-e1b7-4957-bfdf-0acbe7b5d521,1655537349,120,1655536971,,0,0,15.2,5335,6043,467,414,493,439,0,5.1,0.84,0.98,1.08,533,1014,138,163,,,,49.95,34.38,52.06,1,59.15,1382,108,,3.2,0,97,99,,,,13,3,122,78,11.17,10.85,11.54,-7.7,1.2,257,257,,1,268,268,,,,,,,,,"37,11,9,12,22,8,0,0,0","1,56,43,1,0","0,11,78,9,2",,,,,110,,,,,,,,,,,,,,,,,,,,,,,,,,,,,,,,,,,,35.9,23,10,207,60,,1019,2,313,0,2,3,Balve,1,0,U1.000|6:44-U1.000|6:55-U1.000|6:24-U1.000|6:54-U1.000|6:34-U1.000|5:00-U1.000|4:55-U1.000|7:57-U1.000|6:35-U1.000|5:53-U1.000|5:12-U1.000|4:37-U1.000|4:33-U1.000|5:04-U1.000|4:41-U0.196|0:59,,"Balve Running",,,3113,,250,3,9037927062,0,168070,250480,30378,,31169622,,,,,,,,,,,,,,,,,,,,,,,,,,,,,,,,,,,,,,,,"4,4,4,5",
46540562,8d0b5bdc-6421-418c-be09-c28117984ed8,1655563041,120,1655565809,,0,0,0.25,344,1166,,,,,0,,,,,,50,,,,,,,,,1,59.17,1037,,,,0,,100,,,,,,6,26,,,,,,,,,,,,,,,,,,,,,,,151,49,,2500,,,,,,,,,,,,,,,,,,,,,,,,,,,,,,,,,,,,,,,,,,,,,,,1,,,1,0,U0.050|1:00-U0.200|4:44,,"Pool Swimming",,,3113,,250,3,9040912983,0,168071,,30378,,31189173,,,,,,,,,,,,,,,,,,,,,,,,,,,,,,,,,,,,,,,,,
46551229,5ba6807e-fe5a-462c-9657-73c585b9e45a,1655579681,120,1655577815,,0,0,33.98,5273,5310,657,652,644,649,4,4.2,0.61,1.14,1.11,813,817,135,161,,,,,,,1,,,,,,,,,,,,,,118,79,,30.54,,8.4,-2.5,184,156,,0,197,183,,,,,,,,,"36,14,13,13,6,6,12","3,56,41,0,0","24,43,31,2,1",,,,,,,,,,,,,,,,,,,,,53,,,,,,,,,,,,,,,,,,,,42.4,29,4,190,53,,1014,0,304,0,2,3,Balve,1,0,,,,,,wahoo_fitness-43,,258,7,,0,168072,,30378,,31199084,,,,,,,,,,,,,,,,,,,,,,,,,,,,,,,,,,,,,,,,"4,4,4,5,5",
46578496,e622dc0c-e16c-4d61-9176-7753fc02cab2,1655642361,120,1655637487,,0,0,1.15,318,318,4,1,11,8,0,0,0.18,1.14,,,74,147,158,,,,61.65,36.74,62.11,1,59.16,410,24,,1.7,0,,102,,,,7,3,9,79,13.12,13.07,13.25,4.3,6.9,325,325,,1,329,329,,,,,,,,,"0,0,5,13,36,43,3,0,0","0,13,87,0,0","0,0,19,81,0",,,,,137,,,,,,,,,,,,,,,,,,,,,,,,,,,,,,,,,,,,19,24,14,339,66,,1010,5,310,0,3,3,"Menden (Sauerland)",1,0,U1.000|4:36-U0.147|0:42,,"Menden (Sauerland) Running",,,3113,,250,3,9045748944,0,168070,250480,30378,,31223632,,,,,,,,,,,,,,,,,,,,,,,,,,,,,,,,,,,,,,,,,
46578511,f47570f9-c45c-47e6-8f29-c3ff8f38ba92,1655642781,120,1655637491,,0,0,0.11,35,35,5,0,4,0,0,1.2,1,,,,7,136,141,,,,57.43,26.66,63.95,1,59.16,408,3,,0.2,0,,100,,,,7,3,1,78,13.34,11.17,13.34,12.1,11.9,340,340,,1,343,343,,,,,,,,,"0,6,35,41,18,0,0,0,0","0,82,18,0,0","0,0,0,100,0",,,,,121,,,,,,,,,,,,,,,,,,,,,,,,,,,,,,,,,,,,1.5,23,13,339,66,,1010,5,310,0,3,3,"Menden (Sauerland)",1,0,,,"Menden (Sauerland) Running",,,3113,,250,3,9045749383,0,168070,250480,30378,,31223647,,,,,,,,,,,,,,,,,,,,,,,,,,,,,,,,,,,,,,,,,
46578992,e0e3e039-3104-47ea-b88c-3bc2a0a8d26c,1655643540,120,1655638137,1655731375,0,0,5,1066,1066,17,16,30,64,4,0,0,,,,288,163,190,,,,73.27,57.18,73.6,1,59.17,1584,153,,3.4,1.4,104,99,,,,7,3,43,86,16.71,16.73,16.76,15.1,15.5,436,436,,1,438,438,,,,,,,,,"0,0,0,0,1,7,54,37,1","0,4,55,19,21","0,0,0,12,88",,,,,164,,,,,,,,,,,,,,,,,,,,,,,,,,,,,,,,,,,,96.6,23,13,339,66,,1010,5,310,0,3,3,"Menden (Sauerland)",1,0,U1.000|3:38-U1.000|3:29-U1.000|3:36-U1.000|3:45-U1.000|3:19,,"Menden (Sauerland) Running",,,3113,,250,3,9045819972,0,168070,250484,30378,,31224080,,,,,,,,,,,,,,,,,,,,,,5,1066,,,0,"Menden (Sauerland) Running",,,,,,,0,0,30378,46578992,,,,
46579556,3a35e3dc-3e92-4d78-88eb-a3fc376ba4a8,1655645466,120,1655638995,,0,0,1.11,456,494,65,55,68,58,0,2.6,0.73,2.1,1.03,1864,83,130,140,,,,44.31,23.29,48.03,1,59.17,1565,13,,0.9,0,,100,,,,7,3,8,79,9.41,8.93,15.5,25.9,66.4,242,242,,1,415,415,,,,,,,,,"52,36,12,0,0,0,0,0,0","0,100,0,0,0","1,68,13,6,13",,,,,92,,,,,,,,,,,,,,,,,,,,,,,,,,,,,,,,,,,,11,25,17,325,63,,1010,5,313,0,3,3,"Menden (Sauerland)",1,0,U1.000|6:43-U0.111|0:53,,"Menden (Sauerland) Running",,,3113,,250,3,9045910854,0,168070,250480,30378,,31224593,,,,,,,,,,,,,,,,,,,,,,,,,,,,,,,,,,,,,,,,4,
46650927,6c00fecd-cea5-4404-a4b8-ac394445afe5,1655754055,120,1655750343,,0,0,7.81,2606,2912,99,90,133,125,0,1.3,0.44,0.97,0.99,,487,130,159,,,,57.27,34.7,58.25,1,59.13,894,61,,2.5,0.3,98,99,,,,7,2,44,78,11.04,11.18,11.42,-5.4,-14.7,260,260,,1,274,274,,,,,,,,,"17,14,29,18,11,7,3,0,0","1,83,16,0,0","0,11,73,14,2",,,,,115,,,,,,,,,,,,,,,,,,,,,,,,,,,,,,,,,,,,20.6,17,12,334,60,,1017,0,346,0,2,3,Balve,1,0,U1.000|5:50-U1.000|5:43-U1.000|5:37-U1.000|5:53-U1.000|5:35-U0.295|1:36-U1.000|4:07-U1.000|5:23-U0.517|3:43,,"Balve Running",,,3113,,250,3,9054135334,0,168070,250480,30378,,31291926,,,,,,,,,,,,,,,,,,,,,,,,,,,,,,,,,,,,,,,,,
46702726,d4268b6f-baa6-44cb-8677-ed85e3e6f5de,1655837868,120,1655836431,,0,0,11.33,3600,3997,320,232,322,238,0,4.3,0.7,0.99,1.05,619,702,135,148,,,,58.07,37.75,60.66,1,59.13,1109,79,,2.9,0,96,100,,,,9,2,78,78,12.21,11.9,13.38,-3.3,19.5,294,294,,1,327,327,,,,,,,,,"23,15,8,6,26,19,3,0,0","1,82,17,0,0","0,0,73,24,3",,,,,121,,,,,,,,,,,,,,,,,,,,,,,,,,,,,,,,,,,,24.4,21,7,35,56,,1013,1,334,0,3,3,Balve,1,0,U1.000|6:25-U1.000|6:37-U1.000|6:26-U1.000|6:54-U1.000|5:01-U1.000|4:28-U1.000|4:23-U1.000|4:23-U1.000|4:14-U1.000|4:39-U1.000|4:52-U0.325|1:39,,"Balve Running",,,3113,,250,3,9060615406,0,168070,250480,30378,,31339131,,,,,,,,,,,,,,,,,,,,,,,,,,,,,,,,,,,,,,,,"4,4,4,4",
46753497,5269c829-b984-460a-82b2-d0f0e8970759,1655899698,120,1655912436,,0,0,14.86,4869,5103,458,420,508,469,0,5.3,0.87,0.97,1.08,576,1005,147,162,,,,50,37.2,52.07,1,59.1,1473,138,,3.5,0,99,98,,,,16,3,123,77,12.06,11.98,12.32,4.9,8.7,278,278,,1,289,289,,,,,,,,,"27,11,13,10,11,22,6,1,0","0,18,81,1,0","0,10,55,34,1",,,,,119,,,,,,,,,,,,,,,,,,,,,,,,,,,,,,,,,,,,35.3,23,11,16,49,,1012,4,333,0,3,3,Balve,1,0,U1.000|5:51-U1.000|6:13-U1.000|5:53-U1.000|6:27-U1.000|4:38-U1.000|4:25-U1.000|4:23-U1.000|7:02-U1.000|8:37-U1.000|6:18-U1.000|5:10-U1.000|4:11-U1.000|4:10-U1.000|4:07-U0.864|3:45,,"Balve Running",,,3113,,250,3,9065875532,0,168070,250480,30378,,31383225,,,,,,,,,,,,,,,,,,,,,,,,,,,,,,,,,,,,,,,,"3,4,4",
46797457,e8b721b5-1cc3-45ff-b58c-6751e3e98c59,1655987162,120,1655984450,,0,0,13.18,4303,4384,381,360,402,388,0,4.2,0.93,1.09,1.2,455,900,147,163,,,,50.23,37,52.12,1,59.05,1366,124,,3.3,0,97,98,,,,13,4,121,79,11.88,11.67,12,-6.5,6,275,275,,1,281,281,,,,,,,,,"27,12,15,10,11,17,6,0,0","0,18,80,2,0","0,4,72,24,0",,,,,116,,,,,,,,,,,,,,,,,,,,,,,,,,,,,,,,,,,,42.8,28,10,162,40,,1013,7,332,0,2,3,Balve,1,0,U1.000|5:58-U1.000|6:32-U1.000|5:58-U1.000|6:31-U1.000|6:50-U1.000|5:40-U1.000|5:20-U1.000|5:29-U1.000|5:14-U1.000|4:45-U1.000|4:21-U1.000|4:09-U1.000|4:02-U0.178|0:54,,"Balve Running",,,3113,,250,3,9070866577,0,168070,250480,30378,,31422453,,,,,,,,,,,,,,,,,,,,,,,,,,,,,,,,,,,,,,,,3,
46841358,62ed3d39-66e8-4c58-95e9-791eb631505f,1656063383,120,1656058349,,0,0,0.9,1950,1950,113,458,2,9,0,3,1,,,218,6,,,,,,,,,1,,,,,,,,,,,,,,28,45,,10.15,,,,49,3,,0,46,24,,,,,,,,,"4,3,3,1,0,0,90",,"100,0,0,0,0",,,,,,,,,,,,,,,,,,,,,,,,,,,,,,,,,,,,,,,,,,,,,,,,,,1,1,,,1,1,U0.035|0:10-U0.000|1:37-U0.601|0:04-U0.296|30:39,,,,,315-0,,,7,,0,168072,,30378,,31459856,,,,,,,,,,,,,,,,,,,,,,,,,,,,,,,,,,,,,,,,4,
46890706,6c3830dd-e45a-4a64-90dd-3c9b5205a4db,1656095408,120,1656092871,,0,0,15.61,4070,4070,248,246,225,270,4,1.8,0.44,1.11,0.9,,1109,164,183,,,,56.59,48.71,57.71,1,,,,,,,,,,,,,,169,82,14.07,14.36,14.79,15.6,16.1,351,351,,1,378,378,,,,,,,,,"4,3,8,10,10,26,27,9,1","0,7,21,71,1","0,6,24,41,29",,,,,140,,,,,,,,,,,,,,,,,,,,,,,,,,,,,,,,,,,,104.2,20,8,224,77,,1008,1,334,0,3,3,Sundern,1,0,U1.000|3:40-U1.000|3:34-U1.000|3:50-U1.000|3:49-U1.000|3:50-U1.000|3:52-U1.000|3:47-U1.000|4:06-U1.000|4:32-U1.000|4:11-U1.000|4:40-U1.000|4:41-U1.000|5:00-U1.000|5:20-U1.000|5:37-U0.570|3:21,,,,,wahoo_fitness-33,,518,7,,0,168070,250480,30378,,31505283,,,,,,,,,,,,,,,,,,,,,,,,,,,,,,,,,,,,,,,,,
46942360,ca6ef6d5-bd01-4522-8ed3-569c3f75887d,1656151800,120,1656148026,,0,0,7.61,2623,3085,147,141,177,172,0,2,0.61,0.98,0.99,352,519,138,156,,,,51.08,33.33,52.35,1,59.01,898,60,,2.5,0,98,100,,,,11,1,58,77,10.83,10.67,11.09,-0.7,-4.2,252,252,,1,263,263,,,,,,,,,"16,14,18,41,10,1,0,0,0","0,55,45,0,0","0,11,76,12,1",,,,,113,,,,,,,,,,,,,,,,,,,,,,,,,,,,,,,,,,,,30.2,21,10,207,58,,1013,4,328,0,3,3,Balve,1,0,U1.000|6:00-U1.000|5:19-U1.000|6:30-U1.000|5:39-U1.000|5:11-U1.000|6:03-U1.000|5:46-U0.614|3:16,,"Balve Running",,,3113,,250,3,9081679289,0,168070,250480,30378,,31544700,,,,,,,,,,,,,,,,,,,,,,,,,,,,,,,,,,,,,,,,5,
46955752,aa5b12ea-519b-4b97-8c2c-f6df48a05979,1656163514,120,1656161891,,0,0,1.4,1307,1307,12,125,15,132,0,1.2,1,,,,89,86,105,76,,,,,,1,59.02,714,2,,0.1,0,,100,,,,,,6,56,,4.15,,-1.9,,,,,,,,,,,,,,,,"83,17,0,0,0,0","97,3,0,0,0",,,,,,,,,,,,,,,,,,,,,,,,,,,,,,,,,,,,,,,,,,2,24,12,199,46,,1012,6,329,0,3,3,Altena,1,0,,,"Altena Hiking",,,3113,,250,3,9083096450,0,168075,,30378,,31556767,,,,,,,,,,,,,,,,,,,,,,,,,,,,,,,,,,,,,,,,,
46997947,d980d1f6-2e03-42af-b959-051877850d78,1656235269,120,1656229005,,0,0,,914,914,,,,,0,,,,,,71,,,,,,,,,1,,,,,,,,,,,,,,7,,,,,,,,,,,,,,,,,,,,,,,,,,,,,,,,,,,,,,,,,,,,,,,,,,,,,,,,,,,,,,,,,,,,,,,,,,1,,,1,0,,,,,,,,252,7,,0,168073,,30378,,31596101,,,,,,,,,,,,,,,,,,,,,,,,,,,,,,,,,,,,,,,,,
47000823,000c94e4-341a-4b97-9c4b-a7d92bdd045a,1656233930,120,1656233496,,0,0,14.64,5014,5415,422,363,443,387,0,4.5,0.84,0.98,1.16,443,1018,146,168,117,,,47.79,35.28,49.73,1,58.97,1490,141,,3.5,0.1,98,97,,,,11,3,133,79,11.44,11.18,11.63,-7.6,-1.1,264,264,,1,272,272,,,,,,,,,"34,15,9,10,15,16,2,0,0","0,31,65,4,0","0,8,74,18,1",,,,,111,,,,,,,,,,,,,,,,,,,,,,,,,,,,,,,,,,,,47.3,18,7,172,76,,1015,3,333,0,3,3,Balve,1,0,U1.000|6:17-U1.000|6:27-U1.000|6:29-U1.000|6:15-U1.000|6:45-U1.000|5:06-U1.000|5:54-U1.000|6:08-U1.000|8:07-U1.000|5:06-U1.000|4:24-U1.000|4:33-U1.000|4:24-U1.000|4:26-U0.637|3:14,,"Balve Running",,,3113,,250,3,9087859409,0,168070,250480,30378,,31598769,,,,,,,,,,,,,,,,,,,,,,,,,,,,,,,,,,,,,,,,"3,4",
47033143,07b753e2-d594-405b-a053-d1fb59e4e63d,1656269605,120,1656262973,,0,0,,555,555,,,,,0,,,,,,43,,,,,,,,,1,,,,,,,,,,,,,,4,,,,,,,,,,,,,,,,,,,,,,,,,,,,,,,,,,,,,,,,,,,,,,,,,,,,,,,,,,,,,,,,,,,,,,,,,,1,,,1,0,,,,,,,,252,7,,0,168073,,30378,,31627426,,,,,,,,,,,,,,,,,,,,,,,,,,,,,,,,,,,,,,,,,
47070096,43267446-fb74-4e70-9aaa-b529bb5a44ae,1656333461,120,1656330999,,0,0,13.4,4180,4396,336,325,346,340,0,3.7,0.82,0.95,1.1,474,845,138,165,,,,57.77,39.08,59.62,1,58.94,1239,104,,3.1,0,103,98,,,,11,4,98,79,12.34,12.37,12.44,-12.9,-6.5,288,288,,1,293,293,,,,,,,,,"25,14,11,10,9,13,16,1,0","1,63,35,1,0","0,0,68,30,1",,,,,122,,,,,,,,,,,,,,,,,,,,,,,,,,,,,,,,,,,,35,17,7,212,85,,1016,4,331,0,6,3,Balve,1,0,U1.000|5:07-U1.000|5:10-U1.000|6:34-U1.000|6:18-U1.000|6:11-U1.000|6:07-U1.000|6:20-U1.000|4:41-U1.000|3:58-U1.000|4:02-U1.000|4:05-U1.000|3:44-U1.000|4:51-U0.397|2:33,,"Balve Running",,,3113,,250,3,9095178574,0,168070,250480,30378,,31660930,,,,,,,,,,,,,,,,,,,,,,,,,,,,,,,,,,,,,,,,"4,5",
47145567,218b571d-a3bb-448f-a912-7b7e1c1dee11,1656441204,120,1656439513,,0,0,3.85,1030,1030,18,32,28,44,0,0,0.21,1.06,0.96,,240,148,162,,,,63.63,43.1,63.71,1,59.03,932,67,,2.6,0,102,104,,,,7,3,30,79,13.39,13.54,13.44,1.2,-0.4,329,329,,1,331,331,,,,,,,,,"1,0,2,7,30,53,8,0,0","0,12,86,2,0","0,0,15,83,1",,,,,142,,,,,,,,,,,,,,,,,,,,,,,,,,,,,,,,,,,,40.7,23,9,30,47,,1020,1,339,0,3,3,"Menden (Sauerland)",1,0,U1.000|4:51-U1.000|4:28-U1.000|4:11-U0.851|3:41,,"Menden (Sauerland) Running",,,3113,,250,3,9103605593,0,168070,250480,30378,,31732165,,,,,,,,,,,,,,,,,,,,,,,,,,,,,,,,,,,,,,,,,
47145570,f385d8a1-6bae-4f83-b04f-25b5b6928cc4,1656442609,120,1656439520,,0,0,0.87,451,452,15,16,31,30,0,0,0.07,1.45,0.82,,67,120,145,,,,36.47,17.17,37.2,1,59.03,920,12,,0.6,0.2,,100,,,,7,3,7,65,7.21,7.46,7.99,-9.2,-54.4,158,158,,1,183,183,,,,,,,,,"81,2,2,1,2,2,3,6,2","0,91,9,0,0","31,43,13,10,4",,,,,89,,,,,,,,,,,,,,,,,,,,,,,,,,,,,,,,,,,,8.8,23,9,30,47,,1020,1,339,0,3,3,"Menden (Sauerland)",1,0,,,"Menden (Sauerland) Running",,,3113,,250,3,9103606849,0,168070,250480,30378,,31732168,,,,,,,,,,,,,,,,,,,,,,,,,,,,,,,,,,,,,,,,,
47145616,6289e206-a51d-46e9-9ee6-67bb5c68248b,1656443184,120,1656439558,,0,0,5.14,2213,2213,57,55,56,54,0,0,0.12,1.2,0.72,555,378,138,182,111,,,38.8,24.84,39.36,1,59.03,2806,134,,2.8,2.5,,100,,,,7,3,57,74,9.17,12.25,12.41,40.2,13.7,213,213,,1,323,323,,,,,,,,,"62,2,3,2,2,2,4,12,10","9,42,27,22,0","41,15,13,9,22",,,,,94,,,,,,,,,,,,,,,,,,,,,,,,,,,,,,,,,,,,55.8,22,10,28,51,,1019,1,336,0,3,3,"Menden (Sauerland)",1,0,U0.290|0:55-U0.100|0:40-U0.400|1:19-U0.090|0:35-U0.330|0:59-U0.410|2:56-U0.300|0:55-U0.100|0:40-U0.390|1:24-U0.110|0:42-U0.240|0:51-U0.300|9:03-U0.280|0:50-U0.160|1:50-U0.300|0:53-U0.130|2:27-U0.300|0:53-U0.280|4:30-U0.210|0:33-U0.210|2:09-U0.190|0:37-U0.020|1:12,,"Menden (Sauerland) Track Running",,,3113,,250,3,9103612047,0,168070,250480,30378,,31732210,,,,,,,,,,,,,,,,,,,,,,,,,,,,,,,,,,,,,,,,4,
47145624,06a6918c-1b83-46c6-9b9c-c143f66875e0,1656445676,120,1656439562,,0,0,0.53,262,262,4,4,8,7,0,1,0.62,1.18,0.79,,39,126,131,,,,36.57,17.2,36.92,1,59.03,2802,4,,0.3,0,,100,,,,7,3,4,76,7.34,7.53,7.88,19.1,22.1,161,161,,1,176,176,,,,,,,,,"100,0,0,0,0,0,0,0,0","0,100,0,0,0","10,76,15,0,0",,,,,80,,,,,,,,,,,,,,,,,,,,,,,,,,,,,,,,,,,,7,22,10,28,51,,1019,1,336,0,3,3,"Menden (Sauerland)",1,0,,,"Menden (Sauerland) Running",,,3113,,250,3,9103612570,0,168070,250480,30378,,31732217,,,,,,,,,,,,,,,,,,,,,,,,,,,,,,,,,,,,,,,,,
47183196,11602ff8-2e6b-4a13-b685-43bdb10e82ad,1656510046,120,1656507836,,0,0,13.26,4574,4745,312,295,330,316,0,3.6,0.81,0.97,1.06,416,872,135,154,,,,52.47,34.71,54.08,1,59,1889,93,,3,0,97,98,,,,7,1,98,78,11.06,10.82,11.17,-5.7,3.6,254,254,,1,260,260,,,,,,,,,"31,12,16,16,20,5,1,0,0","1,71,28,0,0","0,7,85,9,0",,,,,111,,,,,,,,,,,,,,,,,,,,,,,,,,,,,,,,,,,,27.2,23,7,281,55,,1015,4,328,0,4,3,Balve,1,0,U1.000|5:55-U1.000|5:40-U1.000|6:41-U1.000|6:26-U1.000|6:20-U1.000|6:56-U1.000|5:28-U1.000|4:37-U1.000|4:39-U1.000|4:47-U1.000|4:57-U1.000|6:17-U1.000|6:04-U0.261|1:28,,"Balve Running",,,3113,,250,3,9108228038,0,168070,250480,30378,,31767160,,,,,,,,,,,,,,,,,,,,,,,,,,,,,,,,,,,,,,,,"4,5",
47255717,3685615b-8a93-4984-bb86-a239349e7371,1656614691,120,1656612438,,0,0,13.06,4259,4407,358,334,380,356,0,4,0.89,0.97,1.11,446,866,142,158,107,,,52.69,37.03,54.6,1,58.94,1297,120,,3.2,0.5,99,98,,,,7,3,110,78,11.87,11.72,12.03,-10.5,1.5,275,275,,1,284,284,,,,,,,,,"30,12,10,15,13,15,4,2,0","0,38,62,0,0","0,5,71,23,1",,,,,118,,,,,,,,,,,,,,,,,,,,,,,,,,,,,,,,,,,,37.3,28,10,96,55,,1008,,,0,4,1,Balve,1,0,U1.000|5:42-U1.000|6:32-U1.000|6:03-U1.000|6:44-U1.000|6:33-U1.000|5:52-U1.000|5:31-U1.000|5:31-U1.000|5:12-U1.000|4:44-U1.000|4:21-U1.000|4:21-U1.000|3:39-U0.056|0:13,,"Balve Running",,,3113,,250,3,9116195091,0,168070,250480,30378,,31829247,,,,,,,,,,,,,,,,,,,,,,,,,,,,,,,,,,,,,,,,3,
47295428,6224a41e-e92b-489a-bf35-f61172fc606c,1656682731,120,1656678701,,0,0,9.84,2962,3020,204,218,235,250,0,2.6,0.66,0.98,1.01,351,635,144,167,,,,57.09,39.81,58.45,1,58.95,1338,111,,3.2,0,100,100,,,,7,3,76,79,12.37,12.46,12.64,-1.9,-5,294,294,,1,304,304,,,,,,,,,"10,8,14,21,24,12,8,2,0","1,38,53,8,0","0,2,53,42,2",,,,,126,,,,,,,,,,,,,,,,,,,,,,,,,,,,,,,,,,,,49.1,16,12,255,77,,1019,4,355,0,6,3,Balve,1,0,U1.000|5:20-U1.000|4:34-U1.000|5:18-U1.000|5:25-U1.000|5:15-U1.000|5:43-U1.000|5:23-U1.000|3:43-U1.000|3:54-U0.836|4:45,,"Balve Running",,,3113,,250,3,9120117751,0,168070,250480,30378,,31866396,,,,,,,,,,,,,,,,,,,,,,,,,,,,,,,,,,,,,,,,"4,5",
47327431,d9a00f71-baed-40ee-9f4d-777d839cb7d9,1656752148,120,1656751409,,0,0,17.16,6058,6268,544,500,558,519,0,5,0.91,1.02,1.07,529,1170,145,164,,,,46.46,34.48,48.44,1,58.88,1628,137,,3.5,0,98,96,,,,13,4,160,78,11.13,10.81,11.29,7,12.7,253,253,,1,262,262,,,,,,,,,"37,13,11,12,17,10,0,0,0","0,24,75,1,0","0,9,77,14,0",,,,,109,,,,,,,,,,,,,,,,,,,,,,,,,,,,,,,,,,,,39.5,19,7,180,59,,1024,3,319,0,2,3,Balve,1,0,U1.000|6:11-U1.000|6:19-U1.000|6:20-U1.000|6:47-U1.000|6:57-U1.000|5:44-U1.000|5:46-U1.000|4:25-U1.000|5:28-U1.000|8:41-U1.000|6:55-U1.000|5:38-U1.000|5:43-U1.000|5:20-U1.000|4:51-U1.000|4:40-U1.000|4:26-U0.160|0:48,,"Balve Running",,,3113,,250,3,9124612579,0,168070,250480,30378,,31896059,,,,,,,,,,,,,,,,,,,,,,,,,,,,,,,,,,,,,,,,"4,4,4",
47354267,1886c512-23f4-4aec-b59c-c087708b99c4,1656794818,120,1656788543,,0,0,,908,908,,,,,0,,,,,,70,,,,,,,,,1,,,,,,,,,,,,,,7,,,,,,,,,,,,,,,,,,,,,,,,,,,,,,,,,,,,,,,,,,,,,,,,,,,,,,,,,,,,,,,,,,,,,,,,,,1,,,1,0,,,,,,,,252,7,,0,168073,,30378,,31919411,,,,,,,,,,,,,,,,,,,,,,,,,,,,,,,,,,,,,,,,,
47354601,07d8e72d-7070-42fc-bd7e-db82a44f2d2a,1656795757,120,1656789048,,0,0,,482,482,,,,,0,,,,,,37,,,,,,,,,1,,,,,,,,,,,,,,4,,,,,,,,,,,,,,,,,,,,,,,,,,,,,,,,,,,,,,,,,,,,,,,,,,,,,,,,,,,,,,,,,,,,,,,,,,1,,,1,0,,,,,,,,252,7,,0,168073,,30378,,31919608,,,,,,,,,,,,,,,,,,,,,,,,,,,,,,,,,,,,,,,,,
47377695,e247b48f-099e-4df5-b639-16945c7e9e86,1656848678,120,1656846673,,0,0,14.02,4436,4535,358,324,387,352,0,3.8,0.75,0.65,0.75,432,888,143,162,,,,54.18,38.57,56.06,1,58.82,1305,109,,3.2,0,98,97,,,,7,3,119,78,12.38,16.69,16.24,-29.4,,286,286,,1,411,411,,,,,,,,,"36,11,16,10,7,7,8,2,3","0,29,71,0,0","2,12,59,20,6",,,,,122,,,,,,,,,,,,,,,,,,,,,,,,,,,,,,,,,,,,42.4,25,9,266,45,,1018,6,325,0,3,3,Balve,1,0,U1.000|6:14-U1.000|6:41-U1.000|6:09-U1.000|7:10-U1.000|6:42-U1.000|6:01-U1.000|5:51-U1.000|7:18-U1.000|5:25-U1.000|3:50-U1.000|3:10-U1.000|1:23-U1.000|4:00-U1.000|3:59-U0.019|0:04,,"Balve Running",,,3113,,250,3,9132023960,0,168070,250480,30378,,31940988,,,,,,,,,,,,,,,,,,,,,,,,,,,,,,,,,,,,,,,,3,
47441070,3bbfcb65-10f8-4e15-b46e-2af50f9303ea,1656954218,120,1656954635,,0,0,10.77,2775,3102,243,247,280,287,0,3,0.46,0.99,0.87,565,636,153,178,117,,,63.62,48.05,65.37,1,58.9,1584,166,,3.6,1.8,104,100,,,,7,3,94,81,14.96,19.59,20.53,-16.5,-31.4,348,346,,1,394,387,,,,,,,,,"20,3,4,4,8,30,20,5,7","1,15,54,31,0","2,9,12,57,19",,,,,144,,,,,,,,,,,,,,,,,,,,,,,,,,,,,,,,,,,,70.9,24,10,307,36,,1020,3,340,0,2,3,Balve,1,0,U1.000|4:22-U1.000|4:14-U1.000|4:01-U1.000|4:06-U1.000|6:59-U1.000|4:27-U1.000|4:55-U1.000|1:32-U1.000|3:58-U1.000|4:08-U0.769|3:32,,"Balve Running",,,3113,,250,3,9140183509,0,168070,250480,30378,,31998870,,,,,,,,,,,,,,,,,,,,,,,,,,,,,,,,,,,,,,,,"3,4",
47441074,1aca906e-83f7-4c12-8620-3e39d315f127,1656957790,120,1656954640,,0,0,3.57,2661,2755,131,121,159,146,0,2.4,0.73,,,327,316,113,142,,,,,,,1,58.96,1536,21,,1.5,0,,100,,,,,,34,63,,5.59,,27.1,,,,,,,,,,,,,,,,"29,67,0,0,0,4","13,87,0,0,0",,,,,,,,,,,,,,,,,,,,,,,,,,,,,,,,,,,,,,,,,,11.4,24,9,290,38,,1019,2,339,0,2,3,Balve,1,0,,,"Balve Hiking",,,3113,,250,3,9140183636,0,168075,,30378,,31998874,,,,,,,,,,,,,,,,,,,,,,,,,,,,,,,,,,,,,,,,"4,5",
47498473,77c962aa-c766-41f4-a070-a78e0999848d,1657046018,120,1657044698,,0,0,4.49,1493,1756,47,30,61,45,0,0,0.15,0.89,0.61,240,278,134,150,,,,55.41,33.68,56.39,1,59.01,932,58,,2.5,0.1,106,104,,,,9,3,31,75,11.15,11.83,12.24,15.7,-6,269,269,,1,302,302,,,,,,,,,"31,2,2,6,26,28,2,2,2","2,46,51,0,0","8,16,17,58,2",,,,,120,,,,,,,,,,,,,,,,,,,,,,,,,,,,,,,,,,,,27.5,20,14,305,50,,1021,1,353,0,4,3,"Menden (Sauerland)",1,0,U1.000|4:53-U1.000|4:31-U1.000|4:28-U1.000|6:50-U0.492|4:12,,"Menden (Sauerland) Running",,,3113,,250,3,9146874868,0,168070,250480,30378,,32050471,,,,,,,,,,,,,,,,,,,,,,,,,,,,,,,,,,,,,,,,5,
47498501,bbd1b190-c1e2-4a92-a268-c1f0ffa9d704,1657047987,120,1657044729,,0,0,7.09,2403,2403,0,0,0,0,0,0,0,,,,484,146,185,,,,48.41,33.84,48.41,1,59.01,2377,209,,3.4,2.9,107,105,,,,17,4,74,79,10.63,13.79,13.79,27.2,0.1,266,266,,1,361,361,,,,,,,,,"50,3,2,1,1,2,14,21,7","7,37,13,41,2","29,18,8,5,39",,,,,112,,,,,,,,,,,,,,,,,,,,,,,,,,,,,,,,,,,,68.2,20,14,305,50,,1021,1,353,0,4,3,"Menden (Sauerland)",1,0,U1.210|4:10-U0.400|2:56-U0.600|1:59-U0.200|1:34-U0.610|2:00-U0.190|2:00-U0.610|2:00-U0.320|4:44-U0.300|0:55-U0.100|0:58-U0.300|0:54-U0.100|1:03-U0.300|0:54-U0.470|4:19-U1.200|4:08-U0.180|5:31,,"Menden (Sauerland) Track Running",,,3113,,250,3,9146879363,0,168070,250480,30378,,32050500,,,,,,,,,,,,,,,,,,,,,,,,,,,,,,,,,,,,,,,,,
47498513,d240a4f0-ab6a-4bc0-b168-3f133265e5ce,1657050516,120,1657044743,,0,0,3.21,1041,1041,45,43,60,60,0,0.2,0.31,1.05,0.9,,216,138,143,,,,55.06,33.96,56.06,1,59.01,2738,40,,2.2,0,100,100,,,,7,1,23,79,11.28,11.24,11.42,2.9,2.5,267,267,,1,272,272,,,,,,,,,"3,4,22,55,13,2,0,0,0","0,84,16,0,0","0,5,77,18,0",,,,,117,,,,,,,,,,,,,,,,,,,,,,,,,,,,,,,,,,,,21.2,21,14,316,49,,1022,0,354,0,3,3,"Menden (Sauerland)",1,0,U1.000|5:18-U1.000|5:25-U1.000|5:13-U0.212|1:25,,"Menden (Sauerland) Running",,,3113,,250,3,9146881081,0,168070,250480,30378,,32050512,,,,,,,,,,,,,,,,,,,,,,,,,,,,,,,,,,,,,,,,,
47546391,d0bc0617-8da0-4e44-ac3d-f870295c286f,1657120313,120,1657117787,,0,0,13.44,4017,4326,346,305,369,330,0,3.9,0.76,0.99,1.02,539,852,142,162,,,,58.67,41.09,60.77,1,59.01,2161,126,,3.3,0,103,99,,,,11,4,99,79,12.78,12.43,13.14,-7.2,-1.8,307,307,,1,320,320,,,,,,,,,"6,10,18,15,21,23,7,0,0","1,37,61,0,0","0,1,48,44,6",,,,,127,,,,,,,,,,,,,,,,,,,,,,,,,,,,,,,,,,,,36.4,20,12,303,42,,1025,4,344,0,4,3,Balve,1,0,U1.000|5:06-U1.000|4:52-U1.000|6:03-U1.000|5:47-U1.000|5:43-U1.000|5:47-U1.000|4:56-U1.000|4:26-U1.000|4:21-U1.000|4:09-U1.000|4:02-U1.000|5:02-U1.000|4:50-U0.443|1:52,,"Balve Running",,,3113,,250,3,9151944883,0,168070,250480,30378,,32095158,,,,,,,,,,,,,,,,,,,,,,,,,,,,,,,,,,,,,,,,"3,4",
47591380,7d6ba332-4f26-4eb4-94a8-1b77e5133a85,1657199319,120,1657196848,,0,0,9.74,3640,4638,304,258,323,275,0,4.2,0.79,1.27,0.83,549,661,131,157,,,,49.34,30.82,51.53,1,59.03,1222,92,,2.8,1.2,102,100,,,,7,1,69,76,10.2,10.25,12.2,9.7,2.6,246,246,,1,306,306,,,,,,,,,"29,11,21,24,8,3,2,1,0","2,74,24,0,0","15,19,39,15,11",,,,,106,,,,,,,,,,,,,,,,,,,,,,,,,,,,,,,,,,,,25.4,16,17,308,89,,1022,4,334,0,6,3,Balve,1,0,U1.000|5:25-U1.000|5:50-U1.000|5:51-U0.148|1:02-U0.216|0:55-U0.245|2:05-U0.211|0:55-U0.247|1:42-U0.219|0:56-U0.240|2:06-U0.214|0:54-U0.244|2:25-U0.212|0:55-U0.247|2:18-U0.214|1:02-U0.245|2:22-U0.212|0:57-U0.258|3:26-U0.218|0:56-U1.000|6:29-U1.000|5:25-U1.000|5:53-U0.148|0:51,,"Balve Running",,,3113,,250,3,9157599858,0,168070,250480,30378,,32135589,,,,,,,,,,,,,,,,,,,,,,,,,,,,,,,,,,,,,,,,"4,5,5,5,5,5",
47647464,635253bb-be61-45c7-a00d-8b620a340873,1657299256,120,1657297001,,0,0,13,4321,4602,345,332,362,353,0,3.9,0.81,0.92,1.04,500,859,137,156,,,,53.91,36.2,55.75,1,58.98,1250,102,,3.1,0,100,97,,,,7,1,94,78,11.64,11.56,11.77,-14.1,-9.3,268,268,,1,274,274,,,,,,,,,"33,13,9,10,11,18,5,0,0","1,62,37,0,0","0,3,76,19,1",,,,,116,,,,,,,,,,,,,,,,,,,,,,,,,,,,,,,,,,,,28.4,20,12,323,58,,1029,2,321,0,4,3,Balve,1,0,U1.000|5:19-U1.000|5:18-U1.000|6:43-U1.000|6:43-U1.000|6:43-U1.000|6:29-U1.000|6:58-U1.000|4:58-U1.000|4:23-U1.000|4:16-U1.000|4:17-U1.000|4:07-U1.000|5:45-U0.004|0:02,,"Balve Running",,,3113,,250,3,9164879918,0,168070,250480,30378,,32187271,,,,,,,,,,,,,,,,,,,,,,,,,,,,,,,,,,,,,,,,3,
47670431,426c2196-e8da-41b8-a0be-03a6c50dbac6,1657353810,120,1657350150,,0,0,7.72,2650,3179,105,96,133,127,0,1,0.48,1.01,1.06,,518,142,162,,,,49.46,33.52,50.36,1,58.92,1203,75,,2.8,0,96,97,,,,11,1,64,78,10.83,10.64,10.91,-3.5,-7.7,252,252,,1,257,257,,,,,,,,,"19,12,28,28,11,2,0,0,0","0,30,69,0,0","0,8,88,4,0",,,,,112,,,,,,,,,,,,,,,,,,,,,,,,,,,,,,,,,,,,28.6,16,8,276,76,,1027,2,323,0,3,3,Balve,1,0,U1.000|5:38-U1.000|6:13-U1.000|5:45-U1.000|5:20-U1.000|5:08-U1.000|5:33-U1.000|5:47-U0.716|4:46,,"Balve Running",,,3113,,250,3,9167823611,0,168070,250480,30378,,32208025,,,,,,,,,,,,,,,,,,,,,,,,,,,,,,,,,,,,,,,,,
47739638,c1b7dcd0-d1ef-4ad0-9d60-9303f0ba4492,1657457643,120,1657457363,,0,0,15.02,4377,4541,263,252,295,285,0,2.7,0.59,0.96,1,502,943,146,160,109,,,58.32,42.69,59.64,1,58.92,1396,136,,3.4,0,100,100,,,,13,4,120,80,12.8,12.62,12.9,-4.9,-5.3,308,308,,1,314,314,,,,,,,,,"8,6,9,15,25,27,9,0,0","0,21,79,0,0","0,2,38,58,2",,,,,129,,,,,,,,,,,,,,,,,,,,,,,,,,,,,,,,,,,,39.2,17,13,340,70,,1026,4,329,0,4,3,Aachen-Mitte,1,0,U1.000|5:20-U1.000|6:12-U1.000|5:16-U1.000|4:43-U1.000|4:25-U1.000|5:05-U1.000|4:54-U1.000|5:05-U1.000|4:38-U1.000|4:58-U1.000|4:19-U1.000|4:24-U1.000|4:25-U1.000|4:49-U1.000|4:21-U0.015|0:04,,"Aachen Running",,,3113,,250,3,9176438286,0,168070,250480,30378,,32273210,,,,,,,,,,,,,,,,,,,,,,,,,,,,,,,,,,,,,,,,"4,5",
47785366,237a3bc5-6b17-4083-83ff-27dad11cb7a1,1657551274,120,1657550402,,0,0,40.25,6066,6269,622,619,606,612,4,3.6,0.46,,,1033,1297,,,,,,,,,1,,,,,,,,,,,,,,87,78,,27.47,,,,135,106,,1,180,169,,,,,,,,,"22,13,22,17,15,6,6",,"50,34,14,1,1",,,,,,,,,,,,,,,,,,,,,,,,,,,,,,,,,,,,,,,,,,27,15,45,41,,1023,5,328,0,3,3,Kwaremont,1,0,,,,,,wahoo_fitness-43,,258,7,,0,168072,,30378,,32314374,,,,,,,,,,,,,,,,,,,,,,,,,,,,,,,,,,,,,,,,"4,4,4,4,5",
47788117,3520fc91-a367-4e81-9c5f-b9036a46e4a9,1654953795,120,1657554374,,0,0,44.56,6813,8677,696,696,641,632,4,3,0.54,1.12,1.01,584,982,133,162,,,,,,,1,,,,,,,,,,,,,,146,82,,29.73,,-30.8,-17.4,171,138,,0,179,167,,,,,,,,,"19,27,18,13,6,5,11","4,64,32,1,0","23,54,22,1,0",,,,,,,,,,,,,,,,,,,,,53,,,,,,,,,,,,,,,,,,,,34,22,12,247,65,,1022,5,321,0,3,3,Balve,1,0,,,,,,wahoo_fitness-43,,258,7,,0,168072,,30378,,32316936,,,,,,,,,,,,,,,,,,,,,,,,,,,,,,,,,,,,,,,,"4,5,5",
47824459,2d7f2e1d-dd2f-42d0-b0e3-6c96466b4936,1657620543,120,1657618999,,0,0,16.93,5166,5447,367,369,419,425,0,2.9,0.62,0.97,1.05,339,1129,151,177,,,,52.6,40.85,54,1,58.9,1878,172,,3.8,0,104,98,,,,15,4,157,80,12.46,12.22,12.61,-2.9,-6.1,293,293,,1,303,303,,,,,,,,,"14,8,11,15,22,20,8,0,0","0,17,66,17,0","1,5,47,46,2",,,,,123,,,,,,,,,,,,,,,,,,,,,,,,,,,,,,,,,,,,71,23,7,136,58,,1025,3,316,0,4,3,Kwaremont,1,0,U1.000|4:34-U1.000|5:19-U1.000|5:39-U1.000|4:30-U1.000|6:05-U1.000|6:12-U1.000|6:07-U1.000|5:10-U1.000|4:36-U1.000|4:08-U1.000|5:01-U1.000|5:02-U1.000|4:35-U0.689|3:16-U1.000|5:20-U1.000|5:03-U0.122|0:34-U1.000|4:15-U0.119|0:40,,"Kluisbergen Running",,,3113,,250,3,9187876279,0,168070,250480,30378,,32350079,,,,,,,,,,,,,,,,,,,,,,,,,,,,,,,,,,,,,,,,"4,4,4,5",
47892789,c5f2f449-4137-49fa-a397-797489b7eadd,1657723264,120,1657721244,,0,0,12.02,4215,4612,274,258,312,296,0,3.1,0.61,1.09,0.98,543,815,139,183,,,,49.54,33.78,51.02,1,58.81,1393,125,,3.2,1.1,98,97,,,,16,4,101,78,10.75,10.62,11.67,0.9,-22.2,252,252,,1,290,290,,,,,,,,,"25,19,25,17,5,6,3,0,0","1,58,28,12,1","2,22,55,14,6",,,,,110,,,,,,,,,,,,,,,,,,,,,,,,,,,,,,,,,,,,82.9,29,16,313,33,,1020,6,310,0,3,3,Kluisbos,1,0,U1.000|6:23-U1.000|6:21-U1.000|6:54-U1.000|5:55-U1.000|5:46-U1.000|5:34-U1.000|6:08-U0.555|3:11-U1.000|4:32-U1.000|4:25-U0.130|0:33-U1.000|6:29-U1.000|6:05-U0.336|1:57,,"Kluisbergen Running",,,3113,,250,3,9196015082,0,168070,250480,30378,,32412276,,,,,,,,,,,,,,,,,,,,,,,,,,,,,,,,,,,,,,,,"4,5,5",
47953173,73a1efdd-4efb-4b62-a846-9957220b3e98,1657824821,120,1657822740,,0,0,12.12,3982,4706,320,291,340,309,0,4,0.83,0.94,0.93,591,844,149,179,107,,,48.92,36.49,50.66,1,58.81,2017,222,,3.9,2.3,98,100,,,,16,4,126,78,11.64,11.74,12.72,-0.2,-2.6,278,278,,1,320,320,,,,,,,,,"25,5,8,22,20,8,6,5,0","0,42,17,41,0","5,18,41,19,18",,,,,117,,,,,,,,,,,,,,,,,,,,,,,,,,,,,,,,,,,,84.6,21,15,326,42,,1019,1,344,0,3,3,Balve,1,0,U0.960|5:36-U0.177|0:46-U0.112|0:46-U0.191|0:48-U0.116|0:46-U0.215|0:51-U0.080|0:46-U0.198|0:46-U0.126|0:46-U0.185|0:45-U0.093|0:46-U0.196|0:48-U0.110|0:47-U0.192|0:46-U0.080|0:45-U0.194|0:48-U0.079|0:50-U0.171|0:46-U0.077|0:45-U0.163|0:46-U0.082|0:46-U0.216|0:48-U0.123|0:45-U0.228|0:48-U0.075|0:46-U0.155|0:46-U0.071|0:46-U0.138|0:46-U0.068|0:44-U0.165|0:46-U1.000|6:10-U1.000|5:00-U1.000|5:07-U1.000|5:15-U1.000|5:40-U0.032|0:16-U0.414|1:58-U0.410|1:20-U0.407|2:05-U0.410|1:22-U0.414|4:05,,"Balve Running",,,3113,,250,3,9203947952,0,168070,250480,30378,,32467846,,,,,,,,,,,,,,,,,,,,,,,,,,,,,,,,,,,,,,,,"3,5",
47992248,8727b21a-56cf-4fde-9214-fca855b10e49,1657889318,120,1657886834,,0,0,13.26,4331,4468,318,296,353,335,0,3.7,0.77,0.94,1.01,474,908,147,164,,,,50.2,37,51.79,1,58.76,1899,134,,3.5,0,102,97,,,,11,1,119,78,11.73,11.42,11.85,-4.4,2.4,273,273,,1,280,280,,,,,,,,,"25,12,11,14,22,15,1,0,0","0,18,80,1,0","0,4,74,21,1",,,,,118,,,,,,,,,,,,,,,,,,,,,,,,,,,,,,,,,,,,40.7,19,11,316,43,,1022,5,342,0,3,3,Balve,1,0,U1.000|5:02-U1.000|5:14-U1.000|6:30-U1.000|6:25-U1.000|6:25-U1.000|6:24-U1.000|4:57-U1.000|4:34-U1.000|4:35-U1.000|4:48-U1.000|4:29-U1.000|5:55-U1.000|5:39-U0.260|1:13,,"Balve Running",,,3113,,250,3,9207933868,0,168070,250480,30378,,32502570,,,,,,,,,,,,,,,,,,,,,,,,,,,,,,,,,,,,,,,,"4,5",
48027727,f8f238c2-39f8-433d-81ad-7204c5ee68d4,1657963515,120,1657960893,,0,0,9.23,3797,4270,294,291,327,323,0,3.2,0.67,1.17,0.92,356,722,141,174,,,,39.92,27.36,41.52,1,58.69,1381,115,,3.1,1.4,99,96,,,,19,3,72,77,9.5,9.71,10.69,12.9,-14.8,216,216,,1,253,253,,,,,,,,,"47,8,10,16,14,3,1,0,0","1,47,44,7,0","21,15,49,8,7",,,,,95,,,,,,,,,,,,,,,,,,,,,,,,,,,,,,,,,,,,27,17,13,353,64,,1023,3,338,0,3,3,Balve,1,0,U1.000|5:13-U1.000|5:26-U0.911|5:26-U0.089|0:36-U0.114|1:38-U0.094|0:37-U0.115|1:20-U0.082|0:35-U0.112|1:25-U0.083|0:34-U1.000|6:20-U0.644|3:41-U0.127|0:40-U0.173|1:33-U0.135|0:40-U0.170|1:41-U0.140|0:42-U0.176|1:47-U0.142|0:40-U0.190|1:55-U0.144|0:42-U0.174|1:48-U0.143|0:42-U0.191|1:50-U0.140|0:34-U0.174|2:33-U0.140|0:36-U1.000|7:21-U0.628|4:39,,"Balve Running",,,3113,,250,3,9212778905,0,168070,250480,30378,,32533060,,,,,,,,,,,,,,,,,,,,,,,,,,,,,,,,,,,,,,,,"4,5,5,5",
48046594,c37ee529-dc06-460b-a71b-d627aa2be926,1657990808,120,1657987820,,0,0,24.43,3656,4132,521,522,524,528,4,4.1,0.64,,,805,143,,,,,,,,,1,,,,,,,,,,,,,,49,84,,33.17,,,,174,40,,0,127,118,,,,,,,,,"24,35,7,8,7,5,14",,"32,41,22,4,1",,,,,,,,,,,,,,,,,,,,,54,,,,,,,,,,,,,,,,,,,,,22,13,340,38,,1024,2,331,0,3,3,Balve,1,0,,,,,,wahoo_fitness-43,,258,7,,0,168072,,30378,,32550566,,,,,,,,,,,,,,,,,,,,,,,,,,,,,,,,,,,,,,,,"4,4",
48076738,fdfabbee-c6ae-4f7b-83a7-2e6b11a7a4d1,1658053882,120,1658053680,,0,0,16.3,6355,6815,560,437,574,451,0,5.3,0.83,1.07,1.08,456,1140,136,162,,,,44.7,30.52,47.02,1,58.61,1386,114,,3.3,0,98,94,,,,7,3,133,78,10.16,9.6,10.58,2.5,12.8,231,231,,1,247,247,,,,,,,,,"48,13,18,18,3,0,0,0,0","1,61,39,0,0","1,29,59,11,0",,,,,99,,,,,,,,,,,,,,,,,,,,,,,,,,,,,,,,,,,,30.3,20,6,332,43,,1028,5,324,0,3,3,Balve,1,0,U1.000|6:06-U1.000|7:03-U1.000|6:19-U1.000|7:02-U1.000|6:58-U1.000|5:47-U1.000|5:43-U1.000|8:23-U1.000|8:40-U1.000|7:34-U1.000|6:37-U1.000|5:46-U1.000|5:24-U1.000|5:31-U1.000|5:43-U1.000|5:37-U0.295|1:43,,"Balve Running",,,3113,,250,3,9219979832,0,168070,250480,30378,,32578420,,,,,,,,,,,,,,,,,,,,,,,,,,,,,,,,,,,,,,,,"3,3",
48117239,017dca55-4f29-42a6-8a1b-686920e53925,1658132531,120,1658127982,,0,0,6.75,2236,2305,107,100,120,114,0,1.6,0.58,0.99,1.02,379,442,137,159,,,,54.14,34.67,55.27,1,58.57,1019,61,,2.6,0,99,97,,,,11,1,49,79,11.2,11.11,11.32,-1.4,0.5,263,263,,1,267,267,,,,,,,,,"13,13,26,29,10,7,1,0,0","1,64,35,0,0","0,4,79,16,0",,,,,115,,,,,,,,,,,,,,,,,,,,,,,,,,,,,,,,,,,,29.3,20,5,151,51,,1025,1,314,0,3,3,Balve,1,0,U1.000|5:43-U1.000|5:50-U1.000|5:53-U1.000|5:27-U1.000|5:13-U1.000|4:38-U0.746|4:33,,"Balve Running",,,3113,,250,3,9225443860,0,168070,250480,30378,,32616478,,,,,,,,,,,,,,,,,,,,,,,,,,,,,,,,,,,,,,,,5,
48147014,392f074e-56ea-4389-8843-1f5f8eb30f49,1658177905,120,1658172131,,0,0,2.01,1021,1044,36,44,42,49,0,1.5,0.8,1.02,0.79,,134,104,127,,,,43.43,19.07,44.18,1,58.57,285,11,,0.8,0,,100,,,,7,3,10,70,7.38,7.95,8.26,20.4,17.6,160,160,,1,188,188,,,,,,,,,"67,23,6,3,0,0,0,0,0","27,73,0,0,0","28,40,32,0,0",,,,,84,,,,,,,,,,,,,,,,,,,,,,,,,,,,,,,,,,,,5.7,26,3,247,41,,1021,0,310,0,2,3,Balve,1,0,U1.000|7:25-U1.000|9:31-U0.009|0:06,,"Balve Running",,,3113,,250,3,9229283355,0,168070,250480,30378,,32643748,,,,,,,,,,,,,,,,,,,,,,,,,,,,,,,,,,,,,,,,,
48150183,1f066e80-68a8-4e89-9afc-e85cbf79ba21,1636571571,60,1658174719,,0,0,,920,920,,,,,0,,,,,,71,,,,,,,,,1,,,,,,,,,,,,,,7,,,,,,,,,,,,,,,,,,,,,,,,,,,,,,,,,,,,,,,,,,,,,,,,,,,,,,,,,,,,,,,,,,,,,,,,,,1,,,1,0,,,,,,,,252,7,,0,168073,,30378,,32646651,,,,,,,,,,,,,,,,,,,,,,,,,,,,,,,,,,,,,,,,,
48155330,d77b2696-518c-4c75-ae3f-06cfc503bec1,1636055814,60,1658190891,,0,0,,718,718,,,,,0,,,,,,55,,,,,,,,,1,,,,,,,,,,,,,,4,,,,,,,,,,,,,,,,,,,,,,,,,,,,,,,,,,,,,,,,,,,,,,,,,,,,,,,,,,,,,,,,,,,,,,,,,,1,,,1,0,,,,,,,,252,7,,0,168073,,30378,,32651447,,,,,,,,,,,,,,,,,,,,,,,,,,,,,,,,,,,,,,,,,
48155341,da9e1339-30df-4919-8147-f2b9faf7a072,1636054886,60,1658190923,,0,0,,887,887,,,,,0,,,,,,68,,,,,,,,,1,,,,,,,,,,,,,,5,,,,,,,,,,,,,,,,,,,,,,,,,,,,,,,,,,,,,,,,,,,,,,,,,,,,,,,,,,,,,,,,,,,,,,,,,,1,,,1,0,,,,,,,,252,7,,0,168073,,30378,,32651457,,,,,,,,,,,,,,,,,,,,,,,,,,,,,,,,,,,,,,,,,
48163836,f1d23d52-670e-400c-b2fd-1a115985c2fb,1658216839,120,1658214102,,0,0,13.55,4283,4391,292,262,323,298,0,3.2,0.61,0.94,1.03,410,907,148,170,,,,51.79,38.51,53.31,1,58.55,1467,134,,3.5,0,100,99,,,,16,4,124,79,12.05,11.87,12.17,-7.9,-2.6,284,284,,1,290,290,,,,,,,,,"18,15,12,13,18,21,3,0,0","0,20,73,6,0","0,3,62,35,0",,,,,120,,,,,,,,,,,,,,,,,,,,,,,,,,,,,,,,,,,,52.9,23,6,152,47,,1020,1,316,0,2,3,Balve,1,0,U1.000|5:29-U1.000|5:06-U1.000|6:28-U1.000|6:20-U1.000|6:17-U1.000|6:32-U1.000|4:55-U1.000|4:29-U1.000|4:23-U1.000|4:18-U1.000|4:08-U1.000|5:09-U1.000|5:14-U0.549|2:35,,"Balve Running",,,3113,,250,3,9231583676,0,168070,250480,30378,,32659508,,,,,,,,,,,,,,,,,,,,,,,,,,,,,,,,,,,,,,,,4,
48221272,e1d356f0-a7c0-41c8-b04d-e9f26ac91b24,1658321225,120,1658318742,,0,0,13.9,4505,4602,319,308,356,339,0,3.5,0.68,0.97,0.98,438,951,149,173,,,,49.75,37.48,51.21,1,58.52,1599,152,,3.6,0.5,101,99,,,,15,1,135,79,11.8,11.94,12.24,1.9,-1.4,282,276,,1,294,292,,,,,,,,,"21,13,13,11,15,21,6,0,0","0,15,72,12,0","4,5,55,36,1",,,,,117,,,,,,,,,,,,,,,,,,,,,,,,,,,,,,,,,,,,65.7,31,12,345,33,,1017,7,317,0,2,3,Balve,1,0,U1.000|5:09-U1.000|5:01-U1.000|6:47-U1.000|6:09-U1.000|6:04-U1.000|6:35-U1.000|4:58-U1.000|4:20-U1.000|4:18-U1.000|4:16-U1.000|4:11-U1.000|4:41-U1.000|5:18-U0.904|7:18,,"Balve Running",,,3113,,250,3,9239454170,0,168070,250480,30378,,32713008,,,,,,,,,,,,,,,,,,,,,,,,,,,,,,,,,,,,,,,,"4,5",
48241491,b6424062-55e9-4016-82ff-b66bb93e646c,1630009147,120,1658348222,,0,0,20.86,3545,3545,,,,,0,,,,,,276,85,101,,,,,,,1,,,,,,,,,,,,,,15,78,,21.27,,-2.6,1.4,78,77,,0,79,78,,,,,,,,,"1,9,90,0,0,0,0","100,0,0,0,0","96,4,0,0,0",,,,,,,,,,,,,,,,,,,,,,,,,,,,,,,,,,,,,,,,,1.9,,,,,,,,,,1,,,1,0,,,,,,,,252,7,,0,168072,,30378,,32731600,,,,,,,,,,,,,,,,,,,,,,,,,,,,,,,,,,,,,,,,,
48241513,a786d42f-e5e6-4068-b641-b4420e321498,1630007843,120,1658348279,,0,0,5.39,738,738,,,,,0,,,,,,106,101,122,,,,,,,1,,,,,,,,,,,,,,6,78,,26.88,,0.1,-21.9,143,143,,0,151,150,,,,,,,,,"3,5,17,50,25,0,0","54,46,0,0,0","4,91,4,0,0",,,,,,,,,,,,,,,,,,,,,,,,,,,,,,,,,,,,,,,,,4.8,,,,,,,,,,1,,,1,0,U2.589|6:22-U2.801|5:56,,,,,,,252,7,,0,168072,,30378,,32731622,,,,,,,,,,,,,,,,,,,,,,,,,,,,,,,,,,,,,,,,,
48244556,ecb696c5-595c-407a-9378-74a668152e56,1629275693,120,1658360639,,0,0,,881,881,,,,,0,,,,,,68,,,,,,,,,1,,,,,,,,,,,,,,4,,,,,,,,,,,,,,,,,,,,,,,,,,,,,,,,,,,,,,,,,,,,,,,,,,,,,,,,,,,,,,,,,,,,,,,,,,1,,,1,0,,,,,,,,252,7,,0,168073,,30378,,32734411,,,,,,,,,,,,,,,,,,,,,,,,,,,,,,,,,,,,,,,,,
48247894,3830d67d-49c0-403b-8bac-a0872f0804e4,1628089628,120,1658377573,,0,0,,418,418,,,,,0,,,,,,32,,,,,,,,,1,,,,,,,,,,,,,,2,,,,,,,,,,,,,,,,,,,,,,,,,,,,,,,,,,,,,,,,,,,,,,,,,,,,,,,,,,,,,,,,,,,,,,,,,,1,,,1,0,,,,,,,,252,7,,0,168073,,30378,,32737531,,,,,,,,,,,,,,,,,,,,,,,,,,,,,,,,,,,,,,,,,
48269991,1028d6ee-a9d3-4512-8278-d5225cd54acb,1658422063,120,1658418816,,0,0,9.72,3104,3287,279,268,287,279,0,3.5,0.81,0.98,1.09,492,629,136,160,,,,57.17,37.11,59.29,1,58.51,1230,97,,3.1,0,101,100,,,,13,2,66,79,12.22,11.71,12.36,-8.3,5.3,284,284,,1,295,295,,,,,,,,,"17,14,16,17,14,20,2,0,0","0,52,47,0,0","0,6,52,42,0",,,,,119,,,,,,,,,,,,,,,,,,,,,,,,,,,,,,,,,,,,31,19,14,248,86,,1019,2,320,0,6,3,Balve,1,0,U1.000|5:45-U1.000|6:13-U1.000|5:36-U1.000|6:22-U1.000|6:03-U1.000|4:34-U1.000|4:19-U1.000|4:37-U1.000|4:44-U0.721|3:31,,"Balve Running",,,3113,,250,3,9246968109,0,168070,250480,30378,,32757114,,,,,,,,,,,,,,,,,,,,,,,,,,,,,,,,,,,,,,,,4,
48295153,1a2b6d6d-3c23-462f-aab1-10ffdefe3947,1625593680,120,1658472291,,0,0,5.08,1027,1027,,,,,0,,,,,,62,161,192,,,,,,,1,,,,,,,,,,,,,,38,75,,18.24,,8.1,-1,56,54,,0,59,57,,,,,,,,,"10,70,20,0,0,0,0","0,13,24,50,13","93,7,0,0,0",,,,,,,,,,,,,,,,,,,,,,,,,,,,,,,,,,,,,,,,,76.6,,,,,,,,,,1,,,1,0,U2.525|8:42-U0.850|3:01-U0.167|0:30-U0.469|1:30-U0.362|1:00-U0.439|1:31-U0.273|0:54,,,,,,,252,7,,0,168072,,30378,,32780851,,,,,,,,,,,,,,,,,,,,,,,,,,,,,,,,,,,,,,,,,
48300276,94bc0cb6-e49c-420b-ac5a-69522d9de829,1625426082,120,1658479495,,0,0,2.61,559,559,,,,,0,,,,,,43,161,189,,,,,,,1,,,,,,,,,,,,,,19,75,,17.56,,-4.1,-21.8,52,46,,0,56,53,,,,,,,,,"15,68,17,0,0,0,0","0,9,33,49,10","95,5,0,0,0",,,,,,,,,,,,,,,,,,,,,,,,,,,,,,,,,,,,,,,,,46,,,,,,,,,,1,,,1,0,U2.532|8:59-U0.079|0:20,,,,,,,252,7,,0,168072,,30378,,32785475,,,,,,,,,,,,,,,,,,,,,,,,,,,,,,,,,,,,,,,,,
48300289,9eb402ba-3892-4b0b-9c4a-b18132be5036,1625423415,120,1658479513,,0,0,0.14,33,33,,,,,0,,,,,,3,150,157,,,,,,,1,,,,,,,,,,,,,,1,41,,15.61,,8.2,-17,37,27,,0,37,40,,,,,,,,,"44,56,0,0,0,0,0","0,0,100,0,0","100,0,0,0,0",,,,,,,,,,,,,,,,,,,,,,,,,,,,,,,,,,,,,,,,,1.9,,,,,,,,,,1,,,1,0,,,,,,,,252,7,,0,168072,,30378,,32785487,,,,,,,,,,,,,,,,,,,,,,,,,,,,,,,,,,,,,,,,,
48301015,9924cebf-1606-4887-9577-d705fd8f0077,1625394736,120,1658480102,,0,0,38.29,4688,4688,,,,,0,,,,,,768,141,165,,,,,,,1,,,,,,,,,,,,,,88,92,,29.77,,7.4,-5.8,164,164,,0,176,176,,,,,,,,,"0,0,14,28,54,3,0","1,39,57,3,0","25,52,21,3,0",,,,,,,,,,,,,,,,,,,,,,,,,,,,,,,,,,,,,,,,,28.8,,,,,,,,,,1,,,1,0,U2.598|6:22-U3.292|6:29-U0.622|1:26-U5.193|10:01-U0.866|2:02-U1.104|1:59-U0.866|2:01-U4.131|7:57-U0.854|2:01-U2.182|4:00-U0.866|2:01-U3.100|6:01-U1.633|3:55-U0.362|0:41-U0.164|0:20-U0.350|0:39-U0.179|0:22-U0.351|0:39-U0.156|0:19-U0.391|0:43-U0.174|0:21-U0.359|0:40-U0.167|0:20-U0.429|0:47-U0.888|2:04-U0.268|0:29-U0.257|0:32-U0.286|0:31-U0.240|0:30-U0.302|0:33-U0.244|0:30-U0.282|0:31-U0.239|0:29-U0.292|0:32-U0.246|0:30-U0.323|0:35-U0.855|1:59-U0.219|0:23-U0.318|0:40-U0.197|0:21-U0.324|0:40-U0.198|0:21-U0.316|0:40-U0.204|0:22-U0.348|0:43-U0.184|0:20-U0.319|0:41-U0.186|0:20-U0.361|0:47,,,,,,,252,7,,0,168072,,30378,,32786026,,,,,,,,,,,,,,,,,,,,,,,,,,,,,,,,,,,,,,,,,
48309824,5085a256-d88f-4392-bac2-1a30fd18a14e,1658494801,120,1658491611,,0,0,13.01,3643,3847,143,129,161,147,0,1.1,0.44,1.01,0.97,,827,142,163,,,,63.6,44.21,64.55,1,58.59,2448,201,,4.1,0,104,103,,,,13,4,89,80,13.06,13.09,13.3,-4.3,-9.4,320,320,,1,331,331,,,,,,,,,"2,4,6,13,35,31,9,0,0","0,41,58,0,0","0,0,34,56,10",,,,,134,,,,,,,,,,,,,,,,,,,,,,,,,,,,,,,,,,,,37.4,21,5,350,73,,1020,5,316,0,3,3,Balve,1,0,U1.000|5:33-U1.000|4:33-U1.000|4:59-U1.000|4:52-U1.000|4:55-U1.000|4:42-U1.000|4:27-U1.000|4:21-U1.000|4:11-U1.000|3:56-U1.000|4:02-U1.000|5:06-U1.000|5:05-U0.006|0:01,,"Balve Running",,,3113,,250,3,9251820933,0,168070,250480,30378,,32791381,,,,,,,,,,,,,,,,,,,,,,,,,,,,,,,,,,,,,,,,,
48310810,9ceb89f8-06af-4361-903a-8f7c251accf4,1624696999,120,1658492493,,0,0,3.11,573,573,,,,,0,,,,,,75,,,,,,,,,1,,,,,,,,,,,,,,5,85,,20.74,,,,133,132,,0,143,143,,,,,,,,,"13,33,40,14,0,0,0",,"34,56,11,0,0",,,,,,,,,,,,,,,,,,,,,,,,,,,,,,,,,,,,,,,,,,,,,,,,,,,1,,,1,0,,,,,,,,252,7,,0,168072,,30378,,32791782,,,,,,,,,,,,,,,,,,,,,,,,,,,,,,,,,,,,,,,,,
48312567,7fd3f5bf-5d96-439e-bb6f-9ee1bc9cc6be,1624701283,120,1658495514,,0,0,,279,279,,,,,0,,,,,,21,,,,,,,,,1,,,,,,,,,,,,,,1,,,,,,,,,,,,,,,,,,,,,,,,,,,,,,,,,,,,,,,,,,,,,,,,,,,,,,,,,,,,,,,,,,,,,,,,,,1,,,1,0,,,,,,,,252,7,,0,168073,,30378,,32793221,,,,,,,,,,,,,,,,,,,,,,,,,,,,,,,,,,,,,,,,,
48312571,1b04ebf0-7109-4371-862a-5d2e466a40ea,1624700627,120,1658495526,,0,0,1.22,173,173,,,,,0,,,,,,22,117,133,,,,,,,1,,,,,,,,,,,,,,1,85,,25.39,,-9.8,-19.3,127,127,,0,130,130,,,,,,,,,"6,7,15,69,3,0,0","12,88,0,0,0","25,75,0,0,0",,,,,,,,,,,,,,,,,,,,,,,,,,,,,,,,,,,,,,,,,1.6,,,,,,,,,,1,,,1,0,U0.207|0:41-U1.013|2:12,,,,,,,252,7,,0,168072,,30378,,32793225,,,,,,,,,,,,,,,,,,,,,,,,,,,,,,,,,,,,,,,,,
48312579,93f81726-40aa-48af-a0ee-9f2f4bf17a9c,1624699169,120,1658495532,,0,0,6.53,1002,1002,,,,,0,,,,,,97,108,142,,,,,,,1,,,,,,,,,,,,,,6,82,,23.73,,-1.9,-29.9,98,97,,0,104,104,,,,,,,,,"1,1,85,11,3,0,0","12,88,1,0,0","67,29,4,0,0",,,,,,,,,,,,,,,,,,,,,,,,,,,,,,,,,,,,,,,,,3.2,,,,,,,,,,1,,,1,0,U3.342|9:00-U1.204|3:00-U0.202|0:30-U0.612|1:30-U0.456|1:00-U0.615|1:30-U0.097|0:13,,,,,,,252,7,,0,168072,,30378,,32793233,,,,,,,,,,,,,,,,,,,,,,,,,,,,,,,,,,,,,,,,,
48312584,1051d982-d30e-4c5d-b54d-d0bbf231912c,1624697692,120,1658495548,,0,0,7.29,1049,1049,,,,,0,,,,,,127,115,144,,,,,,,1,,,,,,,,,,,,,,8,86,,25.8,,5.1,-14.1,121,120,,0,136,136,,,,,,,,,"1,13,34,38,15,0,0","16,83,2,0,0","51,36,12,0,0",,,,,,,,,,,,,,,,,,,,,,,,,,,,,,,,,,,,,,,,,6,,,,,,,,,,1,,,1,0,U4.045|9:00-U1.208|3:00-U0.228|0:30-U0.599|1:30-U0.382|1:00-U0.400|1:30-U0.429|0:59,,,,,,,252,7,,0,168072,,30378,,32793238,,,,,,,,,,,,,,,,,,,,,,,,,,,,,,,,,,,,,,,,,
48312591,a7b85c00-f3a0-4139-aa2f-ee0057487392,1624655660,120,1658495573,,0,0,,183,183,,,,,0,,,,,,14,,,,,,,,,1,,,,,,,,,,,,,,1,,,,,,,,,,,,,,,,,,,,,,,,,,,,,,,,,,,,,,,,,,,,,,,,,,,,,,,,,,,,,,,,,,,,,,,,,,1,,,1,0,,,,,,,,252,7,,0,168073,,30378,,32793245,,,,,,,,,,,,,,,,,,,,,,,,,,,,,,,,,,,,,,,,,
48312946,d2c5d431-3de2-49e6-9aa0-1ff088e10c31,1624654280,120,1658496375,,0,0,1.43,263,263,,,,,0,,,,,,18,105,119,,,,,,,1,,,,,,,,,,,,,,1,79,,19.71,,-1.4,28.3,67,67,,0,73,72,,,,,,,,,"4,51,45,0,0,0,0","24,76,0,0,0","94,6,0,0,0",,,,,,,,,,,,,,,,,,,,,,,,,,,,,,,,,,,,,,,,,1,,,,,,,,,,1,,,1,0,,,,,,,,252,7,,0,168072,,30378,,32793577,,,,,,,,,,,,,,,,,,,,,,,,,,,,,,,,,,,,,,,,,
48312957,a313adc5-0525-47fe-8e38-ad3237b50ffb,1624651544,120,1658496389,,0,0,17.43,2138,2138,,,,,0,,,,,,351,134,165,,,,,,,1,,,,,,,,,,,,,,34,86,,29.86,,7.7,-0.9,164,164,,0,177,177,,,,,,,,,"0,0,17,18,63,1,0","1,61,33,4,0","18,66,15,1,0",,,,,,,,,,,,,,,,,,,,,,,,,,,,,,,,,,,,,,,,,26.6,,,,,,,,,,1,,,1,0,U1.669|4:11-U2.466|4:58-U0.435|1:00-U10.601|20:04-U2.080|5:02-U0.179|0:23,,,,,,,252,7,,0,168072,,30378,,32793588,,,,,,,,,,,,,,,,,,,,,,,,,,,,,,,,,,,,,,,,,
48314085,f9b05420-9608-4b00-99bd-3f79c421e4ed,1624565886,120,1658498639,,0,0,5.12,811,811,,,,,0,,,,,,68,106,118,,,,,,,1,,,,,,,,,,,,,,4,83,,23.01,,0.2,2.8,84,84,,0,87,87,,,,,,,,,"1,12,86,1,0,0,0","16,84,0,0,0","90,10,0,0,0",,,,,,,,,,,,,,,,,,,,,,,,,,,,,,,,,,,,,,,,,2,,,,,,,,,,1,,,1,0,,,,,,,,252,7,,0,168072,,30378,,32794641,,,,,,,,,,,,,,,,,,,,,,,,,,,,,,,,,,,,,,,,,
48314094,b8d538c7-4bbe-4399-ae5d-ba8a51653172,1624562504,120,1658498670,,0,0,22.79,2912,2912,,,,,0,,,,,,430,124,140,,,,,,,1,,,,,,,,,,,,,,30,87,,28.53,,2.6,2.7,148,147,,0,156,156,,,,,,,,,"0,1,16,41,42,0,0","1,99,0,0,0","19,80,1,0,0",,,,,,,,,,,,,,,,,,,,,,,,,,,,,,,,,,,,,,,,,9.3,,,,,,,,,,1,,,1,0,U5.298|12:14-U11.738|23:10-U3.115|7:30-U2.639|5:37,,,,,,,252,7,,0,168072,,30378,,32794649,,,,,,,,,,,,,,,,,,,,,,,,,,,,,,,,,,,,,,,,,
48314357,c9f2fe7c-610b-4da7-b588-d95030f46607,1624540095,120,1658499299,,0,0,25.88,3330,3330,,,,,0,,,,,,492,134,165,,,,,,,1,,,,,,,,,,,,,,52,91,,28.55,,8,1.1,148,148,,0,172,172,,,,,,,,,"0,0,39,26,28,6,0","0,70,27,3,0","47,22,30,0,0",,,,,,,,,,,,,,,,,,,,,,,,,,,,,,,,,,,,,,,,,23.7,,,,,,,,,,1,,,1,0,U4.203|9:00-U1.226|3:00-U0.257|0:30-U0.634|1:30-U0.548|1:00-U0.637|1:30-U0.837|1:30-U0.637|1:30-U1.131|2:00-U0.642|1:30-U0.837|1:30-U0.638|1:30-U0.548|1:00-U0.638|1:30-U0.257|0:30-U2.494|6:00-U0.260|0:30-U0.636|1:30-U0.547|1:00-U0.634|1:30-U0.837|1:30-U0.638|1:30-U1.129|2:00-U0.639|1:30-U0.839|1:30-U0.639|1:30-U0.546|1:00-U0.638|1:30-U0.259|0:30-U1.472|3:30,,,,,,,252,7,,0,168072,,30378,,32794899,,,,,,,,,,,,,,,,,,,,,,,,,,,,,,,,,,,,,,,,,
48316807,099fa43a-a3b8-4385-9ee0-45cd1674052d,1624386823,120,1658502904,,0,0,55.19,7211,7211,,,,,0,,,,,,1046,125,150,,,,,,,1,,,,,,,,,,,,,,84,88,,28.44,,4.5,-0.5,145,145,,0,163,163,,,,,,,,,"0,6,25,15,52,0,0","7,80,13,0,0","29,63,8,0,0",,,,,,,,,,,,,,,,,,,,,,,,,,,,,,,,,,,,,,,,,15.8,,,,,,,,,,1,,,1,0,U3.351|8:08-U0.981|1:59-U0.295|0:39-U0.873|1:44-U0.360|0:48-U0.952|1:51-U0.263|0:34-U0.989|1:55-U1.212|3:00-U7.496|14:56-U1.117|3:04-U10.359|19:59-U1.888|5:01-U10.151|19:59-U0.504|1:09-U0.599|1:17-U0.196|0:25-U1.510|3:04-U0.449|1:06-U4.164|7:58-U0.903|2:18-U0.410|0:57-U0.146|0:23-U0.360|1:00-U0.532|1:33-U5.131|15:24,,,,,,,252,7,,0,168072,,30378,,32797242,,,,,,,,,,,,,,,,,,,,,,,,,,,,,,,,,,,,,,,,,
48325226,eaf235c2-e461-41ab-9ca7-d3b27b679d05,1623920950,120,1658513111,,0,0,11.39,1694,1694,,,,,0,,,,,,176,106,154,,,,,,,1,,,,,,,,,,,,,,9,83,,24.32,,4.8,-54.9,104,103,,0,120,120,,,,,,,,,"1,1,84,11,3,2,0","9,88,3,0,0","66,32,1,1,0",,,,,,,,,,,,,,,,,,,,,,,,,,,,,,,,,,,,,,,,,3.9,,,,,,,,,,1,,,1,0,,,,,,,,252,7,,0,168072,,30378,,32805160,,,,,,,,,,,,,,,,,,,,,,,,,,,,,,,,,,,,,,,,,
48325862,51cfc633-dd58-4c3a-9939-979cfd8371c2,1623876632,120,1658514239,,0,0,24.96,3261,3261,,,,,0,,,,,,487,135,170,,,,,,,1,,,,,,,,,,,,,,53,88,,28.35,,4.2,15.9,149,145,,0,165,163,,,,,,,,,"2,1,25,34,36,2,0","1,52,44,3,0","22,67,11,0,0",,,,,,,,,,,,,,,,,,,,,,,,,,,,,,,,,,,,,,,,,27.7,,,,,,,,,,1,,,1,0,U3.960|9:00-U0.852|2:00-U0.793|2:00-U0.438|1:00-U0.466|1:00-U0.485|1:00-U0.502|1:00-U0.519|1:00-U0.533|1:00-U0.550|1:00-U0.563|1:00-U0.576|1:00-U0.588|1:00-U0.347|1:00-U0.036|0:22-U1.910|4:59-U0.746|2:00-U9.843|20:00-U1.257|3:00,,,,,,,252,7,,0,168072,,30378,,32805746,,,,,,,,,,,,,,,,,,,,,,,,,,,,,,,,,,,,,,,,,
48326653,f9f184af-3771-4da6-9c0f-316c14b64415,1623788851,120,1658515241,,0,0,21.88,3014,3014,,,,,0,,,,,,367,116,136,,,,,,,1,,,,,,,,,,,,,,31,85,,26.4,,-0.7,-6.8,122,121,,0,126,126,,,,,,,,,"1,1,18,80,0,0,0","8,92,0,0,0","17,83,0,0,0",,,,,,,,,,,,,,,,,,,,,,,,,,,,,,,,,,,,,,,,,8.7,,,,,,,,,,1,,,1,0,,,,,,,,252,7,,0,168072,,30378,,32806503,,,,,,,,,,,,,,,,,,,,,,,,,,,,,,,,,,,,,,,,,
48328821,fc6fb085-5fe2-42bc-a10b-64c8648304fb,1623703564,120,1658518969,,0,0,16.52,2088,2088,,,,,0,,,,,,339,127,157,,,,,,,1,,,,,,,,,,,,,,32,88,,29.35,,7.3,-11.1,162,160,,0,185,184,,,,,,,,,"1,2,19,40,36,1,0","3,71,27,0,0","19,46,34,1,0",,,,,,,,,,,,,,,,,,,,,,,,,,,,,,,,,,,,,,,,,20.6,,,,,,,,,,1,,,1,0,U6.093|13:32-U0.449|1:01-U2.238|4:01-U1.268|3:01-U2.210|3:58-U1.304|3:02-U2.238|4:03-U0.721|2:09,,,,,,,252,7,,0,168072,,30378,,32808434,,,,,,,,,,,,,,,,,,,,,,,,,,,,,,,,,,,,,,,,,
48337669,8b5ab42c-b49a-4cf1-b603-d702f4c520d7,1622397500,120,1658549644,,0,0,,750,750,,,,,0,,,,,,58,,,,,,,,,1,,,,,,,,,,,,,,5,,,,,,,,,,,,,,,,,,,,,,,,,,,,,,,,,,,,,,,,,,,,,,,,,,,,,,,,,,,,,,,,,,,,,,,,,,1,,,1,0,,,,,,,,252,7,,0,168073,,30378,,32816304,,,,,,,,,,,,,,,,,,,,,,,,,,,,,,,,,,,,,,,,,
48337732,e533d824-99a6-4e3a-89d2-857fad203acb,1622372700,120,1658550094,,0,0,,889,889,,,,,0,,,,,,69,,,,,,,,,1,,,,,,,,,,,,,,6,,,,,,,,,,,,,,,,,,,,,,,,,,,,,,,,,,,,,,,,,,,,,,,,,,,,,,,,,,,,,,,,,,,,,,,,,,1,,,1,0,,,,,,,,252,7,,0,168073,,30378,,32816366,,,,,,,,,,,,,,,,,,,,,,,,,,,,,,,,,,,,,,,,,
48363076,814185e2-789c-47b0-b5aa-20c11ecad8b7,1621198185,120,1658585896,,0,0,6.75,895,895,,,,,0,,,,,,124,,,,,,,,,1,,,,,,,,,,,,,,10,92,,28.12,,,,144,138,,0,157,155,,,,,,,,,"4,2,18,31,44,0,0",,"28,58,13,0,0",,,,,,,,,,,,,,,,,,,,,,,,,,,,,,,,,,,,,,,,,,,,,,,,,,,1,,,1,0,U1.708|4:49-U3.144|6:12-U0.871|2:02-U1.023|1:52,,,,,,,252,7,,0,168072,,30378,,32838714,,,,,,,,,,,,,,,,,,,,,,,,,,,,,,,,,,,,,,,,,
48373486,57f5ff72-278a-4d71-be80-546022b7fb04,1658604550,120,1658600879,,0,0,12.48,3311,3426,166,160,194,191,0,1.4,0.45,1.03,1.01,298,769,152,170,,,,61.93,46.93,62.99,1,58.64,2016,179,,3.7,0.7,103,102,,,,13,4,102,80,13.86,13.82,14.01,1.1,0.9,342,342,,1,348,348,,,,,,,,,"2,3,5,7,26,33,22,2,0","1,10,67,22,0","0,0,16,77,7",,,,,141,,,,,,,,,,,,,,,,,,,,,,,,,,,,,,,,,,,,53.9,22,9,348,63,,1020,0,327,0,3,3,Balve,1,0,U1.000|4:48-U1.000|4:34-U1.000|4:45-U1.000|4:50-U1.000|5:15-U1.000|4:08-U1.000|3:57-U1.000|4:20-U1.000|4:13-U1.000|4:02-U1.000|4:21-U1.000|3:54-U0.475|2:06,,"Balve Running",,,3113,,250,3,9260365708,0,168070,250480,30378,,32848355,,,,,,,,,,,,,,,,,,,,,,,,,,,,,,,,,,,,,,,,"4,5",
48373863,f1570eac-7142-4b3a-bb41-2d5e5e215f50,1620673331,120,1658601818,,0,0,,1210,1210,,,,,0,,,,,,151,,,,,,,,,1,,,,,,,,,,,,,,12,,,,,,,,,,,,,,,,,,,,,,,,,,,,,,,,,,,,,,,,,,,,,,,,,,,,,,,,,,,,,,,,,,,,,,,,,,1,,,1,0,,,,,,,,252,7,,0,168074,,30378,,32848704,,,,,,,,,,,,,,,,,,,,,,,,,,,,,,,,,,,,,,,,,
48373938,c9bcac69-80e8-4106-8418-50198fac31e7,1620673020,120,1658601988,,0,0,,209,209,,,,,0,,,,,,16,,,,,,,,,1,,,,,,,,,,,,,,2,,,,,,,,,,,,,,,,,,,,,,,,,,,,,,,,,,,,,,,,,,,,,,,,,,,,,,,,,,,,,,,,,,,,,,,,,,1,,,1,0,,,,,,,,252,7,,0,168073,,30378,,32848773,,,,,,,,,,,,,,,,,,,,,,,,,,,,,,,,,,,,,,,,,
48377775,8697261f-aba1-487f-9757-8f43151076dd,1620505153,120,1658605962,,0,0,,409,409,,,,,0,,,,,,31,,,,,,,,,1,,,,,,,,,,,,,,2,,,,,,,,,,,,,,,,,,,,,,,,,,,,,,,,,,,,,,,,,,,,,,,,,,,,,,,,,,,,,,,,,,,,,,,,,,1,,,1,0,,,,,,,,252,7,,0,168073,,30378,,32851486,,,,,,,,,,,,,,,,,,,,,,,,,,,,,,,,,,,,,,,,,
48377785,4ee24988-3979-4f5e-b6e4-9efa51d31c1a,1620504129,120,1658605989,,0,0,,860,860,,,,,0,,,,,,66,,,,,,,,,1,,,,,,,,,,,,,,5,,,,,,,,,,,,,,,,,,,,,,,,,,,,,,,,,,,,,,,,,,,,,,,,,,,,,,,,,,,,,,,,,,,,,,,,,,1,,,1,0,,,,,,,,252,7,,0,168073,,30378,,32851496,,,,,,,,,,,,,,,,,,,,,,,,,,,,,,,,,,,,,,,,,
48381348,da58abca-441e-4991-81ff-a9c8ec1e0bce,1620251587,120,1658613189,,0,0,,728,728,,,,,0,,,,,,91,,,,,,,,,1,,,,,,,,,,,,,,6,,,,,,,,,,,,,,,,,,,,,,,,,,,,,,,,,,,,,,,,,,,,,,,,,,,,,,,,,,,,,,,,,,,,,,,,,,1,,,1,0,,,,,,,,252,7,,0,168074,,30378,,32854930,,,,,,,,,,,,,,,,,,,,,,,,,,,,,,,,,,,,,,,,,
48382623,84e8d302-cf9a-4d95-bc28-f5bb5fa42d0b,1620074284,120,1658620001,,0,0,,919,919,,,,,0,,,,,,71,,,,,,,,,1,,,,,,,,,,,,,,3,,,,,,,,,,,,,,,,,,,,,,,,,,,,,,,,,,,,,,,,,,,,,,,,,,,,,,,,,,,,,,,,,,,,,,,,,,1,,,1,0,,,,,,,,252,7,,0,168073,,30378,,32856028,,,,,,,,,,,,,,,,,,,,,,,,,,,,,,,,,,,,,,,,,
48382862,eddfc516-c3fe-4b8b-a686-fd193dead96b,1620040220,120,1658621042,,0,0,,738,738,,,,,0,,,,,,92,,,,,,,,,1,,,,,,,,,,,,,,4,,,,,,,,,,,,,,,,,,,,,,,,,,,,,,,,,,,,,,,,,,,,,,,,,,,,,,,,,,,,,,,,,,,,,,,,,,1,,,1,0,,,,,,,,252,7,,0,168074,,30378,,32856255,,,,,,,,,,,,,,,,,,,,,,,,,,,,,,,,,,,,,,,,,
48395283,cd0acd31-6639-4fa9-97b5-c2950b9242c7,1658656892,120,1658655360,,0,0,14.52,4878,5106,459,389,472,408,0,5,0.85,0.97,1.09,596,1007,149,172,109,,,47.59,36.06,49.74,1,58.6,2185,151,,3.6,0,97,98,,,,15,3,139,77,11.85,11.52,12.25,3,3.7,274,274,,1,291,291,,,,,,,,,"26,11,12,13,20,13,3,1,0","0,20,68,12,0","1,12,54,31,3",,,,,116,,,,,,,,,,,,,,,,,,,,,,,,,,,,,,,,,,,,48.7,24,10,219,56,,1020,4,314,0,2,3,Balve,1,0,U1.000|5:49-U1.000|6:11-U1.000|5:48-U1.000|6:29-U1.000|4:46-U1.000|4:31-U1.000|4:25-U1.000|6:04-U1.000|9:13-U1.000|6:25-U1.000|4:46-U1.000|4:50-U1.000|4:44-U1.000|4:31-U0.520|2:46,,"Balve Running",,,3113,,250,3,9263448636,0,168070,250480,30378,,32867600,,,,,,,,,,,,,,,,,,,,,,,,,,,,,,,,,,,,,,,,"3,4",
48427102,1c47e727-d5f1-4baf-83a6-435f9397f746,1658691124,120,1658684882,,0,0,,912,912,,,,,0,,,,,,70,,,,,,,,,1,,,,,,,,,,,,,,8,,,,,,,,,,,,,,,,,,,,,,,,,,,,,,,,,,,,,,,,,,,,,,,,,,,,,,,,,,,,,,,,,,,,,,,,,,1,,,1,0,,,,,,,,252,7,,0,168073,,30378,,32894986,,,,,,,,,,,,,,,,,,,,,,,,,,,,,,,,,,,,,,,,,
48434524,fbe0347b-2e9d-40b8-92bf-833af38202e7,1617912479,120,1658697832,,0,0,4.8,656,656,,,,,0,,,,,,89,111,142,,,,,,,1,,,,,,,,,,,,,,6,86,,26.64,,-0.5,-62.3,135,132,,0,146,149,,,,,,,,,"2,2,29,51,13,3,0","13,86,0,0,0","39,50,6,4,0",,,,,,,,,,,,,,,,,,,,,,,,,,,,,,,,,,,,,,,,,4.7,,,,,,,,,,1,,,1,0,U3.786|8:45-U0.643|1:30-U0.373|0:41,,,,,,,252,7,,0,168072,,30378,,32901725,,,,,,,,,,,,,,,,,,,,,,,,,,,,,,,,,,,,,,,,,
48434532,9256553f-8e70-47eb-aebd-8e82007b0bb7,1617912297,120,1658697881,,0,0,0.68,125,125,,,,,0,,,,,,10,94,102,,,,,,,1,,,,,,,,,,,,,,1,65,,19.61,,-18.9,-0.5,78,77,,0,77,77,,,,,,,,,"13,14,73,0,0,0,0","89,11,0,0,0","96,4,0,0,0",,,,,,,,,,,,,,,,,,,,,,,,,,,,,,,,,,,,,,,,,0.6,,,,,,,,,,1,,,1,0,,,,,,,,252,7,,0,168072,,30378,,32901733,,,,,,,,,,,,,,,,,,,,,,,,,,,,,,,,,,,,,,,,,
48436274,b202b442-a7d0-4d20-bc1d-b66c94fc063a,1617736279,120,1658705018,,0,0,5.96,817,817,,,,,0,,,,,,115,129,149,,,,,,,1,,,,,,,,,,,,,,11,92,,26.64,,-0.4,-18.9,141,140,,0,151,151,,,,,,,,,"1,0,41,46,12,0,0","0,84,16,0,0","34,52,14,0,0",,,,,,,,,,,,,,,,,,,,,,,,,,,,,,,,,,,,,,,,,11.2,,,,,,,,,,1,,,1,0,U4.883|11:04-U0.821|2:02-U0.253|0:31,,,,,,,252,7,,0,168072,,30378,,32903380,,,,,,,,,,,,,,,,,,,,,,,,,,,,,,,,,,,,,,,,,
48436314,336ccb51-04bd-4b5d-8ca9-a1db69882437,1617736164,120,1658705072,,0,0,0.51,101,101,,,,,0,,,,,,7,106,114,,,,,,,1,,,,,,,,,,,,,,1,86,,18.02,,-14.7,-19.4,74,70,,0,72,71,,,,,,,,,"15,34,51,0,0,0,0","30,70,0,0,0","100,0,0,0,0",,,,,,,,,,,,,,,,,,,,,,,,,,,,,,,,,,,,,,,,,0.5,,,,,,,,,,1,,,1,0,,,,,,,,252,7,,0,168072,,30378,,32903419,,,,,,,,,,,,,,,,,,,,,,,,,,,,,,,,,,,,,,,,,
48436507,86a0d827-48d2-46fe-9396-971b9fae95e9,1617735700,120,1658705117,,0,0,1.43,246,246,,,,,0,,,,,,23,111,123,,,,,,,1,,,,,,,,,,,,,,2,85,,21.84,,-19.3,-7.4,101,93,,0,103,99,,,,,,,,,"9,6,85,0,0,0,0","17,83,0,0,0","31,69,0,0,0",,,,,,,,,,,,,,,,,,,,,,,,,,,,,,,,,,,,,,,,,1.7,,,,,,,,,,1,,,1,0,,,,,,,,252,7,,0,168072,,30378,,32903611,,,,,,,,,,,,,,,,,,,,,,,,,,,,,,,,,,,,,,,,,
48467050,5d9c4d83-6bbd-4ad5-bfa5-bc04c47668d3,1658772222,120,1658769266,,0,0,5.16,3157,3157,156,154,170,167,0,3.6,0.66,,,461,424,122,161,100,,,,,,1,58.65,2304,39,,2.1,0.1,,100,,,,,,44,65,,6.37,,-34.3,,,,,,,,,,,,,,,,"22,77,0,0,0,1","1,90,9,0,0",,,,,,,,,,,,,,,,,,,,,,,,,,,,,,,,,,,,,,,,,,19.4,25,17,263,55,,1009,1,318,0,3,3,Balve,1,0,,,"Balve Hiking",,,3113,,250,3,9272375294,0,168075,,30378,,32930903,,,,,,,,,,,,,,,,,,,,,,,,,,,,,,,,,,,,,,,,3,
48467051,62b7f9ae-4c88-4118-90ed-5540d8215319,1658768589,120,1658769266,,0,0,12.41,3512,3570,144,137,178,171,0,1.7,0.49,0.96,1.01,253,800,152,165,,,,57.19,43.52,58.05,1,58.6,1873,165,,3.7,0.2,103,100,,,,13,4,105,80,13,12.96,13.08,1.5,3.6,316,316,,1,320,320,,,,,,,,,"5,4,7,16,30,28,11,0,0","1,5,84,11,0","0,0,30,69,0",,,,,133,,,,,,,,,,,,,,,,,,,,,,,,,,,,,,,,,,,,44.4,25,14,216,59,,1009,2,316,0,3,3,Balve,1,0,U1.000|4:56-U1.000|4:35-U1.000|4:57-U1.000|5:18-U1.000|5:36-U1.000|4:15-U1.000|4:09-U1.000|5:00-U1.000|4:37-U1.000|4:32-U1.000|4:41-U1.000|4:15-U0.406|1:43,,"Balve Running",,,3113,,250,3,9272375180,0,168070,250480,30378,,32930904,,,,,,,,,,,,,,,,,,,,,,,,,,,,,,,,,,,,,,,,4,
48527491,ead779e9-1aff-4478-af25-dba2977911ff,1658860349,120,1658858716,,0,0,5.46,1560,1896,29,24,31,27,0,0,0.04,1.03,,,342,139,157,,,,63.79,40.79,64.28,1,58.67,1222,76,,2.8,0,104,101,,,,9,3,37,79,12.7,12.79,12.93,9.4,0.5,312,312,,1,321,321,,,,,,,,,"10,3,9,8,29,33,4,4,1","2,34,65,0,0","0,6,24,64,5",,,,,133,,,,,,,,,,,,,,,,,,,,,,,,,,,,,,,,,,,,30.7,18,11,332,71,,1016,1,328,0,4,3,"Menden (Sauerland)",1,0,U1.000|4:47-U1.000|4:34-U1.000|4:31-U1.000|4:23-U0.202|0:52-U1.000|5:42-U0.256|1:11,,"Menden (Sauerland) Running",,,3113,,250,3,9279266743,0,168070,250480,30378,,32985294,,,,,,,,,,,,,,,,,,,,,,,,,,,,,,,,,,,,,,,,,
48527526,74ad7dde-152a-47a3-bb87-d9f94d16e210,1658862382,120,1658858751,,0,0,9.3,2665,2665,0,0,0,0,0,0,0,,,,628,149,184,,,,57.91,42.01,57.91,1,58.69,3456,202,,3.9,1.2,105,102,,,,19,3,82,79,12.56,14.69,14.69,6.8,8.5,318,318,,1,382,382,,,,,,,,,"30,1,1,2,3,8,30,21,3","0,30,49,19,2","22,7,7,15,49",,,,,133,,,,,,,,,,,,,,,,,,,,,,,,,,,,,,,,,,,,83,18,11,332,71,,1016,1,328,0,4,3,"Menden (Sauerland)",1,0,U1.790|6:13-U0.260|2:31-U1.200|4:13-U0.180|3:07-U0.510|1:41-U0.260|2:43-U0.990|3:40-U0.250|2:19-U1.500|5:36-U0.300|3:11-U0.390|1:32-U0.400|1:30-U0.400|1:30-U0.400|1:29-U0.400|1:19-U0.070|1:50,,"Menden (Sauerland) Track Running",,,3113,,250,3,9279271499,0,168070,250480,30378,,32985327,,,,,,,,,,,,,,,,,,,,,,,,,,,,,,,,,,,,,,,,,
48527528,8c3a917d-8cfe-4203-aeee-56350f3ef752,1658865087,120,1658858754,,0,0,1.25,423,423,0,0,9,9,0,0,0.03,,,,84,135,137,,,,53.73,29.52,53.73,1,58.68,3449,16,,1.1,0,99,98,,,,13,4,9,78,10.63,10.71,10.71,3.2,4.2,250,250,,1,252,252,,,,,,,,,"3,12,54,26,5,0,0,0,0","0,100,0,0,0","0,0,100,0,0",,,,,114,,,,,,,,,,,,,,,,,,,,,,,,,,,,,,,,,,,,13.7,19,11,342,70,,1016,0,328,0,3,3,"Menden (Sauerland)",1,0,U1.000|5:36-U0.246|1:26,,"Menden (Sauerland) Running",,,3113,,250,3,9279272187,0,168070,250480,30378,,32985329,,,,,,,,,,,,,,,,,,,,,,,,,,,,,,,,,,,,,,,,,
48580884,4130d610-4507-46d9-938a-22c990c820a0,1658925867,120,1658921555,,0,0,7.23,2540,2631,128,116,141,130,0,2,0.56,1.01,1,335,483,136,155,,,,50.83,32.47,52.04,1,58.66,2401,56,,2.5,0,96,98,,,,11,1,57,77,10.62,10.37,10.78,-4.7,-7.1,246,246,,1,254,254,,,,,,,,,"21,15,28,31,5,0,0,0,0","0,64,36,0,0","0,9,82,9,0",,,,,111,,,,,,,,,,,,,,,,,,,,,,,,,,,,,,,,,,,,28.1,18,10,342,61,,1020,5,333,0,3,3,Balve,1,0,U1.000|6:22-U1.000|5:19-U1.000|5:59-U1.000|5:45-U1.000|5:39-U1.000|5:53-U1.000|6:07-U0.232|1:15,,"Balve Running",,,3113,,250,3,9283460548,0,168070,250480,30378,,33025352,,,,,,,,,,,,,,,,,,,,,,,,,,,,,,,,,,,,,,,,5,
48598969,2da2c11f-27f5-4146-8809-8d456470515e,1658949117,120,1658944649,,0,0,3.9,2655,2655,174,178,196,199,0,2.6,0.57,1.67,0.71,367,350,116,150,,,,26.91,,28.41,1,58.66,2448,45,,2.2,0.2,,100,,,,13,3,37,66,5.83,6.44,8.38,28.4,-3.2,130,129,,1,201,201,,,,,,,,,"84,3,5,5,2,1,0,0,0","14,82,4,0,0","60,19,11,5,6",,,,,67,,,,,,,,,,,,,,,,,,,,,,,,,,,,,,,,,,,,17.4,19,10,12,49,,1019,0,332,0,2,3,Balve,1,0,U0.592|6:00-U0.112|0:39-U0.140|1:23-U0.120|0:36-U0.148|1:39-U0.117|0:38-U0.149|2:11-U0.117|0:37-U0.144|1:58-U0.117|0:37-U0.146|2:43-U0.116|0:37-U0.145|1:22-U0.114|0:35-U0.152|2:02-U0.120|0:38-U0.141|2:09-U0.116|0:40-U0.145|1:34-U0.117|0:35-U0.828|15:04,,"Balve Running",,,3113,,250,3,9285936525,0,168070,250480,30378,,33042028,,,,,,,,,,,,,,,,,,,,,,,,,,,,,,,,,,,,,,,,"4,4",
48648476,6347cb45-1dab-43e8-a006-b3fe29fe38de,1659031769,120,1659028964,,0,0,11.93,3974,4233,273,224,289,248,0,3,0.68,1.03,1.07,470,767,137,154,,,,53.77,35.86,55.57,1,58.63,1413,102,,3.1,0.4,100,98,,,,13,,75,78,11.41,11.15,11.58,-2.8,2.8,268,268,,1,276,276,,,,,,,,,"22,13,20,15,22,8,0,0,0","1,57,42,0,0","0,5,74,20,1",,,,,115,,,,,,,,,,,,,,,,,,,,,,,,,,,,,,,,,,,,24.6,23,8,44,48,,1016,1,333,0,4,3,Balve,1,0,U1.000|5:53-U1.000|6:33-U1.000|5:57-U1.000|7:07-U1.000|5:31-U1.000|4:42-U1.000|4:51-U1.000|4:44-U1.000|4:35-U1.000|5:21-U1.000|5:38-U0.932|5:24,,"Balve Running",,,3113,,250,3,9292234682,0,168070,250480,30378,,33087093,,,,,,,,,,,,,,,,,,,,,,,,,,,,,,,,,,,,,,,,4,
48677590,f2f7db71-67ab-444c-86b8-dc888d94945b,1645690997,60,1659090116,,0,0,,497,497,,,,,0,,,,,,38,,,,,,,,,1,,,,,,,,,,,,,,3,,,,,,,,,,,,,,,,,,,,,,,,,,,,,,,,,,,,,,,,,,,,,,,,,,,,,,,,,,,,,,,,,,,,,,,,,,1,,,1,0,,,,,,,,252,7,,0,168073,,30378,,33114294,,,,,,,,,,,,,,,,,,,,,,,,,,,,,,,,,,,,,,,,,
48691346,1b82e75b-dd6f-45b0-931a-3a9305c404a4,1659117583,120,1659114409,,0,0,1,255,536,0,0,0,0,0,0,0,,,,61,134,155,95,,,76.97,39.64,76.97,1,58.63,410,25,,1.7,0,,100,,,,7,3,5,81,14.12,14.16,14.16,16.9,15.1,355,355,,1,356,356,,,,,,,,,"0,2,7,4,15,35,35,2,0","6,47,47,0,0","0,0,12,75,13",,,,,145,,,,,,,,,,,,,,,,,,,,,,,,,,,,,,,,,,,,11.1,20,8,157,68,,1016,1,332,0,6,3,Balve,1,0,U0.400|1:45-U0.400|1:43-U0.200|0:47,,"Balve Track Running",,,3113,,250,3,9298334139,0,168070,250480,30378,,33127088,,,,,,,,,,,,,,,,,,,,,,,,,,,,,,,,,,,,,,,,,
48691347,e3d84b05-5a43-4a5b-a28c-e1281b64f918,1659118145,120,1659114409,,0,0,7.57,2217,2431,115,71,136,94,0,1.5,0.51,1.06,1.02,457,471,144,163,,,,59.06,40.4,60.59,1,58.64,1280,90,,3,0.3,100,99,,,,11,1,56,80,12.74,12.51,13.12,-1.2,-0.9,313,313,,1,327,327,,,,,,,,,"3,5,9,24,36,17,4,2,0","1,29,68,3,0","0,0,52,41,8",,,,,128,,,,,,,,,,,,,,,,,,,,,,,,,,,,,,,,,,,,35.4,20,8,157,68,,1016,1,332,0,6,3,Balve,1,0,U1.000|4:40-U1.000|4:57-U1.000|4:34-U1.000|4:57-U1.000|5:39-U0.885|4:23-U1.000|4:18-U0.684|3:29,,"Balve Running",,,3113,,250,3,9298334269,0,168070,250480,30378,,33127089,,,,,,,,,,,,,,,,,,,,,,,,,,,,,,,,,,,,,,,,5,
48719975,932fe211-725d-4e27-9813-f774544516ee,1659175455,120,1659172910,,0,0,12.51,3490,3692,168,133,197,159,0,1.8,0.52,1.04,1.03,307,812,155,180,,,,56.6,44.27,57.74,1,58.64,2021,182,,3.8,0.2,99,100,,,,13,4,113,81,13.28,13.21,13.43,-2.4,-2.3,326,326,,1,332,332,,,,,,,,,"3,5,5,18,30,24,12,3,0","0,10,59,31,0","0,0,27,69,4",,,,,133,,,,,,,,,,,,,,,,,,,,,,,,,,,,,,,,,,,,74.3,20,8,319,70,,1019,3,331,0,3,3,Balve,1,0,U1.000|5:21-U1.000|4:51-U1.000|4:55-U1.000|5:12-U1.000|5:34-U1.000|4:29-U1.000|4:26-U1.000|4:47-U1.000|4:34-U1.000|4:00-U1.000|4:03-U1.000|3:51-U0.513|2:07,,"Balve Running",,,3113,,250,3,9301748870,0,168070,250480,30378,,33154248,,,,,,,,,,,,,,,,,,,,,,,,,,,,,,,,,,,,,,,,"5,5",
48781617,71928d59-322b-4187-b987-1f7c5ededf8d,1659261349,120,1659260513,,0,0,15.29,3892,4598,119,62,150,95,0,0,0.17,1.08,0.77,461,964,161,180,,,,59.94,50,60.8,1,58.67,3168,266,,4.5,1,104,99,,,,18,4,147,82,14.44,14.48,14.77,6.8,3.6,365,365,,1,378,378,,,,,,,,,"2,1,3,7,15,35,30,7,0","1,8,25,66,0","1,1,11,57,30",,,,,144,,,,,,,,,,,,,,,,,,,,,,,,,,,,,,,,,,,,85.2,22,9,228,59,,1018,3,316,0,4,3,Sundern,1,0,U1.000|4:35-U1.000|4:00-U1.000|3:46-U1.000|4:02-U1.000|3:59-U1.000|3:58-U1.000|3:52-U1.000|4:20-U1.000|4:24-U1.000|4:21-U1.000|4:19-U1.000|4:30-U1.000|3:35-U0.511|2:51-U1.000|3:31-U0.776|4:49,,"Sundern (Sauerland) Running",,,3113,,250,3,9308265325,0,168070,250480,30378,,33204659,,,,,,,,,,,,,,,,,,,,,,,,,,,,,,,,,,,,,,,,5,
48858737,e0ad34a4-bd01-480b-b67a-52b0057740c3,1659380645,120,1659376772,,0,0,10.91,2958,3166,154,302,160,310,0,2.4,0.65,0.98,1.03,669,662,148,174,,,,62.58,45.32,62.63,1,58.68,1872,131,,3.4,0,100,101,,,,15,4,78,80,13.37,13.76,13.58,-2.5,-3.4,315,315,,1,326,326,,,,,,,,,"4,9,9,12,9,25,31,1,0","0,23,64,13,0","0,0,41,54,5",,,,,138,,,,,,,,,,,,,,,,,,,,,,,,,,,,,,,,,,,,55.8,20,8,349,76,,1018,0,327,0,3,3,Balve,1,0,U1.000|5:48-U1.000|4:53-U1.000|4:08-U1.000|4:07-U1.000|4:56-U1.000|5:10-U1.000|4:03-U1.000|3:59-U1.000|3:53-U1.000|3:44-U0.905|4:38,,"Balve Running",,,3113,,250,3,9317709929,0,168070,250480,30378,,33274799,,,,,,,,,,,,,,,,,,,,,,,,,,,,,,,,,,,,,,,,"4,5",
48911386,05a7c657-cd4b-4efd-b88c-15edf97a7461,1659465199,120,1659463726,,0,0,5.13,1622,1792,38,28,50,40,0,0,0.09,0.96,0.59,,331,141,157,,,,55.25,36.05,55.89,1,58.76,1106,75,,2.7,0.4,105,102,,,,7,3,26,75,11.48,12.12,12.35,18.1,0.9,280,280,,1,305,305,,,,,,,,,"25,2,4,6,29,27,3,1,2","1,32,67,0,0","10,8,28,50,4",,,,,127,,,,,,,,,,,,,,,,,,,,,,,,,,,,,,,,,,,,16.7,26,6,239,56,,1016,1,302,0,4,3,"Menden (Sauerland)",1,0,U1.000|4:51-U1.000|4:36-U1.000|4:35-U1.000|4:37-U1.000|6:50-U0.125|1:33,,"Menden (Sauerland) Running",,,3113,,250,3,9324611786,0,168070,250480,30378,,33324596,,,,,,,,,,,,,,,,,,,,,,,,,,,,,,,,,,,,,,,,,
48911496,0b9ab30c-2d76-4ab3-8cae-19d96373f334,1659467049,120,1659463778,,0,0,7.8,2784,2784,0,0,0,0,0,0,0,,,,592,155,187,,,,41.76,32.03,41.76,1,58.77,2978,223,,3.5,2.8,101,102,,,,19,4,78,74,10.08,12.5,12.5,25,3.8,247,247,,1,321,321,,,,,,,,,"52,4,2,2,2,4,18,10,7","0,27,26,45,2","31,18,11,11,29",,,,,114,,,,,,,,,,,,,,,,,,,,,,,,,,,,,,,,,,,,56.5,27,3,193,57,,1016,,,0,4,1,"Menden (Sauerland)",1,0,U1.010|3:41-U0.400|2:27-U0.210|0:36-U0.090|1:00-U0.200|0:35-U0.100|0:51-U0.210|0:34-U0.090|1:09-U0.200|0:35-U0.110|1:00-U0.200|0:35-U0.410|3:55-U1.000|3:44-U0.420|4:18-U0.200|0:36-U0.120|1:14-U0.200|0:35-U0.100|1:05-U0.210|0:35-U0.090|1:23-U0.210|0:35-U0.110|1:06-U0.190|0:36-U0.410|4:50-U1.010|3:44-U0.300|5:03,,"Menden (Sauerland) Track Running",,,3113,,250,3,9324618668,0,168070,250480,30378,,33324704,,,,,,,,,,,,,,,,,,,,,,,,,,,,,,,,,,,,,,,,,
48911522,993258a7-7d05-4a09-b8bb-8a9afabd5b36,1659469854,120,1659463789,,0,0,1.34,518,518,12,0,24,13,0,0,0.15,1.15,0.98,,97,137,144,102,,,44.75,25.53,45.74,1,58.76,2963,16,,1.1,0,93,93,,,,7,3,7,77,9.63,9.34,9.77,4.4,8.6,224,224,,1,229,229,,,,,,,,,"44,40,12,4,0,0,0,0,0","0,88,12,0,0","0,19,78,3,0",,,,,101,,,,,,,,,,,,,,,,,,,,,,,,,,,,,,,,,,,,7.8,27,3,193,57,,1016,,,0,4,1,"Menden (Sauerland)",1,0,U1.000|6:31-U0.338|2:07,,"Menden (Sauerland) Running",,,3113,,250,3,9324620161,0,168070,250480,30378,,33324730,,,,,,,,,,,,,,,,,,,,,,,,,,,,,,,,,,,,,,,,,
48965147,8ed29437-95c9-4e35-8a88-e143da1e6a3f,1659557801,120,1659554801,,0,0,10.29,3239,3660,255,283,259,294,0,3.3,0.8,0.93,1.05,488,673,145,173,,,,53.53,37.9,54.99,1,58.77,1872,126,,3.2,1,96,101,,,,11,4,81,79,12.26,12.66,12.64,-15.8,-9.3,283,283,,1,299,299,,,,,,,,,"34,13,8,7,4,10,21,4,0","0,27,65,7,0","1,8,52,35,5",,,,,121,,,,,,,,,,,,,,,,,,,,,,,,,,,,,,,,,,,,42.9,27,4,39,52,,1014,0,309,0,2,3,Balve,1,0,U1.000|6:32-U1.000|6:26-U1.000|7:00-U1.000|6:41-U1.000|6:16-U1.000|3:35-U1.000|3:53-U1.000|4:06-U1.000|3:59-U1.000|3:50-U0.289|1:40,,"Balve Running",,,3113,,250,3,9332017509,0,168070,250480,30378,,33374589,,,,,,,,,,,,,,,,,,,,,,,,,,,,,,,,,,,,,,,,"4,4",
49014273,8e662366-fc04-40d7-bd43-afee0f21c75c,1659636912,120,1659634578,1659680253,0,0,8.89,3661,3811,307,308,372,357,4,4.1,0.54,1.11,0.7,432,695,141,175,,,,39.87,27.24,41.57,1,58.72,1307,111,,3.1,0.9,101,97,,,,18,3,65,74,9.72,9.88,11.33,10.9,1.3,223,223,,1,271,271,,,,,,,,,"46,6,11,22,12,2,0,0,0","1,43,48,7,0","29,8,37,17,9",,,,,98,,,,,,,,,,,,,,,,,,,,,,,,,,,,,,,,,,,,24.9,27,8,287,52,,1013,1,314,0,3,3,Balve,1,0,U1.000|5:26-U1.000|5:16-U0.972|5:47-U0.163|1:00-U0.201|2:13-U0.161|1:01-U0.195|2:18-U0.158|1:04-U0.199|2:27-U0.163|1:03-U0.195|2:09-U0.160|1:04-U0.204|2:45-U0.165|1:07-U0.184|2:21-U0.160|1:05-U0.201|2:54-U0.157|1:02-U1.000|7:37-U1.000|4:45-U1.000|5:08-U0.254|1:26,,"Balve Running",,,3113,,250,3,9337739318,0,168070,250480,30378,,33419923,,,,,,,,,,,,,,,,,,,,,,,,,,,,,,,,,,,,,,,,"4,4,4,5",
49043796,9caee33f-98f3-44fb-b257-3f7ae361de0c,1659691078,120,1659686275,,0,0,6.33,2080,2187,104,99,111,108,0,1.6,0.54,1.02,1.02,347,416,138,153,105,,,54.18,34.87,55.33,1,58.69,1012,58,,2.5,0,99,98,,,,7,1,32,78,11.29,11.17,11.43,-5.6,-6.2,265,265,,1,271,271,,,,,,,,,"10,14,26,24,20,4,1,0,0","1,50,50,0,0","0,4,81,15,0",,,,,117,,,,,,,,,,,,,,,,,,,,,,,,,,,,,,,,,,,,14.8,17,7,351,88,,1016,2,320,0,4,3,Balve,1,0,U1.000|5:30-U1.000|5:34-U1.000|5:51-U1.000|5:33-U1.000|4:48-U1.000|5:22-U0.331|2:02,,"Balve Running",,,3113,,250,3,9340926858,0,168070,250480,30378,,33447680,,,,,,,,,,,,,,,,,,,,,,,,,,,,,,,,,,,,,,,,"5,5",
49092106,6a40d0f5-ae39-4d28-8cd2-045e4a9fc0d3,1659777128,120,1659771755,,0,0,4.49,1499,1663,40,10,47,17,0,0,0.18,1.07,,,292,134,148,,,,55.14,33.52,56.2,1,58.7,700,42,,2.2,0,104,100,,,,7,1,30,78,11.05,10.9,11.23,8.5,8.1,265,265,,1,271,271,,,,,,,,,"10,9,26,33,20,1,0,0,0","1,77,22,0,0","0,6,74,20,0",,,,,115,,,,,,,,,,,,,,,,,,,,,,,,,,,,,,,,,,,,18.8,16,17,292,74,,1027,2,340,0,3,3,Mitte-Nord,1,0,U1.000|5:18-U1.000|5:13-U1.000|5:48-U1.000|5:42-U0.493|2:59,,"Bremerhaven Running",,,3113,,250,3,9346718352,0,168070,250480,30378,,33491850,,,,,,,,,,,,,,,,,,,,,,,,,,,,,,,,,,,,,,,,,
49113890,35adc8fb-6d2b-44b7-8c91-b14a4e660e81,1659804050,120,1659799848,,0,0,9.88,2526,2760,49,24,64,39,0,0,0.14,1.09,,,596,151,164,,,,65.44,48.2,66.05,1,58.78,1872,155,,3.6,0,106,104,,,,13,4,74,81,14.24,14.15,14.29,5.3,4.5,359,359,,1,361,361,,,,,,,,,"0,1,2,4,13,57,22,1,0","1,9,83,7,0","0,0,5,86,8",,,,,145,,,,,,,,,,,,,,,,,,,,,,,,,,,,,,,,,,,,49.1,20,13,331,45,,1027,2,330,0,3,3,Altstadt,1,0,U1.000|4:32-U1.000|4:08-U1.000|4:12-U1.000|4:06-U1.000|4:16-U0.030|0:08-U1.000|4:24-U1.000|4:14-U1.000|4:05-U1.000|4:11-U0.853|3:50,,"Bremen Running",,,3113,,250,3,9349791180,0,168070,250480,30378,,33511494,,,,,,,,,,,,,,,,,,,,,,,,,,,,,,,,,,,,,,,,,
49164402,b81911be-4b93-43e4-ba05-3ae95d1920ec,1659890598,120,1659886958,,0,0,10,3265,3265,,,,,0,,,,,,681,149,175,124,,,49.3,36.23,49.3,1,58.82,1396,134,,3.3,0.9,,100,,,,,,92,78,,11.05,,34,,,,,,,,,,,,,,,,"36,4,3,18,25,13,1,0,0","0,18,62,20,0",,,,,,118,,,,,,,,,,,,,,,,,,,,,,,,,,,,,,,,,,,,50,,,,,,,,,,1,,,1,1,U1.000|4:57-U1.000|6:19-U1.000|4:55-U1.000|4:23-U1.000|7:25-U1.000|6:01-U1.000|7:39-U1.000|9:00-U0.565|3:47,,"Treadmill Running",,,3113,,250,3,9356649314,0,168070,250480,30378,,33556113,,,,,,,,,,,,,,,,,,,,,,,,,,,,,,,,,,,,,,,,,
49225675,a4b8a8a0-4812-41f7-b64c-1d64ab8a2b14,1659982617,120,1659979389,,0,0,8.92,3429,3747,362,343,397,376,0,4.2,0.53,1.23,0.7,565,660,136,173,,,,45.48,29.6,47.89,1,58.81,1222,112,,3.1,1,103,101,,,,11,4,71,77,10.81,10.53,12.96,8.5,-10.1,254,254,,1,315,315,,,,,,,,,"41,6,11,20,13,5,3,0,0","2,56,33,9,0","26,8,28,24,14",,,,,101,,,,,,,,,,,,,,,,,,,,,,,,,,,,,,,,,,,,39.3,23,9,23,40,,1024,1,316,0,3,3,Balve,1,0,U1.000|5:13-U1.000|5:06-U0.958|5:24-U0.155|1:02-U0.194|2:39-U0.165|1:03-U0.188|2:01-U0.162|1:05-U0.185|1:53-U0.160|1:04-U0.194|2:09-U0.162|0:59-U0.194|2:04-U0.168|0:55-U0.194|2:21-U0.162|0:59-U0.195|2:21-U0.162|1:01-U1.000|6:55-U1.000|4:20-U1.000|4:53-U0.324|1:42,,"Balve Running",,,3113,,250,3,9363345575,0,168070,250480,30378,,33610403,,,,,,,,,,,,,,,,,,,,,,,,,,,,,,,,,,,,,,,,"4,4,4,4,5",
49260743,1a486d50-7669-498a-941f-5a198ba5defc,1660044203,120,1660045025,,0,0,,98,98,,,,,0,,,,,,7,,,,,,,,,1,,,,,,,,,,,,,,1,,,,,,,,,,,,,,,,,,,,,,,,,,,,,,,,,,,,,,,,,,,,,,,,,,,,,,,,,,,,,,,,,,,,,,,,,,1,,,1,0,,,,,,,,252,7,,0,168073,,30378,,33643223,,,,,,,,,,,,,,,,,,,,,,,,,,,,,,,,,,,,,,,,,
49261633,735a721f-84ed-4143-8d8b-538fa68d8f74,1660052233,120,1660046512,,0,0,,1336,1336,,,,,0,,,,,,103,,,,,,,,,1,,,,,,,,,,,,,,11,,,,,,,,,,,,,,,,,,,,,,,,,,,,,,,,,,,,,,,,,,,,,,,,,,,,,,,,,,,,,,,,,,,,,,,,,,1,,,1,0,,,,,,,,252,7,,0,168073,,30378,,33644051,,,,,,,,,,,,,,,,,,,,,,,,,,,,,,,,,,,,,,,,,
49279061,466d14e0-5b21-495e-81b5-cb1eda2dd7ef,1660070127,120,1660067722,,0,0,4.01,1111,1111,23,24,27,29,0,0,0.15,1.02,1.02,,251,140,155,,,,65.65,41.49,66.1,1,58.85,932,64,,2.6,0,104,100,,,,7,3,27,78,13.03,13.05,13.13,4.1,6.1,320,320,,1,324,324,,,,,,,,,"2,1,3,11,37,42,3,0,0","2,35,63,0,0","0,1,22,74,2",,,,,139,,,,,,,,,,,,,,,,,,,,,,,,,,,,,,,,,,,,29.5,25,12,42,44,,1025,1,317,0,2,3,"Menden (Sauerland)",1,0,U1.000|4:49-U1.000|4:33-U1.000|4:32-U1.000|4:35-U0.006|0:02,,"Menden (Sauerland) Running",,,3113,,250,3,9370558793,0,168070,250480,30378,,33660661,,,,,,,,,,,,,,,,,,,,,,,,,,,,,,,,,,,,,,,,,
49279065,a7a15e58-3ccb-4a96-91ca-5de9117a37fa,1660071585,120,1660067727,,0,0,0.62,302,302,5,0,12,6,0,0,0.03,1.87,,,47,117,136,,,,40.52,17.81,41.33,1,58.85,922,8,,0.5,0,,100,,,,9,3,4,63,7.53,7.73,8.1,-6.2,-9.6,174,174,,1,190,190,,,,,,,,,"76,1,2,2,2,3,4,8,1","3,97,0,0,0","31,32,26,9,2",,,,,98,,,,,,,,,,,,,,,,,,,,,,,,,,,,,,,,,,,,5.7,25,12,42,44,,1025,1,317,0,2,3,"Menden (Sauerland)",1,0,,,"Menden (Sauerland) Running",,,3113,,250,3,9370559571,0,168070,250480,30378,,33660665,,,,,,,,,,,,,,,,,,,,,,,,,,,,,,,,,,,,,,,,,
49279104,91061edd-494e-403c-90f7-6ecff3a6db58,1660071989,120,1660067763,,0,0,8.68,2305,2305,0,0,0,0,0,0,0,,,,547,150,175,,,,63.03,45.72,63.03,1,58.86,2304,185,,3.6,2,103,101,,,,19,3,72,81,13.54,14.66,14.66,12.6,3.5,342,342,,1,380,380,,,,,,,,,"21,4,8,5,5,8,15,29,4","0,18,67,14,0","3,14,22,15,46",,,,,139,,,,,,,,,,,,,,,,,,,,,,,,,,,,,,,,,,,,53.3,25,12,42,44,,1025,1,317,0,2,3,"Menden (Sauerland)",1,0,U1.200|4:19-U0.400|2:25-U0.800|2:49-U0.400|2:26-U0.400|1:20-U0.210|1:17-U0.400|1:20-U0.190|1:14-U0.400|1:20-U0.210|1:22-U0.410|1:20-U0.180|1:13-U0.400|1:20-U0.210|1:19-U0.400|1:19-U0.400|3:16-U0.800|2:46-U0.410|2:50-U0.800|2:45-U0.060|0:23,,"Menden (Sauerland) Track Running",,,3113,,250,3,9370564324,0,168070,250480,30378,,33660703,,,,,,,,,,,,,,,,,,,,,,,,,,,,,,,,,,,,,,,,,
49311469,a5a03902-7719-47f9-8895-e7d7d7605a7a,1660136357,120,1660130113,,0,0,,921,921,,,,,0,,,,,,71,,,,,,,,,1,,,,,,,,,,,,,,8,,,,,,,,,,,,,,,,,,,,,,,,,,,,,,,,,,,,,,,,,,,,,,,,,,,,,,,,,,,,,,,,,,,,,,,,,,1,,,1,0,,,,,,,,252,7,,0,168073,,30378,,33690250,,,,,,,,,,,,,,,,,,,,,,,,,,,,,,,,,,,,,,,,,
49311789,3bff1439-0f2d-4987-b8b0-98033e8b74b2,1660137335,120,1660130670,,0,0,,526,526,,,,,0,,,,,,40,,,,,,,,,1,,,,,,,,,,,,,,5,,,,,,,,,,,,,,,,,,,,,,,,,,,,,,,,,,,,,,,,,,,,,,,,,,,,,,,,,,,,,,,,,,,,,,,,,,1,,,1,0,,,,,,,,252,7,,0,168073,,30378,,33690550,,,,,,,,,,,,,,,,,,,,,,,,,,,,,,,,,,,,,,,,,
49325671,212733e9-e6bc-4b72-8c98-8966e5ce9cae,1660154047,120,1660150802,,0,0,5.04,1599,1604,70,70,191,42,4,1.3,0.56,1.01,0.97,386,316,134,153,,,,58.72,35.86,59.73,1,,,,,,,,,,,,,,34,77,11.6,11.4,11.71,0.8,4,275,275,,1,281,281,,,,,,,,,"3,7,23,39,22,5,1,0,0","1,71,28,0,0","0,6,67,27,0",,,,,123,,,,,,,,,,,,,,,,,,,,,,,,,,,,,,,,,,,,22.7,28,11,55,35,,1023,1,308,0,3,3,Balve,1,0,U1.000|5:28-U1.000|5:28-U1.000|5:31-U0.321|1:43-U1.000|4:56-U0.702|3:33,,,,,wahoo_fitness-33,,518,7,,0,168070,250480,30378,,33703516,,,,,,,,,,,,,,,,,,,,,,,,,,,,,,,,,,,,,,,,5,
49326277,b314a433-d4bd-4ca1-9e3c-b80ecfce4fcf,1660158390,120,1660151538,,0,0,,321,321,,,,,0,,,,,,24,,,,,,,,,1,,,,,,,,,,,,,,3,,,,,,,,,,,,,,,,,,,,,,,,,,,,,,,,,,,,,,,,,,,,,,,,,,,,,,,,,,,,,,,,,,,,,,,,,,1,,,1,0,,,,,,,,252,7,,0,168073,,30378,,33704090,,,,,,,,,,,,,,,,,,,,,,,,,,,,,,,,,,,,,,,,,
49351843,a8cf8380-88b4-4c9b-82cd-b295062f0d24,1660207734,120,1660201467,,0,0,,915,915,,,,,0,,,,,,71,,,,,,,,,1,,,,,,,,,,,,,,8,,,,,,,,,,,,,,,,,,,,,,,,,,,,,,,,,,,,,,,,,,,,,,,,,,,,,,,,,,,,,,,,,,,,,,,,,,1,,,1,0,,,,,,,,252,7,,0,168073,,30378,,33727925,,,,,,,,,,,,,,,,,,,,,,,,,,,,,,,,,,,,,,,,,
49369092,480cb397-5475-409a-a038-91fd553eb1ab,1660225768,120,1660227084,,0,0,8.09,2561,2665,134,114,161,142,0,1.2,0.55,1.01,0.95,217,534,141,159,,,,55.17,37.02,56.47,1,58.85,1170,87,,3,0,98,100,,,,7,3,64,77,11.7,11.45,11.89,1,0.9,279,279,,1,287,287,,,,,,,,,"5,6,18,40,29,1,1,0,0","0,45,55,0,0","0,3,67,26,3",,,,,123,,,,,,,,,,,,,,,,,,,,,,,,,,,,,,,,,,,,35.1,29,10,97,23,,1022,6,304,0,2,3,Balve,1,0,U1.000|5:44-U1.000|4:54-U1.000|5:23-U1.000|5:13-U1.000|5:09-U1.000|5:12-U1.000|5:29-U1.000|5:07-U0.092|0:30,,"Balve Running",,,3113,,250,3,9382665282,0,168070,250480,30378,,33743271,,,,,,,,,,,,,,,,,,,,,,,,,,,,,,,,,,,,,,,,5,
49431698,f9bff6ba-73ac-461b-8ed3-dfc85914e183,1660324418,120,1660320231,,0,0,8.49,2830,2862,139,117,168,148,0,1.7,0.45,1.11,1,534,547,136,151,,,,54.23,34.94,55.5,1,58.83,948,66,,2.6,0,100,99,,,,7,3,57,78,11.14,10.88,11.55,6.9,14.1,264,264,,1,278,278,,,,,,,,,"7,14,31,34,13,1,0,0,0","1,77,23,0,0","0,6,77,14,2",,,,,115,,,,,,,,,,,,,,,,,,,,,,,,,,,,,,,,,,,,21.1,28,13,93,21,,1018,3,309,0,2,3,Balve,1,0,U1.000|5:34-U1.000|5:27-U1.000|5:26-U1.000|5:36-U1.000|6:02-U1.000|5:52-U1.000|5:24-U1.000|5:12-U0.491|2:36,,"Balve Running",,,3113,,250,3,9389973835,0,168070,250480,30378,,33799360,,,,,,,,,,,,,,,,,,,,,,,,,,,,,,,,,,,,,,,,4,
49481956,efdfe503-c99e-44f5-960f-6f815b1bcd62,1660412675,120,1660413345,,0,0,49.82,7105,7730,644,637,640,655,4,2.7,0.39,,,809,1082,,,,,,,,,1,,,,,,,,,,,,,,92,85,,29.44,,,,175,153,,0,191,180,,,,,,,,,"20,18,10,17,15,11,9",,"21,52,24,2,0",,,,,,,,,,,,,,,,,,,,,52,,,,,,,,,,,,,,,,,,,,,29,8,79,35,,1015,1,321,0,2,3,Balve,1,0,,,,,,wahoo_fitness-43,,258,7,,0,168072,,30378,,33844476,,,,,,,,,,,,,,,,,,,,,,,,,,,,,,,,,,,,,,,,"4,4,4",
49484283,fa9aa5b1-d45a-4ee1-807b-32fdefaf8110,1660384510,120,1660417218,,0,0,6.84,2309,3168,154,161,198,264,4,1.6,0.56,1.19,0.97,270,543,152,176,,,,46.01,33.93,47.23,1,,,,,,,,,,,,,,71,79,11.3,10.79,11.74,11.9,11.9,266,266,,1,279,279,,,,,,,,,"18,15,22,25,14,5,1,0,0","0,17,57,26,0","0,10,66,21,3",,,,,112,,,,,,,,,,,,,,,,,,,,,,,,,,,,,,,,,,,,64.6,25,9,103,33,,1018,4,325,0,2,3,Balve,1,0,U1.000|5:27-U0.373|2:18-U1.000|5:46-U1.000|5:25-U1.000|5:11-U1.000|5:34-U1.000|5:49-U0.457|3:00,,,,,wahoo_fitness-33,,518,7,,0,168070,250480,30378,,33846674,,,,,,,,,,,,,,,,,,,,,,,,,,,,,,,,,,,,,,,,"4,5",
49507064,9dd579ce-e70e-48e6-bdb1-eb6333695058,1660475700,120,1660471584,,0,0,9.03,2957,3039,150,127,166,144,0,2,0.58,1.03,1,240,600,145,167,,,,50.98,35.83,52.19,1,58.78,1134,81,,2.9,0,97,97,,,,11,2,75,77,11.35,11.13,11.57,1.6,4.5,269,269,,1,279,279,,,,,,,,,"13,11,19,33,19,5,1,0,0","0,21,78,2,0","0,4,74,21,1",,,,,119,,,,,,,,,,,,,,,,,,,,,,,,,,,,,,,,,,,,33,27,6,126,50,,1011,5,320,0,2,3,Balve,1,0,U1.000|5:16-U1.000|5:38-U1.000|5:43-U1.000|5:09-U1.000|5:27-U1.000|5:01-U1.000|5:08-U1.000|5:34-U1.000|6:08-U0.033|0:12,,"Balve Running",,,3113,,250,3,9400733871,0,168070,250480,30378,,33866270,,,,,,,,,,,,,,,,,,,,,,,,,,,,,,,,,,,,,,,,"5,5",
49535019,e3d57154-ffb4-4bd2-bce0-26eda9cc54f8,1660498273,120,1660498758,,0,0,34.47,5349,6831,663,663,654,655,4,4.1,0.53,,,961,796,,,,,,,,,1,,,,,,,,,,,,,,68,79,,29.72,,,,190,151,,0,206,189,,,,,,,,,"27,22,16,12,6,6,11",,"28,36,31,4,1",,,,,,,,,,,,,,,,,,,,,53,,,,,,,,,,,,,,,,,,,,,29,8,125,42,,1006,1,314,0,3,3,Balve,1,0,,,,,,wahoo_fitness-43,,258,7,,0,168072,,30378,,33890554,,,,,,,,,,,,,,,,,,,,,,,,,,,,,,,,,,,,,,,,"4,4,4,4",
49602832,92131a1c-4f93-42af-97c4-a755f3212add,1660587865,120,1660598111,,0,0,7.69,2685,2905,134,89,156,109,0,2,0.61,1.03,1,299,480,126,144,,,,56.2,32.85,57.82,1,58.77,824,53,,2.4,0,99,97,,,,9,1,41,77,10.79,10.41,10.93,0.6,-0.9,254,254,,1,260,260,,,,,,,,,"19,14,30,31,4,1,0,0,0","3,95,2,0,0","0,8,80,12,0",,,,,112,,,,,,,,,,,,,,,,,,,,,,,,,,,,,,,,,,,,14.5,20,12,221,83,,1006,1,323,0,3,3,Balve,1,0,U1.000|5:41-U1.000|5:56-U1.000|5:39-U1.000|5:37-U1.000|5:52-U1.000|6:09-U1.000|5:58-U0.691|3:52,,"Balve Running",,,3113,,250,3,9411275790,0,168070,250480,30378,,33953223,,,,,,,,,,,,,,,,,,,,,,,,,,,,,,,,,,,,,,,,"5,5",
49649900,c5880b79-8522-46d7-ba4f-f6349b284c7f,1660674668,120,1660669546,,0,0,3.93,1070,1070,19,16,21,19,0,0,0,1.06,,,254,146,166,,,,63.43,42.29,63.87,1,58.78,1150,75,,2.8,0,104,103,,,,7,1,22,80,13.27,13.25,13.3,7.6,9.4,328,328,,1,330,330,,,,,,,,,"0,0,2,6,44,45,2,0,0","0,19,77,4,0","0,0,10,88,2",,,,,138,,,,,,,,,,,,,,,,,,,,,,,,,,,,,,,,,,,,24.6,26,6,276,54,,1009,1,309,0,3,3,"Menden (Sauerland)",1,0,U1.000|4:44-U1.000|4:31-U1.000|4:32-U0.926|4:04,,"Menden (Sauerland) Running",,,3113,,250,3,9416540559,0,168070,250480,30378,,33997269,,,,,,,,,,,,,,,,,,,,,,,,,,,,,,,,,,,,,,,,,
49649907,cbf11f82-b207-4ca5-bf12-0a7b00db75b4,1660676108,120,1660669551,,0,0,1.09,258,258,10,0,10,0,0,0,0.19,1.51,,,64,154,167,,,,70.01,43.52,71.61,1,58.78,1140,30,,2,0,,100,,,,9,3,7,82,15.49,16.36,16.86,24,15.8,406,406,,1,448,448,,,,,,,,,"13,1,1,2,2,5,35,36,5","0,11,47,42,0","5,10,3,14,69",,,,,155,,,,,,,,,,,,,,,,,,,,,,,,,,,,,,,,,,,,17,26,6,276,54,,1009,1,309,0,3,3,"Menden (Sauerland)",1,0,U0.210|0:47-U0.190|0:45-U0.200|0:42-U0.200|0:41-U0.210|0:39-U0.080|0:45,,"Menden (Sauerland) Track Running",,,3113,,250,3,9416541379,0,168070,250480,30378,,33997276,,,,,,,,,,,,,,,,,,,,,,,,,,,,,,,,,,,,,,,,,
49657640,fecd024b-7b34-4f2c-9f1b-ea703362f766,1656270556,120,1660673510,,0,0,,68,68,,,,,0,,,,,,5,,,,,,,,,1,,,,,,,,,,,,,,1,,,,,,,,,,,,,,,,,,,,,,,,,,,,,,,,,,,,,,,,,,,,,,,,,,,,,,,,,,,,,,,,,,,,,,,,,,1,,,1,0,,,,,,,,252,7,,0,168073,,30378,,34004750,,,,,,,,,,,,,,,,,,,,,,,,,,,,,,,,,,,,,,,,,
49659986,16bd75da-0505-40c6-9b22-dc2129be25ff,1660680825,120,1660674388,,0,0,,751,751,,,,,0,,,,,,58,,,,,,,,,1,,,,,,,,,,,,,,4,,,,,,,,,,,,,,,,,,,,,,,,,,,,,,,,,,,,,,,,,,,,,,,,,,,,,,,,,,,,,,,,,,,,,,,,,,1,,,1,0,,,,,,,,252,7,,0,168073,,30378,,34007054,,,,,,,,,,,,,,,,,,,,,,,,,,,,,,,,,,,,,,,,,
49660656,ad894725-7b85-4154-8820-8456fd35b51b,1660681675,120,1660675121,,0,0,,633,633,,,,,0,,,,,,49,,,,,,,,,1,,,,,,,,,,,,,,3,,,,,,,,,,,,,,,,,,,,,,,,,,,,,,,,,,,,,,,,,,,,,,,,,,,,,,,,,,,,,,,,,,,,,,,,,,1,,,1,0,,,,,,,,252,7,,0,168073,,30378,,34007681,,,,,,,,,,,,,,,,,,,,,,,,,,,,,,,,,,,,,,,,,
49681781,6af1b8fd-1705-49e6-94a3-964fb655c652,1660721873,120,1660718221,,0,0,10.49,3343,3395,150,143,170,164,0,2.1,0.65,1.01,0.99,429,709,141,157,,,,54.71,37.4,55.73,1,58.74,1361,111,,3.2,0,97,99,,,,7,3,7,79,11.57,11.39,11.74,-2.8,-1.7,275,275,,1,281,281,,,,,,,,,"4,7,23,40,23,3,0,0,0","0,45,55,0,0","0,3,71,25,1",,,,,119,,,,,,,,,,,,,,,,,,,,,,,,,,,,,,,,,,,,1.2,19,5,148,71,,1011,0,316,0,4,3,Balve,1,0,U1.000|5:44-U1.000|5:10-U1.000|5:29-U1.000|5:17-U1.000|5:22-U1.000|5:36-U1.000|5:09-U1.000|4:59-U1.000|5:21-U1.000|5:10-U0.485|2:25,,"Balve Running",,,3113,,250,3,9419887692,0,168070,250480,30378,,34027860,,,,,,,,,,,,,,,,,,,,,,,,,,,,,,,,,,,,,,,,5,
49757623,b8662f20-3e19-4315-b96d-7445234e6e82,1660808928,120,1660805013,,0,0,10.66,3192,3192,150,154,172,177,0,1.6,0.68,1.04,0.94,,715,142,164,,,,58.54,40.28,59.53,1,58.76,1494,140,,3.5,0,102,102,,,,11,3,82,79,12.27,12.07,12.41,2.6,1.5,295,295,,1,301,301,,,,,,,,,"2,2,8,31,48,9,0,0,0","1,35,63,1,0","0,3,45,52,0",,,,,127,,,,,,,,,,,,,,,,,,,,,,,,,,,,,,,,,,,,41.1,17,6,240,87,,1014,1,312,0,4,3,Balve,1,0,U1.000|5:14-U1.000|4:57-U1.000|5:00-U1.000|4:53-U1.000|5:06-U1.000|5:08-U1.000|5:01-U1.000|4:48-U1.000|4:57-U1.000|5:03-U0.655|3:07,,"Balve Running",,,3113,,250,3,9426515621,0,168070,250480,30378,,34098651,,,,,,,,,,,,,,,,,,,,,,,,,,,,,,,,,,,,,,,,,
49803172,6cf29de7-c251-4725-b209-e18f3405c13f,1660846793,120,1660842706,,0,0,9,2837,2971,132,103,153,124,0,1.3,0.43,0.99,0.97,233,587,139,159,,,,56.5,37.47,57.75,1,58.76,1454,84,,3,0,100,100,,,,7,3,68,78,11.79,11.53,11.98,0,-2.1,283,283,,1,291,291,,,,,,,,,"7,8,16,29,33,7,1,0,0","1,49,51,0,0","0,4,58,37,1",,,,,122,,,,,,,,,,,,,,,,,,,,,,,,,,,,,,,,,,,,34.7,23,8,327,58,,1012,1,309,0,4,3,Balve,1,0,U1.000|5:18-U1.000|5:27-U1.000|5:14-U1.000|5:12-U1.000|5:31-U1.000|4:56-U1.000|4:59-U1.000|5:05-U1.000|5:35-U0.002|0:01,,"Balve Running",,,3113,,250,3,9429934475,0,168070,250480,30378,,34142024,,,,,,,,,,,,,,,,,,,,,,,,,,,,,,,,,,,,,,,,5,
49872565,898a8268-9857-4403-a311-b3073accbfa1,1660915757,120,1660913223,,0,0,13.02,3952,4157,263,225,297,266,0,2.7,0.58,1.04,0.99,362,831,141,162,102,,,58.1,40.25,59.77,1,58.78,1396,119,,3.3,0,104,99,,,,7,3,99,78,12.39,12.02,12.6,0.2,0.7,298,298,,1,306,306,,,,,,,,,"5,4,12,28,35,15,1,0,0","0,45,55,0,0","1,1,47,48,3",,,,,127,,,,,,,,,,,,,,,,,,,,,,,,,,,,,,,,,,,,33.7,25,11,296,49,,1015,4,312,0,3,3,Balve,1,0,U1.000|4:50-U1.000|5:17-U1.000|5:23-U1.000|4:58-U1.000|4:42-U1.000|5:36-U1.000|5:22-U1.000|4:52-U1.000|4:37-U1.000|4:48-U1.000|5:23-U1.000|5:16-U1.000|4:41-U0.021|0:08,,"Balve Running",,,3113,,250,3,9434704808,0,168070,250480,30378,,34206460,,,,,,,,,,,,,,,,,,,,,,,,,,,,,,,,,,,,,,,,"4,5,5",
49924546,36a3f431-462c-4987-af6d-b27cd7377912,1660986005,120,1660984342,,0,0,14.05,4416,4579,347,355,360,372,0,3.8,0.8,0.65,0.73,441,912,145,165,,,,53.62,38.88,55.22,1,58.73,1483,144,,3.4,0.4,95,100,,,,7,3,111,79,12.38,14.2,14.13,-22.1,-82.6,286,286,,1,348,348,,,,,,,,,"27,14,13,11,9,13,10,1,2","2,22,71,5,0","3,6,58,31,2",,,,,121,,,,,,,,,,,,,,,,,,,,,,,,,,,,,,,,,,,,38.8,18,7,269,87,,1017,2,308,0,6,3,Balve,1,0,U1.000|6:20-U1.000|6:25-U1.000|5:55-U1.000|6:32-U1.000|6:34-U1.000|5:41-U1.000|4:59-U1.000|5:26-U1.000|5:05-U1.000|4:23-U1.000|4:01-U1.000|4:00-U1.000|4:05-U1.000|4:09-U0.054|0:03,,"Balve Running",,,3113,,250,3,9439338110,0,168070,250480,30378,,34253231,,,,,,,,,,,,,,,,,,,,,,,,,,,,,,,,,,,,,,,,3,
49989560,fded617f-ef22-46d8-b253-0165650ac770,1661077705,120,1661076390,,0,0,15.51,3937,4315,89,57,125,87,0,0,0.09,1.08,0.84,371,980,161,177,,,,60.15,50.22,60.73,1,58.78,2736,255,,4.4,1,104,98,,,,16,4,150,81,14.42,14.49,14.68,3.8,-0.1,363,363,,1,374,374,,,,,,,,,"2,1,2,5,17,37,31,5,0","0,6,34,60,0","1,1,9,64,24",,,,,146,,,,,,,,,,,,,,,,,,,,,,,,,,,,,,,,,,,,81.6,21,8,241,60,,1018,4,308,0,2,3,Sundern,1,0,U1.000|4:35-U1.000|3:59-U1.000|3:58-U1.000|3:55-U1.000|3:52-U1.000|3:52-U1.000|3:59-U1.000|4:11-U1.000|4:15-U1.000|4:06-U1.000|4:32-U1.000|4:35-U1.000|5:20-U1.000|3:27-U1.000|4:38-U0.505|2:21,,"Sundern (Sauerland) Running",,,3113,,250,3,9446569981,0,168070,250480,30378,,34313486,,,,,,,,,,,,,,,,,,,,,,,,,,,,,,,,,,,,,,,,5,
50069477,80893f5c-0851-4e88-9248-5e98c3bf75f7,1661171374,120,1661169374,,0,0,11.65,3766,4850,377,247,379,257,0,4.6,0.79,0.97,1.04,565,783,142,169,,,,53.26,37.08,56.14,1,58.76,1597,105,,3.1,0.1,100,98,,,,13,3,88,78,12.22,11.78,12.65,-10.7,-7.4,293,293,,1,307,307,,,,,,,,,"27,14,14,12,7,22,5,0,0","0,39,59,1,0","0,3,65,28,5",,,,,119,,,,,,,,,,,,,,,,,,,,,,,,,,,,,,,,,,,,32.9,23,6,183,51,,1015,4,305,0,3,3,Balve,1,0,U1.000|5:28-U1.000|5:23-U1.000|6:33-U1.000|6:26-U1.000|6:31-U1.000|6:19-U1.000|4:46-U1.000|4:10-U1.000|4:09-U1.000|4:14-U1.000|4:37-U0.652|4:09,,"Balve Running",,,3113,,250,3,9453742630,0,168070,250480,30378,,34386929,,,,,,,,,,,,,,,,,,,,,,,,,,,,,,,,,,,,,,,,"4,4,4,5",
50157079,6ec3d885-caa0-4368-9928-c73be7f98c26,1661281104,120,1661280875,,0,0,7.16,1912,1912,3,0,2,0,0,0,0,,,,479,155,184,,,,59.74,44.89,59.81,1,58.76,1872,221,,3.8,2.3,103,103,,,,7,3,65,80,13.49,15.11,15.13,2.9,6.3,344,344,,1,394,394,,,,,,,,,"27,1,2,2,2,6,27,31,3","0,16,40,37,7","13,11,8,8,60",,,,,140,,,,,,,,,,,,,,,,,,,,,,,,,,,,,,,,,,,,80.1,27,3,132,44,,1016,0,286,0,3,3,"Menden (Sauerland)",1,0,U0.990|3:40-U0.210|1:18-U1.000|3:28-U0.200|1:22-U1.000|3:20-U0.350|5:03-U1.000|3:39-U0.190|1:10-U1.000|3:30-U0.200|1:37-U0.810|2:50-U0.190|0:35-U0.020|0:19,,"Menden (Sauerland) Track Running",,,3113,,250,3,9463387383,0,168070,250480,30378,,34466771,,,,,,,,,,,,,,,,,,,,,,,,,,,,,,,,,,,,,,,,,
50157086,b3db3476-3c23-421a-a7c8-c664556a24ec,1661283525,120,1661280880,,0,0,1.05,389,389,21,2,26,7,0,0.2,0.23,1.08,0.93,429,78,138,157,,,,46.72,26.09,48.93,1,58.75,1858,15,,1,0,97,97,,,,7,3,8,77,10.4,9.77,11.35,9,22.9,252,252,,1,271,271,,,,,,,,,"24,33,33,10,0,0,0,0,0","0,81,19,0,0","0,3,87,4,6",,,,,105,,,,,,,,,,,,,,,,,,,,,,,,,,,,,,,,,,,,13,27,3,132,44,,1016,0,286,0,3,3,"Menden (Sauerland)",1,0,U1.000|6:12-U0.050|0:17,,"Menden (Sauerland) Running",,,3113,,250,3,9463388326,0,168070,250480,30378,,34466778,,,,,,,,,,,,,,,,,,,,,,,,,,,,,,,,,,,,,,,,5,
50214900,415e3962-3efd-478a-8ae8-966dd0dac678,1661362535,120,1661360012,,0,0,12.29,4029,4648,182,117,214,149,0,1.8,0.49,0.99,0.98,308,804,135,153,,,,55.87,36.62,57.26,1,58.77,1280,96,,3.1,0,99,100,,,,7,3,86,76,11.41,11.21,11.57,2.7,4.1,271,271,,1,278,278,,,,,,,,,"12,10,19,32,22,5,0,0,0","1,73,27,0,0","0,4,75,21,0",,,,,120,,,,,,,,,,,,,,,,,,,,,,,,,,,,,,,,,,,,26.8,29,5,85,36,,1018,1,293,0,3,3,Balve,1,0,U1.000|5:51-U1.000|4:52-U1.000|5:08-U1.000|5:26-U1.000|5:35-U1.000|6:08-U1.000|6:08-U1.000|5:19-U1.000|5:35-U1.000|4:44-U1.000|4:53-U1.000|5:33-U0.292|1:57,,"Balve Running",,,3113,,250,3,9469380367,0,168070,250480,30378,,34519553,,,,,,,,,,,,,,,,,,,,,,,,,,,,,,,,,,,,,,,,"5,5",
50289478,325015e0-27a6-4842-a277-1fdb69877544,1661451352,120,1661444616,,0,0,1,345,427,24,17,25,19,0,1.1,0.6,1.18,1.17,,75,153,185,,,,44.37,28.15,46.08,1,58.77,294,21,,1.5,0,,102,,,,7,3,12,76,10.93,10.96,11.69,-5.8,3.2,259,259,,1,284,284,,,,,,,,,"15,13,26,30,9,3,4,0,0","0,41,21,29,10","6,13,41,39,0",,,,,114,,,,,,,,,,,,,,,,,,,,,,,,,,,,,,,,,,,,35.7,29,5,116,40,,1014,1,291,0,3,3,Balve,1,0,U1.000|5:42-U0.004|0:02,,"Balve Running",,,3113,,250,3,9475821805,0,168070,250480,30378,,34589985,,,,,,,,,,,,,,,,,,,,,,,,,,,,,,,,,,,,,,,,,
50290696,10156ba7-1c40-4b12-b318-da58191828d7,1661451959,120,1661445943,,0,0,1.73,1134,1134,159,174,164,178,0,3.4,1,,,1677,191,133,174,,,,23.99,,26.56,1,58.77,816,40,,2.1,0.3,,100,,,,16,1,26,72,7.17,6.5,13.79,30.3,8.6,170,170,,1,341,341,,,,,,,,,"90,4,2,2,1,1,0,0,0","7,53,17,24,0","64,7,5,9,14",,,,,64,,,,,,,,,,,,,,,,,,,,,,,,,,,,,,,,,,,,32.8,28,5,116,40,,1014,1,291,0,3,3,Balve,1,0,U0.148|1:01-U0.182|1:55-U0.161|1:04-U0.185|1:50-U0.161|1:02-U0.195|2:15-U0.164|1:08-U0.221|5:13-U0.165|1:08-U0.146|2:18,,"Balve Running",,,3113,,250,3,9475972976,0,168070,250480,30378,,34591138,,,,,,,,,,,,,,,,,,,,,,,,,,,,,,,,,,,,,,,,"4,4",
50340275,99d8bfb8-ce8f-473e-9997-1043cc468333,1661528480,120,1661526873,,0,0,14.5,4429,5482,325,279,338,294,0,3.9,0.64,0.87,0.89,578,948,140,173,,,,58.19,40.3,60.04,1,58.76,1584,149,,3.6,0,104,98,,,,15,3,99,79,12.51,12.56,12.94,-9,-10.5,299,299,,1,317,317,,,,,,,,,"15,15,14,12,18,14,9,5,0","0,52,47,1,0","0,3,56,30,11",,,,,124,,,,,,,,,,,,,,,,,,,,,,,,,,,,,,,,,,,,37.8,26,13,307,58,,1013,3,292,0,3,3,Balve,1,0,U1.000|5:09-U1.000|5:18-U1.000|6:16-U1.000|6:08-U1.000|6:20-U1.000|6:25-U1.000|5:16-U1.000|4:41-U1.000|4:32-U1.000|4:25-U1.000|4:05-U0.343|1:30-U1.000|3:33-U1.000|3:34-U0.172|0:36-U0.985|6:01,,"Balve Running",,,3113,,250,3,9481843610,0,168070,250480,30378,,34634799,,,,,,,,,,,,,,,,,,,,,,,,,,,,,,,,,,,,,,,,"4,4,4",
50376379,28c7f6c7-4b4b-4ced-a340-46a5f11be031,1661600541,120,1661599284,,0,0,11.02,3452,3630,202,187,219,207,0,2.7,0.65,0.99,1.01,710,720,138,161,94,,,57.47,38.31,58.87,1,58.75,1282,101,,3.1,0,98,100,,,,7,3,61,78,11.92,11.82,12.15,-4.5,-8.5,283,283,,1,292,292,,,,,,,,,"9,13,17,26,21,9,5,0,0","0,60,40,0,0","0,2,62,36,0",,,,,123,,,,,,,,,,,,,,,,,,,,,,,,,,,,,,,,,,,,27.4,17,7,349,88,,1017,3,300,0,4,3,Balve,1,0,U1.000|5:52-U1.000|5:05-U1.000|5:27-U1.000|5:26-U1.000|5:06-U1.000|5:38-U1.000|5:48-U1.000|4:08-U1.000|4:08-U1.000|5:29-U1.000|5:19-U0.019|0:06,,"Balve Running",,,3113,,250,3,9486779665,0,168070,250480,30378,,34669000,,,,,,,,,,,,,,,,,,,,,,,,,,,,,,,,,,,,,,,,4,
50421591,ca07c419-5388-4416-9269-5eb4c85dd6f1,1661680343,120,1661680722,,0,0,21.26,6695,7293,506,450,536,482,0,4.6,0.67,1.03,0.97,605,1452,149,176,,,,51.54,40.09,53.23,1,58.76,2592,224,,4.3,0,100,100,,,,15,3,193,80,12.15,11.73,12.42,1.1,-1.6,287,287,,1,299,299,,,,,,,,,"14,9,12,18,31,13,2,0,0","0,13,74,13,0","1,8,43,47,2",,,,,119,,,,,,,,,,,,,,,,,,,,,,,,,,,,,,,,,,,,67.8,17,10,20,71,,1020,3,298,0,3,3,Balve,1,0,U1.000|5:34-U1.000|6:09-U1.000|6:18-U1.000|6:01-U1.000|5:57-U1.000|5:30-U1.000|4:33-U1.000|4:47-U1.000|4:51-U1.000|4:38-U1.000|4:41-U1.000|4:44-U1.000|5:12-U1.000|5:05-U1.000|4:50-U1.000|4:45-U1.000|4:37-U1.000|5:13-U1.000|6:11-U1.000|4:54-U1.000|5:32-U0.261|1:34,,"Balve Running",,,3113,,250,3,9492891689,0,168070,250480,30378,,34711606,,,,,,,,,,,,,,,,,,,,,,,,,,,,,,,,,,,,,,,,"3,4,5",
50492996,2f5e6d49-1d30-4347-a77b-60e70857c12f,1661795305,120,1661790205,,0,0,1.76,1456,1456,93,85,92,83,0,2.6,0.77,1.24,0.83,389,146,97,139,,,,25.2,,27.06,1,58.76,775,9,,0.6,0,,100,,,,7,3,11,63,5.21,4.91,8.01,5.7,-65,112,111,,1,190,189,,,,,,,,,"97,1,1,0,0,0,0,0,0","68,32,0,0,0","60,30,5,2,3",,,,,58,,,,,,,,,,,,,,,,,,,,,,,,,,,,,,,,,,,,6,22,7,23,48,,1020,1,296,0,3,3,Balve,1,0,U0.508|6:20-U0.176|2:59-U0.181|3:42-U0.159|0:56-U0.732|10:19,,"Balve Running",,,3113,,250,3,9501666733,0,168070,250480,30378,,34777731,,,,,,,,,,,,,,,,,,,,,,,,,,,,,,,,,,,,,,,,4,
50498826,23b5dc23-f246-4831-8f1e-95d7a4a7095a,1661799575,120,1661795783,,0,0,7.22,2399,2439,91,81,98,90,0,0.6,0.47,0.92,1,185,479,134,150,,,,55.46,34.69,56.42,1,58.74,1290,74,,2.8,0,99,98,,,,7,3,48,78,11.1,11.13,11.2,-4.8,-3.3,261,261,,1,265,265,,,,,,,,,"16,17,17,23,20,5,2,0,0","2,77,21,0,0","0,2,86,12,0",,,,,116,,,,,,,,,,,,,,,,,,,,,,,,,,,,,,,,,,,,23.2,21,4,42,55,,1019,,,0,4,1,Balve,1,0,U1.000|5:45-U1.000|6:33-U1.000|6:01-U1.000|5:35-U1.000|5:25-U1.000|5:08-U1.000|4:26-U0.221|1:04,,"Balve Running",,,3113,,250,3,9502376232,0,168070,250480,30378,,34783283,,,,,,,,,,,,,,,,,,,,,,,,,,,,,,,,,,,,,,,,5,
50583147,0add2fdd-46fc-49b4-b085-81a6ab1d23a0,1661884544,120,1661885541,,0,0,4.02,1111,1111,14,24,17,28,0,0,0.05,,,,258,144,158,,,,63.44,41.62,63.52,1,58.77,1048,72,,2.8,0,104,103,,,,7,3,28,79,12.97,13.12,13.09,7.1,9.5,317,317,,1,323,323,,,,,,,,,"1,3,6,11,32,42,5,0,0","1,20,79,0,0","0,3,18,79,0",,,,,137,,,,,,,,,,,,,,,,,,,,,,,,,,,,,,,,,,,,33.5,24,10,35,51,,1019,0,291,0,4,3,"Menden (Sauerland)",1,0,U1.000|4:56-U1.000|4:27-U1.000|4:29-U1.000|4:35-U0.015|0:05,,"Menden (Sauerland) Running",,,3113,,250,3,9509553129,0,168070,250480,30378,,34861597,,,,,,,,,,,,,,,,,,,,,,,,,,,,,,,,,,,,,,,,,
50583149,d0003e68-233f-43fd-85dd-6f8fef050413,1661889353,120,1661885540,,0,0,3.03,889,895,10,18,10,18,0,0,0,,0.75,,205,143,154,,,,59.47,38.01,59.52,1,58.78,2880,48,,2.4,0,103,103,,,,7,3,20,79,12.35,12.48,12.49,-2.2,-1.1,296,296,,1,304,304,,,,,,,,,"3,2,3,13,65,14,0,0,0","3,11,86,0,0","2,3,31,64,0",,,,,129,,,,,,,,,,,,,,,,,,,,,,,,,,,,,,,,,,,,23.7,21,10,36,57,,1019,0,291,0,4,3,"Menden (Sauerland)",1,0,U1.000|4:56-U1.000|4:45-U1.000|4:45-U0.030|0:21-U0.003|0:03,,"Menden (Sauerland) Running",,,3113,,250,3,9509553388,0,168070,250480,30378,,34861596,,,,,,,,,,,,,,,,,,,,,,,,,,,,,,,,,,,,,,,,,
50583150,0278c373-f8b4-4f84-9e91-288ee4e68f20,1661886030,120,1661885543,,0,0,9.39,3267,3267,9,0,9,0,0,0,0.02,,,,587,137,173,,,,50.96,33.45,51.08,1,58.77,2429,127,,3.1,2.1,,100,,,,7,3,73,75,10.36,13.16,13.24,16.4,-1.8,257,257,,1,346,346,,,,,,,,,"50,2,3,4,3,3,7,22,6","2,51,44,3,0","30,18,11,9,32",,,,,115,,,,,,,,,,,,,,,,,,,,,,,,,,,,,,,,,,,,31.1,21,10,36,57,,1019,0,291,0,4,3,"Menden (Sauerland)",1,0,U0.400|1:20-U0.210|1:29-U0.390|1:21-U0.110|0:55-U0.090|0:28-U0.400|1:19-U0.190|1:34-U0.400|1:19-U0.200|1:23-U0.400|1:19-U0.400|5:01-U0.400|1:19-U0.210|1:38-U0.400|1:18-U0.200|1:40-U0.400|1:17-U0.200|1:47-U0.400|1:19-U0.200|1:42-U0.400|1:19-U0.390|5:09-U0.610|2:59-U0.400|1:18-U0.190|1:45-U0.400|1:18-U0.210|1:41-U0.410|1:17-U0.190|1:45-U0.400|1:14-U0.190|5:14,,"Menden (Sauerland) Track Running",,,3113,,250,3,9509553312,0,168070,250480,30378,,34861599,,,,,,,,,,,,,,,,,,,,,,,,,,,,,,,,,,,,,,,,,
50645381,fc29575a-aa6b-497e-b3e1-1c851c91f39a,1661970811,120,1661968904,,0,0,13.14,3843,4170,161,128,184,148,0,1.4,0.38,1.05,0.97,337,841,141,182,,,,60.83,42.06,61.94,1,58.83,2304,153,,3.5,1.5,104,103,,,,13,4,96,79,12.57,12.71,13.09,-2.2,-12.3,307,307,,1,327,327,,,,,,,,,"5,5,13,25,26,13,9,3,0","1,59,28,11,0","0,1,57,30,11",,,,,130,,,,,,,,,,,,,,,,,,,,,,,,,,,,,,,,,,,,73.3,20,11,51,60,,1021,0,298,0,3,3,Balve,1,0,U1.000|5:11-U1.000|5:14-U1.000|5:10-U1.000|5:18-U1.000|5:17-U1.000|5:21-U1.000|5:29-U1.000|4:39-U1.000|4:53-U1.000|4:29-U1.000|3:51-U1.000|3:31-U1.000|5:01-U0.138|0:38,,"Balve Running",,,3113,,250,3,9515864846,0,168070,250480,30378,,34919863,,,,,,,,,,,,,,,,,,,,,,,,,,,,,,,,,,,,,,,,5,
50693035,21b90386-66c3-43f4-b1e7-718c014b7789,1662054812,120,1662054012,,0,0,15.06,4672,5113,431,348,431,347,0,4.3,0.89,1,1.1,538,1003,144,165,,,,55,39.7,57.33,1,58.81,2032,145,,3.6,0,98,98,,,,13,4,123,79,12.58,12.53,12.77,-5.6,-1.5,297,297,,1,304,304,,,,,,,,,"20,15,15,10,14,9,12,5,0","1,24,74,1,0","0,1,53,45,1",,,,,122,,,,,,,,,,,,,,,,,,,,,,,,,,,,,,,,,,,,40.7,22,10,95,45,,1019,0,301,0,2,3,Balve,1,0,U1.000|6:31-U1.000|6:21-U1.000|6:03-U1.000|5:56-U1.000|4:58-U1.000|4:31-U1.000|4:29-U1.000|5:23-U1.000|6:41-U1.000|5:52-U1.000|5:39-U1.000|4:07-U1.000|3:46-U1.000|3:39-U1.000|3:29-U0.063|0:27,,"Balve Running",,,3113,,250,3,9522241760,0,168070,250480,30378,,34964551,,,,,,,,,,,,,,,,,,,,,,,,,,,,,,,,,,,,,,,,"4,4",
50747160,6502bb2d-799f-44b8-b002-6a1e0d45039e,1662148062,120,1662144268,,0,0,8.39,2797,3007,119,87,128,101,0,1.5,0.42,1.05,1.01,518,558,133,151,,,,55.75,34.91,56.99,1,58.8,1170,71,,2.7,0,97,98,,,,9,2,52,77,11.15,10.94,11.26,4.1,3.7,264,264,,1,268,268,,,,,,,,,"13,10,21,38,16,1,0,0,0","1,77,22,0,0","0,1,89,10,0",,,,,117,,,,,,,,,,,,,,,,,,,,,,,,,,,,,,,,,,,,22.4,19,7,130,48,,1014,0,291,0,3,3,Balve,1,0,U1.000|6:18-U1.000|5:12-U1.000|5:37-U1.000|5:39-U1.000|5:28-U1.000|5:11-U1.000|5:05-U1.000|5:37-U0.386|2:28,,"Balve Running",,,3113,,250,3,9528898745,0,168070,250480,30378,,35014237,,,,,,,,,,,,,,,,,,,,,,,,,,,,,,,,,,,,,,,,5,
50776590,81f00cf1-ccbc-44ab-96fe-8776b62f9774,1662204369,120,1662203146,,0,0,14.67,4417,4695,68,43,101,74,0,0,0.12,1.07,,,988,155,175,,,,51.52,41.02,51.92,1,58.75,1760,191,,3.7,2,96,98,,,,13,2,148,79,12.05,12.19,12.31,-2.3,-9.5,292,292,,1,303,303,,,,,,,,,"4,5,13,34,30,9,5,1,0","0,3,79,18,0","0,1,65,29,5",,,,,126,,,,,,,,,,,,,,,,,,,,,,,,,,,,,,,,,,,,60,21,15,150,47,,1014,4,296,0,3,3,Sundern,1,0,U1.000|5:22-U1.000|5:15-U1.000|5:05-U1.000|5:15-U1.000|5:10-U1.000|5:09-U1.000|4:59-U1.000|5:05-U1.000|5:03-U1.000|4:39-U1.000|4:59-U1.000|4:44-U1.000|5:14-U0.102|0:30-U1.000|3:36-U0.572|3:33,,"Sundern (Sauerland) Running",,,3113,,250,3,9532479765,0,168070,250480,30378,,35042441,,,,,,,,,,,,,,,,,,,,,,,,,,,,,,,,,,,,,,,,,
50817385,ca697f7c-8d59-4916-9621-ab5baa6c7ff0,1662285872,120,1662283624,,0,0,13.02,4139,4611,177,155,197,174,0,1.7,0.51,0.98,0.93,276,871,146,180,,,,52.39,38.14,53.38,1,58.71,1478,137,,3.4,1,100,97,,,,15,2,108,78,11.57,11.78,12.08,-8.4,-23.9,277,277,,1,298,298,,,,,,,,,"13,13,19,25,16,8,5,1,0","0,30,63,7,0","0,4,74,15,6",,,,,121,,,,,,,,,,,,,,,,,,,,,,,,,,,,,,,,,,,,55.2,22,5,203,65,,1019,3,291,0,3,3,Balve,1,0,U1.000|5:09-U1.000|4:59-U1.000|5:04-U1.000|5:52-U1.000|5:51-U1.000|6:22-U1.000|5:23-U1.000|5:18-U1.000|5:31-U0.610|3:11-U1.000|4:07-U0.243|1:11-U1.000|3:38-U1.000|6:21-U0.161|1:02,,"Balve Running",,,3113,,250,3,9538390819,0,168070,250480,30378,,35079975,,,,,,,,,,,,,,,,,,,,,,,,,,,,,,,,,,,,,,,,"5,5",
50834504,a6c2148b-a444-40a8-9bb5-4984c1b27f4c,1662296907,120,1662298294,,0,0,8.73,8389,8389,265,270,277,281,0,3.1,0.69,,,242,576,89,136,115,,,,,,1,58.76,1230,7,,0.5,0,,100,,,,,,44,56,,4.28,,-27.1,,,,,,,,,,,,,,,,"80,19,0,0,0,0","79,21,0,0,0",,,,,,,,,,,,,,,,,,,,,,,,,,,,,,,,,,,,,,,,,,5.5,26,5,257,50,,1018,4,288,0,3,3,Balve,1,0,U0.249|2:55-U8.482|2:16:54,,"Balve Hiking",,,3113,,250,3,9540362802,0,168075,,30378,,35094873,,,,,,,,,,,,,,,,,,,,,,,,,,,,,,,,,,,,,,,,"4,5,5",
50951223,58b132bf-ef00-42a3-84f1-30fd76c3e72f,1662489143,120,1662489681,,0,0,4.03,1183,1183,13,28,24,41,0,0,0.2,1.19,0.91,,254,136,148,,,,63.44,38.79,63.4,1,58.76,874,54,,2.5,0,104,101,,,,7,4,24,78,12.18,12.38,12.35,-0.6,0.4,293,293,,1,301,301,,,,,,,,,"4,5,7,15,51,17,1,0,0","2,73,26,0,0","0,4,51,42,3",,,,,131,,,,,,,,,,,,,,,,,,,,,,,,,,,,,,,,,,,,22.3,25,2,246,50,,1014,0,290,0,3,3,"Menden (Sauerland)",1,0,U1.000|5:22-U1.000|4:48-U1.000|4:42-U1.000|4:41-U0.028|0:10,,"Menden (Sauerland) Running",,,3113,,250,3,9555311828,0,168070,250480,30378,,35201889,,,,,,,,,,,,,,,,,,,,,,,,,,,,,,,,,,,,,,,,,
50951243,a4d142e3-2dd5-43d2-9397-5cbbca7621d7,1662490729,120,1662489693,,0,0,1.8,817,817,35,28,49,42,0,1.1,0.55,2.72,0.82,,129,121,146,,,,42.6,21.73,43.83,1,58.76,896,42,,1.4,1.7,,100,,,,7,3,12,66,7.85,9.26,10.77,-1.9,-3.8,195,195,,1,286,286,,,,,,,,,"78,1,1,1,1,1,3,5,9","4,90,6,0,0","51,20,6,6,17",,,,,100,,,,,,,,,,,,,,,,,,,,,,,,,,,,,,,,,,,,10.7,25,2,246,50,,1014,0,290,0,3,3,"Menden (Sauerland)",1,0,U1.000|7:59-U0.801|5:38,,"Menden (Sauerland) Running",,,3113,,250,3,9555313602,0,168070,250480,30378,,35201908,,,,,,,,,,,,,,,,,,,,,,,,,,,,,,,,,,,,,,,,,
50951292,bfc0c45f-2fe4-43f4-9acd-324007135a12,1662491731,120,1662489739,,0,0,9.24,2974,2974,0,0,0,0,0,0,0,,,,577,146,184,,,,51.59,36.63,51.59,1,58.76,4128,225,,3.1,3.4,104,100,,,,18,4,83,76,11.19,13.65,13.65,15.7,-4.4,280,280,,1,357,357,,,,,,,,,"48,2,3,4,2,2,6,20,14","0,38,32,29,1","26,18,12,9,35",,,,,123,,,,,,,,,,,,,,,,,,,,,,,,,,,,,,,,,,,,47,25,3,214,50,,1014,0,291,0,3,3,"Menden (Sauerland)",1,0,U0.510|1:39-U0.190|1:29-U0.500|1:40-U0.200|1:36-U0.500|1:39-U0.370|3:30-U0.310|0:53-U0.190|1:17-U0.310|0:56-U0.190|1:24-U0.290|0:55-U0.210|1:38-U0.300|0:56-U0.200|1:27-U0.300|0:54-U0.210|3:56-U0.500|1:33-U0.190|1:33-U0.510|1:34-U0.200|1:54-U0.490|1:36-U0.240|3:56-U0.300|0:56-U0.200|1:29-U0.300|0:55-U0.200|1:36-U0.300|0:54-U0.200|1:44-U0.310|0:55-U0.200|1:54-U0.290|0:53-U0.030|0:26,,"Menden (Sauerland) Track Running",,,3113,,250,3,9555319423,0,168070,250480,30378,,35201950,,,,,,,,,,,,,,,,,,,,,,,,,,,,,,,,,,,,,,,,,
50951294,b3936f8f-8756-4764-9e4a-38797a2e5887,1662494940,120,1662489744,,0,0,0.94,362,384,19,0,20,4,0,0,0.21,1.23,0.87,,69,132,137,,,,47.1,24.63,49.46,1,58.75,4118,13,,0.9,0,96,96,,,,7,3,7,80,10.1,9.42,10.71,14.8,25.7,242,242,,1,258,258,,,,,,,,,"49,26,23,2,0,0,0,0,0","0,100,0,0,0","0,15,72,13,0",,,,,97,,,,,,,,,,,,,,,,,,,,,,,,,,,,,,,,,,,,10.4,24,3,184,53,,1014,0,291,1,3,3,"Menden (Sauerland)",1,0,,,"Menden (Sauerland) Running",,,3113,,250,3,9555320258,0,168070,250480,30378,,35201952,,,,,,,,,,,,,,,,,,,,,,,,,,,,,,,,,,,,,,,,,
50974447,1aa69efb-5e4d-4c7c-ad0d-6b8624e245d7,1662223053,120,1662532242,,0,0,34.21,5154,5161,663,662,673,681,4,4.4,0.59,,,939,844,,,,,,,,,1,,,,,,,,,,,,,,75,83,,31.27,,,,194,165,,0,203,189,,,,,,,,,"33,16,12,10,11,5,14",,"20,40,37,3,0",,,,,,,,,,,,,,,,,,,,,52,,,,,,,,,,,,,,,,,,,,,22,11,155,62,,1013,1,305,0,3,3,Balve,1,0,,,,,,wahoo_fitness-43,,258,7,,0,168072,,30378,,35223518,,,,,,,,,,,,,,,,,,,,,,,,,,,,,,,,,,,,,,,,"4,4,4,4",
50974449,63dec4fc-ae83-4f54-96f7-3dc058ee1e5b,1661106787,120,1662532242,,0,0,31.48,4221,4539,441,405,410,391,4,2.5,0.44,,,764,713,,,,,,,,,1,,,,,,,,,,,,,,63,91,,32.19,,,,180,169,,0,194,185,,,,,,,,,"15,19,12,20,11,7,17",,"11,60,27,1,1",,,,,,,,,,,,,,,,,,,,,51,,,,,,,,,,,,,,,,,,,,,22,7,134,54,,1016,0,305,0,4,3,Balve,1,0,,,,,,wahoo_fitness-43,,258,7,,0,168072,,30378,,35223519,,,,,,,,,,,,,,,,,,,,,,,,,,,,,,,,,,,,,,,,"4,5",
51041418,53a4b743-375d-4c16-8a1e-8ae98b2e75cc,1662574533,120,1662572595,,0,0,9.16,3252,3358,217,208,237,228,0,2.8,0.63,0.94,1,437,612,131,151,100,,,52.56,32.6,54.16,1,58.76,2742,68,,2.7,0,103,99,,,,11,1,51,77,10.84,10.68,11.02,-9.4,0,247,247,,1,257,257,,,,,,,,,"35,9,8,21,24,3,0,0,0","1,87,12,0,0","1,13,76,10,0",,,,,110,,,,,,,,,,,,,,,,,,,,,,,,,,,,,,,,,,,,15.7,23,5,272,64,,1012,0,292,0,4,3,Neuenrade,1,0,U1.000|5:11-U1.000|5:47-U1.000|7:09-U1.000|7:34-U1.000|6:55-U1.000|5:11-U1.000|4:54-U1.000|5:28-U1.000|5:09-U0.156|0:54,,"Neuenrade Running",,,3113,,250,3,9561373686,0,168070,250480,30378,,35284800,,,,,,,,,,,,,,,,,,,,,,,,,,,,,,,,,,,,,,,,4,
51212062,eae6558f-1b81-4f8c-8c82-1b49539c1451,1662659108,120,1662661232,,0,0,13.51,4015,4797,134,123,185,175,0,1.3,0.39,0.99,1,469,887,150,185,,,,54.85,41.38,55.58,1,58.77,2448,211,,3.7,2.3,98,101,,,,16,3,128,79,12.39,13.2,13.23,3.4,-9.7,300,300,,1,333,333,,,,,,,,,"12,15,19,18,13,2,8,13,1","0,23,55,15,8","0,5,62,14,20",,,,,128,,,,,,,,,,,,,,,,,,,,,,,,,,,,,,,,,,,,103.5,18,9,216,80,,1010,0,317,0,3,3,Balve,1,0,U1.000|6:12-U1.000|5:43-U1.000|4:57-U1.000|5:14-U1.000|5:22-U0.952|5:03-U1.000|3:21-U1.000|3:35-U0.163|0:34-U1.000|5:53-U1.000|5:54-U0.266|1:30-U1.000|3:18-U1.000|3:31-U0.164|0:34-U0.954|6:12,U0.011|0:02|3197,"Balve Running",,,3113,,250,3,9568103861,0,168070,250480,30378,,35442977,,,,,,,,,,,,,,,,,,,,,,,,,,,,,,,,,,,,,,,,5,
51271505,8f110f16-c2dd-403d-a423-30a76a9c898c,1662745526,120,1662741405,,0,0,7.72,2425,2881,113,129,120,134,0,1.8,0.61,0.98,1,449,503,140,172,,,,56.22,37.24,57.09,1,58.77,1338,96,,3,0.7,100,100,,,,9,,41,78,11.72,11.99,12.05,-4.9,-10.1,277,277,,1,290,290,,,,,,,,,"12,11,19,27,17,5,6,3,0","1,48,46,4,0","0,3,69,26,2",,,,,122,,,,,,,,,,,,,,,,,,,,,,,,,,,,,,,,,,,,24.4,17,14,207,82,,1010,0,325,0,4,3,Balve,1,0,U1.000|6:04-U1.000|5:11-U1.000|5:42-U1.000|5:36-U0.483|2:33-U1.000|3:37-U1.000|4:42-U1.000|5:30-U0.236|1:28,,"Balve Running",,,3113,,250,3,9573367083,0,168070,250480,30378,,35495184,,,,,,,,,,,,,,,,,,,,,,,,,,,,,,,,,,,,,,,,5,
51307142,870789c8-f742-4e5b-b843-a5b56da49c38,1662802163,120,1662800794,,0,0,13.51,4539,5363,321,314,342,335,0,3.7,0.72,0.97,1.01,468,916,142,158,113,,,50.79,35.85,52.31,1,58.73,1360,113,,3.2,0,97,97,,,,7,3,113,79,11.34,11.12,11.42,-5,2.7,261,261,,1,266,266,,,,,,,,,"29,13,10,15,24,8,0,0,0","0,43,57,0,0","0,5,84,12,0",,,,,113,,,,,,,,,,,,,,,,,,,,,,,,,,,,,,,,,,,,37.3,14,12,218,92,,1013,2,332,0,4,3,Balve,1,0,U1.000|5:08-U1.000|5:47-U1.000|6:44-U1.000|6:49-U1.000|6:43-U1.000|6:39-U1.000|5:15-U1.000|4:36-U1.000|4:29-U1.000|4:42-U1.000|4:51-U1.000|5:39-U1.000|5:44-U0.505|2:34,,"Balve Running",,,3113,,250,3,9576828603,0,168070,250480,30378,,35529318,,,,,,,,,,,,,,,,,,,,,,,,,,,,,,,,,,,,,,,,"4,5",
51358187,9a5e553e-131a-4cc0-829e-13589f9d4adc,1662888669,120,1662887167,,0,0,11.74,4287,5338,362,331,374,343,0,4.3,0.79,0.96,1.02,504,793,138,163,,,,47.57,32.14,49.54,1,58.71,1177,90,,3,0,101,97,,,,7,1,93,78,10.82,10.47,11.04,-9.7,-1.6,244,244,,1,257,257,,,,,,,,,"43,6,7,21,22,2,0,0,0","0,58,41,0,0","1,18,68,13,0",,,,,105,,,,,,,,,,,,,,,,,,,,,,,,,,,,,,,,,,,,34.2,14,7,295,96,,1019,2,308,0,3,3,Balve,1,0,U1.000|5:23-U1.000|6:57-U1.000|8:05-U1.000|8:18-U1.000|7:18-U1.000|5:46-U1.000|5:04-U1.000|5:03-U1.000|4:54-U1.000|4:48-U1.000|5:01-U0.743|4:51,,"Balve Running",,,3113,,250,3,9583338253,0,168070,250480,30378,,35577315,,,,,,,,,,,,,,,,,,,,,,,,,,,,,,,,,,,,,,,,"3,5",
51449622,07090276-22a8-42c2-9487-3ea0952b1f14,1663012143,120,1663007646,,0,0,8.15,2310,2359,92,105,105,118,0,1.4,0.5,0.96,1.02,,511,144,169,,,,61.49,42.18,62.23,1,58.78,1280,109,,3.2,0,103,104,,,,7,4,59,79,12.92,13.09,13.09,1.8,-0.9,312,312,,1,320,320,,,,,,,,,"6,6,8,10,29,29,11,1,0","1,34,58,8,0","0,0,41,57,2",,,,,134,,,,,,,,,,,,,,,,,,,,,,,,,,,,,,,,,,,,44.3,17,7,165,68,,1014,0,286,1,4,3,Balve,1,0,U1.000|5:03-U1.000|4:29-U1.000|5:04-U1.000|4:49-U0.967|4:15-U1.000|3:43-U1.000|4:16-U1.000|5:43-U0.178|1:06,,"Balve Running",,,3113,,250,3,9593479488,0,168070,250480,30378,,35660494,,,,,,,,,,,,,,,,,,,,,,,,,,,,,,,,,,,,,,,,,
51531018,d6e27f45-4515-4bd2-bc5a-e2c2c9387681,1663094241,120,1663093057,,0,0,3.67,1166,1414,45,32,54,41,0,0.7,0.39,1.01,0.77,,258,143,170,,,,53.91,35.12,54.96,1,58.79,896,79,,2.4,1.7,101,102,,,,7,3,30,78,11.58,11.73,12.15,-9.9,-36.4,282,282,,1,303,303,,,,,,,,,"24,8,9,23,18,5,1,8,4","2,27,68,2,0","7,9,52,20,12",,,,,121,,,,,,,,,,,,,,,,,,,,,,,,,,,,,,,,,,,,33.4,21,8,287,72,,1009,0,280,0,4,3,"Menden (Sauerland)",1,0,U1.000|5:46-U1.000|5:28-U0.508|2:40-U0.204|0:39-U0.112|0:52-U0.202|0:38-U0.104|0:58-U0.199|0:37-U0.103|1:00-U0.205|0:37-U0.034|0:10,,"Menden (Sauerland) Running",,,3113,,250,3,9600051513,0,168070,250480,30378,,35736842,,,,,,,,,,,,,,,,,,,,,,,,,,,,,,,,,,,,,,,,,
51531052,02251da2-c760-4e26-a709-dbad311934aa,1663095826,120,1663093095,,0,0,7.73,2679,2683,9,0,8,0,0,0,0.03,,,,564,152,188,,,,44.54,33.15,44.66,1,58.81,2978,252,,3.6,3.1,103,105,,,,18,4,91,77,10.41,13.9,13.98,29.5,0.2,265,262,,1,368,367,,,,,,,,,"46,3,1,2,1,3,16,20,8","0,41,14,40,6","34,11,8,5,42",,,,,112,,,,,,,,,,,,,,,,,,,,,,,,,,,,,,,,,,,,75.6,21,8,287,72,,1009,0,280,0,4,3,"Menden (Sauerland)",1,0,U0.400|1:27-U0.400|1:25-U0.400|1:25-U0.390|1:19-U0.410|3:38-U0.400|1:27-U0.400|1:25-U0.400|1:20-U0.400|3:26-U0.400|1:22-U0.400|1:13-U0.210|4:03-U0.400|1:26-U0.400|1:26-U0.400|1:21-U0.190|6:53-U0.400|1:13-U0.300|2:51-U0.410|1:15-U0.190|3:00-U0.400|1:17-U0.030|0:28,,"Menden (Sauerland) Track Running",,,3113,,250,3,9600056614,0,168070,250480,30378,,35736874,,,,,,,,,,,,,,,,,,,,,,,,,,,,,,,,,,,,,,,,,
51531059,2a1c8f19-ed97-4c59-8ce6-3ab138178dda,1663098906,120,1663093099,,0,0,1,495,495,33,11,35,13,0,1.6,0.6,1.3,0.57,207,80,130,153,96,,,35.17,18.44,37.59,1,58.81,2962,10,,0.7,0,,100,,,,7,1,9,72,7.9,7.69,10.36,24,30.3,190,190,,1,247,247,,,,,,,,,"94,4,2,0,0,0,0,0,0","0,85,15,0,0","20,43,26,5,5",,,,,84,,,,,,,,,,,,,,,,,,,,,,,,,,,,,,,,,,,,12.3,20,7,315,75,,1009,0,280,1,4,3,"Menden (Sauerland)",1,0,U1.000|8:13-U0.003|0:02,,"Menden (Sauerland) Running",,,3113,,250,3,9600057587,0,168070,250480,30378,,35736881,,,,,,,,,,,,,,,,,,,,,,,,,,,,,,,,,,,,,,,,5,
51655611,b335fe49-60c8-4e40-8005-93871a1b118d,1663179659,120,1663177520,,0,0,12.8,3942,4350,159,148,180,171,0,1.5,0.39,1,1.04,471,796,135,159,,,,60.35,39.53,61.34,1,58.82,1872,103,,3.1,0.4,101,102,,,,7,3,66,78,12.02,11.92,12.15,2.8,2.8,287,287,,1,292,292,,,,,,,,,"7,5,11,32,37,5,2,1,0","1,76,24,0,0","0,0,70,29,1",,,,,125,,,,,,,,,,,,,,,,,,,,,,,,,,,,,,,,,,,,21.1,14,4,13,100,,1005,0,293,0,6,3,Balve,1,0,U1.000|5:17-U1.000|4:47-U1.000|5:08-U1.000|5:13-U1.000|4:59-U1.000|4:56-U1.000|4:59-U1.000|5:20-U1.000|5:21-U1.000|5:01-U1.000|5:54-U1.000|4:08-U0.804|4:38,,"Balve Running",,,3113,,250,3,9606313085,0,168070,250480,30378,,35856503,,,,,,,,,,,,,,,,,,,,,,,,,,,,,,,,,,,,,,,,"5,5",
51801819,d6f19509-e60c-4c89-9ae2-1126f50a9374,1663265300,120,1663262883,,0,0,13.49,3765,4022,136,143,155,161,0,0.9,0.33,0.98,0.84,,860,144,170,87,,,62.68,44.51,63.42,1,58.84,2160,188,,3.9,0.3,101,101,,,,7,3,101,80,13.07,13.84,13.89,5.8,-3,321,321,,1,352,352,,,,,,,,,"5,4,16,23,20,8,6,17,0","2,29,64,6,0","1,5,40,30,24",,,,,134,,,,,,,,,,,,,,,,,,,,,,,,,,,,,,,,,,,,49.2,14,12,286,76,,1009,0,289,0,3,3,Balve,1,0,U1.000|5:27-U1.000|5:03-U1.000|4:35-U1.000|4:40-U1.000|4:59-U0.837|4:15-U1.000|3:18-U1.000|3:22-U0.170|0:33-U1.000|6:09-U1.000|5:35-U0.307|1:38-U1.000|3:27-U1.000|3:26-U0.176|0:34-U1.000|5:41-U0.003|0:02,,"Balve Running",,,3113,,250,3,9612431829,0,168070,250480,30378,,35997222,,,,,,,,,,,,,,,,,,,,,,,,,,,,,,,,,,,,,,,,,
51918491,340875db-a7c8-45eb-a56f-fcfa014e368d,1663353362,120,1663351485,,0,0,13.1,4330,4674,391,367,407,390,0,5,0.83,1.06,1,567,865,141,168,100,,,52.31,36.45,54.36,1,58.83,1407,112,,3.2,0,100,98,,,,11,3,108,79,11.85,11.59,12.43,-1.5,5.8,276,276,,1,294,294,,,,,,,,,"28,13,15,10,15,16,2,2,0","1,41,57,1,0","0,9,64,20,6",,,,,115,,,,,,,,,,,,,,,,,,,,,,,,,,,,,,,,,,,,41.8,12,15,284,78,,1010,0,320,0,3,3,Balve,1,0,U1.000|5:47-U1.000|6:01-U1.000|6:35-U1.000|6:54-U1.000|6:19-U1.000|6:35-U1.000|5:57-U1.000|5:04-U1.000|4:48-U1.000|4:29-U1.000|4:25-U1.000|4:25-U0.071|0:18-U1.000|4:23-U0.030|0:10,,"Balve Running",,,3113,,250,3,9618590282,0,168070,250480,30378,,36107424,,,,,,,,,,,,,,,,,,,,,,,,,,,,,,,,,,,,,,,,"3,4,5",
51959373,7451cb30-3f7e-4eb8-8637-05ab4c58e8ea,1663402783,120,1663399616,,0,0,10.83,3476,3906,176,169,190,183,0,2.3,0.57,0.95,0.94,537,712,137,159,,,,56.29,37.18,57.47,1,58.82,1340,101,,3.1,0,99,100,,,,11,2,73,79,11.56,11.61,11.84,-5.4,-12.3,273,273,,1,285,285,,,,,,,,,"13,14,14,32,18,6,2,2,0","1,58,41,0,0","0,5,67,25,2",,,,,118,,,,,,,,,,,,,,,,,,,,,,,,,,,,,,,,,,,,34.1,9,16,293,86,,1014,0,323,0,3,3,Balve,1,0,U1.000|6:07-U1.000|5:16-U1.000|5:39-U1.000|6:11-U1.000|5:28-U1.000|5:35-U1.000|5:07-U0.653|3:25-U1.000|4:31-U1.000|4:07-U1.000|5:30-U0.175|1:02,,"Balve Running",,,3113,,250,3,9620969652,0,168070,250480,30378,,36146422,,,,,,,,,,,,,,,,,,,,,,,,,,,,,,,,,,,,,,,,"5,5,5",
52072742,8a3bf494-0a15-427a-8c1d-6cfed8a6db82,1663518410,120,1663517654,,0,0,17.23,5186,5524,449,435,450,438,0,4.4,0.87,1,1.09,595,1107,145,158,99,,,56.57,41.57,58.45,1,58.82,1588,154,,3.6,0,98,100,,,,13,4,135,80,12.71,12.53,12.86,-4.7,0.4,301,301,,1,308,308,,,,,,,,,"10,14,20,12,10,22,13,0,0","0,27,73,0,0","0,0,51,48,2",,,,,125,,,,,,,,,,,,,,,,,,,,,,,,,,,,,,,,,,,,38.6,10,16,294,83,,1013,1,323,0,6,3,Balve,1,0,U1.000|6:07-U1.000|6:10-U1.000|5:38-U1.000|6:09-U1.000|4:42-U1.000|4:24-U1.000|4:07-U1.000|4:50-U1.000|6:00-U1.000|5:32-U1.000|5:21-U1.000|4:43-U1.000|5:27-U1.000|4:15-U1.000|4:04-U1.000|4:00-U1.000|3:56-U0.232|1:03,,"Balve Running",,,3113,,250,3,9630872413,0,168070,250480,30378,,36253230,,,,,,,,,,,,,,,,,,,,,,,,,,,,,,,,,,,,,,,,"4,4",
52159467,c838e053-7d38-4479-85aa-0fb84fd7dd55,1663612618,120,1663608849,,0,0,10.01,3267,3367,191,201,198,207,0,2.7,0.7,1.01,1.03,472,661,139,162,,,,54.13,36.24,55.34,1,58.8,1174,82,,2.9,0,98,99,,,,7,1,75,78,11.39,11.32,11.53,-3.9,-4.3,266,266,,1,271,271,,,,,,,,,"16,11,18,28,18,7,2,0,0","0,52,47,1,0","0,1,83,15,0",,,,,118,,,,,,,,,,,,,,,,,,,,,,,,,,,,,,,,,,,,31.2,10,12,296,96,,1020,0,327,0,6,3,Balve,1,0,U1.000|6:15-U1.000|5:19-U1.000|5:31-U1.000|5:47-U1.000|5:19-U1.000|5:47-U1.000|5:29-U1.000|4:16-U1.000|4:39-U1.000|6:04-U0.006|0:02,,"Balve Running",,,3113,,250,3,9636972481,0,168070,250480,30378,,36327550,,,,,,,,,,,,,,,,,,,,,,,,,,,,,,,,,,,,,,,,"5,5,5",
52237858,4ec269e6-2269-406a-ac55-d7cd26c01a28,1663698822,120,1663699781,,0,0,4.03,1133,1133,25,28,32,36,0,0,0.15,1.09,0.92,,257,140,155,,,,64.47,40.8,64.91,1,58.88,932,65,,2.6,0,105,101,,,,9,3,28,79,12.83,12.9,12.95,3,0.9,314,314,,1,319,319,,,,,,,,,"2,2,2,7,53,31,2,0,0","3,26,71,0,0","0,3,19,78,1",,,,,135,,,,,,,,,,,,,,,,,,,,,,,,,,,,,,,,,,,,30.6,12,6,286,86,,1024,0,309,0,3,3,"Menden (Sauerland)",1,0,U1.000|4:58-U1.000|4:33-U1.000|4:39-U1.000|4:32-U0.030|0:11,,"Menden (Sauerland) Running",,,3113,,250,3,9643904093,0,168070,250480,30378,,36399677,,,,,,,,,,,,,,,,,,,,,,,,,,,,,,,,,,,,,,,,,
52237859,b8533e5a-5988-4fbc-995b-a2f3dd6639d3,1663700341,120,1663699780,,0,0,0.28,94,94,11,4,11,4,0,1.3,0.72,1.78,1.08,,17,128,133,,,,57.91,25.94,62.54,1,58.88,925,14,,0.2,0.7,,100,,,,7,3,2,77,11.44,10.69,14.46,35.1,59.6,299,299,,1,383,383,,,,,,,,,"47,11,6,1,3,4,7,15,5","0,100,0,0,0","0,47,20,10,23",,,,,116,,,,,,,,,,,,,,,,,,,,,,,,,,,,,,,,,,,,3.5,12,7,286,86,,1024,0,309,0,3,3,"Menden (Sauerland)",1,0,,,"Menden (Sauerland) Running",,,3113,,250,3,9643904154,0,168070,250480,30378,,36399676,,,,,,,,,,,,,,,,,,,,,,,,,,,,,,,,,,,,,,,,,
52237860,fc37c8ba-b7d6-4f42-bf34-746c0882cff3,1663703527,120,1663699783,,0,0,2.07,659,659,24,2,30,7,0,0,0.2,1.4,,,139,138,149,,,,56.33,33.43,57.88,1,58.88,2611,28,,2,0,100,101,,,,7,3,15,79,11.72,11.39,12.32,-11.1,-29.2,289,289,,1,307,307,,,,,,,,,"1,1,20,60,18,0,0,0,0","0,62,38,0,0","0,2,81,8,8",,,,,119,,,,,,,,,,,,,,,,,,,,,,,,,,,,,,,,,,,,20.3,11,3,323,88,,1024,,,1,5,1,"Menden (Sauerland)",1,0,U1.000|5:20-U1.000|5:15-U0.073|0:24,,"Menden (Sauerland) Running",,,3113,,250,3,9643904381,0,168070,250480,30378,,36399678,,,,,,,,,,,,,,,,,,,,,,,,,,,,,,,,,,,,,,,,,
52237861,8cf0d452-5cef-41ae-9c8d-db39167fa532,1663700825,120,1663699783,,0,0,7.77,2683,2683,0,0,0,0,0,0,0,,,,531,145,172,,,,47.75,33.3,47.75,1,58.88,2629,143,,3.1,2.3,,100,,,,7,3,78,78,10.43,13.58,13.58,16.1,0.8,266,263,,1,357,356,,,,,,,,,"50,1,1,1,2,5,8,18,15","3,26,44,26,0","37,11,7,8,37",,,,,111,,,,,,,,,,,,,,,,,,,,,,,,,,,,,,,,,,,,49.8,11,3,323,88,,1024,,,0,5,1,"Menden (Sauerland)",1,0,U0.400|1:15-U0.120|0:52-U0.400|1:16-U0.120|1:02-U0.400|1:17-U0.110|0:58-U0.410|1:16-U0.110|1:07-U0.400|1:17-U0.170|4:53-U0.400|1:16-U0.120|1:06-U0.400|1:13-U0.110|1:04-U0.400|1:16-U0.110|1:11-U0.410|1:18-U0.090|1:05-U0.410|1:18-U0.170|3:42-U0.400|1:16-U0.110|1:10-U0.400|1:18-U0.100|1:06-U0.400|1:20-U0.080|1:02-U0.400|1:23-U0.100|1:01-U0.410|1:16-U0.110|4:11,,"Menden (Sauerland) Track Running",,,3113,,250,3,9643904303,0,168070,250480,30378,,36399679,,,,,,,,,,,,,,,,,,,,,,,,,,,,,,,,,,,,,,,,,
52298176,654001bb-2eee-4d85-a1ae-0fafabc8da4f,1663782105,120,1663781611,,0,0,13.06,4333,4570,433,391,441,404,0,4.5,0.94,1.06,1.11,490,891,139,162,,,,53.04,36.29,55.43,1,58.86,1741,117,,3.2,0.2,97,98,,,,7,4,100,78,11.85,11.31,12.08,-3.9,9.7,275,275,,1,285,285,,,,,,,,,"25,17,12,9,21,15,0,0,0","1,55,43,1,0","0,6,67,26,1",,,,,116,,,,,,,,,,,,,,,,,,,,,,,,,,,,,,,,,,,,36.5,15,6,37,62,,1026,0,304,0,3,3,Balve,1,0,U1.000|6:23-U1.000|6:32-U1.000|6:09-U1.000|6:46-U1.000|6:31-U1.000|5:39-U1.000|5:17-U1.000|5:22-U1.000|5:05-U1.000|4:45-U1.000|4:31-U1.000|4:32-U1.000|4:25-U0.061|0:17,,"Balve Running",,,3113,,250,3,9649921930,0,168070,250480,30378,,36454750,,,,,,,,,,,,,,,,,,,,,,,,,,,,,,,,,,,,,,,,"3,4",
52361442,13352eec-c0a6-41f2-b394-a20756d3950b,1663871323,120,1663869397,,0,0,13.08,3872,4539,140,104,172,138,0,1.1,0.39,0.9,0.99,361,865,144,181,,,,58.28,41.46,59.25,1,58.88,2016,192,,3.8,1.2,100,100,,,,15,3,101,80,12.5,13.32,13.39,4.7,0.3,304,304,,1,338,338,,,,,,,,,"14,12,16,19,13,2,7,16,0","1,47,40,13,0","0,5,58,15,22",,,,,127,,,,,,,,,,,,,,,,,,,,,,,,,,,,,,,,,,,,59.4,13,5,143,72,,1022,0,297,0,2,3,Balve,1,0,U1.000|5:03-U1.000|5:39-U1.000|5:01-U1.000|5:04-U1.000|5:47-U0.067|0:19-U1.000|3:23-U1.000|3:27-U0.184|0:38-U1.000|6:03-U1.000|5:59-U0.268|1:28-U1.000|3:23-U1.000|3:30-U1.000|6:23-U0.562|3:24,,"Balve Running",,,3113,,250,3,9656375383,0,168070,250480,30378,,36514433,,,,,,,,,,,,,,,,,,,,,,,,,,,,,,,,,,,,,,,,5,
52416215,b01fb743-66a9-4a58-86f7-ee7d29452c88,1663952952,120,1663952067,,0,0,15.27,4994,5592,407,363,437,378,0,4.4,0.77,1.02,0.95,401,1052,144,180,,,,51.54,37.37,53.42,1,58.87,2457,243,,4,2.2,99,99,,,,15,3,103,80,11.86,11.6,12.56,2.1,6.1,279,279,,1,310,310,,,,,,,,,"21,7,15,17,25,7,5,2,0","1,48,32,19,0","2,11,50,25,11",,,,,115,,,,,,,,,,,,,,,,,,,,,,,,,,,,,,,,,,,,60.9,16,6,218,67,,1016,0,304,0,4,3,Balve,1,0,U1.000|5:39-U1.000|5:35-U1.000|6:55-U0.104|0:23-U0.062|0:21-U0.543|2:23-U0.148|1:00-U0.102|0:22-U0.061|0:20-U0.509|2:24-U0.096|1:00-U0.137|0:41-U0.589|2:25-U0.116|1:02-U0.134|0:42-U0.965|5:58-U0.173|1:01-U0.908|4:05-U1.000|7:30-U1.000|6:02-U1.000|5:16-U1.000|5:16-U1.000|4:56-U1.000|4:50-U1.000|4:13-U0.618|2:55,,"Balve Running",,,3113,,250,3,9661933984,0,168070,250480,30378,,36565275,,,,,,,,,,,,,,,,,,,,,,,,,,,,,,,,,,,,,,,,"3,4",
52444902,02aa2760-23d3-428e-919a-5f7e01139d80,1664015194,120,1664011750,,0,0,10.39,3495,3526,142,144,166,167,0,1.4,0.47,0.98,0.99,392,675,136,160,,,,53.62,35.08,54.51,1,58.85,1463,73,,2.8,0,97,99,,,,7,1,72,79,10.99,10.9,11.17,-4.2,-9.5,257,257,,1,266,266,,,,,,,,,"14,15,28,24,12,6,0,0,0","1,74,26,0,0","0,7,83,9,1",,,,,113,,,,,,,,,,,,,,,,,,,,,,,,,,,,,,,,,,,,27,14,3,191,79,,1014,2,316,0,4,3,Balve,1,0,U1.000|6:05-U1.000|5:51-U1.000|5:36-U1.000|5:53-U1.000|5:28-U1.000|5:03-U1.000|5:45-U1.000|5:56-U1.000|4:48-U1.000|5:20-U0.394|2:29,,"Balve Running",,,3113,,250,3,9665270153,0,168070,250480,30378,,36591587,,,,,,,,,,,,,,,,,,,,,,,,,,,,,,,,,,,,,,,,5,
52514941,ab33ecd6-483f-418e-acae-791c1b844741,1664107503,120,1664106969,,0,0,0.34,105,177,17,0,15,0,0,1,0.6,,,,21,123,138,,,,67.26,28.98,75.71,1,58.85,,6,,0.4,0,,100,,,,7,3,1,79,14.05,11.48,14.3,15.4,15.1,366,366,,1,371,371,,,,,,,,,"0,1,8,77,4,8,3,0,0","12,88,0,0,0","0,0,0,100,0",,,,,123,,,,,,,,,,,,,,,,,,,,,,,,,,,,,,,,,,,,2.2,12,9,6,80,,1015,2,325,0,3,3,Sundern,1,0,,,"Sundern (Sauerland) Running",,,3113,,250,3,9672734259,0,168070,250480,30378,,36655008,,,,,,,,,,,,,,,,,,,,,,,,,,,,,,,,,,,,,,,,,
52514945,74ff8428-64d9-4caf-b711-06676c1171c8,1664111413,120,1664106972,,0,0,0.38,249,249,1,16,3,8,0,1.2,1,1.13,0.48,,44,129,154,88,,,24.94,,23.77,1,58.91,4438,11,,0.7,0,,100,,,,7,3,4,75,6.52,8.72,8.51,41.1,-4.7,136,118,,1,200,193,,,,,,,,,"47,10,18,21,4,0,0,0,0","0,80,20,0,0","51,13,36,0,0",,,,,61,,,,,,,,,,,,,,,,,,,,,,,,,,,,,,,,,,,,7.9,13,8,12,76,,1015,3,326,0,3,3,Sundern,1,0,,,"Sundern (Sauerland) Running",,,3113,,250,3,9672734707,0,168070,250480,30378,,36655012,,,,,,,,,,,,,,,,,,,,,,,,,,,,,,,,,,,,,,,,,
52514946,d24e8ad6-5dc1-4037-996f-74ee460b8abf,1664107755,120,1664106972,,0,0,15.27,3622,3622,96,96,119,119,0,0,0.15,1.1,0.94,,961,165,183,,,,63.01,54.25,63.5,1,58.91,4483,359,,5,1.3,104,100,,,,19,4,147,82,15.23,15.27,15.4,1.3,-2.5,389,389,,1,396,396,,,,,,,,,"0,0,0,0,7,36,46,10,0","0,1,18,80,1","0,0,1,59,40",,,,,154,,,,,,,,,,,,,,,,,,,,,,,,,,,,,,,,,,,,96.4,13,8,12,76,,1015,3,326,0,3,3,Sundern,1,0,U1.000|4:24-U1.000|4:10-U1.000|3:53-U1.000|4:11-U1.000|3:59-U1.000|3:53-U1.000|3:52-U1.000|3:52-U1.000|4:04-U1.000|4:00-U1.000|3:32-U1.000|4:06-U1.000|3:47-U1.000|4:00-U1.000|3:32-U0.274|1:08,,"Sundern (Sauerland) Running",,,3113,,250,3,9672734600,0,168070,250480,30378,,36655013,,,,,,,,,,,,,,,,,,,,,,,,,,,,,,,,,,,,,,,,,
52607135,28b5a70a-b2af-43ae-9119-2dc79974ad5a,1664217468,120,1664215090,,0,0,10,3639,3904,282,278,286,282,0,3.7,0.85,0.96,1.11,442,662,131,147,86,,,50.98,31.87,52.79,1,58.89,2649,65,,2.6,0,95,96,,,,7,3,62,78,10.68,10.42,10.89,-15.2,1.7,241,241,,1,251,251,,,,,,,,,"46,10,10,14,15,4,1,0,0","1,87,12,0,0","0,14,83,2,1",,,,,106,,,,,,,,,,,,,,,,,,,,,,,,,,,,,,,,,,,,19.1,10,24,197,80,,1000,0,324,0,6,3,Balve,1,0,U1.000|6:36-U1.000|7:09-U1.000|6:53-U1.000|7:24-U1.000|7:09-U1.000|5:16-U1.000|4:55-U1.000|5:03-U1.000|4:40-U1.000|5:33-U0.003|0:03,,"Balve Running",,,3113,,250,3,9680600112,0,168070,250480,30378,,36732287,,,,,,,,,,,,,,,,,,,,,,,,,,,,,,,,,,,,,,,,3,
52689647,b3944680-1386-494d-b8e1-5631c8b45d95,1664304840,120,1664304197,,0,0,0.55,375,375,17,12,19,14,0,1.1,0.63,1.02,0.08,,57,119,142,,,,26.1,,27.43,1,58.92,1153,7,,0.5,0,,100,,,,7,3,6,71,6.48,7.29,9.35,16.1,36.9,148,143,,1,250,248,,,,,,,,,"75,0,1,1,2,2,3,6,10","18,79,3,0,0","46,32,7,7,9",,,,,62,,,,,,,,,,,,,,,,,,,,,,,,,,,,,,,,,,,,7.6,9,12,232,92,,1000,0,335,0,6,3,"Menden (Sauerland)",1,0,,,"Menden (Sauerland) Running",,,3113,,250,3,9686946440,0,168070,250480,30378,,36803681,,,,,,,,,,,,,,,,,,,,,,,,,,,,,,,,,,,,,,,,,
52689648,e675700d-5d61-4c70-b005-5547da58fac1,1664303459,120,1664304197,,0,0,3.33,1018,1018,19,36,22,39,0,0.2,0.33,1.14,0.98,,212,135,144,,,,60.9,36.5,60.95,1,58.92,1164,40,,2.2,0,102,101,,,,7,3,22,80,11.75,11.83,11.84,-0.7,-9.2,279,279,,1,283,283,,,,,,,,,"1,1,12,46,35,4,0,0,0","3,90,7,0,0","0,2,81,16,1",,,,,123,,,,,,,,,,,,,,,,,,,,,,,,,,,,,,,,,,,,21.5,9,12,232,92,,1000,0,335,0,6,3,"Menden (Sauerland)",1,0,U1.000|5:08-U1.000|4:58-U1.000|5:10-U0.325|1:42,,"Menden (Sauerland) Running",,,3113,,250,3,9686946380,0,168070,250480,30378,,36803682,,,,,,,,,,,,,,,,,,,,,,,,,,,,,,,,,,,,,,,,,
52689649,46200b9e-c4a4-48f9-8ddf-25d0b83be132,1664308125,120,1664304198,,0,0,2.59,776,777,16,5,20,9,0,0,0.16,1.12,,,174,140,145,,,,59.6,36.61,60.36,1,58.93,2448,41,,2.2,0,104,102,,,,7,3,19,81,12.18,12.09,12.33,7.7,10,297,297,,1,303,303,,,,,,,,,"2,1,5,35,50,6,0,0,0","0,58,42,0,0","0,1,51,48,0",,,,,124,,,,,,,,,,,,,,,,,,,,,,,,,,,,,,,,,,,,22.4,9,12,230,93,,1000,0,336,1,4,3,"Menden (Sauerland)",1,0,U1.000|4:52-U1.000|5:05-U0.593|2:59,,"Menden (Sauerland) Running",,,3113,,250,3,9686946670,0,168070,250480,30378,,36803683,,,,,,,,,,,,,,,,,,,,,,,,,,,,,,,,,,,,,,,,,
52689651,2bd6c8c0-2b1a-46f8-88db-dbf365f435fc,1664305277,120,1664304199,,0,0,7.4,2458,2458,0,0,0,0,0,0,0,,,,522,143,176,,,,51.03,34.76,51.03,1,58.92,2160,160,,3.3,2.1,107,107,,,,19,1,69,80,10.84,13.73,13.73,-2.9,-18.3,271,271,,1,361,361,,,,,,,,,"46,4,3,4,4,5,15,11,7","9,24,39,28,0","26,17,13,18,26",,,,,113,,,,,,,,,,,,,,,,,,,,,,,,,,,,,,,,,,,,46.1,9,12,230,93,,1000,0,336,1,4,3,"Menden (Sauerland)",1,0,U0.960|3:36-U0.520|6:16-U0.260|0:37-U0.090|0:43-U0.230|0:37-U0.110|0:54-U0.150|0:38-U0.160|1:04-U0.170|0:37-U0.090|0:50-U0.260|0:36-U0.480|3:14-U0.400|1:19-U0.100|1:06-U0.410|1:18-U0.110|1:21-U0.420|1:24-U0.250|4:42-U1.000|3:41-U0.200|2:24-U1.000|3:32-U0.030|0:31,,"Menden (Sauerland) Track Running",,,3113,,250,3,9686946577,0,168070,250480,30378,,36803685,,,,,,,,,,,,,,,,,,,,,,,,,,,,,,,,,,,,,,,,,
52751152,0de48a1a-bc52-426b-aa8b-25c315bdfabf,1664388933,120,1664387579,,0,0,13.01,4555,4832,384,374,387,380,0,4,0.93,0.99,0.99,398,894,144,170,,,,47.38,34.05,49.16,1,58.92,1459,103,,3.1,0,96,96,,,,7,1,113,79,11.14,10.81,11.33,-2.7,-0.3,253,253,,1,265,265,,,,,,,,,"41,11,7,11,20,8,1,0,0","0,24,72,4,0","0,13,80,6,1",,,,,108,,,,,,,,,,,,,,,,,,,,,,,,,,,,,,,,,,,,44.1,9,6,233,90,,998,,,0,4,1,Balve,1,0,U1.000|6:32-U1.000|7:03-U1.000|6:45-U1.000|7:12-U1.000|6:58-U1.000|5:49-U1.000|5:46-U1.000|5:59-U1.000|4:50-U1.000|4:38-U1.000|4:53-U1.000|4:38-U1.000|4:49-U0.010|0:04,,"Balve Running",,,3113,,250,3,9692753277,0,168070,250480,30378,,36861321,,,,,,,,,,,,,,,,,,,,,,,,,,,,,,,,,,,,,,,,3,
52794164,87218f70-e99c-4029-8ed2-6d7972508c9f,1664467729,120,1664464976,,0,0,13.03,3951,4077,165,143,192,173,0,1.3,0.47,0.99,0.94,307,833,137,156,,,,60.38,40.3,61.46,1,58.95,1396,135,,3.4,0,102,102,,,,11,1,89,79,12.11,12.16,12.4,-1.1,-3.2,292,292,,1,304,304,,,,,,,,,"3,9,15,25,34,6,6,0,0","0,64,36,0,0","1,1,61,34,4",,,,,125,,,,,,,,,,,,,,,,,,,,,,,,,,,,,,,,,,,,31.7,14,4,298,57,,1004,1,342,0,3,3,Balve,1,0,U1.000|5:36-U1.000|4:41-U1.000|5:06-U1.000|5:07-U1.000|5:12-U1.000|4:53-U1.000|4:42-U0.177|0:47-U1.000|3:45-U0.683|3:48-U1.000|4:48-U1.000|5:19-U1.000|6:03-U1.000|5:13-U0.165|0:51,,"Balve Running",,,3113,,250,3,9697655441,0,168070,250480,30378,,36901792,,,,,,,,,,,,,,,,,,,,,,,,,,,,,,,,,,,,,,,,"5,5",
52852407,a68d122b-b546-461a-94e8-032d95d2f742,1664544568,120,1664542823,,0,0,14.8,4183,4475,163,149,200,187,0,1.2,0.35,1.02,0.96,998,945,146,174,,,,60.57,44.18,61.46,1,58.99,2016,198,,3.8,1.4,100,103,,,,7,2,109,80,12.96,13.11,13.29,-3.6,-8.8,317,317,,1,330,330,,,,,,,,,"4,3,7,17,40,18,7,4,0","1,24,63,12,0","0,1,39,49,11",,,,,133,,,,,,,,,,,,,,,,,,,,,,,,,,,,,,,,,,,,59.6,15,12,226,56,,1012,3,330,0,2,3,Balve,1,0,U1.000|5:19-U1.000|4:48-U1.000|5:09-U1.000|5:08-U1.000|5:08-U1.000|4:50-U1.000|4:37-U1.000|4:32-U1.000|4:20-U1.000|4:52-U1.000|4:41-U0.540|2:24-U1.000|3:33-U1.000|3:39-U1.000|5:17-U0.258|1:26,,"Balve Running",,,3113,,250,3,9702683878,0,168070,250480,30378,,36956513,,,,,,,,,,,,,,,,,,,,,,,,,,,,,,,,,,,,,,,,5,
52931901,c11cb19e-16a6-4929-863c-71ed02a5a6cd,1664638598,120,1664637314,,0,0,13.28,5109,5718,439,385,460,410,0,5,0.83,0.97,1.06,493,901,132,155,,,,47.16,30.51,49.33,1,58.96,1240,92,,3,0,100,97,,,,17,,94,75,10.51,10.25,10.99,-4.5,6.3,235,235,,1,256,256,,,,,,,,,"41,12,10,15,19,3,0,0,0","1,76,23,0,0","1,27,59,11,2",,,,,104,,,,,,,,,,,,,,,,,,,,,,,,,,,,,,,,,,,,24.4,12,21,250,86,,1008,1,318,0,6,3,Balve,1,0,U1.000|5:42-U1.000|5:51-U1.000|6:28-U1.000|9:03-U1.000|10:16-U1.000|6:08-U1.000|4:58-U1.000|7:57-U1.000|6:46-U1.000|6:03-U1.000|4:57-U1.000|4:55-U1.000|4:50-U0.277|1:14,,"Balve Running",,,3113,,250,3,9709402370,0,168070,250480,30378,,37030717,,,,,,,,,,,,,,,,,,,,,,,,,,,,,,,,,,,,,,,,"3,4,5",
52971870,f928dbc8-876f-4a25-b0d3-87ab69b670d8,1664709459,120,1664707901,,0,0,11.87,3504,3655,147,154,165,178,0,1.8,0.47,0.97,0.95,,746,142,170,,,,59.58,41.29,60.45,1,58.99,1454,136,,3.4,0,97,103,,,,11,2,86,79,12.44,12.71,12.79,-4.5,-11.3,300,300,,1,314,314,,,,,,,,,"4,8,14,30,22,5,16,1,0","1,53,32,14,0","0,1,55,39,5",,,,,129,,,,,,,,,,,,,,,,,,,,,,,,,,,,,,,,,,,,57,12,17,218,93,,1017,2,306,0,6,3,Balve,1,0,U1.000|5:46-U1.000|5:05-U1.000|5:15-U1.000|5:17-U1.000|5:36-U1.000|4:52-U0.803|4:09-U1.000|3:54-U0.800|3:49-U1.000|3:43-U1.000|3:45-U0.187|0:43-U1.000|6:03-U0.080|0:25,,"Balve Running",,,3113,,250,3,9714070542,0,168070,250480,30378,,37066855,,,,,,,,,,,,,,,,,,,,,,,,,,,,,,,,,,,,,,,,,
53052563,03e8cfc7-fb8f-459d-9a4b-f27b9a09d79e,1664819388,120,1664815886,,0,0,10.45,3363,3406,174,165,198,189,0,2.1,0.56,0.99,0.99,278,669,135,152,,,,57.16,36.97,58.4,1,58.99,1048,77,,2.8,0,98,100,,,,11,1,66,77,11.57,11.38,11.79,-3.1,-4.8,273,273,,1,283,283,,,,,,,,,"9,15,15,29,26,6,0,0,0","0,78,21,0,0","0,6,71,21,2",,,,,121,,,,,,,,,,,,,,,,,,,,,,,,,,,,,,,,,,,,20.6,13,6,356,74,,1026,0,283,0,4,3,Balve,1,0,U1.000|5:28-U1.000|5:16-U1.000|6:09-U1.000|5:28-U1.000|5:23-U1.000|5:33-U1.000|5:05-U0.322|1:41-U1.000|4:35-U1.000|4:52-U1.000|5:46-U0.129|0:49,,"Balve Running",,,3113,,250,3,9722149324,0,168070,250480,30378,,37141128,,,,,,,,,,,,,,,,,,,,,,,,,,,,,,,,,,,,,,,,"5,5",
53102220,b3eb2cc3-c1c9-49ca-84e1-3a1f82d6f960,1664896207,120,1664892143,,0,0,15.04,3125,3125,9192,10471,129,127,0,9.4,0.7,,,17160,235,,,,,,,,,1,,,,,,,,,,,,,,45,70,,25.23,,,,127,75,,0,142,123,,,,,,,,,"29,14,15,10,19,7,5",,"52,45,2,1,0",,,,,,,,,,,,,,,,,,,,,,,,,,,,,,,,,,,,,,,,,,,,,,,,,,0,1,,,1,1,U10.627|41:45-U4.408|10:20,,,,,315-0,,,7,,0,168072,,30378,,37187610,,,,,,,,,,,,,,,,,,,,,,,,,,,,,,,,,,,,,,,,"0,1,2,2,2,3",
53116417,8eba95be-16ad-4e1b-b6b6-d342d82d5acd,1664906748,120,1664904997,,0,0,4.01,1007,1007,13,24,15,27,0,0,0.05,,,,238,147,162,,,,69.46,46.53,69.5,1,59.06,990,70,,2.7,0,107,107,,,,15,3,29,81,14.3,14.48,14.43,1,1,358,358,,1,364,364,,,,,,,,,"0,2,1,1,18,43,31,3,0","2,13,77,7,0","0,3,4,83,10",,,,,147,,,,,,,,,,,,,,,,,,,,,,,,,,,,,,,,,,,,42,15,10,199,69,,1020,0,265,0,2,3,"Menden (Sauerland)",1,0,U1.000|4:42-U1.000|4:10-U1.000|4:04-U1.000|3:47-U0.011|0:03,,"Menden (Sauerland) Running",,,3113,,250,3,9728847941,0,168070,250480,30378,,37200812,,,,,,,,,,,,,,,,,,,,,,,,,,,,,,,,,,,,,,,,,
53116435,1c745e96-9663-4356-8c40-bc6a7b579979,1664908046,120,1664905016,,0,0,1.47,669,669,39,12,38,11,0,0,0.14,1.46,0.61,,106,122,145,,,,42.06,21.26,44.41,1,59.06,975,17,,1,0.1,,100,,,,7,3,11,67,8.21,8.66,11.04,10.4,25,205,205,,1,291,291,,,,,,,,,"76,1,1,1,2,2,3,8,5","0,95,5,0,0","35,27,11,16,10",,,,,98,,,,,,,,,,,,,,,,,,,,,,,,,,,,,,,,,,,,11.2,15,10,199,69,,1020,0,265,0,2,3,"Menden (Sauerland)",1,0,U0.233|1:47-U1.000|7:28-U0.237|1:54,,"Menden (Sauerland) Running",,,3113,,250,3,9728850809,0,168070,250480,30378,,37200828,,,,,,,,,,,,,,,,,,,,,,,,,,,,,,,,,,,,,,,,,
53116480,aa662c00-cba9-49f1-a0ea-3b3210db7d3a,1664908845,120,1664905062,,0,0,5.91,1903,1903,8,0,8,0,0,0,0.03,,,,386,140,163,,,,54.53,35.57,54.71,1,59.06,1396,95,,2.7,1.6,,100,,,,19,2,47,79,11.2,13.31,13.42,2.6,-10.2,280,280,,1,349,349,,,,,,,,,"48,2,2,3,3,5,11,15,12","1,37,61,1,0","21,21,13,11,34",,,,,118,,,,,,,,,,,,,,,,,,,,,,,,,,,,,,,,,,,,33.3,14,10,191,71,,1020,0,265,0,3,3,"Menden (Sauerland)",1,0,U0.280|0:55-U0.110|0:56-U0.400|1:20-U0.090|0:58-U0.300|0:57-U0.400|2:29-U0.290|0:58-U0.120|1:00-U0.400|1:21-U0.100|1:11-U0.300|0:57-U0.210|2:32-U0.290|0:53-U0.120|0:49-U0.400|1:17-U0.100|0:54-U0.310|0:59-U0.450|5:13-U0.300|0:58-U0.100|0:53-U0.400|1:25-U0.100|0:48-U0.300|0:55-U0.040|1:04,,"Menden (Sauerland) Track Running",,,3113,,250,3,9728857004,0,168070,250480,30378,,37200869,,,,,,,,,,,,,,,,,,,,,,,,,,,,,,,,,,,,,,,,,
53116494,f0115713-0daa-4f23-beca-83fb28af689b,1664910880,120,1664905081,,0,0,3.28,958,958,16,16,19,21,0,0,0.14,1.04,0.88,,214,142,150,,,,60.37,38.45,60.73,1,59.09,1728,51,,2.4,0,104,101,,,,7,3,24,80,12.39,12.4,12.44,4.6,5.5,301,301,,1,303,303,,,,,,,,,"3,3,6,15,58,15,1,0,0","0,23,77,0,0","0,2,40,58,0",,,,,128,,,,,,,,,,,,,,,,,,,,,,,,,,,,,,,,,,,,27.8,14,9,191,71,,1020,0,265,1,3,3,"Menden (Sauerland)",1,0,U1.000|5:06-U1.000|4:43-U1.000|4:46-U0.276|1:22,,"Menden (Sauerland) Running",,,3113,,250,3,9728859820,0,168070,250480,30378,,37200881,,,,,,,,,,,,,,,,,,,,,,,,,,,,,,,,,,,,,,,,,
53179208,97e55165-603d-43fc-9cc2-b8052d2f5453,1664992442,120,1664990720,,0,0,11.11,3821,4435,298,270,291,270,0,3.6,0.85,1.05,1.06,487,700,133,154,,,,53.65,34.35,55.6,1,59.06,1126,70,,2.7,0,98,97,,,,7,2,78,77,11.2,10.94,11.33,1.1,8,259,259,,1,265,265,,,,,,,,,"36,13,11,8,20,9,1,2,0","1,85,14,0,0","0,8,78,13,0",,,,,113,,,,,,,,,,,,,,,,,,,,,,,,,,,,,,,,,,,,24.7,18,19,206,67,,1016,0,263,0,3,3,Balve,1,0,U1.000|6:17-U1.000|6:43-U1.000|6:26-U1.000|6:52-U1.000|6:43-U1.000|5:24-U1.000|4:49-U1.000|4:41-U1.000|4:39-U1.000|4:44-U1.000|5:54-U0.111|0:28,,"Balve Running",,,3113,,250,3,9735121397,0,168070,250480,30378,,37255358,,,,,,,,,,,,,,,,,,,,,,,,,,,,,,,,,,,,,,,,3,
53212354,e1e4332a-7c69-4d0b-8e11-e00ed689036f,1665044754,120,1665038497,,0,0,,908,908,,,,,0,,,,,,70,,,,,,,,,1,,,,,,,,,,,,,,7,,,,,,,,,,,,,,,,,,,,,,,,,,,,,,,,,,,,,,,,,,,,,,,,,,,,,,,,,,,,,,,,,,,,,,,,,,1,,,1,0,,,,,,,,252,7,,0,168073,,30378,,37283689,,,,,,,,,,,,,,,,,,,,,,,,,,,,,,,,,,,,,,,,,
53246809,d7d35e8a-6618-4f39-b92f-bd97bf219f8c,1665078357,120,1665076274,,0,0,14.73,4465,4647,369,378,374,384,0,4,0.9,0.98,1.04,517,932,140,158,91,,,58.75,40.71,60.52,1,59.04,1406,130,,3.4,0,100,99,,,,7,4,106,80,12.58,12.39,12.68,3.4,9.4,296,296,,1,302,302,,,,,,,,,"10,12,18,13,13,25,8,0,0","0,45,54,0,0","0,1,56,42,1",,,,,124,,,,,,,,,,,,,,,,,,,,,,,,,,,,,,,,,,,,31.8,12,8,216,68,,1030,0,299,0,2,3,Balve,1,0,U1.000|5:58-U1.000|5:37-U1.000|5:51-U1.000|5:14-U1.000|4:26-U1.000|4:17-U1.000|4:38-U1.000|6:02-U1.000|6:11-U1.000|5:53-U1.000|4:50-U1.000|3:57-U1.000|4:08-U1.000|4:08-U0.734|3:14,,"Balve Running",,,3113,,250,3,9741155278,0,168070,250480,30378,,37316210,,,,,,,,,,,,,,,,,,,,,,,,,,,,,,,,,,,,,,,,"4,4",
53301543,5bcdf3f2-b1cd-46bb-b420-1a01f04df6ee,1665166995,120,1665162617,,0,0,8.25,2488,2734,101,109,113,120,0,1.6,0.49,1,1,475,531,138,167,,,,60.23,39.25,61.07,1,59.05,1222,105,,3.1,0,100,101,,,,7,3,55,78,12.17,12.53,12.7,2.1,-8.2,292,292,,1,311,311,,,,,,,,,"9,7,14,23,21,13,10,2,0","0,58,37,4,0","2,4,54,36,5",,,,,128,,,,,,,,,,,,,,,,,,,,,,,,,,,,,,,,,,,,42.4,12,7,200,71,,1020,0,293,0,3,3,Balve,1,0,U1.000|5:49-U1.000|4:54-U1.000|5:33-U1.000|5:34-U1.000|5:05-U0.251|1:10-U1.000|3:53-U1.000|4:00-U1.000|5:27-U0.003|0:03,,"Balve Running",,,3113,,250,3,9747016896,0,168070,250480,30378,,37364208,,,,,,,,,,,,,,,,,,,,,,,,,,,,,,,,,,,,,,,,5,
53364952,281b6372-e48a-43ed-aeb8-9d347313deae,1665247286,120,1665252688,,0,0,15.17,4740,4916,387,363,397,371,0,4.2,0.87,0.95,1.02,509,973,140,158,,,,56.59,39.39,58.49,1,59.04,1344,123,,3.3,0,100,99,,,,7,4,107,79,12.26,12.04,12.38,1.6,7,288,288,,1,293,293,,,,,,,,,"15,17,15,10,14,24,5,0,0","0,52,47,0,0","0,0,68,31,1",,,,,122,,,,,,,,,,,,,,,,,,,,,,,,,,,,,,,,,,,,28.3,11,11,273,72,,1023,0,305,0,3,3,Balve,1,0,U1.000|6:01-U1.000|6:17-U1.000|5:48-U1.000|5:51-U1.000|4:51-U1.000|4:26-U1.000|4:23-U1.000|5:26-U1.000|6:43-U1.000|5:51-U1.000|5:32-U1.000|4:32-U1.000|4:14-U1.000|4:18-U1.000|3:59-U0.171|0:47,,"Balve Running",,,3113,,250,3,9753751530,0,168070,250480,30378,,37424725,,,,,,,,,,,,,,,,,,,,,,,,,,,,,,,,,,,,,,,,"4,4,5",
53390765,197083be-d9cc-4a06-91c4-3a259bd7b5f2,1665316585,120,1665310759,,0,0,3.83,1101,1324,43,18,55,29,0,0,0.21,1.15,0.88,,259,147,162,,,,58.76,39.62,60.06,1,59.06,1048,67,,2.7,0,103,101,,,,7,3,30,79,12.88,12.73,13.2,6.6,6.2,320,320,,1,329,329,,,,,,,,,"2,1,4,12,54,26,1,0,0","2,7,90,1,0","1,1,26,64,8",,,,,132,,,,,,,,,,,,,,,,,,,,,,,,,,,,,,,,,,,,32.8,13,13,160,67,,1024,2,296,0,2,3,Sundern,1,0,U1.000|4:36-U1.000|4:40-U1.000|4:53-U0.833|4:12,,"Sundern (Sauerland) Running",,,3113,,250,3,9757063154,0,168070,250480,30378,,37446899,,,,,,,,,,,,,,,,,,,,,,,,,,,,,,,,,,,,,,,,,
53393961,82144a93-871a-40d4-b921-296e88627386,1665317929,120,1665314145,,0,0,10.33,2867,3312,92,47,119,77,0,0,0.18,1.18,,,656,149,167,,,,60.24,43.93,61.23,1,59.07,2592,157,,3.6,0,100,100,,,,7,1,81,81,13.21,13.23,13.56,6.5,6.3,329,329,,1,342,342,,,,,,,,,"5,2,5,13,24,37,13,0,0","0,19,62,19,0","0,2,26,63,8",,,,,133,,,,,,,,,,,,,,,,,,,,,,,,,,,,,,,,,,,,50.9,14,14,162,62,,1024,3,295,0,2,3,Sundern,1,0,U1.000|4:01-U1.000|4:07-U1.000|4:12-U1.000|4:20-U1.000|4:17-U1.000|4:41-U1.000|4:49-U1.000|5:08-U1.000|5:00-U1.000|5:27-U0.332|1:45,,"Sundern (Sauerland) Running",,,3113,,250,3,9757540965,0,168070,250480,30378,,37449927,,,,,,,,,,,,,,,,,,,,,,,,,,,,,,,,,,,,,,,,,
53471624,7dde90e9-eb89-400b-ad9d-7e884f6b8d12,1665426167,120,1665422824,,0,0,10.02,3411,3604,239,220,249,230,0,3.1,0.72,1,1.01,439,647,132,146,105,,,54.84,34.49,56.59,1,59.03,1358,68,,2.7,0,100,97,,,,7,3,54,78,11.21,10.98,11.37,-3.7,6.3,259,259,,1,267,267,,,,,,,,,"31,13,8,19,23,6,0,0,0","1,90,9,0,0","0,4,80,15,0",,,,,113,,,,,,,,,,,,,,,,,,,,,,,,,,,,,,,,,,,,16.2,13,9,294,86,,1019,0,281,1,4,3,Balve,1,0,U1.000|6:24-U1.000|6:51-U1.000|6:20-U1.000|7:06-U1.000|5:35-U1.000|4:59-U1.000|4:59-U1.000|5:02-U1.000|4:33-U1.000|4:54-U0.018|0:08,,"Balve Running",,,3113,,250,3,9765773677,0,168070,250480,30378,,37516934,,,,,,,,,,,,,,,,,,,,,,,,,,,,,,,,,,,,,,,,4,
53526484,930140d9-1da4-40d3-9df6-bcc67c8d2e13,1665512081,120,1665509214,,0,0,13.46,4002,4129,142,135,172,165,0,1.3,0.39,0.99,0.98,451,876,140,159,,,,60.16,41.34,60.99,1,59.06,1454,147,,3.5,0,101,102,,,,13,3,78,79,12.35,12.39,12.54,1.9,-0.1,297,297,,1,305,305,,,,,,,,,"6,6,7,24,40,11,6,0,0","0,46,54,0,0","0,1,55,44,1",,,,,128,,,,,,,,,,,,,,,,,,,,,,,,,,,,,,,,,,,,28.2,10,5,50,82,,1026,0,295,1,3,3,Balve,1,0,U1.000|5:37-U1.000|4:49-U1.000|5:13-U1.000|5:01-U1.000|5:08-U1.000|5:02-U1.000|4:53-U1.000|4:51-U1.000|5:12-U1.000|4:46-U0.233|1:05-U1.000|4:06-U1.000|4:03-U1.000|5:32-U0.227|1:25,,"Balve Running",,,3113,,250,3,9772087835,0,168070,250480,30378,,37567034,,,,,,,,,,,,,,,,,,,,,,,,,,,,,,,,,,,,,,,,5,
53593835,a3d584e6-e559-4cdd-94fd-dd963ccf4a3f,1665597829,120,1665596554,,0,0,4.18,1151,1405,17,40,21,46,0,0,0.13,,1,,257,143,159,,,,64.33,41.91,64.21,1,59.11,990,63,,2.6,0,104,102,,,,7,3,29,79,12.99,13.15,13.01,-1.3,-4.4,316,316,,1,317,317,,,,,,,,,"2,3,3,11,34,40,7,1,0","0,33,67,0,0","0,0,30,68,3",,,,,138,,,,,,,,,,,,,,,,,,,,,,,,,,,,,,,,,,,,30.9,13,5,251,71,,1022,0,291,0,4,3,"Menden (Sauerland)",1,0,U1.000|4:52-U1.000|4:35-U1.000|4:25-U1.000|4:23-U0.182|0:57,,"Menden (Sauerland) Running",,,3113,,250,3,9778720124,0,168070,250480,30378,,37624488,,,,,,,,,,,,,,,,,,,,,,,,,,,,,,,,,,,,,,,,,
53593874,db14c286-80a2-4c7e-bf51-7b5566232e2e,1665599296,120,1665596614,,0,0,9.54,3033,3033,0,0,9,0,0,0,0,,,,600,142,177,,,,54.37,37.25,54.37,1,59.12,2477,177,,3.2,2.6,97,104,,,,19,4,80,79,11.33,13.67,13.67,17.3,0.7,281,281,,1,355,355,,,,,,,,,"46,4,4,4,2,2,6,26,5","1,48,29,22,0","18,24,16,8,35",,,,,119,,,,,,,,,,,,,,,,,,,,,,,,,,,,,,,,,,,,54.6,12,5,199,77,,1023,0,293,1,4,3,"Menden (Sauerland)",1,0,U0.790|2:42-U0.400|2:28-U0.610|2:00-U0.290|1:47-U0.400|1:19-U0.210|1:14-U0.210|0:39-U0.360|3:52-U0.800|2:42-U0.390|2:36-U0.610|1:59-U0.300|2:12-U0.400|1:19-U0.210|1:38-U0.190|0:38-U0.300|3:32-U0.800|2:41-U0.400|3:03-U0.610|2:01-U0.290|2:22-U0.400|1:17-U0.190|1:32-U0.210|0:36-U0.170|4:23,,"Menden (Sauerland) Track Running",,,3113,,250,3,9778727081,0,168070,250480,30378,,37624524,,,,,,,,,,,,,,,,,,,,,,,,,,,,,,,,,,,,,,,,,
53593890,4fe9f0e2-c40c-4d5f-a965-e2ea067686c3,1665602554,120,1665596629,,0,0,3.29,984,984,24,28,21,27,0,0,0.18,1.09,0.98,,219,145,168,,,,57.01,37.41,57.44,1,59.12,3168,50,,2.3,0,100,101,,,,7,3,27,80,12.02,12.05,12.2,-0.5,6.5,290,290,,1,297,297,,,,,,,,,"1,0,6,36,53,3,0,0,0","0,53,30,17,0","0,0,75,24,0",,,,,125,,,,,,,,,,,,,,,,,,,,,,,,,,,,,,,,,,,,31.1,11,5,196,80,,1023,0,294,1,4,3,"Menden (Sauerland)",1,0,U1.000|4:57-U1.000|4:56-U1.000|5:04-U0.285|1:27,,"Menden (Sauerland) Running",,,3113,,250,3,9778729259,0,168070,250480,30378,,37624540,,,,,,,,,,,,,,,,,,,,,,,,,,,,,,,,,,,,,,,,,
53644775,c10efa62-886a-46ab-a9c4-80d558d0c2d5,1665683538,120,1665681817,,0,0,13.12,4462,4509,354,338,361,347,0,3.8,0.81,0.93,1.05,428,892,134,150,,,,53.89,35.26,55.78,1,59.1,1883,100,,3.1,0,98,97,,,,7,2,84,79,11.34,10.99,11.43,-9.4,2.7,261,261,,1,267,267,,,,,,,,,"30,16,13,11,21,9,1,0,0","0,77,23,0,0","0,9,82,10,0",,,,,112,,,,,,,,,,,,,,,,,,,,,,,,,,,,,,,,,,,,24.3,12,7,195,94,,1018,0,302,0,6,3,Balve,1,0,U1.000|6:18-U1.000|6:28-U1.000|6:12-U1.000|6:43-U1.000|6:35-U1.000|5:51-U1.000|5:25-U1.000|5:35-U1.000|5:24-U1.000|5:13-U1.000|4:41-U1.000|4:42-U1.000|4:38-U0.117|0:37,,"Balve Running",,,3113,,250,3,9784446740,0,168070,250480,30378,,37668005,,,,,,,,,,,,,,,,,,,,,,,,,,,,,,,,,,,,,,,,3,
53701106,b6342d01-b556-4711-8976-7d98dbd9fbed,1665767103,120,1665764392,,0,0,14.24,3994,4143,207,184,227,210,0,2.2,0.52,1,1.01,337,881,145,162,,,,61.72,44.44,62.95,1,59.13,1584,141,,3.5,0,107,96,,,,13,3,100,80,13.22,13.02,13.37,0.5,-2.3,323,323,,1,329,329,,,,,,,,,"3,3,7,14,31,31,11,0,0","1,18,80,0,0","0,0,28,67,4",,,,,134,,,,,,,,,,,,,,,,,,,,,,,,,,,,,,,,,,,,34,13,12,204,100,,1011,0,294,0,6,3,Balve,1,0,U1.000|4:22-U1.000|4:28-U1.000|4:22-U1.000|4:33-U1.000|4:42-U1.000|4:55-U1.000|4:55-U1.000|5:10-U1.000|4:08-U1.000|4:33-U1.000|4:25-U1.000|4:36-U1.000|4:38-U1.000|5:23-U0.235|1:22,,"Balve Running",,,3113,,250,3,9789691997,0,168070,250480,30378,,37718930,,,,,,,,,,,,,,,,,,,,,,,,,,,,,,,,,,,,,,,,"4,5,5",
53702704,d8b1dfa4-1583-4b43-92c7-dbed76cb3d9b,1665772678,120,1665766403,,0,0,,909,909,,,,,0,,,,,,70,,,,,,,,,1,,,,,,,,,,,,,,6,,,,,,,,,,,,,,,,,,,,,,,,,,,,,,,,,,,,,,,,,,,,,,,,,,,,,,,,,,,,,,,,,,,,,,,,,,1,,,1,0,,,,,,,,252,7,,0,168073,,30378,,37720383,,,,,,,,,,,,,,,,,,,,,,,,,,,,,,,,,,,,,,,,,
53722477,97e064fe-467a-4c53-b161-c368d7e622dc,1665827187,120,1665820525,,0,0,,525,525,,,,,0,,,,,,40,,,,,,,,,1,,,,,,,,,,,,,,4,,,,,,,,,,,,,,,,,,,,,,,,,,,,,,,,,,,,,,,,,,,,,,,,,,,,,,,,,,,,,,,,,,,,,,,,,,1,,,1,0,,,,,,,,252,7,,0,168073,,30378,,37738626,,,,,,,,,,,,,,,,,,,,,,,,,,,,,,,,,,,,,,,,,
53742412,def7b1e5-5ab8-431d-ac9c-94aa2ca26299,1665844958,120,1665844495,,0,0,16.01,4840,5151,354,351,365,363,0,3.9,0.78,0.91,1.02,527,1025,143,157,,,,57.32,41.11,58.9,1,59.14,1584,144,,3.5,0,99,100,,,,,,108,79,12.52,12.69,12.65,0.8,3.7,292,292,,1,298,298,,,,,,,,,"12,13,17,8,11,30,9,0,0","0,28,72,0,0","0,1,54,45,0",,,,,126,,,,,,,,,,,,,,,,,,,,,,,,,,,,,,,,,,,,29.1,16,17,204,96,,1008,1,288,0,4,3,Balve,1,0,U1.000|6:12-U1.000|6:08-U1.000|5:37-U1.000|6:05-U1.000|4:17-U1.000|4:01-U1.000|4:10-U1.000|5:02-U1.000|7:03-U1.000|5:33-U1.000|4:18-U1.000|4:25-U1.000|4:14-U1.000|4:07-U1.000|4:21-U1.000|5:01-U0.014|0:04,,"Balve Running",,,3113,,250,3,9795121672,0,168070,250480,30378,,37756929,,,,,,,,,,,,,,,,,,,,,,,,,,,,,,,,,,,,,,,,"4,4",
53785125,6fd67243-d121-4cfa-91db-957fd7f42b53,1665920763,120,1665918958,,0,0,0.29,93,93,7,0,6,0,0,1.2,1,,,,18,125,143,,,,63.01,27.45,66.8,1,59.14,237,4,,0.3,0,,100,,,,,,1,76,12.3,11.45,12.44,9.4,9.2,305,305,,1,307,307,,,,,,,,,"0,9,14,66,12,0,0,0,0","0,75,25,0,0","0,0,45,55,0",,,,,123,,,,,,,,,,,,,,,,,,,,,,,,,,,,,,,,,,,,0.5,14,15,233,90,,1017,2,280,0,3,3,Sundern,1,0,,,"Sundern (Sauerland) Running",,,3113,,250,3,9800041368,0,168070,250480,30378,,37796156,,,,,,,,,,,,,,,,,,,,,,,,,,,,,,,,,,,,,,,,,
53800807,14aea6b2-9966-42a5-87fc-27a72bdeb397,1665924694,120,1665933106,,0,0,0.72,243,243,4,4,10,10,0,0,0,,0.87,,51,136,142,,,,53.4,27.84,53.77,1,59.19,4315,12,,0.8,0,,100,,,,,,4,79,10.69,10.83,10.96,-14.9,-19.3,251,251,,1,259,259,,,,,,,,,"12,3,15,54,16,0,0,0,0","0,90,10,0,0","0,16,84,0,0",,,,,113,,,,,,,,,,,,,,,,,,,,,,,,,,,,,,,,,,,,6.2,15,14,235,81,,1017,2,280,0,3,3,Sundern,1,0,,,"Sundern (Sauerland) Running",,,3113,,250,3,9801923406,0,168070,250480,30378,,37808916,,,,,,,,,,,,,,,,,,,,,,,,,,,,,,,,,,,,,,,,,
53800809,5749e976-86e8-4d4c-bb37-9b874dcae94b,1665920938,120,1665933106,,0,0,15.23,3640,3659,93,89,133,129,0,0,0.15,,,,954,164,179,,,,63.01,53.77,63.51,1,59.19,4320,351,,5,2.1,104,101,,,,,,131,82,15.08,15.37,15.46,1.6,-4.3,380,380,,1,393,393,,,,,,,,,"1,0,1,1,7,38,43,10,0","0,1,14,85,0","0,1,5,65,28",,,,,153,,,,,,,,,,,,,,,,,,,,,,,,,,,,,,,,,,,,75,14,15,233,87,,1017,2,281,0,3,3,Sundern,1,0,U1.000|4:17-U1.000|3:59-U1.000|3:58-U1.000|4:07-U1.000|3:42-U1.000|4:03-U1.000|4:00-U1.000|3:50-U1.000|4:11-U1.000|4:01-U1.000|3:32-U1.000|4:20-U1.000|3:44-U1.000|3:35-U1.000|4:35-U0.227|0:47,,"Sundern (Sauerland) Running",,,3113,,250,3,9801923103,0,168070,250480,30378,,37808917,,,,,,,,,,,,,,,,,,,,,,,,,,,,,,,,,,,,,,,,,
53801973,33c77629-8df3-4836-9b2c-250c59eebf5d,1665940890,120,1665934459,,0,0,1.33,762,762,41,455,4,6,0,2.1,0.69,,,211,14,,,,,,,,,1,,,,,,,,,,,,,,7,58,,15.83,,,,74,18,,0,84,52,,,,,,,,,"48,19,14,5,12,2,0",,"92,8,0,0,0",,,,,,,,,,,,,,,,,,,,,,,,,,,,,,,,,,,,,,,,,,,,,,,,,,0,1,,,1,1,U0.047|0:09-U1.281|12:33,,,,,315-0,,,7,,0,168072,,30378,,37809988,,,,,,,,,,,,,,,,,,,,,,,,,,,,,,,,,,,,,,,,4,
53805455,eb68c30b-c496-4e82-983b-57aefc49c58f,1665942926,120,1665937671,,0,0,0.56,1820,1820,3,430,0,10,0,1.2,1,,,,1,,,,,,,,,1,,,,,,,,,,,,,,17,63,,9.43,,,,42,0,,0,42,10,,,,,,,,,"19,32,49,0,0,0,0",,"100,0,0,0,0",,,,,,,,,,,,,,,,,,,,,,,,,,,,,,,,,,,,,,,,,,,,,,,,,,0,1,,,1,1,U0.046|0:09-U0.512|30:12,,,,,315-0,,,7,,0,168072,,30378,,37813231,,,,,,,,,,,,,,,,,,,,,,,,,,,,,,,,,,,,,,,,,
53837791,dda9babd-7a7a-4032-864d-177d327e3416,1666017667,120,1666011175,,0,0,0.89,207,207,70,482,2,8,0,3.2,1,,,1853,7,,,,,,,,,1,,,,,,,,,,,,,,2,75,,21.03,,,,51,33,,0,52,47,,,,,,,,,"30,27,8,35,0,0,0",,"98,2,0,0,0",,,,,,,,,,,,,,,,,,,,,,,,,,,,,,,,,,,,,,,,,,,,,,,,,,1,1,,,1,1,U0.048|0:10-U0.838|3:17,,,,,315-0,,,7,,0,168072,,30378,,37842224,,,,,,,,,,,,,,,,,,,,,,,,,,,,,,,,,,,,,,,,4,
53862813,45d2234b-53e7-4134-8361-84244385bbda,1666029362,120,1666031343,,0,0,9.84,3283,3694,249,224,246,228,0,3.1,0.88,0.94,1.08,496,628,131,145,,,,56.75,35.27,58.7,1,59.19,2515,66,,2.6,0,97,100,,,,,,54,78,11.52,11.7,11.7,-10.4,-0.5,263,263,,1,268,268,,,,,,,,,"37,13,5,6,13,21,4,0,0","2,92,6,0,0","1,2,89,8,0",,,,,115,,,,,,,,,,,,,,,,,,,,,,,,,,,,,,,,,,,,17.1,17,8,231,90,,1025,0,265,0,4,3,Balve,1,0,U1.000|6:37-U1.000|6:53-U1.000|6:39-U1.000|7:08-U1.000|5:08-U1.000|4:15-U1.000|4:27-U1.000|5:05-U1.000|4:17-U0.837|4:15,,"Balve Running",,,3113,,250,3,9808759412,0,168070,250480,30378,,37865832,,,,,,,,,,,,,,,,,,,,,,,,,,,,,,,,,,,,,,,,4,
53918531,d2759f36-c52b-4909-8235-9047eab302bb,1666107338,120,1666101545,,0,0,7.16,3136,3136,10062,9199,125,107,0,9.5,0.86,1.01,0.59,45388,140,82,115,,,,,,,1,,,,,,,,,,,,,,2,82,,26.88,,-49,23,114,100,,0,138,133,,,,,,,,,"41,20,7,12,8,3,10","90,10,0,0,0","56,36,7,0,0",,,,,,,,,,,,,,,,,,,,,,,,,,,,,,,,,,,,,,,,,0.2,,,,,,,,,0,1,,,1,1,,,,,,315-0,,,7,,0,168072,,30378,,37916888,,,,,,,,,,,,,,,,,,,,,,,,,,,,,,,,,,,,,,,,"0,4",
53933864,54ff16d7-4ee5-4906-b9ad-f26393155c8c,1666117340,120,1666114647,,0,0,1.22,311,311,4,0,6,2,0,0,0,,,,73,149,161,,,,66.92,40.53,67.46,1,59.19,1051,29,,1.5,0.5,,100,,,,,,8,85,14.27,15.68,15.81,-5.8,-12.2,355,355,,1,410,410,,,,,,,,,"28,1,9,5,4,3,7,28,16","0,14,85,2,0","0,8,37,17,38",,,,,138,,,,,,,,,,,,,,,,,,,,,,,,,,,,,,,,,,,,17.8,15,6,338,83,,1028,0,283,0,2,3,"Menden (Sauerland)",1,0,U0.142|0:27-U0.115|0:39-U0.190|0:38-U0.103|0:45-U0.251|0:47-U0.107|0:52-U0.293|0:56-U0.021|0:07,,"Menden (Sauerland) Running",,,3113,,250,3,9814629587,0,168070,250480,30378,,37931040,,,,,,,,,,,,,,,,,,,,,,,,,,,,,,,,,,,,,,,,,
53933927,4770b392-aa47-438a-9297-2caad953859b,1666120356,120,1666114661,,0,0,3.28,1050,1092,16,24,21,31,0,0,0.12,,0.8,,215,134,149,,,,58.07,34.54,58.25,1,59.19,1396,39,,2.2,0,101,102,,,,,,19,79,11.21,11.29,11.31,-0.9,2.2,262,262,,1,267,267,,,,,,,,,"9,5,18,39,25,5,0,0,0","1,78,21,0,0","1,4,86,9,0",,,,,119,,,,,,,,,,,,,,,,,,,,,,,,,,,,,,,,,,,,16.3,13,4,346,84,,1028,0,280,1,2,3,"Menden (Sauerland)",1,0,U1.000|5:30-U1.000|5:20-U1.000|5:11-U0.283|1:29,,"Menden (Sauerland) Running",,,3113,,250,3,9814636876,0,168070,250480,30378,,37931107,,,,,,,,,,,,,,,,,,,,,,,,,,,,,,,,,,,,,,,,,
53934063,d94d0fe3-d7e7-485d-94b5-e74b068ecf4a,1666118444,120,1666114689,,0,0,5.88,1660,1660,8,0,9,1,0,0,0.03,,,,326,139,164,,,,64.74,41.56,64.96,1,59.19,1280,62,,2.3,0.9,,100,,,,,,35,82,12.79,14.55,14.66,11.2,0.4,321,321,,1,380,380,,,,,,,,,"41,2,1,1,1,3,10,32,9","0,51,48,1,0","11,26,9,8,47",,,,,130,,,,,,,,,,,,,,,,,,,,,,,,,,,,,,,,,,,,25.2,13,4,346,84,,1028,0,280,1,2,3,"Menden (Sauerland)",1,0,U0.490|1:41-U0.120|0:50-U0.510|1:38-U0.100|0:54-U0.510|1:38-U0.310|2:47-U0.500|1:38-U0.110|1:03-U0.500|1:37-U0.100|1:05-U0.500|1:36-U0.390|4:02-U0.510|1:39-U0.100|1:03-U0.500|1:40-U0.100|1:02-U0.510|1:38-U0.020|0:10,,"Menden (Sauerland) Track Running",,,3113,,250,3,9814635506,0,168070,250480,30378,,37931241,,,,,,,,,,,,,,,,,,,,,,,,,,,,,,,,,,,,,,,,,
53934119,3c18a99b-68a4-4fb6-8c90-09b3cb9f7d95,1666117860,120,1666114700,,0,0,1.12,294,294,2,0,6,4,0,0,0.08,,,,65,140,159,,,,70.19,38.84,70.5,1,59.19,1044,26,,1.2,0.6,,100,,,,,,6,83,13.74,16.12,16.28,6.6,-8.2,341,341,,1,427,427,,,,,,,,,"32,7,2,6,3,3,5,22,18","0,49,51,0,0","0,17,32,17,34",,,,,138,,,,,,,,,,,,,,,,,,,,,,,,,,,,,,,,,,,,12.8,14,4,343,85,,1028,0,281,1,3,3,"Menden (Sauerland)",1,0,U0.120|0:40-U0.200|0:35-U0.118|0:51-U0.254|0:46-U0.106|0:59-U0.299|0:55-U0.021|0:07,,"Menden (Sauerland) Running",,,3113,,250,3,9814630434,0,168070,250480,30378,,37931296,,,,,,,,,,,,,,,,,,,,,,,,,,,,,,,,,,,,,,,,,
53947900,,1666103040,120,1666128286,,0,0,4,1080,1080,,,,,0,,,,,,271,,,,,,,42.76,,1,,,,,,,,,,,,,,25,,,,,,,,,,,,,,,,,,,,,,,,,,,,,,,,,,,,,,,,,,,,,,,,,,,,,,,,,,,,,,,,,,,,,,,,,,1,,,0,0,,,Running,,,connect,,,3,9815882152,0,168070,250480,30378,,37941552,,,,,,,,,,,,,,,,,,,,,,,,,,,,,,,,,,,,,,,,,
53986840,e7cdacba-f976-4da4-99a4-493bb50f2ffc,1666184989,120,1666182471,,0,0,13.12,4415,4543,393,353,403,362,0,4.6,0.91,1.04,1.14,509,856,134,153,,,,54.6,35.7,56.84,1,59.16,1238,91,,3,0,100,98,,,,,,81,78,11.48,11.33,11.81,-5,12,262,262,,1,273,273,,,,,,,,,"30,17,12,8,14,18,1,0,0","1,83,16,0,0","0,4,81,15,0",,,,,114,,,,,,,,,,,,,,,,,,,,,,,,,,,,,,,,,,,,21.6,13,9,93,71,,1027,2,272,0,3,3,Balve,1,0,U1.000|6:22-U1.000|6:41-U1.000|6:10-U1.000|6:49-U1.000|6:36-U1.000|5:57-U1.000|5:36-U1.000|5:30-U1.000|5:13-U1.000|5:00-U1.000|4:20-U1.000|4:22-U1.000|4:25-U0.122|0:34,,"Balve Running",,,3113,,250,3,9819027862,0,168070,250480,30378,,37976873,,,,,,,,,,,,,,,,,,,,,,,,,,,,,,,,,,,,,,,,"3,4",
54077216,c88b297c-3b2d-4934-9791-abc4b7cf428f,1666288289,120,1666285960,,0,0,14.08,4377,4720,141,139,166,167,0,0.7,0.32,0.99,1.01,420,913,140,181,,,,56.94,39.39,57.66,1,59.18,1454,144,,3.5,0.2,100,100,,,,,,98,78,11.78,13.13,12.96,7.3,-1.1,278,278,,1,318,318,,,,,,,,,"12,20,28,14,4,1,14,7,0","1,67,19,13,0","0,6,70,13,11",,,,,124,,,,,,,,,,,,,,,,,,,,,,,,,,,,,,,,,,,,61.7,13,12,167,97,,1014,0,266,1,6,3,Balve,1,0,U1.000|6:03-U1.000|5:43-U1.000|5:43-U1.000|5:45-U1.000|5:24-U1.000|3:37-U1.000|3:44-U1.000|5:36-U1.000|6:12-U0.468|3:04-U1.000|3:30-U1.000|3:33-U0.167|0:34-U1.000|6:09-U1.000|5:35-U0.445|2:44,,"Balve Running",,,3113,,250,3,9826563021,0,168070,250480,30378,,38054056,,,,,,,,,,,,,,,,,,,,,,,,,,,,,,,,,,,,,,,,5,
54102892,5c7c6a22-35cf-4501-b21a-32b788f20e24,1666344612,120,1666338314,,0,0,,887,887,,,,,0,,,,,,68,,,,,,,,,1,,,,,,,,,,,,,,7,,,,,,,,,,,,,,,,,,,,,,,,,,,,,,,,,,,,,,,,,,,,,,,,,,,,,,,,,,,,,,,,,,,,,,,,,,1,,,1,0,,,,,,,,252,7,,0,168073,,30378,,38077165,,,,,,,,,,,,,,,,,,,,,,,,,,,,,,,,,,,,,,,,,
54124725,aea521cb-0593-49eb-8ade-e8d86f803480,1666373265,120,1666371070,,0,0,16.03,4772,4894,355,349,360,354,0,3.8,0.78,0.89,1,546,1016,137,162,,,,61.77,41.86,63.5,1,59.17,1459,147,,3.4,0.7,101,99,,,,,,107,79,12.71,13.05,13.02,-4.5,-8.3,297,297,,1,311,311,,,,,,,,,"13,11,18,9,14,19,14,3,0","0,66,33,0,0","0,0,62,33,5",,,,,128,,,,,,,,,,,,,,,,,,,,,,,,,,,,,,,,,,,,33.5,16,15,206,93,,1010,0,284,0,3,3,Balve,1,0,U1.000|5:59-U1.000|6:08-U1.000|5:41-U1.000|6:14-U1.000|4:43-U1.000|4:32-U1.000|4:19-U1.000|5:05-U1.000|7:01-U1.000|5:42-U1.000|4:26-U1.000|4:18-U1.000|4:06-U1.000|3:52-U1.000|3:37-U1.000|3:41-U0.026|0:08,,"Balve Running",,,3113,,250,3,9831941755,0,168070,250480,30378,,38097769,,,,,,,,,,,,,,,,,,,,,,,,,,,,,,,,,,,,,,,,"4,4",
54171694,24b4487d-3af7-4045-9af6-1c154be0e814,1666451732,120,1666446203,,0,0,4.11,1475,1545,74,44,80,51,0,0.8,0.4,1.05,0.58,,320,148,176,,,,44.28,30.58,45.66,1,59.19,2929,101,,2.6,2.1,96,94,,,,,,42,75,10.28,13.16,13.41,-11.1,-7.8,244,244,,1,346,346,,,,,,,,,"50,10,10,4,4,1,5,14,2","0,27,51,21,0","17,19,42,5,16",,,,,111,,,,,,,,,,,,,,,,,,,,,,,,,,,,,,,,,,,,48.7,16,14,240,81,,1016,1,300,0,3,3,Balve,1,0,U0.185|1:11-U0.154|0:31-U0.165|1:24-U0.154|0:31-U0.323|2:01-U1.000|6:20-U0.427|3:54-U1.000|4:02-U0.702|4:41,,"Balve Running",,,3113,,250,3,9836783834,0,168070,250480,30378,,38141533,,,,,,,,,,,,,,,,,,,,,,,,,,,,,,,,,,,,,,,,,
54171695,b10b012e-981a-48a8-b54f-d37bb4ee4c82,1666450397,120,1666446204,,0,0,4.18,1244,1307,8,12,13,17,0,0,0.05,,,,303,160,174,,,,49.89,38.25,49.95,1,59.2,1454,107,,3.1,0.9,102,101,,,,,,45,77,12.1,12.71,12.7,-25.5,-25.2,292,292,,1,312,312,,,,,,,,,"27,2,2,2,4,40,9,8,4","0,5,34,61,0","7,14,15,57,6",,,,,131,,,,,,,,,,,,,,,,,,,,,,,,,,,,,,,,,,,,62.4,15,13,240,81,,1016,1,300,0,3,3,Balve,1,0,U0.110|0:35-U0.110|0:21-U0.290|1:50-U0.120|0:21-U0.290|2:03-U0.400|2:28-U0.120|0:22-U0.090|0:53-U0.520|2:45-U1.600|6:43-U0.530|2:23,,"Balve Track Running",,,3113,,250,3,9836783728,0,168070,250480,30378,,38141535,,,,,,,,,,,,,,,,,,,,,,,,,,,,,,,,,,,,,,,,,
54171696,06e2ac45-dda8-4514-beb6-7d2e46dea2a7,1666448003,120,1666446203,,0,0,3.09,860,2363,16,45,16,45,0,0.1,0.33,1.1,1,,196,137,154,,,,67.14,40.48,66.79,1,59.18,758,48,,2.3,0,103,102,,,,,,19,78,12.71,13.02,12.76,2.6,-1.3,300,300,,1,303,303,,,,,,,,,"1,1,2,14,36,43,3,0,0","3,54,43,0,0","0,1,38,61,0",,,,,138,,,,,,,,,,,,,,,,,,,,,,,,,,,,,,,,,,,,23.4,16,14,234,84,,1016,1,302,0,3,3,Balve,1,0,U1.000|4:44-U1.000|4:47-U1.000|4:25-U0.092|0:24,,"Balve Running",,,3113,,250,3,9836783619,0,168070,250480,30378,,38141534,,,,,,,,,,,,,,,,,,,,,,,,,,,,,,,,,,,,,,,,,
54217949,e62a1c9e-0e33-4f6c-9cd8-0d670c738dce,1666528069,120,1666526474,,0,0,15.28,3677,3688,127,120,167,162,0,0,0.24,1.1,0.86,,974,157,180,,,,66.69,53.36,67.42,1,59.21,4320,362,,5,2.1,104,99,,,,,,127,82,15,15.19,15.39,18.1,14,378,378,,1,392,392,,,,,,,,,"1,0,0,1,11,31,49,7,0","0,16,32,52,0","0,1,7,56,36",,,,,152,,,,,,,,,,,,,,,,,,,,,,,,,,,,,,,,,,,,87.8,16,14,158,78,,1013,2,293,0,4,3,Sundern,1,0,U1.000|4:01-U1.000|3:54-U1.000|3:50-U1.000|3:58-U1.000|3:47-U1.000|3:45-U1.000|3:54-U1.000|3:52-U1.000|3:59-U1.000|3:59-U1.000|4:28-U1.000|3:42-U1.000|4:32-U1.000|3:36-U1.000|4:51-U0.275|1:09,,"Sundern (Sauerland) Running",,,3113,,250,3,9842559887,0,168070,250480,30378,,38183246,,,,,,,,,,,,,,,,,,,,,,,,,,,,,,,,,,,,,,,,,
54297564,f6749256-aac3-4290-8f5e-0adbd2515943,1666635106,120,1666631335,,0,0,9.98,3065,3083,173,180,188,198,0,2.2,0.66,0.94,1.05,521,641,140,160,,,,57.8,38.92,58.99,1,59.21,2308,88,,3,0,100,100,,,,,,70,78,11.88,12.01,12,-1.3,-2.2,279,279,,1,284,284,,,,,,,,,"7,8,16,19,32,17,1,0,0","0,56,44,0,0","0,0,76,23,0",,,,,125,,,,,,,,,,,,,,,,,,,,,,,,,,,,,,,,,,,,31.7,14,18,219,81,,1012,0,293,1,4,3,Balve,1,0,U1.000|5:35-U1.000|4:57-U1.000|5:19-U1.000|5:12-U1.000|5:00-U1.000|5:31-U1.000|5:11-U1.000|4:17-U1.000|4:20-U0.983|5:44,,"Balve Running",,,3113,,250,3,9849961639,0,168070,250480,30378,,38258439,,,,,,,,,,,,,,,,,,,,,,,,,,,,,,,,,,,,,,,,"5,5",
54341964,011c5c63-dcfc-48ae-ab4a-edeb695d3131,1666704253,120,1666702316,,0,0,14.05,4279,4599,357,317,375,342,0,3.8,0.77,0.93,1.04,459,883,139,154,89,,,58.95,40.34,61.02,1,59.21,1586,109,,3.2,0,100,100,,,,,,91,80,12.6,12.9,12.92,-4,6.1,295,295,,1,306,306,,,,,,,,,"19,11,15,9,11,20,13,1,0","1,50,49,0,0","0,2,59,37,2",,,,,123,,,,,,,,,,,,,,,,,,,,,,,,,,,,,,,,,,,,26.9,14,14,230,90,,1018,2,275,0,3,3,Balve,1,0,U1.000|6:00-U1.000|6:13-U1.000|5:41-U1.000|6:19-U1.000|6:21-U1.000|5:25-U1.000|5:08-U1.000|5:09-U1.000|4:39-U1.000|4:20-U1.000|4:04-U1.000|4:07-U1.000|3:40-U1.000|3:59-U0.052|0:14,,"Balve Running",,,3113,,250,3,9854475753,0,168070,250480,30378,,38300075,,,,,,,,,,,,,,,,,,,,,,,,,,,,,,,,,,,,,,,,"4,4,5",
54422562,f62f5f14-e220-42d1-9e0e-c0cecaddaccf,1666807010,120,1666808438,,0,0,4.02,1131,1131,13,49,14,50,0,0,0.27,,0.98,,243,136,145,,,,66.86,40.76,66.39,1,59.28,758,48,,2.3,0,105,106,,,,,,23,78,12.54,12.87,12.65,4.6,7.5,297,297,,1,303,303,,,,,,,,,"1,3,3,8,53,29,2,0,0","2,76,22,0,0","0,3,56,42,0",,,,,137,,,,,,,,,,,,,,,,,,,,,,,,,,,,,,,,,,,,19.1,17,12,230,80,,1018,0,261,0,3,3,"Menden (Sauerland)",1,0,U1.000|4:45-U1.000|4:32-U1.000|4:43-U1.000|4:44-U0.023|0:08,,"Menden (Sauerland) Running",,,3113,,250,3,9862847471,0,168070,250480,30378,,38375451,,,,,,,,,,,,,,,,,,,,,,,,,,,,,,,,,,,,,,,,,
54422601,31dca8be-6a77-4c61-8e72-bb20fa03f1cc,1666810958,120,1666808447,,0,0,3.3,1023,1216,66,31,68,32,0,1.2,0.38,1.25,1.03,857,213,134,147,,,,60.42,35.88,62.72,1,59.3,2160,37,,2.1,0,101,99,,,,,,19,79,12.06,11.66,13.11,3.3,5.3,293,293,,1,327,327,,,,,,,,,"4,1,9,47,39,0,0,0,0","2,88,9,0,0","0,3,70,18,9",,,,,122,,,,,,,,,,,,,,,,,,,,,,,,,,,,,,,,,,,,17.1,15,10,216,89,,1020,0,260,1,3,3,"Menden (Sauerland)",1,0,U1.000|5:15-U1.000|4:57-U1.000|5:10-U0.298|1:42,,"Menden (Sauerland) Running",,,3113,,250,3,9862847680,0,168070,250480,30378,,38375489,,,,,,,,,,,,,,,,,,,,,,,,,,,,,,,,,,,,,,,,4,
54422619,58beb8b7-fc5a-4f5a-82b1-87b8ea69b6a7,1666808638,120,1666808451,,0,0,7.55,1955,1955,24,0,23,0,0,0,0.05,,,,464,146,173,,,,67.5,46.69,68.03,1,59.28,1872,177,,3.5,2.1,107,109,,,,,,52,83,14.04,15.31,15.63,14,9.2,357,357,,1,407,407,,,,,,,,,"21,3,6,5,3,6,22,27,7","1,34,45,20,0","5,12,18,10,54",,,,,140,,,,,,,,,,,,,,,,,,,,,,,,,,,,,,,,,,,,47,16,10,219,87,,1019,0,260,1,3,3,"Menden (Sauerland)",1,0,U1.000|3:32-U0.600|3:32-U1.000|3:28-U0.400|2:41-U1.020|3:28-U0.200|1:45-U0.990|3:29-U0.210|1:27-U0.990|3:28-U0.100|1:01-U1.020|3:26-U0.020|1:19,,"Menden (Sauerland) Track Running",,,3113,,250,3,9862847595,0,168070,250480,30378,,38375507,,,,,,,,,,,,,,,,,,,,,,,,,,,,,,,,,,,,,,,,,
54467939,d00256b1-045a-438c-a429-18ca9a2553cd,1666892193,120,1666890073,,0,0,14.29,4194,4294,163,167,187,190,0,1.3,0.42,0.98,0.99,,890,138,168,82,,,62.29,42.17,63.14,1,59.31,1872,154,,3.5,0.4,101,100,,,,,,90,78,12.41,13.41,13.36,-7.2,-18.8,297,297,,1,331,331,,,,,,,,,"5,8,25,21,16,4,15,6,0","1,70,18,11,0","0,4,65,21,11",,,,,131,,,,,,,,,,,,,,,,,,,,,,,,,,,,,,,,,,,,53.5,17,13,172,77,,1021,0,249,0,4,3,Balve,1,0,U1.000|5:44-U1.000|5:27-U1.000|5:10-U1.000|5:13-U1.000|5:19-U1.000|5:06-U0.781|3:47-U1.000|3:35-U1.000|3:44-U1.000|5:19-U1.000|5:37-U0.471|2:37-U1.000|3:34-U1.000|3:35-U1.000|5:47-U0.040|0:18,,"Balve Running",,,3113,,250,3,9868301841,0,168070,250480,30378,,38416229,,,,,,,,,,,,,,,,,,,,,,,,,,,,,,,,,,,,,,,,,
54493415,89c829a5-1da5-4986-984f-fbded4aef717,1666949595,120,1666944928,,0,0,6.61,2166,2292,95,107,105,118,0,1.7,0.69,1.02,1.03,399,440,140,161,,,,53.36,35.07,54.19,1,59.28,1183,62,,2.6,0,98,97,,,,,,47,78,11.08,11.22,11.32,-0.6,1.8,257,257,,1,266,266,,,,,,,,,"7,14,26,27,22,3,0,0,0","0,51,49,0,0","0,2,87,11,0",,,,,117,,,,,,,,,,,,,,,,,,,,,,,,,,,,,,,,,,,,23.4,17,14,181,78,,1020,0,258,0,4,3,Balve,1,0,U1.000|5:33-U1.000|5:08-U1.000|5:35-U1.000|5:29-U1.000|5:50-U1.000|5:28-U0.614|3:05,,"Balve Running",,,3113,,250,3,9871389051,0,168070,250480,30378,,38437076,,,,,,,,,,,,,,,,,,,,,,,,,,,,,,,,,,,,,,,,5,
54535487,5f1a7354-8297-415e-ada9-f931c479dd6a,1667029233,120,1667027071,,0,0,14.02,4645,4802,325,332,351,361,0,3.7,0.69,1.08,0.99,455,961,140,167,,,,52.64,36.55,54.12,1,59.29,1396,128,,3.4,0,102,100,,,,,,115,79,11.32,11.26,11.73,-0.3,-4.4,261,261,,1,278,278,,,,,,,,,"20,11,16,20,19,13,1,0,0","0,46,52,2,0","2,17,51,29,1",,,,,115,,,,,,,,,,,,,,,,,,,,,,,,,,,,,,,,,,,,48.4,12,4,170,92,,1022,0,260,0,4,3,Strotzbüsch,1,0,U1.000|4:27-U1.000|6:00-U1.000|5:22-U1.000|6:37-U1.000|5:53-U1.000|5:31-U1.000|6:26-U1.000|5:27-U1.000|5:08-U1.000|5:34-U1.000|5:39-U1.000|5:43-U1.000|5:08-U1.000|4:25-U0.020|0:06,,"Strotzbüsch Running",,,3113,,250,3,9876550003,0,168070,250480,30378,,38474945,,,,,,,,,,,,,,,,,,,,,,,,,,,,,,,,,,,,,,,,"4,4,5,5",
54551863,f5275206-9722-4e02-84eb-396f08243bac,1667038863,120,1667048421,,0,0,16.53,16609,16609,412,406,426,421,0,4,0.59,,,109,1113,87,131,,,,,,,1,59.31,1040,14,,1,0,,100,,,,,,110,57,,4.5,,-24.9,,,,,,,,,,,,,,,,"73,27,0,0,0,0","77,23,0,0,0",,,,,,,,,,,,,,,,,,,,,,,,,,,,,,,,,,,,,,,,,,10.5,17,7,204,84,,1022,2,260,0,4,3,Strotzbüsch,1,0,,,"Strotzbüsch Hiking",,,3113,,250,3,9878630189,0,168075,,30378,,38489727,,,,,,,,,,,,,,,,,,,,,,,,,,,,,,,,,,,,,,,,"4,4,5,5,5",
54620357,86800e02-ac97-43f1-918e-e5c4e99dccf3,1667116397,60,1667147458,,0,0,12.06,3837,4032,251,240,274,268,0,3,0.67,0.97,1.06,420,763,134,157,102,,,58.52,37.87,60.09,1,59.29,1164,85,,3,0,99,100,,,,,,73,79,11.73,11.65,11.96,-5.1,-2,273,273,,1,281,281,,,,,,,,,"10,10,15,29,24,12,0,0,0","1,73,26,0,0","0,5,72,22,1",,,,,119,,,,,,,,,,,,,,,,,,,,,,,,,,,,,,,,,,,,23.9,11,3,190,93,,1020,0,254,0,3,3,Strotzbüsch,1,0,U1.000|5:32-U1.000|5:24-U1.000|6:25-U1.000|5:20-U1.000|5:27-U1.000|5:14-U1.000|5:21-U1.000|4:47-U1.000|5:02-U1.000|4:40-U1.000|5:53-U1.000|4:37-U0.058|0:17,,"Strotzbüsch Running",,,3113,,250,3,9887323646,0,168070,250480,30378,,38553360,,,,,,,,,,,,,,,,,,,,,,,,,,,,,,,,,,,,,,,,"5,5",
54620392,ebdaef2c-a092-4576-97c8-9c40f3acc29c,1667128913,60,1667147503,,0,0,2.5,9533,9533,203,186,144,123,0,2.9,0.84,,,54,643,87,128,76,,,,,,1,59.31,861,5,,0.3,0,,100,,,,,,41,55,,2.67,,-5.1,,,,,,,,,,,,,,,,"98,2,0,0,0,0","85,15,0,0,0",,,,,,,,,,,,,,,,,,,,,,,,,,,,,,,,,,,,,,,,,,4.5,17,11,206,79,,1020,2,256,0,3,3,Manderscheid,1,0,,,"Manderscheid Climb",,,3113,,250,3,9887329635,0,168075,,30378,,38553395,,,,,,,,,,,,,,,,,,,,,,,,,,,,,,,,,,,,,,,,4,
54684555,fcde10bb-3a67-45a5-9a74-0bf591054ea8,1667236864,60,1667238813,,0,0,10.02,3101,3137,171,177,177,183,0,2.5,0.67,0.95,1.01,373,645,133,155,107,,,61.12,38.58,62.36,1,59.29,1164,86,,3,0,100,100,,,,,,58,77,11.81,11.81,11.95,4.4,4.5,277,277,,1,284,284,,,,,,,,,"6,10,12,20,43,8,0,0,0","1,76,23,0,0","0,0,75,24,0",,,,,126,,,,,,,,,,,,,,,,,,,,,,,,,,,,,,,,,,,,26,16,11,151,74,,1016,0,263,1,3,3,Balve,1,0,U1.000|5:27-U1.000|4:50-U1.000|5:08-U1.000|5:17-U1.000|5:09-U1.000|5:34-U1.000|5:07-U1.000|4:47-U1.000|4:35-U1.000|5:41-U0.019|0:06,,"Balve Running",,,3113,,250,3,9893444001,0,168070,250480,30378,,38611921,,,,,,,,,,,,,,,,,,,,,,,,,,,,,,,,,,,,,,,,"5,5",
54719160,f300e0bb-a013-4c26-bcee-9a510272ef12,1667299442,60,1667301258,,0,0,15.18,3690,3847,93,85,134,125,0,0,0.2,1.16,,,968,161,178,,,,63.45,52.71,63.98,1,59.32,4320,322,,4.9,1.6,104,100,,,,,,136,81,14.87,14.95,15.03,9.8,8.2,372,372,,1,379,379,,,,,,,,,"0,0,0,1,7,47,43,2,0","0,5,28,67,0","0,0,2,81,17",,,,,152,,,,,,,,,,,,,,,,,,,,,,,,,,,,,,,,,,,,78,13,17,236,76,,1018,1,287,0,3,3,Sundern,1,0,U1.000|4:09-U1.000|3:59-U1.000|4:01-U1.000|3:56-U1.000|3:58-U1.000|4:01-U1.000|3:58-U1.000|3:54-U1.000|4:05-U1.000|3:59-U1.000|4:28-U1.000|4:16-U1.000|3:40-U1.000|4:34-U1.000|3:51-U0.178|0:39,,"Sundern (Sauerland) Running",,,3113,,250,3,9897337357,0,168070,250480,30378,,38642708,,,,,,,,,,,,,,,,,,,,,,,,,,,,,,,,,,,,,,,,,
54868864,19a34995-771e-4f31-b7e0-762fe800c1a2,1667409805,60,1667495283,,0,0,4.59,1334,1346,15,49,16,51,0,0,0.19,,0.85,,290,136,146,,,,64.23,39.57,63.9,1,59.34,2571,56,,2.5,0,104,102,,,,,,27,79,12.22,12.43,12.25,5.4,7.1,287,287,,1,291,291,,,,,,,,,"4,0,1,14,66,14,0,0,0","3,86,12,0,0","0,5,60,35,0",,,,,131,,,,,,,,,,,,,,,,,,,,,,,,,,,,,,,,,,,,19.6,12,12,207,75,,1021,0,302,1,3,3,"Menden (Sauerland)",1,0,U1.000|4:41-U1.000|4:56-U1.000|4:43-U1.000|4:48-U0.587|3:05,,"Menden (Sauerland) Running",,,3113,,250,3,9911464381,0,168070,250480,30378,,38779700,,,,,,,,,,,,,,,,,,,,,,,,,,,,,,,,,,,,,,,,,
54868865,5b19556b-363c-4d9e-ae94-80257b4e7e1a,1667315704,60,1667495283,,0,0,1.02,221,221,3,0,2,1,0,0,0,,,,58,145,169,,,,85.04,47.76,85.67,1,59.32,4110,30,,2,0,,100,,,,,,6,85,16.76,16.85,17.06,22.1,25.7,435,435,,1,444,444,,,,,,,,,"0,0,0,0,0,14,39,43,2","7,14,73,5,0","0,0,0,18,82",,,,,163,,,,,,,,,,,,,,,,,,,,,,,,,,,,,,,,,,,,15,16,17,213,64,,1017,0,288,0,2,3,"Menden (Sauerland)",1,0,,,"Menden (Sauerland) Track Running",,,3113,,250,3,9911464311,0,168070,250480,30378,,38779701,,,,,,,,,,,,,,,,,,,,,,,,,,,,,,,,,,,,,,,,,
54868867,458122c2-0517-4dd6-b6b3-d0175d3e0cd3,1667415592,60,1667495285,,0,0,1.28,420,420,22,0,24,2,0,0.7,0.51,0.97,,,87,131,146,,,,57.92,30.66,60.39,1,59.34,4430,18,,1.2,0,,100,,,,,,7,77,11.62,11.11,11.8,-6.1,-5.6,281,281,,1,287,287,,,,,,,,,"5,5,33,45,12,0,0,0,0","0,92,8,0,0","0,0,90,10,0",,,,,119,,,,,,,,,,,,,,,,,,,,,,,,,,,,,,,,,,,,10.3,11,13,200,76,,1021,0,299,1,3,3,"Menden (Sauerland)",1,0,U1.000|5:29-U0.279|1:31,,"Menden (Sauerland) Running",,,3113,,250,3,9911464573,0,168070,250480,30378,,38779704,,,,,,,,,,,,,,,,,,,,,,,,,,,,,,,,,,,,,,,,,
54868868,53ab7a97-c974-41e1-bdfa-dd3a0a41e792,1667411899,60,1667495286,,0,0,8.82,3339,3356,28,32,33,37,0,0,0.09,,0.56,1337,634,143,171,,,,43.43,30.12,43.57,1,59.34,4440,143,,3.2,2.1,,100,,,,,,86,78,9.77,11.87,12.1,26.4,-10.7,231,230,,1,306,306,,,,,,,,,"57,6,5,3,2,3,4,12,8","5,24,54,17,0","25,27,18,12,19",,,,,102,,,,,,,,,,,,,,,,,,,,,,,,,,,,,,,,,,,,46.9,11,12,202,76,,1021,0,300,1,3,3,"Menden (Sauerland)",1,0,U0.200|0:55-U0.200|0:37-U0.210|1:04-U0.200|0:38-U0.200|1:11-U0.200|0:38-U0.200|1:11-U0.190|0:38-U0.200|1:14-U0.210|0:37-U0.200|2:12-U0.190|0:36-U0.210|1:19-U0.190|0:37-U0.200|1:17-U0.200|0:36-U0.200|1:22-U0.200|0:36-U0.200|1:31-U0.200|0:37-U0.210|1:29-U0.200|0:37-U0.300|7:32-U0.190|1:19-U0.200|0:35-U0.200|1:20-U0.200|0:36-U0.210|1:30-U0.200|0:36-U0.200|1:39-U0.200|0:37-U0.200|1:40-U0.200|0:38-U0.270|5:44-U0.190|0:35-U0.200|1:35-U0.200|0:36-U0.200|1:38-U0.200|0:37-U0.200|1:37-U0.200|0:37-U0.210|1:47-U0.200|0:37-U0.040|0:48,,"Menden (Sauerland) Track Running",,,3113,,250,3,9911464529,0,168070,250480,30378,,38779703,,,,,,,,,,,,,,,,,,,,,,,,,,,,,,,,,,,,,,,,5,
54868872,7c53538a-1281-424d-8156-a4118ed17ad3,1667496344,60,1667495288,,0,0,6.03,2096,2199,85,110,96,121,0,1.7,0.62,0.95,1.02,,389,126,143,,,,56.52,32.51,57.21,1,59.33,3029,41,,2.2,0,96,95,,,,,,33,77,10.44,10.61,10.56,-1.8,-2.6,236,236,,1,241,241,,,,,,,,,"19,14,30,28,8,1,0,0,0","1,95,5,0,0","0,5,94,1,0",,,,,112,,,,,,,,,,,,,,,,,,,,,,,,,,,,,,,,,,,,13.2,11,19,179,81,,1006,0,301,1,6,3,Balve,1,0,U1.000|6:00-U1.000|5:22-U1.000|5:37-U1.000|6:03-U1.000|6:04-U1.000|5:40-U0.028|0:10,,"Balve Running",,,3113,,250,3,9911464627,0,168070,250480,30378,,38779708,,,,,,,,,,,,,,,,,,,,,,,,,,,,,,,,,,,,,,,,,
54917655,419c9358-c389-4642-89d9-e30d937c58da,1667565870,60,1667565006,,0,0,6.04,1959,2484,133,83,139,92,0,2.2,0.62,1.02,0.97,402,400,137,157,100,,,55.57,35.31,57.65,1,59.33,1830,68,,2.7,0,98,99,,,,,,42,78,11.57,11.32,12.19,1.7,13.1,274,274,,1,298,298,,,,,,,,,"10,10,21,32,23,4,0,0,0","2,63,36,0,0","0,2,81,16,2",,,,,119,,,,,,,,,,,,,,,,,,,,,,,,,,,,,,,,,,,,24.2,10,7,245,87,,1008,1,323,0,3,3,Balve,1,0,U1.000|5:06-U1.000|5:17-U1.000|5:50-U1.000|5:20-U1.000|5:01-U1.000|5:50-U0.039|0:15,,"Balve Running",,,3113,,250,3,9915642082,0,168070,250480,30378,,38823831,,,,,,,,,,,,,,,,,,,,,,,,,,,,,,,,,,,,,,,,4,
54970169,771a2658-4910-40ee-a4f7-3f76ea1574e3,1667644157,60,1667646322,,0,0,16.01,4567,4815,377,336,387,348,0,4.4,0.69,0.94,1.02,610,1026,145,169,,,,60.44,43.98,62.4,1,59.33,2016,187,,3.8,1.1,98,100,,,,,,118,80,13.32,13.66,13.89,-4.4,-8.4,317,317,,1,335,335,,,,,,,,,"10,11,14,13,7,19,22,4,0","0,25,70,4,0","0,1,42,47,10",,,,,131,,,,,,,,,,,,,,,,,,,,,,,,,,,,,,,,,,,,47.2,8,13,223,95,,1019,1,294,0,3,3,Balve,1,0,U1.000|5:58-U1.000|6:07-U1.000|5:34-U1.000|5:58-U1.000|4:32-U1.000|4:13-U1.000|3:55-U1.000|4:35-U1.000|6:26-U1.000|5:10-U1.000|4:00-U1.000|4:04-U1.000|3:56-U1.000|3:48-U0.356|1:26-U1.000|3:28-U0.650|2:57,,"Balve Running",,,3113,,250,3,9920716045,0,168070,250480,30378,,38870601,,,,,,,,,,,,,,,,,,,,,,,,,,,,,,,,,,,,,,,,"4,4",
55049895,742dffcb-db20-4a18-bbd8-d599422d0621,1667750327,60,1667750830,,0,0,15.35,3987,4042,72,56,123,108,0,0,0.07,1.06,,,939,150,162,,,,64.78,48.86,65.24,1,59.4,2016,181,,3.9,0,104,104,,,,,,122,79,13.92,13.98,14.08,3.6,5,344,344,,1,350,350,,,,,,,,,"0,0,1,5,26,49,18,1,0","0,8,91,1,0","0,0,8,87,5",,,,,146,,,,,,,,,,,,,,,,,,,,,,,,,,,,,,,,,,,,47.8,9,20,183,67,,1011,0,287,0,4,3,Sundern,1,0,U1.000|4:29-U1.000|4:08-U1.000|4:02-U1.000|4:15-U1.000|4:08-U1.000|4:19-U1.000|4:23-U1.000|4:37-U1.000|4:35-U1.000|4:05-U1.000|4:10-U1.000|4:16-U1.000|4:25-U1.000|4:21-U1.000|4:25-U0.354|1:48,,"Sundern (Sauerland) Running",,,3113,,250,3,9929189484,0,168070,250480,30378,,38943923,,,,,,,,,,,,,,,,,,,,,,,,,,,,,,,,,,,,,,,,,
55126367,,1667826480,60,1667858934,,0,0,14,4320,4320,,,,,0,,,,,,925,,,,,,,39.71,,1,,,,,,,,,,,,,,88,,,,,,,,,,,,,,,,,,,,,,,,,,,,,,,,,,,,,,,,,,,,,,,,,,,,,,,,,,,,,,,,,,,,,,,,,,1,,,0,0,,,Running,,,connect,,,3,9936565539,0,168070,250480,30378,,39012692,,,,,,,,,,,,,,,,,,,,,,,,,,,,,,,,,,,,,,,,,
55177438,4833a14c-2f11-4ed5-8e52-16c5a97ab4d9,1667930019,60,1667930989,,0,0,10.39,3152,3300,175,171,202,202,0,2.6,0.6,1.13,1,662,662,137,165,,,,60.35,39.6,61.64,1,59.41,1222,102,,3.1,0.1,99,100,,,,,,67,78,12.02,12.44,12.81,-4.2,-11.3,286,286,,1,315,315,,,,,,,,,"3,8,18,33,22,7,9,1,0","1,64,34,2,0","0,3,60,31,5",,,,,127,,,,,,,,,,,,,,,,,,,,,,,,,,,,,,,,,,,,37.8,14,19,189,72,,1010,0,284,1,4,3,Balve,1,0,U1.000|5:23-U1.000|5:23-U1.000|5:07-U1.000|5:26-U1.000|5:37-U1.000|5:19-U0.854|4:11-U1.000|3:44-U1.000|4:03-U1.000|5:19-U0.538|2:59,,"Balve Running",,,3113,,250,3,9941319412,0,168070,250480,30378,,39060502,,,,,,,,,,,,,,,,,,,,,,,,,,,,,,,,,,,,,,,,"4,5",
55235731,2e04e051-bf58-49d9-8dbf-a4d12a44dac4,1668017420,60,1668021845,,0,0,4.01,1106,1106,24,25,27,28,0,0,0.21,1.13,,,258,141,152,106,,,65.41,41.71,65.87,1,59.48,990,69,,2.7,0,104,102,,,,,,26,80,13.09,13.14,13.27,6,10.5,319,319,,1,326,326,,,,,,,,,"4,1,2,6,35,46,6,0,0","2,19,79,0,0","0,3,11,82,3",,,,,136,,,,,,,,,,,,,,,,,,,,,,,,,,,,,,,,,,,,27.9,12,19,229,83,,1013,0,309,1,4,3,"Menden (Sauerland)",1,0,U1.000|4:57-U1.000|4:30-U1.000|4:26-U1.000|4:27-U0.010|0:06,,"Menden (Sauerland) Running",,,3113,,250,3,9947774320,0,168070,250480,30378,,39114450,,,,,,,,,,,,,,,,,,,,,,,,,,,,,,,,,,,,,,,,,
55235732,3c7ecf8c-7b8a-4b80-ab4a-3b84429b0a41,1668021560,60,1668021846,,0,0,3.28,1028,1080,23,15,34,26,0,0,0.13,1.13,,,222,140,155,,,,56.37,35.41,57.03,1,59.48,1584,45,,2.3,0,102,101,,,,,,23,79,11.58,11.64,11.88,2.4,4.4,275,275,,1,287,287,,,,,,,,,"2,2,16,51,24,4,1,0,0","0,52,48,0,0","0,3,79,19,0",,,,,121,,,,,,,,,,,,,,,,,,,,,,,,,,,,,,,,,,,,21.6,12,18,228,84,,1014,0,311,1,4,3,"Menden (Sauerland)",1,0,U1.000|5:02-U1.000|5:07-U1.000|5:15-U0.282|1:44,,"Menden (Sauerland) Running",,,3113,,250,3,9947774483,0,168070,250480,30378,,39114451,,,,,,,,,,,,,,,,,,,,,,,,,,,,,,,,,,,,,,,,,
55235733,b59e659d-893c-4398-b490-d3e9747c8a44,1668019301,60,1668021847,,0,0,2.26,667,667,8,2,7,1,0,0,0.09,1.41,,,152,139,171,,,,61.28,36.78,61.75,1,59.48,1338,88,,2.4,2,,100,,,,,,16,81,12.25,14.68,14.87,31.9,9.2,310,310,,1,385,385,,,,,,,,,"30,1,1,0,1,6,36,23,1","12,27,43,18,0","21,11,4,9,56",,,,,125,,,,,,,,,,,,,,,,,,,,,,,,,,,,,,,,,,,,29.1,12,19,229,83,,1013,0,309,1,4,3,"Menden (Sauerland)",1,0,U1.600|8:15-U0.660|2:52,,"Menden (Sauerland) Track Running",,,3113,,250,3,9947774378,0,168070,250480,30378,,39114452,,,,,,,,,,,,,,,,,,,,,,,,,,,,,,,,,,,,,,,,,
55235735,3f11dc70-7244-48d3-94eb-9a6d84531341,1668020494,60,1668021848,,0,0,1.92,623,623,46,36,48,39,0,1.5,0.74,1.01,0.25,,110,124,152,97,,,62.69,32.46,64.95,1,59.48,1316,19,,1.3,0,,100,,,,,,10,70,11.15,14.91,16.03,16.3,-14.5,296,296,,1,436,436,,,,,,,,,"66,0,1,1,1,2,3,7,20","4,84,12,0,0","49,8,6,5,32",,,,,132,,,,,,,,,,,,,,,,,,,,,,,,,,,,,,,,,,,,9.7,11,18,228,84,,1014,0,311,1,4,3,"Menden (Sauerland)",1,0,U0.190|0:36-U0.150|1:32-U0.200|0:37-U0.370|1:53-U0.190|0:36-U0.150|1:48-U0.300|0:37-U0.150|1:51-U0.200|0:37-U0.020|0:16,,"Menden (Sauerland) Track Running",,,3113,,250,3,9947774437,0,168070,250480,30378,,39114453,,,,,,,,,,,,,,,,,,,,,,,,,,,,,,,,,,,,,,,,,
55294658,90116b23-d214-4ef9-a6f0-06fb23e54926,1668104309,60,1668112680,,0,0,13.03,4425,4809,117,122,146,148,0,1.1,0.35,1.1,0.95,446,864,136,160,,,,53,35.3,53.56,1,59.47,1286,115,,3.1,1,98,99,,,,,,94,77,10.64,11.79,12.02,16,-14.8,248,248,,1,299,299,,,,,,,,,"21,17,14,25,17,2,1,2,1","1,65,34,0,0","2,26,57,12,3",,,,,115,,,,,,,,,,,,,,,,,,,,,,,,,,,,,,,,,,,,28.6,10,12,209,72,,1028,0,276,1,3,3,Balve,1,0,U1.000|5:40-U1.000|5:34-U1.000|5:20-U1.000|5:35-U1.000|5:03-U1.000|4:57-U1.000|5:44-U0.705|3:50-U0.415|1:17-U0.411|2:33-U0.202|0:52-U0.205|0:37-U0.416|2:53-U1.000|5:47-U1.000|6:41-U1.000|6:49-U0.672|4:33,,"Balve Running",,,3113,,250,3,9953883267,0,168070,250480,30378,,39167893,,,,,,,,,,,,,,,,,,,,,,,,,,,,,,,,,,,,,,,,5,
55332938,20e43cb0-1614-4ab7-90a3-7fb7520cdb7e,1668182839,60,1668186835,,0,0,7.72,2318,2702,111,122,122,136,0,1.3,0.49,1.18,1.01,527,487,133,152,,,,63.44,39.28,64.46,1,59.48,990,70,,2.7,0,101,100,,,,,,47,78,12.08,12.14,12.44,8.5,14.1,286,286,,1,299,299,,,,,,,,,"3,3,9,36,37,11,2,0,0","2,79,19,0,0","0,0,68,30,2",,,,,128,,,,,,,,,,,,,,,,,,,,,,,,,,,,,,,,,,,,22.9,10,7,186,63,,1032,0,271,0,3,3,Balve,1,0,U1.000|5:16-U1.000|4:45-U1.000|5:11-U1.000|5:01-U1.000|5:13-U1.000|5:07-U0.158|0:45-U1.000|4:27-U0.562|2:52,,"Balve Running",,,3113,,250,3,9958566680,0,168070,250480,30378,,39203463,,,,,,,,,,,,,,,,,,,,,,,,,,,,,,,,,,,,,,,,5,
55405513,b7aa1094-5c33-4308-a3ec-e0bd9a7b5f45,1668259626,60,1668322766,,0,0,3.71,1405,1689,29,10,44,18,0,0,0.27,,0.57,,275,134,159,104,,,47.2,28.49,47.95,1,59.48,876,58,,2.5,0,97,99,,,,,,31,77,9.62,11.04,11.27,-16.3,-19.5,225,225,,1,275,275,,,,,,,,,"35,5,15,16,9,16,4,0,0","1,60,39,0,0","17,18,40,24,0",,,,,103,,,,,,,,,,,,,,,,,,,,,,,,,,,,,,,,,,,,33.2,12,5,152,58,,1032,1,274,0,3,3,Hörstel,1,0,U1.000|6:36-U1.000|7:33-U1.000|4:57-U0.708|4:20,,"Hörstel Running",,,3113,,250,3,9966973077,0,168070,250480,30378,,39265578,,,,,,,,,,,,,,,,,,,,,,,,,,,,,,,,,,,,,,,,,
55405517,25d746c4-d887-4cb7-9600-298435e9a1bc,1668262220,60,1668322783,,0,0,10.32,2411,2411,41,46,72,78,0,0,0.07,,,,668,174,185,117,,,59.04,53.71,59.3,1,59.46,4333,288,,4.7,0.7,98,99,,,,,,121,85,15.41,15.59,15.61,5.8,4.6,389,389,,1,397,397,,,,,,,,,"0,0,0,1,3,26,63,7,0","0,1,3,93,3","0,0,0,74,26",,,,,151,,,,,,,,,,,,,,,,,,,,,,,,,,,,,,,,,,,,115.3,12,4,135,60,,1031,0,274,0,3,3,Hörstel,1,0,U1.000|3:46-U1.000|3:39-U1.000|3:55-U1.000|3:47-U1.000|3:58-U1.000|3:53-U1.000|3:54-U1.000|4:09-U1.000|3:58-U1.000|4:06-U0.324|1:06,,"Hörstel Running",,,3113,,250,3,9966973768,0,168070,250480,30378,,39265582,,,,,,,,,,,,,,,,,,,,,,,,,,,,,,,,,,,,,,,,,
55405521,d2aa8557-17fb-4118-9198-8ec58d0ca747,1668265458,60,1668322790,,0,0,4.02,1271,1271,51,33,75,57,0,0.9,0.28,1.41,0.94,1446,273,139,166,,,,56.29,35.53,57.48,1,59.48,4320,52,,2.4,0,99,100,,,,,,30,79,11.59,11.42,14,4.2,29.5,279,279,,1,342,342,,,,,,,,,"4,4,16,46,29,1,0,0,0","0,71,27,2,0","0,2,85,6,6",,,,,120,,,,,,,,,,,,,,,,,,,,,,,,,,,,,,,,,,,,24.8,12,4,118,58,,1031,0,274,0,3,3,Hörstel,1,0,U1.000|5:18-U1.000|5:18-U1.000|5:15-U1.000|5:11-U0.023|0:08,,"Hörstel Running",,,3113,,250,3,9966974059,0,168070,250480,30378,,39265585,,,,,,,,,,,,,,,,,,,,,,,,,,,,,,,,,,,,,,,,4,
55422262,19742683-737a-4dd1-931d-76783ac118b0,1668339611,60,1668341809,,0,0,13.74,4566,4851,356,289,386,316,0,4.1,0.82,1,1.03,455,933,136,148,,,,54.43,36.36,56.51,1,59.48,2968,115,,3.2,0,,100,,,,,,99,78,11.47,11.41,12.16,-4.5,16.7,265,265,,1,291,291,,,,,,,,,"21,20,13,14,23,8,1,0,0","1,84,15,0,0","0,2,88,9,1",,,,,116,,,,,,,,,,,,,,,,,,,,,,,,,,,,,,,,,,,,27.2,15,5,115,59,,1024,1,273,0,2,3,Balve,1,0,U1.000|6:23-U1.000|6:45-U1.000|6:20-U1.000|7:02-U1.000|5:33-U1.000|5:23-U1.000|6:07-U1.000|5:38-U1.000|4:39-U1.000|4:37-U1.000|4:20-U1.000|4:43-U1.000|4:51-U0.736|3:46,,"Balve Running",,,3113,,250,3,9968923234,0,168070,250480,30378,,39281410,,,,,,,,,,,,,,,,,,,,,,,,,,,,,,,,,,,,,,,,"4,4",
55524628,8a29c683-c7bd-47a7-a1ab-901dd7ed9a07,1668442153,60,1668508464,,0,0,16.01,4823,4956,363,337,367,341,0,3.8,0.76,0.99,0.98,550,1108,163,175,,,,47.8,41.28,49.23,1,59.48,2736,185,,3.9,0,,100,,,,,,191,79,12.52,12.49,12.65,-0.5,-0.3,294,294,,1,301,301,,,,,,,,,"8,12,16,12,17,30,4,0,0","0,2,22,75,0","0,0,54,44,2",,,,,126,,,,,,,,,,,,,,,,,,,,,,,,,,,,,,,,,,,,81.8,9,15,162,81,,1012,0,310,1,3,3,Balve,1,0,U1.000|5:47-U1.000|6:07-U1.000|5:31-U1.000|6:08-U1.000|4:42-U1.000|4:21-U1.000|4:18-U1.000|5:04-U1.000|6:46-U1.000|5:24-U1.000|4:34-U1.000|4:36-U1.000|4:21-U1.000|4:19-U1.000|3:58-U1.000|4:28-U0.008|0:02,,"Balve Running",,,3113,,250,3,9979727959,0,168070,250480,30378,,39375739,,,,,,,,,,,,,,,,,,,,,,,,,,,,,,,,,,,,,,,,"4,4",
55538058,39e336da-81d5-4cfc-a7cb-6a6af8726b8c,1668515696,60,1668522352,,0,0,12.85,3706,3966,398,263,409,273,0,4.3,0.81,,,498,920,,,,,,,42.68,,1,59.48,1529,,,,0,,100,,,,,,89,80,13.35,14.15,14.59,,,325,325,,1,370,370,,,,,,,,,"4,4,7,36,25,23,0,0,1",,"0,2,36,57,6",,,,,130,,,,,,,,,,,,,,,,,,,,,,,,,,,,,,,,,,,,,11,16,180,82,,1008,1,275,0,4,3,Balve,1,0,U1.000|5:14-U1.000|5:32-U1.000|5:01-U1.000|5:22-U1.000|4:51-U1.000|5:14-U1.000|5:03-U1.000|4:44-U1.000|4:41-U1.000|4:38-U1.000|4:11-U1.000|3:32-U0.849|3:43,,"Balve Running",,,3113,,250,3,9980903866,0,168070,250480,30378,,39385752,,,,,,,,,,,,,,,,,,,,,,,,,,,,,,,,,,,,,,,,"3,5",
55629670,a40550ce-aa6e-4f90-b16d-718da211f682,1668623438,60,1668626821,,0,0,0.87,494,494,48,33,48,33,0,1.3,0.54,1.15,0.14,276,75,117,142,,,,33.49,15.34,36.54,1,59.48,859,9,,0.6,0,,100,,,,,,6,67,6.5,11.4,12.28,40.4,5.3,162,152,,1,330,327,,,,,,,,,"83,2,0,2,1,1,3,2,5","13,84,3,0,0","34,47,8,5,6",,,,,79,,,,,,,,,,,,,,,,,,,,,,,,,,,,,,,,,,,,6.9,10,9,149,81,,1001,0,289,1,3,3,"Menden (Sauerland)",1,0,,,"Menden (Sauerland) Running",,,3113,,250,3,9988227784,0,168070,250480,30378,,39468626,,,,,,,,,,,,,,,,,,,,,,,,,,,,,,,,,,,,,,,,5,
55629671,fe48a127-e518-4b6d-bba3-b7a727763e7c,1668621958,60,1668626821,,0,0,4.06,1016,1039,4,46,5,46,0,0,0.1,,0.92,,228,145,157,,,,71.08,46.76,70.25,1,59.48,874,56,,2.5,0,,100,,,,,,26,80,14.02,14.87,14.42,0.5,-8.1,341,341,,1,356,356,,,,,,,,,"2,2,0,3,5,70,11,4,3","3,17,80,0,0","0,0,9,81,10",,,,,150,,,,,,,,,,,,,,,,,,,,,,,,,,,,,,,,,,,,34,10,9,155,82,,1001,0,291,1,3,3,"Menden (Sauerland)",1,0,U1.000|4:30-U1.000|4:09-U1.000|4:00-U1.000|3:58-U0.064|0:20,,"Menden (Sauerland) Running",,,3113,,250,3,9988227738,0,168070,250480,30378,,39468627,,,,,,,,,,,,,,,,,,,,,,,,,,,,,,,,,,,,,,,,,
55629672,c8346db0-b645-48d5-b55e-beb95674e720,1668626258,60,1668626822,,0,0,3.07,1011,1067,77,46,79,46,0,2,0.53,1.17,1.05,687,210,140,160,,,,53.03,33.25,55.35,1,59.48,2016,40,,2.2,0,,100,,,,,,23,79,11.51,11.19,13.11,-1.6,-10.9,276,276,,1,321,321,,,,,,,,,"10,15,19,46,6,0,1,1,2","0,47,53,0,0","0,0,78,17,6",,,,,115,,,,,,,,,,,,,,,,,,,,,,,,,,,,,,,,,,,,23.6,10,8,141,80,,1002,0,285,1,3,3,"Menden (Sauerland)",1,0,U1.000|5:14-U1.000|5:09-U1.000|6:03-U0.068|0:25,,"Menden (Sauerland) Running",,,3113,,250,3,9988227901,0,168070,250480,30378,,39468628,,,,,,,,,,,,,,,,,,,,,,,,,,,,,,,,,,,,,,,,"4,5",
55629673,7e7fb791-2584-42f6-ba61-ee615bba81e0,1668624217,60,1668626822,,0,0,5.46,1465,1465,9,0,10,1,0,0,0.04,,,,352,148,162,,,,63.4,43.93,63.65,1,59.48,1728,117,,3.2,0.4,,100,,,,,,41,83,13.48,14.63,14.77,6.8,-1.7,338,338,,1,380,380,,,,,,,,,"24,6,6,3,2,5,23,25,6","0,22,74,4,0","8,9,22,12,49",,,,,135,,,,,,,,,,,,,,,,,,,,,,,,,,,,,,,,,,,,36.5,10,8,149,81,,1001,0,289,1,3,3,"Menden (Sauerland)",1,0,U0.990|3:31-U0.410|2:22-U0.190|0:37-U0.100|0:41-U0.200|0:37-U0.100|0:45-U0.600|2:01-U0.400|2:40-U0.200|0:38-U0.100|0:41-U0.200|0:38-U0.100|0:47-U0.600|2:07-U0.120|2:17-U1.150|4:02,,"Menden (Sauerland) Track Running",,,3113,,250,3,9988227854,0,168070,250480,30378,,39468629,,,,,,,,,,,,,,,,,,,,,,,,,,,,,,,,,,,,,,,,,
55664068,480992e2-d408-4447-a312-81e2916b1b0f,1668687743,60,1668687716,,0,0,10.13,3172,3362,159,179,176,200,0,2.2,0.66,1.09,1.08,388,561,136,156,79,,,58.58,38.09,59.57,1,59.48,1222,65,,2.6,0.1,,100,,,,,,68,78,11.62,14.98,14.74,0.6,28.3,274,274,,1,378,378,,,,,,,,,"12,15,24,22,19,4,2,1,2","0,63,36,0,0","0,7,67,21,4",,,,,123,,,,,,,,,,,,,,,,,,,,,,,,,,,,,,,,,,,,27.2,11,16,201,84,,994,1,254,0,6,3,Balve,1,0,U1.000|4:51-U1.000|4:59-U1.000|4:53-U1.000|4:48-U1.000|5:40-U1.000|5:32-U1.000|5:50-U1.000|4:59-U1.000|5:03-U1.000|5:30-U0.128|0:48,,"Balve Running",,,3113,,250,3,9991466580,0,168070,250480,30378,,39499857,,,,,,,,,,,,,,,,,,,,,,,,,,,,,,,,,,,,,,,,"5,5",
55727877,69434988-43cc-44ed-8b05-396b957d7ed5,1668790327,60,1668792274,,0,0,11.99,4617,5212,407,398,438,428,0,3.8,0.69,1.41,0.91,551,763,135,167,,,,45.81,30.23,47.78,1,59.48,1048,80,,2.8,0.2,,100,,,,,,96,77,9.48,17.84,20.15,21.4,7.7,218,218,,1,431,420,,,,,,,,,"54,12,8,9,7,4,2,2,3","3,64,30,4,0","15,35,32,11,7",,,,,101,,,,,,,,,,,,,,,,,,,,,,,,,,,,,,,,,,,,35.3,7,6,257,91,,1006,0,289,1,6,3,Balve,1,0,U1.000|5:13-U1.000|6:19-U1.000|5:30-U1.000|5:23-U0.861|4:45-U0.159|0:41-U0.193|1:21-U0.153|0:44-U0.181|1:13-U0.173|0:41-U0.183|1:19-U0.136|0:41-U0.144|1:17-U0.150|0:43-U0.186|3:00-U0.146|0:42-U0.228|1:26-U0.166|0:45-U0.140|1:26-U0.164|0:42-U0.163|1:33-U0.192|0:42-U0.163|1:29-U0.226|0:44-U0.160|2:48-U0.150|0:42-U0.148|1:26-U0.137|0:39-U0.192|1:46-U0.134|0:46-U0.164|2:04-U0.144|0:46-U0.254|2:16-U0.116|0:43-U1.000|8:21-U1.000|4:13-U0.286|2:06,,"Balve Running",,,3113,,250,3,9998102637,0,168070,250480,30378,,39558067,,,,,,,,,,,,,,,,,,,,,,,,,,,,,,,,,,,,,,,,"4,5,5,5",
55769439,4eba966a-c8cb-496d-a6c1-2a7277fbd32a,1668862885,60,1668864132,,0,0,9.57,3152,3594,286,249,297,257,0,3.9,0.8,1.08,0.99,597,673,152,171,,,,47.43,35.74,49.41,1,59.46,1290,105,,3.2,0,96,100,,,,,,99,79,11.68,11.33,12.46,6.1,25.3,272,272,,1,295,295,,,,,,,,,"20,16,13,14,30,7,1,0,0","1,8,77,14,0","0,6,66,26,2",,,,,115,,,,,,,,,,,,,,,,,,,,,,,,,,,,,,,,,,,,61.1,6,8,61,77,,1013,1,300,0,3,3,Balve,1,0,U1.000|6:15-U1.000|6:11-U1.000|6:02-U1.000|6:45-U1.000|5:24-U1.000|4:57-U1.000|4:50-U1.000|4:36-U1.000|4:34-U0.574|2:58,,"Balve Running",,,3113,,250,3,10002324470,0,168070,250480,30378,,39595512,,,,,,,,,,,,,,,,,,,,,,,,,,,,,,,,,,,,,,,,"4,4",
55836008,dc18a2ed-052f-4906-b26a-0d7e3eb95518,1668957138,60,1668963309,,0,0,15.54,5103,5624,401,399,420,421,0,4.9,0.69,0.98,1.11,562,1035,141,163,,,,52.73,37.24,54.42,1,59.42,1362,125,,3.3,0,100,98,,,,,,128,79,11.66,11.65,12.11,-9,5.6,265,265,,1,278,278,,,,,,,,,"27,10,12,13,17,19,2,0,0","1,37,61,1,0","0,5,77,18,1",,,,,116,,,,,,,,,,,,,,,,,,,,,,,,,,,,,,,,,,,,39.1,5,8,168,83,,1009,0,308,0,4,3,Balve,1,0,U1.000|5:11-U1.000|5:13-U1.000|5:27-U1.000|6:14-U1.000|6:35-U1.000|7:18-U1.000|6:12-U1.000|6:36-U1.000|5:51-U1.000|5:54-U1.000|4:36-U1.000|4:11-U1.000|4:16-U1.000|4:16-U1.000|4:32-U0.543|2:43,,"Balve Running",,,3113,,250,3,10009433759,0,168070,250480,30378,,39652409,,,,,,,,,,,,,,,,,,,,,,,,,,,,,,,,,,,,,,,,"3,4,5",
55940158,328fd7d1-c226-4d9e-847a-51a012b9ba06,1669056217,60,1669056243,,0,0,11.1,3119,3459,5,5,533,320,4,0,0,,,,681,143,180,,,,62.74,43.52,62.77,1,,,,,,,,,,,,,,86,78,12.81,13.48,13.5,-2.2,-18.5,313,313,,1,337,337,,,,,,,,,"10,2,3,12,39,17,7,9,1","1,49,32,17,0","0,8,38,40,14",,,,,137,,,,,,,,,,,,,,,,,,,,,,,,,,,,,,,,,,,,63.8,6,11,151,80,,998,0,301,1,4,3,Balve,1,0,U1.000|5:09-U1.000|4:53-U1.000|4:52-U1.000|4:59-U1.000|4:45-U1.000|4:43-U0.059|0:17-U0.425|1:43-U0.413|1:43-U0.436|1:25-U0.426|1:40-U0.429|1:26-U0.415|1:47-U0.427|1:28-U0.409|1:52-U0.429|1:24-U1.000|6:19-U0.196|1:34,,,,,wahoo_fitness-33,,518,7,,0,168070,250480,30378,,39743564,,,,,,,,,,,,,,,,,,,,,,,,,,,,,,,,,,,,,,,,,
56095691,907eb5ee-eeff-48d3-ab53-5ca900e2f03f,1669293124,60,1669293956,,0,0,13.64,4065,4202,306,293,318,310,0,3.4,0.71,0.97,0.99,467,906,142,160,100,,,58.88,41.27,60.59,1,59.52,2016,163,,3.8,0,102,101,,,,,,103,80,12.58,12.52,12.72,-1,8.2,296,296,,1,302,302,,,,,,,,,"6,6,17,20,19,28,3,0,0","0,35,65,0,0","0,0,52,48,0",,,,,126,,,,,,,,,,,,,,,,,,,,,,,,,,,,,,,,,,,,36.4,9,15,242,89,,1013,1,317,0,3,3,Balve,1,0,U1.000|4:46-U1.000|4:42-U1.000|5:49-U1.000|5:34-U1.000|5:20-U1.000|5:46-U1.000|4:39-U1.000|4:20-U1.000|4:14-U1.000|4:10-U1.000|4:12-U1.000|5:18-U1.000|5:42-U0.637|3:13,,"Balve Running",,,3113,,250,3,10029014124,0,168070,250480,30378,,39885160,,,,,,,,,,,,,,,,,,,,,,,,,,,,,,,,,,,,,,,,"4,4",
56095694,a2f750cf-4406-4a11-a578-ad7eb86f1006,1669227551,60,1669293957,,0,0,10.2,2826,2977,109,98,132,124,0,1.2,0.3,1.1,0.97,3109,645,147,162,,,,61.5,43.98,62.4,1,59.49,1376,119,,3.3,0,103,101,,,,,,81,79,13.13,13.07,15.37,4.4,-30,323,323,,1,384,384,,,,,,,,,"2,2,1,13,42,35,6,0,0","1,7,92,1,0","0,0,29,68,2",,,,,137,,,,,,,,,,,,,,,,,,,,,,,,,,,,,,,,,,,,42.4,7,21,188,85,,1002,0,320,1,6,3,"Menden (Sauerland)",1,0,U1.000|4:37-U1.000|4:18-U1.000|4:31-U1.000|4:26-U1.000|4:31-U1.000|4:40-U1.000|4:39-U1.000|4:57-U1.000|4:44-U1.000|4:35-U0.200|1:09,,"Menden (Sauerland) Running",,,3113,,250,3,10029014048,0,168070,250480,30378,,39885162,,,,,,,,,,,,,,,,,,,,,,,,,,,,,,,,,,,,,,,,4,
56107367,97a34bca-9e8e-4581-b64d-384c779c6418,1669142666,60,1669305448,,0,0,13.14,4334,4525,125,124,590,218,4,0.4,0.29,0.99,1.02,,868,135,162,,,,55.45,36.55,56.11,1,,,,,,,,,,,,,,88,77,11.07,11,11.16,-2.3,-2,257,257,,1,261,261,,,,,,,,,"7,8,30,41,13,2,0,0,0","0,72,27,0,0","0,4,90,6,0",,,,,118,,,,,,,,,,,,,,,,,,,,,,,,,,,,,,,,,,,,22.9,7,16,182,87,,998,0,337,1,4,3,Balve,1,0,U1.000|5:39-U1.000|5:37-U1.000|5:31-U1.000|5:33-U1.000|5:51-U1.000|5:54-U1.000|5:35-U1.000|5:48-U1.000|5:18-U1.000|5:30-U1.000|5:16-U1.000|5:06-U1.000|4:59-U0.120|0:37,,,,,wahoo_fitness-33,,518,7,,0,168070,250480,30378,,39892905,,,,,,,,,,,,,,,,,,,,,,,,,,,,,,,,,,,,,,,,,
56162080,ae31bb70-2af9-4108-a444-ffab99baf4ec,1669395439,60,1669396027,,0,0,10.21,3098,3158,162,173,186,199,0,2.2,0.59,0.98,1.04,328,654,137,156,85,,,60.33,39.54,61.44,1,59.54,1280,94,,3.1,0,98,101,,,,,,69,78,12,12.21,12.19,0.6,0.9,283,283,,1,290,290,,,,,,,,,"7,7,9,27,30,18,2,0,0","1,67,33,0,0","0,0,67,32,1",,,,,127,,,,,,,,,,,,,,,,,,,,,,,,,,,,,,,,,,,,28,7,10,240,99,,1019,0,327,1,3,3,Balve,1,0,U1.000|5:04-U1.000|5:09-U1.000|5:16-U1.000|5:17-U1.000|5:11-U1.000|5:12-U1.000|4:27-U1.000|5:53-U1.000|4:42-U1.000|4:33-U0.206|0:55,,"Balve Running",,,3113,,250,3,10035540492,0,168070,250480,30378,,39944470,,,,,,,,,,,,,,,,,,,,,,,,,,,,,,,,,,,,,,,,"5,5",
56215281,af3992b4-329b-4b1e-a41b-c78904b1d6db,1669446808,60,1669486024,,0,0,14.43,4401,4593,325,299,325,300,0,3.8,0.76,0.92,1.01,503,975,149,175,,,,53.62,40.36,55.23,1,59.49,1759,145,,3.6,0,101,98,,,,,,130,80,12.33,12.44,12.71,-15.1,-12.2,290,290,,1,302,302,,,,,,,,,"13,15,11,12,15,28,5,0,0","0,16,77,7,0","0,0,63,35,1",,,,,123,,,,,,,,,,,,,,,,,,,,,,,,,,,,,,,,,,,,57.9,5,6,191,97,,1029,0,311,1,3,3,Balve,1,0,U1.000|5:09-U1.000|5:13-U1.000|6:34-U1.000|6:22-U1.000|6:02-U1.000|6:15-U1.000|4:58-U1.000|4:22-U1.000|4:14-U1.000|4:17-U1.000|4:15-U0.242|1:04-U1.000|3:58-U1.000|4:26-U1.000|5:15-U0.183|0:56,,"Balve Running",,,3113,,250,3,10041436246,0,168070,250480,30378,,39993156,,,,,,,,,,,,,,,,,,,,,,,,,,,,,,,,,,,,,,,,"4,4",
56266560,550488b0-ef89-4277-8f6b-fd7454ce9156,1669572769,60,1669571412,,0,0,6.01,2091,2141,105,104,114,112,0,2.3,0.58,1.01,1.04,283,399,132,148,,,,53.39,32.46,54.55,1,59.42,796,45,,2.3,0,94,100,,,,,,41,77,10.51,10.51,10.93,-7,-17.1,241,241,,1,256,256,,,,,,,,,"21,11,30,33,5,0,0,0,0","1,83,16,0,0","0,9,87,3,1",,,,,112,,,,,,,,,,,,,,,,,,,,,,,,,,,,,,,,,,,,20.7,6,15,171,71,,1019,0,279,1,4,3,Balve,1,0,U1.000|6:07-U1.000|5:31-U1.000|5:34-U1.000|5:56-U1.000|5:56-U1.000|5:44-U0.007|0:02,,"Balve Running",,,3113,,250,3,10047159861,0,168070,250480,30378,,40038524,,,,,,,,,,,,,,,,,,,,,,,,,,,,,,,,,,,,,,,,4,
56305632,e21aaac9-1b8d-462d-8663-b95c38e9575e,1669637938,60,1669638425,,0,0,12.04,3799,3937,312,283,322,295,0,4.1,0.9,0.91,1.01,573,789,138,156,,,,56.96,38.24,58.96,1,59.35,1326,102,,3.2,0,100,97,,,,,,81,79,12.04,12.08,12.44,-10.1,2.2,280,280,,1,292,292,,,,,,,,,"17,17,12,11,20,20,4,0,0","0,55,45,0,0","0,0,80,18,2",,,,,120,,,,,,,,,,,,,,,,,,,,,,,,,,,,,,,,,,,,28.6,7,12,192,75,,1012,1,280,0,4,3,Balve,1,0,U1.000|5:06-U1.000|5:04-U1.000|6:24-U1.000|6:14-U1.000|6:12-U1.000|6:16-U1.000|4:54-U1.000|4:28-U1.000|4:34-U1.000|4:26-U1.000|4:06-U1.000|5:23-U0.041|0:12,,"Balve Running",,,3113,,250,3,10050383989,0,168070,250480,30378,,40072344,,,,,,,,,,,,,,,,,,,,,,,,,,,,,,,,,,,,,,,,3,
56382745,c0a8857b-6518-4034-80e3-24ee9863ab4d,1669734699,60,1669736083,,0,0,13.11,4434,4645,319,306,330,316,0,3.6,0.77,0.96,1.03,478,851,134,148,,,,54.26,35.49,55.96,1,59.3,1193,88,,3,0,103,97,,,,,,93,78,11.14,11.12,11.36,-7.2,2.5,255,255,,1,263,263,,,,,,,,,"28,15,11,17,24,5,1,0,0","0,79,20,0,0","0,5,85,10,0",,,,,114,,,,,,,,,,,,,,,,,,,,,,,,,,,,,,,,,,,,28.2,6,7,281,91,,1020,0,328,0,4,3,Balve,1,0,U1.000|5:18-U1.000|5:18-U1.000|6:39-U1.000|6:37-U1.000|6:30-U1.000|6:39-U1.000|5:21-U1.000|4:52-U1.000|4:37-U1.000|4:46-U1.000|4:52-U1.000|6:03-U1.000|5:43-U0.109|0:39,,"Balve Running",,,3113,,250,3,10056730665,0,168070,250480,30378,,40138864,,,,,,,,,,,,,,,,,,,,,,,,,,,,,,,,,,,,,,,,"4,5",
56468059,a0ba8174-5acb-49e6-b8ed-5cbdb3e0caca,1669833386,60,1669837209,,0,0,4.01,1120,1120,6,40,9,44,0,0,0.11,,1,,250,141,147,113,,,64.4,41.1,63.84,1,59.38,874,57,,2.5,0,105,103,,,,,,28,79,12.62,12.98,12.7,6.6,6.5,300,300,,1,303,303,,,,,,,,,"2,0,3,11,48,34,2,0,0","3,16,81,0,0","0,1,48,51,0",,,,,136,,,,,,,,,,,,,,,,,,,,,,,,,,,,,,,,,,,,29.3,6,5,29,94,,1024,0,330,1,4,3,"Menden (Sauerland)",1,0,U1.000|4:45-U1.000|4:28-U1.000|4:39-U1.000|4:43-U0.014|0:05,,"Menden (Sauerland) Running",,,3113,,250,3,10063646477,0,168070,250480,30378,,40216055,,,,,,,,,,,,,,,,,,,,,,,,,,,,,,,,,,,,,,,,,
56468089,262e75bd-3b2b-4eda-9748-764b387e5466,1669835170,60,1669837254,,0,0,8.04,2071,2071,24,2,25,2,0,0,0.08,1.19,,,533,159,179,,,,60.18,47.16,60.61,1,59.49,2736,210,,3.9,2.1,104,105,,,,,,78,82,14.11,14.65,14.81,10.1,6.3,353,353,,1,376,376,,,,,,,,,"10,4,8,5,2,10,52,9,0","0,18,22,60,0","3,4,17,38,38",,,,,142,,,,,,,,,,,,,,,,,,,,,,,,,,,,,,,,,,,,76.3,6,5,40,94,,1024,0,329,1,4,3,"Menden (Sauerland)",1,0,U0.400|2:04-U0.400|1:31-U0.400|1:29-U0.400|1:30-U0.400|1:23-U0.400|2:23-U0.400|1:29-U0.400|1:33-U0.400|1:32-U0.400|1:26-U0.400|2:51-U0.400|1:30-U0.400|1:33-U0.400|1:33-U0.410|1:26-U0.420|3:10-U0.400|1:30-U0.400|1:34-U0.400|1:35-U0.400|1:29-U0.010|0:01,,"Menden (Sauerland) Track Running",,,3113,,250,3,10063650373,0,168070,250480,30378,,40216083,,,,,,,,,,,,,,,,,,,,,,,,,,,,,,,,,,,,,,,,,
56506212,e3442859-9398-49fa-9fdf-872d9ab2ad7d,1669900864,60,1669901994,,0,0,13.54,4185,4320,316,317,337,339,0,3.8,0.83,0.94,0.98,457,899,146,161,112,,,54.24,39.53,55.8,1,59.45,2476,139,,3.5,0.1,100,96,,,,,,111,79,12.14,12.21,12.5,-9.4,4.9,282,282,,1,294,294,,,,,,,,,"9,14,17,13,21,22,3,0,0","0,19,81,0,0","0,1,73,25,1",,,,,123,,,,,,,,,,,,,,,,,,,,,,,,,,,,,,,,,,,,42.8,5,10,32,83,,1025,0,317,0,3,3,Balve,1,0,U1.000|5:04-U1.000|5:03-U1.000|6:19-U1.000|6:01-U1.000|5:57-U1.000|6:07-U1.000|4:56-U1.000|4:30-U1.000|4:08-U1.000|4:17-U1.000|4:24-U1.000|5:14-U1.000|5:11-U0.544|2:33,,"Balve Running",,,3113,,250,3,10067073638,0,168070,250480,30378,,40250239,,,,,,,,,,,,,,,,,,,,,,,,,,,,,,,,,,,,,,,,"4,5",
56558935,77180690-2e03-4fd0-a220-6ff189936acd,1669984815,60,1669985453,,0,0,11.53,3657,3891,279,271,296,285,0,3.5,0.81,0.97,1.06,507,757,140,160,,,,55.55,37.88,57.26,1,59.4,1481,101,,3.2,0,100,97,,,,,,83,78,11.93,11.9,12.15,-12.6,-9.6,276,276,,1,284,284,,,,,,,,,"13,19,13,10,25,18,1,0,0","0,45,55,0,0","0,1,83,15,2",,,,,121,,,,,,,,,,,,,,,,,,,,,,,,,,,,,,,,,,,,29.8,3,13,54,88,,1022,1,297,0,4,3,Balve,1,0,U1.000|5:08-U1.000|5:25-U1.000|6:38-U1.000|6:04-U1.000|6:17-U1.000|5:42-U1.000|4:39-U1.000|4:36-U1.000|4:40-U1.000|4:19-U1.000|4:34-U0.527|2:55,,"Balve Running",,,3113,,250,3,10071931269,0,168070,250480,30378,,40297648,,,,,,,,,,,,,,,,,,,,,,,,,,,,,,,,,,,,,,,,"4,4",
56600333,e2d3b526-ecd8-469d-ad21-b172ab990183,1670063738,60,1670066758,,0,0,16.68,5434,5656,450,443,470,467,0,4.4,0.82,0.99,1.03,540,1146,148,173,,,,49.89,37.8,51.58,1,59.38,1887,155,,3.7,0,95,101,,,,,,147,80,11.66,11.46,11.82,-9,1.1,268,268,,1,275,275,,,,,,,,,"14,14,22,15,26,9,0,0,0","0,24,67,9,0","0,6,75,18,0",,,,,115,,,,,,,,,,,,,,,,,,,,,,,,,,,,,,,,,,,,50.7,1,9,75,86,,1022,1,298,0,3,3,Balve,1,0,U1.000|5:56-U1.000|6:10-U1.000|5:42-U1.000|6:16-U1.000|6:14-U1.000|5:03-U1.000|5:20-U1.000|6:06-U1.000|5:05-U1.000|5:23-U1.000|6:31-U1.000|4:47-U1.000|4:38-U1.000|4:37-U1.000|4:35-U1.000|4:43-U0.678|3:27,,"Balve Running",,,3113,,250,3,10076528765,0,168070,250480,30378,,40334110,,,,,,,,,,,,,,,,,,,,,,,,,,,,,,,,,,,,,,,,"4,4,5",
56656213,4d688ab8-08f4-422a-a10a-b1be771b82ee,1670157272,60,1670159869,,0,0,16.44,5595,6043,506,505,519,522,0,5.4,0.79,0.99,1.04,582,1111,145,174,,,,48.61,35.87,50.47,1,59.33,1611,134,,3.5,0,99,98,,,,,,151,78,11.48,11.3,11.88,6.6,17.2,269,269,,1,283,283,,,,,,,,,"28,8,13,14,22,14,0,0,0","0,30,66,4,0","1,8,66,25,1",,,,,113,,,,,,,,,,,,,,,,,,,,,,,,,,,,,,,,,,,,50.9,3,9,69,79,,1017,0,319,0,3,3,Balve,1,0,U1.000|5:33-U1.000|5:40-U1.000|7:06-U1.000|7:15-U1.000|4:48-U1.000|4:28-U1.000|4:30-U1.000|8:54-U1.000|5:54-U1.000|6:40-U1.000|5:52-U1.000|5:37-U1.000|4:48-U1.000|4:31-U1.000|4:44-U1.000|4:41-U0.443|2:15,,"Balve Running",,,3113,,250,3,10082661794,0,168070,250480,30378,,40386277,,,,,,,,,,,,,,,,,,,,,,,,,,,,,,,,,,,,,,,,"3,4,4",
56700234,84b68f1c-3fb9-4e7a-8764-4f793ed47ba2,1668440176,60,1670226531,,0,0,,421,421,,,,,0,,,,,,52,,,,,,,,,1,,,,,,,,,,,,,,4,,,,,,,,,,,,,,,,,,,,,,,,,,,,,,,,,,,,,,,,,,,,,,,,,,,,,,,,,,,,,,,,,,,,,,,,,,1,,,1,0,,,,,,,,252,7,,0,168074,,30378,,40426064,,,,,,,,,,,,,,,,,,,,,,,,,,,,,,,,,,,,,,,,,
56713992,0f79690a-e1db-482c-b57e-288e8b7c3ce4,1670245934,60,1670246763,,0,0,13.12,4108,4369,354,332,366,346,0,3.8,0.92,1.03,1.17,425,881,140,157,,,,56.44,38.84,58.44,1,59.29,1424,114,,3.3,0,101,98,,,,,,92,79,12.19,12.37,12.36,-8.9,1.8,294,294,,1,300,300,,,,,,,,,"16,17,15,13,14,14,11,1,0","1,45,54,0,0","0,1,58,41,0",,,,,121,,,,,,,,,,,,,,,,,,,,,,,,,,,,,,,,,,,,33.6,2,5,232,87,,1020,0,331,0,6,3,Balve,1,0,U1.000|5:57-U1.000|6:07-U1.000|5:53-U1.000|6:18-U1.000|6:22-U1.000|5:23-U1.000|5:16-U1.000|5:20-U1.000|4:53-U1.000|4:30-U1.000|4:12-U1.000|4:03-U1.000|3:45-U0.117|0:29,,"Balve Running",,,3113,,250,3,10087591052,0,168070,250480,30378,,40439250,,,,,,,,,,,,,,,,,,,,,,,,,,,,,,,,,,,,,,,,3,
56788957,56125d72-398c-446f-a4ec-b0356fc20748,1670348869,60,1670350435,,0,0,3.93,1075,1075,16,40,18,43,0,0,0.05,,1,,257,141,155,,,,66.08,42.06,65.91,1,59.3,932,62,,2.6,0,104,103,,,,,,25,79,12.96,13.22,13.03,2,3.9,324,324,,1,327,327,,,,,,,,,"1,0,2,11,32,51,3,0,0","0,39,61,0,0","0,0,18,82,1",,,,,139,,,,,,,,,,,,,,,,,,,,,,,,,,,,,,,,,,,,25.5,4,9,170,79,,1018,0,302,1,4,3,"Menden (Sauerland)",1,0,U1.000|4:44-U1.000|4:35-U1.000|4:23-U0.926|4:13,,"Menden (Sauerland) Running",,,3113,,250,3,10094362286,0,168070,250480,30378,,40506325,,,,,,,,,,,,,,,,,,,,,,,,,,,,,,,,,,,,,,,,,
56788974,f00ef02d-8003-4f99-9a09-ee9ee93ed9ce,1670350350,60,1670350466,,0,0,8.23,2127,2127,28,6,28,6,0,0,0.02,,,612,577,157,181,,,,61.06,47.05,61.52,1,59.3,3744,229,,4.3,0.5,,100,,,,,,72,82,14.09,14.7,14.91,3.4,3.4,369,369,,1,394,394,,,,,,,,,"12,8,8,5,5,7,32,22,2","1,5,53,41,0","3,4,22,15,57",,,,,142,,,,,,,,,,,,,,,,,,,,,,,,,,,,,,,,,,,,61.7,4,9,199,79,,1018,0,301,1,4,3,"Menden (Sauerland)",1,0,U0.290|1:48-U0.200|0:40-U0.110|0:36-U0.190|0:39-U0.100|0:33-U0.200|0:42-U0.110|0:33-U0.200|0:41-U0.090|0:29-U0.210|0:39-U0.100|0:35-U0.210|0:41-U0.400|3:14-U0.400|1:29-U0.400|1:28-U0.410|1:29-U0.400|1:28-U0.400|1:26-U0.400|2:12-U0.400|1:30-U0.400|1:29-U0.400|1:28-U0.400|2:32-U0.400|1:26-U0.400|1:27-U0.190|1:15-U0.810|2:47-U0.010|0:11,,"Menden (Sauerland) Track Running",,,3113,,250,3,10094365173,0,168070,250480,30378,,40506342,,,,,,,,,,,,,,,,,,,,,,,,,,,,,,,,,,,,,,,,5,
56788976,4fa161b6-df09-4af2-8a99-df3f8acf226d,1670352737,60,1670350469,,0,0,2.96,886,886,30,12,32,15,0,0,0.22,1.21,,,200,143,151,,,,58.02,37.07,59.19,1,59.3,4320,42,,2.2,0,98,100,,,,,,21,79,12.27,12.04,12.64,6.9,16.1,309,309,,1,322,322,,,,,,,,,"2,3,8,34,45,9,0,0,0","0,18,82,0,0","0,0,55,36,8",,,,,127,,,,,,,,,,,,,,,,,,,,,,,,,,,,,,,,,,,,24.7,3,9,199,79,,1018,0,301,1,4,3,"Menden (Sauerland)",1,0,U1.000|5:10-U1.000|4:56-U0.955|4:40,,"Menden (Sauerland) Running",,,3113,,250,3,10094365748,0,168070,250480,30378,,40506343,,,,,,,,,,,,,,,,,,,,,,,,,,,,,,,,,,,,,,,,,
56848159,6322e39c-1574-4b2e-9a1d-4b67acfa4c1d,1670441401,60,1670441205,,0,0,9.87,3307,3337,165,183,187,207,0,2.6,0.71,1.01,1.01,385,674,138,151,,,,52.89,35.1,53.86,1,59.3,2803,75,,2.9,0,97,100,,,,,,72,77,10.9,11,11.04,-5.3,-6.2,261,261,,1,267,267,,,,,,,,,"16,14,17,30,21,2,0,0,0","0,60,39,0,0","0,2,83,15,0",,,,,116,,,,,,,,,,,,,,,,,,,,,,,,,,,,,,,,,,,,26.3,2,9,242,99,,1014,0,295,1,6,3,Balve,1,0,U1.000|6:04-U1.000|5:19-U1.000|5:52-U1.000|5:45-U1.000|5:28-U1.000|5:53-U1.000|5:55-U1.000|4:52-U1.000|4:50-U0.866|5:10,,"Balve Running",,,3113,,250,3,10100151341,0,168070,250480,30378,,40561660,,,,,,,,,,,,,,,,,,,,,,,,,,,,,,,,,,,,,,,,"5,5,5",
56934285,e5b7fa11-cc7f-40c2-a1bc-a543ba6244ee,1670578766,60,1670579509,,0,0,13.51,4119,4226,381,357,397,373,0,4.5,0.82,0.99,1.01,584,939,152,176,,,,52.17,40.16,54.1,1,59.22,2622,157,,3.7,0,97,96,,,,,,123,80,12.52,12.45,13.47,-9.2,10.3,306,306,,1,337,337,,,,,,,,,"12,10,17,15,17,21,8,0,0","0,12,65,22,0","0,0,50,45,5",,,,,123,,,,,,,,,,,,,,,,,,,,,,,,,,,,,,,,,,,,62.7,0,3,121,94,,1007,0,312,0,4,3,Balve,1,0,U1.000|4:57-U1.000|5:14-U1.000|6:19-U1.000|6:15-U1.000|5:47-U1.000|5:58-U1.000|4:41-U1.000|4:07-U1.000|4:03-U1.000|4:08-U1.000|4:15-U1.000|5:19-U1.000|5:16-U0.508|2:22,,"Balve Running",,,3113,,250,3,10107687521,0,168070,250480,30378,,40640593,,,,,,,,,,,,,,,,,,,,,,,,,,,,,,,,,,,,,,,,"3,4",
56938079,dca6bfab-ef96-4650-b8fe-335110c4c2fd,1670530723,60,1670585952,,0,0,1.58,639,639,36,24,39,28,0,1.5,0.78,1.07,0.92,,124,135,148,,,,43.12,24.64,44.74,1,59.27,2292,19,,1.3,0,95,96,,,,,,13,78,9.32,8.89,9.67,-8.8,-22.3,221,221,,1,235,235,,,,,,,,,"59,35,6,0,0,0,0,0,0","0,74,26,0,0","0,23,75,2,0",,,,,95,,,,,,,,,,,,,,,,,,,,,,,,,,,,,,,,,,,,18.8,1,8,225,98,,1008,0,311,1,4,3,Balve,1,0,U1.000|6:34-U0.583|4:05,,"Balve Running",,,3113,,250,3,10105425961,0,168070,250480,30378,,40643638,,,,,,,,,,,,,,,,,,,,,,,,,,,,,,,,,,,,,,,,,
56938080,02820a70-5c97-4c16-9298-264a88ed4dcf,1670528046,60,1670585952,,0,0,4.47,2488,2488,268,251,287,269,0,4,0.77,2.11,1.09,802,448,135,170,,,,28.97,17.83,31.31,1,59.27,2304,66,,2.7,0,,100,,,,,,56,74,6.81,8.56,13.5,23.1,3.8,164,164,,1,359,359,,,,,,,,,"75,2,4,8,7,3,0,0,0","0,59,29,12,0","44,29,10,9,8",,,,,73,,,,,,,,,,,,,,,,,,,,,,,,,,,,,,,,,,,,32.3,0,7,225,98,,1008,0,311,1,4,3,Balve,1,0,U0.132|0:42-U0.162|1:32-U0.136|0:43-U0.154|1:19-U0.139|0:43-U0.165|1:21-U0.139|0:42-U0.152|1:19-U0.134|0:43-U0.201|2:52-U0.134|0:42-U0.161|1:25-U0.140|0:41-U0.157|1:34-U0.138|0:42-U0.165|1:34-U0.139|0:42-U0.157|1:39-U0.135|0:43-U0.171|3:35-U0.131|0:36-U0.187|2:56-U0.137|0:38-U0.208|2:57-U0.136|0:38-U0.186|2:55-U0.138|0:40-U0.181|3:22-U0.131|0:41-U0.021|0:47,,"Balve Running",,,3113,,250,3,10105425908,0,168070,250480,30378,,40643639,,,,,,,,,,,,,,,,,,,,,,,,,,,,,,,,,,,,,,,,"4,4,5,5,5,5",
56938097,2657226c-1928-43c0-bad9-377661f2bfcf,1670525045,60,1670585961,,0,0,8.55,2768,2838,115,173,130,188,0,2.2,0.66,0.97,1.04,391,565,135,154,,,,56.74,36.18,57.21,1,59.27,1473,66,,2.7,0,98,98,,,,,,57,77,11.1,11.32,11.17,-4,-3.2,264,264,,1,268,268,,,,,,,,,"12,12,14,35,24,4,0,0,0","0,80,20,0,0","0,0,88,12,0",,,,,120,,,,,,,,,,,,,,,,,,,,,,,,,,,,,,,,,,,,24.8,1,9,219,99,,1008,0,310,1,3,3,Balve,1,0,U1.000|6:09-U1.000|5:13-U1.000|5:30-U1.000|5:24-U1.000|5:50-U1.000|5:31-U1.000|4:54-U1.000|4:50-U0.545|2:47,,"Balve Running",,,3113,,250,3,10105425844,0,168070,250480,30378,,40643655,,,,,,,,,,,,,,,,,,,,,,,,,,,,,,,,,,,,,,,,"5,5",
57016120,7efbda80-db61-46fc-902a-6f884e95f86c,1670673161,60,1670718316,,0,0,13.2,4133,4264,352,363,359,372,0,3.9,0.94,1.01,1.2,441,907,145,164,98,,,53.88,38.86,55.6,1,59.16,1910,130,,3.4,0,97,97,,,,,,104,79,12.1,12.33,12.29,-12.5,2.5,290,290,,1,295,295,,,,,,,,,"17,18,16,8,11,22,8,0,0","0,33,63,4,0","0,1,64,36,0",,,,,121,,,,,,,,,,,,,,,,,,,,,,,,,,,,,,,,,,,,43.5,-1,5,282,80,,1010,0,344,0,3,3,Balve,1,0,U1.000|5:53-U1.000|6:18-U1.000|5:51-U1.000|6:25-U1.000|5:59-U1.000|5:26-U1.000|5:16-U1.000|5:07-U1.000|4:50-U1.000|4:34-U1.000|4:11-U1.000|4:04-U1.000|4:08-U0.195|0:52,,"Balve Running",,,3113,,250,3,10113138729,0,168070,250480,30378,,40711619,,,,,,,,,,,,,,,,,,,,,,,,,,,,,,,,,,,,,,,,3,
57047306,1326784b-81a8-4cf3-829c-167a2e46ac9c,1670755793,60,1670758033,,0,0,15.05,4154,5506,106,81,117,93,0,0.1,0.23,1.05,0.96,,1020,158,176,,,,55.78,45.47,56.38,1,59.11,2479,197,,4.1,0,99,98,,,,,,143,80,13.16,13.11,13.3,2,0.4,334,334,,1,341,341,,,,,,,,,"0,1,2,7,47,41,1,0,0","0,7,47,46,0","0,0,10,87,3",,,,,136,,,,,,,,,,,,,,,,,,,,,,,,,,,,,,,,,,,,68.1,-1,5,220,82,,1011,0,367,0,4,3,Sundern,1,0,U1.000|4:59-U1.000|4:27-U1.000|4:24-U1.000|4:27-U1.000|4:23-U1.000|4:26-U1.000|4:35-U1.000|4:57-U1.000|4:47-U1.000|4:40-U1.000|4:39-U1.000|4:42-U1.000|4:38-U1.000|4:31-U1.000|4:33-U0.052|0:05,,"Sundern (Sauerland) Running",,,3113,,250,3,10117962697,0,168070,250480,30378,,40738521,,,,,,,,,,,,,,,,,,,,,,,,,,,,,,,,,,,,,,,,,
57098117,330a8224-e232-42ab-acbd-1a366a65f49e,1670848816,60,1670849264,,0,0,11.79,3785,4019,271,269,282,281,0,3.3,0.82,0.96,1.07,457,794,141,159,,,,54.22,37.41,55.77,1,59.03,1383,95,,3.1,0,101,96,,,,,,94,79,11.74,11.87,11.86,-14.7,-7.3,281,281,,1,285,285,,,,,,,,,"21,17,9,11,19,21,2,0,0","0,38,62,0,0","0,0,75,24,0",,,,,118,,,,,,,,,,,,,,,,,,,,,,,,,,,,,,,,,,,,34.1,-1,5,242,86,,1013,0,359,0,7,3,Balve,1,0,U1.000|5:09-U1.000|5:11-U1.000|6:48-U1.000|6:33-U1.000|6:17-U1.000|6:04-U1.000|4:43-U1.000|4:30-U1.000|4:32-U1.000|4:21-U1.000|4:24-U0.788|4:32,,"Balve Running",,,3113,,250,3,10123213899,0,168070,250480,30378,,40782950,,,,,,,,,,,,,,,,,,,,,,,,,,,,,,,,,,,,,,,,4,
57144808,3ed89b90-d9bb-46ac-96e0-3df1cba2b9b5,1670936509,60,1670938010,,0,0,13.2,4251,4398,372,351,377,360,0,4.1,0.83,1.09,1.2,427,913,147,164,,,,51.08,37.61,52.96,1,58.94,1395,119,,3.3,0,98,95,,,,,,113,80,11.84,11.82,12.29,-7.5,10.8,285,285,,1,300,300,,,,,,,,,"22,14,14,11,15,22,2,0,0","0,16,82,2,0","0,2,72,23,3",,,,,116,,,,,,,,,,,,,,,,,,,,,,,,,,,,,,,,,,,,39.5,-1,5,117,72,,1012,0,340,0,3,3,Balve,1,0,U1.000|5:44-U1.000|6:21-U1.000|5:49-U1.000|6:43-U1.000|6:39-U1.000|5:50-U1.000|5:25-U1.000|5:04-U1.000|5:02-U1.000|4:36-U1.000|4:17-U1.000|4:13-U1.000|4:11-U0.197|0:57,,"Balve Running",,,3113,,250,3,10128330451,0,168070,250480,30378,,40823427,,,,,,,,,,,,,,,,,,,,,,,,,,,,,,,,,,,,,,,,"3,5",
57192066,05df3f46-185a-42fb-a63c-495651441f35,1671024541,60,1671025804,,0,0,13.01,3829,4749,228,237,235,251,0,2.9,0.64,1.07,1.03,582,854,148,178,,,,56.55,41.73,57.73,1,58.89,1482,142,,3.5,0.2,100,97,,,,,,114,80,12.43,13.44,14.45,-1.3,10.8,311,311,,1,387,387,,,,,,,,,"9,6,10,24,22,11,13,4,0","1,29,52,18,0","2,3,49,30,16",,,,,127,,,,,,,,,,,,,,,,,,,,,,,,,,,,,,,,,,,,65.3,-1,4,72,67,,1003,0,298,0,3,3,Balve,1,0,U1.000|5:02-U1.000|5:01-U1.000|5:16-U1.000|4:57-U0.702|3:20-U0.410|1:29-U0.408|1:24-U0.406|1:34-U0.403|1:24-U0.405|3:31-U0.409|1:33-U0.411|1:29-U0.409|1:42-U0.412|1:34-U1.000|5:34-U1.000|5:41-U1.000|4:45-U1.000|4:43-U0.636|3:50,,"Balve Running",,,3113,,250,3,10133383112,0,168070,250480,30378,,40866553,,,,,,,,,,,,,,,,,,,,,,,,,,,,,,,,,,,,,,,,"5,5,5",
57247142,08e19218-aa12-4675-b67c-f072b925f12e,1671128750,60,1671128615,,0,0,9.3,3086,3382,180,213,183,218,0,2.4,0.71,0.98,0.99,369,638,137,152,,,,54.03,35.35,55.08,1,58.85,1192,81,,3,0,99,98,,,,,,51,78,11.02,11.26,11.32,-3.3,0.5,264,263,,1,275,275,,,,,,,,,"14,11,22,27,20,6,0,0,0","1,62,38,0,0","1,1,80,17,0",,,,,116,,,,,,,,,,,,,,,,,,,,,,,,,,,,,,,,,,,,19.1,-4,4,126,90,,1010,0,286,1,2,3,Balve,1,0,U1.000|6:39-U1.000|5:08-U1.000|5:40-U1.000|5:37-U1.000|5:33-U1.000|5:55-U1.000|5:10-U1.000|4:30-U1.000|5:25-U0.300|1:49,,"Balve Running",,,3113,,250,3,10139229349,0,168070,250480,30378,,40916443,,,,,,,,,,,,,,,,,,,,,,,,,,,,,,,,,,,,,,,,"5,5",
57298722,c71d4047-2fc5-44c2-851c-66ab2dadd80a,1671219295,60,1671217851,,0,0,5.88,1953,2049,133,125,145,139,0,2.6,0.67,1.13,1.02,485,431,153,176,,,,46.5,34.27,47.88,1,58.85,1164,81,,3,0,,100,,,,,,61,78,11.15,10.95,11.47,6.4,11.4,271,271,,1,285,285,,,,,,,,,"17,10,17,32,24,1,0,0,0","0,12,59,29,0","0,4,68,28,0",,,,,116,,,,,,,,,,,,,,,,,,,,,,,,,,,,,,,,,,,,61.4,-5,2,240,91,,1020,0,324,1,2,3,Balve,1,0,U1.000|5:59-U1.000|5:18-U1.000|5:21-U1.000|5:09-U1.000|5:52-U0.876|4:53,,"Balve Running",,,3113,,250,3,10143856234,0,168070,250480,30378,,40962239,,,,,,,,,,,,,,,,,,,,,,,,,,,,,,,,,,,,,,,,"4,5,5",
57335369,2d042321-d3bc-44a7-bdfb-22f7521d5272,1671291404,60,1671291849,,0,0,14.57,3788,3938,74,92,99,122,0,0,0.13,1.2,0.98,,939,157,173,,,,60.61,48.61,60.9,1,58.86,2448,215,,4.2,0.1,101,100,,,,,,128,82,13.83,14.07,14.16,4,0.2,356,356,,1,369,369,,,,,,,,,"3,1,2,5,19,49,16,3,2","1,4,59,36,0","0,1,11,70,18",,,,,141,,,,,,,,,,,,,,,,,,,,,,,,,,,,,,,,,,,,66.6,-3,3,109,90,,1027,0,282,0,2,3,Wilten,1,0,U1.000|4:29-U1.000|4:16-U1.000|4:08-U1.000|4:21-U1.000|4:15-U1.000|4:19-U1.000|4:18-U1.000|4:20-U1.000|4:44-U1.000|4:18-U1.000|4:11-U1.000|4:37-U1.000|4:05-U1.000|4:11-U0.565|2:34,,"Innsbruck Running",,,3113,,250,3,10147813633,0,168070,250480,30378,,40994779,,,,,,,,,,,,,,,,,,,,,,,,,,,,,,,,,,,,,,,,,
57370930,9258ae1c-f2a5-4958-876c-40a587752718,1671360497,60,1671371660,,0,0,9.11,11626,12321,534,553,553,567,0,6.5,0.91,,,222,1067,105,138,,,,,,,1,58.87,1158,26,,1.9,0,,100,,,,,,97,55,,4.19,,-90.6,,,,,,,,,,,,,,,,"84,15,0,0,0,0","39,61,0,0,0",,,,,,,,,,,,,,,,,,,,,,,,,,,,,,,,,,,,,,,,,,9.3,3,3,191,59,,1031,1,292,0,2,3,Igls,1,0,U1.907|48:05-U0.003|0:03-U7.200|2:25:38,,"Innsbruck Hiking",,,3113,,250,3,10152353542,0,168075,,30378,,41027061,,,,,,,,,,,,,,,,,,,,,,,,,,,,,,,,,,,,,,,,0,
57401300,d63952e2-174a-41ac-9a91-115916f153f9,1671383418,60,1671438577,,0,0,4.34,1597,1597,,,,,0,,,,,,323,137,151,121,,,47.56,29.77,47.56,1,58.87,1280,45,,2.3,0.1,,100,,,,,,33,69,,9.5,,37.5,11.8,174,174,,1,230,230,,,,,,,,,"55,6,18,20,0,0,0,0,0","0,72,28,0,0","29,24,47,0,0",,,,,118,,,,,,,,,,,,,,,,,,,,,,,,,,,,,,,,,,,,20.6,,,,,,,,,,1,,,1,1,U1.000|5:59-U1.000|5:43-U1.000|9:55-U0.345|5:00,,"Treadmill Running",,,3113,,250,3,10155363349,0,168070,250480,30378,,41054697,,,,,,,,,,,,,,,,,,,,,,,,,,,,,,,,,,,,,,,,,
57409375,e46a6d93-0774-472d-a971-f3cbfe224c84,1671446051,60,1671454946,,0,0,19.52,11601,11830,951,942,1000,992,0,8.1,0.9,1.08,1.03,492,1776,135,173,,,,26.66,18.21,28.33,1,58.27,1877,154,,3.7,0.1,93,98,,,,,,240,69,7.18,8.19,9.14,-6.9,11.7,154,154,,1,208,208,,,,,,,,,"79,4,6,7,3,1,0,0,0","4,51,41,5,0","31,39,26,5,0",,,,,73,,,,,,,,,,,,,,,,,,,,,,,,,,,,,,,,,,,,44.3,6,3,179,66,,1029,1,267,0,4,3,Birgitz,1,0,U1.000|6:46-U1.000|10:03-U1.000|11:32-U0.040|0:47-U1.000|20:39-U1.000|15:56-U1.000|12:12-U1.000|10:43-U1.000|5:34-U1.000|7:17-U1.000|6:38-U1.000|7:57-U1.000|13:34-U1.000|19:42-U1.000|6:48-U1.000|5:35-U1.000|5:59-U1.000|5:07-U1.000|5:12-U1.000|9:44-U0.476|5:34,,"Birgitz Running",,,3113,,250,3,10156329730,0,168070,250480,30378,,41062323,,,,,,,,,,,,,,,,,,,,,,,,,,,,,,,,,,,,,,,,"1,2,3,4,4,5",
57451556,7c9172cb-4cc8-4573-89d3-395eab9600cb,1671523655,60,1671523544,,0,0,,3463,3463,,,,,0,,,,,,200,80,106,,,,,,,1,58.28,725,3,,0.1,0,,100,,,,,,10,,,,,,,,,,,,,,,,,,,,,,"98,2,0,0,0",,,,,,,,,,,,,,,,,,,,,,,,,,,,,,,,,,,,,,,,,,1.6,,,,,,,,,,1,,,1,0,,,Strength,,,3113,,250,3,10160001072,0,168074,,30378,,41098362,,,,,,,,,,,,,,,,,,,,,,,,,,,,,,,,,,,,,,,,,
57458268,9b442075-588b-441a-9455-7c3a68ac24ea,1671531362,60,1671534626,,0,0,5.08,5566,5568,1127,51,1121,45,0,9.1,0.96,2.31,0.63,737,927,139,161,,,,,,18.51,1,58.27,1396,102,,3.1,0.1,,100,,,,,,123,58,6.9,4.09,10.05,25.3,-6.6,181,178,,1,240,239,,,,,,,,,"100,0,0,0,0,0,0,0,0","5,33,62,0,0","15,50,27,7,1",,,,,47,,,,,,,,,,,,,,,,,,,,,,,,,,,,,,,,,,,,32.3,4,4,189,79,,1025,1,260,0,3,3,Hungerburg,1,0,U1.000|14:57-U1.000|18:36-U1.000|20:32-U1.000|16:21-U1.000|17:17-U0.084|5:02,,"Innsbruck Running",,,3113,,250,3,10160626014,0,168070,250480,30378,,41104261,,,,,,,,,,,,,,,,,,,,,,,,,,,,,,,,,,,,,,,,0,
57504245,28e8998b-2f6b-4447-bfb1-37b4cab4f547,1671621432,60,1671622822,,0,0,10.28,4757,4775,716,705,726,716,0,7.9,1,,,832,809,136,153,89,,,36.15,23.92,39.35,1,58.09,1049,80,,2.8,0.1,99,96,,,,,,92,71,11.14,11.05,11.75,-19.5,21.8,220,220,,1,251,251,,,,,,,,,"63,2,2,4,9,14,5,0,0","1,72,28,0,0","1,41,47,9,2",,,,,91,,,,,,,,,,,,,,,,,,,,,,,,,,,,,,,,,,,,24.2,7,3,80,81,,1020,1,262,0,4,3,Thaur,1,0,U1.000|7:17-U1.000|8:58-U1.000|16:16-U1.000|17:29-U1.000|5:40-U1.000|4:42-U1.000|4:40-U1.000|4:24-U1.000|4:17-U1.000|4:20-U0.276|1:13,,"Thaur Running",,,3113,,250,3,10165722706,0,168070,250480,30378,,41146019,,,,,,,,,,,,,,,,,,,,,,,,,,,,,,,,,,,,,,,,0,
57555906,685163ce-61e3-4ab3-a232-787c7c90df8a,1671711490,60,1671715021,,0,0,6.54,6627,6627,304,308,317,315,0,5.2,0.97,1.96,2.18,276,517,92,117,73,,,20.36,,21.59,1,58.09,,10,,0.7,0,,100,,,,,,46,53,4,4.55,5,-24.5,-12.5,79,79,,1,106,106,,,,,,,,,"100,0,0,0,0,0,0,0,0","59,41,0,0,0","72,28,0,0,0",,,,,56,,,,,,,,,,,,,,,,,,,,,,,,,,,,,,,,,,,,6,2,3,267,87,,1015,1,294,0,4,3,Patsch,1,0,U0.504|9:11-U1.000|18:37-U1.000|19:31-U1.000|24:34-U1.000|12:31-U1.000|11:30-U1.000|11:46-U0.036|2:47,,"Patsch Running",,,3113,,250,3,10170890971,0,168070,250480,30378,,41190100,,,,,,,,,,,,,,,,,,,,,,,,,,,,,,,,,,,,,,,,2,
57565580,fb5f653f-587e-47b0-a0b9-7a438968f3c5,1671726314,60,1671724336,,0,0,1.37,1602,1602,,,,,0,,,,,,161,118,155,,,,,,,1,58.1,584,31,,2,0,,100,,,,,,25,69,,12.7,,86.7,29.4,147,77,,1,368,338,,,,,,,,,"52,7,3,1,3,3,16,14,0","16,60,24,0,0","79,1,6,3,10",,,,,37,,,,,,,,,,,,,,,,,,,,,,,,,,,,,,,,,,,,18.6,,,,,,,,,,1,,,1,1,U1.000|14:42-U0.373|12:00,,"Treadmill Running",,,3113,,250,3,10171543860,0,168070,250480,30378,,41199243,,,,,,,,,,,,,,,,,,,,,,,,,,,,,,,,,,,,,,,,,
57604509,2c5b5163-1754-4f0d-8aa6-b21fa04e21cf,1671786859,60,1671786525,,0,0,10.02,2903,3206,101,75,110,86,0,0.3,0.3,1.08,0.94,,670,147,163,,,,58.2,41.68,59.11,1,58.6,1347,118,,3.3,0,100,100,,,,,,82,79,12.56,12.5,12.77,-1.5,-3.3,317,317,,1,326,326,,,,,,,,,"2,1,4,20,60,11,1,1,1","0,8,90,2,0","0,0,32,64,3",,,,,131,,,,,,,,,,,,,,,,,,,,,,,,,,,,,,,,,,,,39.6,5,5,245,94,,1015,0,281,0,6,3,Wilten,1,0,U1.000|4:42-U1.000|4:50-U1.000|4:48-U1.000|4:59-U1.000|5:01-U1.000|4:47-U1.000|4:45-U1.000|4:53-U1.000|4:37-U1.000|4:54-U0.018|0:04,,"Innsbruck Running",,,3113,,250,3,10174376484,0,168070,250480,30378,,41232662,,,,,,,,,,,,,,,,,,,,,,,,,,,,,,,,,,,,,,,,,
57651796,68510e96-98f2-4a70-ba05-7f05d5616be0,1671882120,60,1671882800,,0,0,14.1,3802,4166,127,104,145,130,0,0.7,0.34,1.13,0.96,265,919,154,168,,,,59.58,46.48,60.37,1,58.77,2160,186,,4,0,103,100,,,,,,119,80,13.48,13.44,13.76,2.7,0.5,346,346,,1,357,357,,,,,,,,,"2,1,1,7,38,43,7,1,0","1,10,68,21,0","0,1,13,74,12",,,,,139,,,,,,,,,,,,,,,,,,,,,,,,,,,,,,,,,,,,55.8,6,1,281,100,,1020,1,278,0,6,3,Wilten,1,0,U1.000|4:42-U1.000|4:28-U1.000|4:25-U1.000|4:26-U1.000|4:27-U1.000|4:19-U1.000|4:33-U1.000|4:39-U1.000|4:33-U1.000|4:25-U1.000|4:22-U1.000|4:33-U1.000|4:35-U1.000|4:31-U0.098|0:24,,"Innsbruck Running",,,3113,,250,3,10179691676,0,168070,250480,30378,,41275271,,,,,,,,,,,,,,,,,,,,,,,,,,,,,,,,,,,,,,,,5,
57693959,f305457b-3a13-4938-93b7-0d9ba30d794e,1671957686,60,1671956738,,0,0,2.91,941,1171,,,,,0,,,,,,189,136,148,,,,56.3,33.83,56.3,1,58.77,932,38,,2.1,0,,100,,,,,,21,78,,14.17,,-22.5,-13.1,293,285,,1,377,375,,,,,,,,,"30,1,0,0,4,5,58,1,0","1,45,54,0,0","22,10,13,13,42",,,,,119,,,,,,,,,,,,,,,,,,,,,,,,,,,,,,,,,,,,25.2,,,,,,,,,,1,,,1,1,U1.000|4:51-U1.000|5:59-U0.914|4:51,,"Treadmill Running",,,3113,,250,3,10183078504,0,168070,250480,30378,,41309527,,,,,,,,,,,,,,,,,,,,,,,,,,,,,,,,,,,,,,,,,
57693961,e28f4ddf-97db-4c38-9f1f-905fe1f38731,1671959000,60,1671956742,,0,0,,1118,1118,,,,,0,,,,,,97,91,137,,,,,,,1,58.77,912,5,,0.3,0,,100,,,,,,8,,,,,,,,,,,,,,,,,,,,,,"73,27,0,0,0",,,,,,,,,,,,,,,,,,,,,,,,,,,,,,,,,,,,,,,,,,4.5,,,,,,,,,,1,,,1,0,,,Cardio,,,3113,,250,3,10183078799,0,168075,,30378,,41309529,,,,,,,,,,,,,,,,,,,,,,,,,,,,,,,,,,,,,,,,,
57718440,1315c52e-d6bd-45f3-9d23-a266d9cefa12,1671969219,60,1671980257,,0,0,12.09,14320,14364,927,927,922,912,0,7.7,0.98,2.24,2.2,290,1137,91,145,57,,,16.71,,18.45,1,58.77,521,15,,1,0,,100,,,,,,96,52,3.76,4.13,6.16,-28.4,42.1,77,76,,1,138,138,,,,,,,,,"100,0,0,0,0,0,0,0,0","65,35,0,0,0","72,24,3,1,0",,,,,49,,,,,,,,,,,,,,,,,,,,,,,,,,,,,,,,,,,,9.3,2,7,176,99,,1022,1,275,0,2,3,"Neustift im Stubaital",1,0,U1.000|18:10-U1.000|26:32-U1.000|19:35-U0.977|21:02-U1.000|26:17-U1.000|30:17-U0.382|9:33-U1.000|14:37-U0.359|12:33-U1.000|12:56-U1.000|11:15-U1.000|14:10-U1.000|14:58-U0.374|6:45,,"Neustift im Stubaital Running",,,3113,,250,3,10184852469,0,168070,250480,30378,,41332652,,,,,,,,,,,,,,,,,,,,,,,,,,,,,,,,,,,,,,,,0,
57739594,2b0e32f5-0ca5-41c3-8c4c-fd88dcad871f,1672043483,60,1672043875,,0,0,14.16,3793,3932,109,72,125,96,0,0,0.16,1.16,0.95,686,937,155,174,,,,59.52,46.85,60.28,1,58.84,2448,217,,4.2,0.1,102,102,,,,,,124,81,13.59,13.53,13.89,-3.1,-10.9,349,349,,1,362,362,,,,,,,,,"1,1,2,6,32,49,8,1,0","0,3,63,34,0","0,0,8,83,8",,,,,138,,,,,,,,,,,,,,,,,,,,,,,,,,,,,,,,,,,,62.7,2,5,160,91,,1026,0,276,0,3,3,Wilten,1,0,U1.000|4:54-U1.000|4:33-U1.000|4:25-U1.000|4:27-U1.000|4:25-U1.000|4:25-U1.000|4:20-U1.000|4:26-U1.000|4:23-U1.000|4:29-U1.000|4:14-U1.000|4:35-U1.000|4:12-U1.000|4:39-U0.162|0:45,,"Innsbruck Running",,,3113,,250,3,10187249708,0,168070,250480,30378,,41351076,,,,,,,,,,,,,,,,,,,,,,,,,,,,,,,,,,,,,,,,5,
57812406,618b8301-df01-46cc-881e-3469181d79b2,1672153717,60,1672156182,,0,0,11.83,3867,5731,369,315,383,334,0,4.1,0.76,1.09,1.19,457,833,146,163,,,,50.62,36.64,52.86,1,58.83,1355,109,,3.2,0,102,98,,,,,,103,78,11.89,12.22,12.66,-17.1,-14.8,286,286,,1,314,314,,,,,,,,,"28,14,13,11,12,14,8,0,0","1,24,74,1,0","0,4,61,32,3",,,,,118,,,,,,,,,,,,,,,,,,,,,,,,,,,,,,,,,,,,43.3,6,16,229,80,,1025,0,309,0,4,3,Balve,1,0,U1.000|4:58-U1.000|5:17-U1.000|6:45-U1.000|6:27-U1.000|6:14-U1.000|6:09-U1.000|6:51-U1.000|4:16-U1.000|4:15-U1.000|4:10-U1.000|4:24-U0.832|4:42,,"Balve Running",,,3113,,250,3,10195197493,0,168070,250480,30378,,41419290,,,,,,,,,,,,,,,,,,,,,,,,,,,,,,,,,,,,,,,,"3,4,5",
57861017,709263a0-c409-4437-af75-72a59b4df902,1672222109,60,1672222851,,0,0,13.6,4220,4237,311,331,323,344,0,3.4,0.74,0.92,0.99,459,938,148,164,,,,52.98,39.37,54.38,1,58.76,1499,136,,3.4,0,100,97,,,,,,116,79,12.07,12.27,12.19,-10.5,-4.6,291,291,,1,295,295,,,,,,,,,"15,13,15,14,17,20,6,0,0","0,6,93,1,0","0,2,59,40,0",,,,,122,,,,,,,,,,,,,,,,,,,,,,,,,,,,,,,,,,,,42.5,6,22,208,90,,1015,0,305,0,4,3,Balve,1,0,U1.000|5:08-U1.000|5:04-U1.000|6:30-U1.000|6:10-U1.000|6:04-U1.000|6:16-U1.000|5:03-U1.000|4:20-U1.000|4:10-U1.000|4:08-U1.000|4:08-U1.000|5:11-U1.000|5:17-U0.597|2:50,,"Balve Running",,,3113,,250,3,10198931732,0,168070,250480,30378,,41459036,,,,,,,,,,,,,,,,,,,,,,,,,,,,,,,,,,,,,,,,"4,5",
57963866,6b2e4a93-154f-4d0a-a022-ffd5f54592a4,1672327363,60,1672329284,,0,0,10.69,4546,5380,391,418,399,433,0,4.3,0.7,1.01,0.84,824,810,140,176,,,,38.67,26.59,40.31,1,58.75,1406,148,,3.4,1.4,96,101,,,,,,112,76,8.92,10.37,13.72,33,-49.1,214,213,,1,369,369,,,,,,,,,"49,5,6,15,18,6,2,0,0","0,50,39,11,0","28,18,30,17,6",,,,,93,,,,,,,,,,,,,,,,,,,,,,,,,,,,,,,,,,,,49.1,7,21,226,90,,1008,0,366,0,4,3,Balve,1,0,U1.000|5:31-U1.000|5:05-U1.000|5:08-U1.000|4:52-U1.000|5:12-U1.000|4:54-U0.376|2:52-U0.139|0:40-U0.184|1:32-U0.135|0:43-U0.171|1:32-U0.136|0:41-U0.172|1:26-U0.141|0:41-U0.173|1:35-U0.133|0:42-U0.386|5:25-U0.144|0:34-U0.248|3:37-U0.144|0:38-U0.206|3:22-U0.146|0:40-U0.218|3:21-U0.142|0:37-U0.232|4:36-U0.143|0:39-U0.926|9:10,,"Balve Running",,,3113,,250,3,10206595032,0,168070,250480,30378,,41548208,,,,,,,,,,,,,,,,,,,,,,,,,,,,,,,,,,,,,,,,"4,4,4,5",
58079086,d79a5565-5f74-4875-ba14-d09b57604660,1672414628,60,1672474535,,0,0,6.03,2048,2073,121,115,139,134,0,2.2,0.66,1.02,0.95,298,439,148,168,,,,47.39,33.42,48.63,1,58.75,990,70,,2.7,0,,100,,,,,,58,78,10.87,10.77,11.03,-1.6,-2.1,262,262,,1,270,270,,,,,,,,,"17,11,22,39,10,0,0,0,0","0,16,80,4,0","0,3,83,13,0",,,,,113,,,,,,,,,,,,,,,,,,,,,,,,,,,,,,,,,,,,44.2,7,33,178,89,,1005,0,336,0,6,3,Balve,1,0,U1.000|6:08-U1.000|5:26-U1.000|5:20-U1.000|5:45-U1.000|5:50-U1.000|5:30-U0.028|0:09,,"Balve Running",,,3113,,250,3,10215195629,0,168070,250480,30378,,41650636,,,,,,,,,,,,,,,,,,,,,,,,,,,,,,,,,,,,,,,,"4,5",
58104175,2821ed5c-bbd0-47f2-8e67-8f9e86fe3804,1672489113,60,1672489992,,0,0,15.02,4275,4460,294,294,405,262,4,2.9,0.58,1.21,0.91,381,1081,156,168,,,,54.71,43.87,56.04,1,,,,,,,,,,,,,,141,79,12.91,12.71,13.28,4.2,2.2,324,324,,1,337,337,,,,,,,,,"2,2,5,19,41,28,3,0,0","0,2,66,31,0","0,2,40,43,14",,,,,133,,,,,,,,,,,,,,,,,,,,,,,,,,,,,,,,,,,,57,14,29,214,91,,1009,0,309,0,11,3,Sundern,1,0,U1.000|4:57-U1.000|4:39-U1.000|4:40-U1.000|4:42-U1.000|4:27-U1.000|4:25-U1.000|4:53-U1.000|5:08-U1.000|4:48-U1.000|4:47-U1.000|4:41-U1.000|4:54-U1.000|4:43-U1.000|4:43-U0.994|4:49,,,,,wahoo_fitness-33,,518,7,,0,168070,250480,30378,,41672410,,,,,,,,,,,,,,,,,,,,,,,,,,,,,,,,,,,,,,,,"4,5,5,5",
58166287,,1672481640,,1672564525,,0,0,55,18000,,,,,,0,,,,,,4400,,,,,,,40.18,,1,,,,,,,,,,,,,,428,,,,,,,,,,,,,,,,,,,,,,,,,,,,,,,,,,,,,,,,,,,,,,,,,,,,,,,,,,,,,,,,,,,,,,,,,,1,,,0,0,,,"Strava shows more KM for the year and Runalyze misses some runs, so this compensates that.",,,,,,0,,0,168070,250480,30378,,,,,,,,,,,,,,,,,,,,,,,,,,,,,,,,,,,,,,,,,,,
58196567,d042b03d-8a4d-44fe-9f2a-36f87e6650a1,1672586016,60,1672587124,,0,0,13.11,4364,4661,456,458,405,365,4,4.7,0.85,1.07,1.16,443,923,140,166,,,,52.34,36.16,54.58,1,,,,,,,,,,,,,,99,78,11.85,11.39,12.22,-22.2,-9.2,280,280,,1,293,293,,,,,,,,,"31,13,11,12,13,19,2,0,0","0,45,53,2,0","0,9,58,29,4",,,,,116,,,,,,,,,,,,,,,,,,,,,,,,,,,,,,,,,,,,37.1,12,16,211,78,,1017,0,305,0,4,3,Balve,1,0,U1.000|6:24-U1.000|6:45-U1.000|6:00-U1.000|6:51-U1.000|6:39-U1.000|6:01-U1.000|5:37-U1.000|5:12-U1.000|5:04-U1.000|4:50-U1.000|4:22-U1.000|4:13-U1.000|4:17-U0.085|0:28,,,,,wahoo_fitness-33,,518,7,,0,168070,250480,30378,,41756744,,,,,,,,,,,,,,,,,,,,,,,,,,,,,,,,,,,,,,,,2,
58572989,ae8c3db9-abaf-411c-8bc0-29c3e7a5a482,1673017142,60,1673016026,,0,0,6.65,2414,2414,116,111,137,133,0,2.1,0.62,1.07,1.01,724,466,134,154,,,,49.73,31.05,50.85,1,58.63,1112,48,,2.4,0,98,95,,,,,,49,78,10.06,10.07,10.54,-0.6,7.5,240,240,,1,258,258,,,,,,,,,"25,24,30,20,1,0,0,0,0","1,78,22,0,0","0,15,78,7,1",,,,,106,,,,,,,,,,,,,,,,,,,,,,,,,,,,,,,,,,,,23,10,17,245,89,,1018,0,312,0,6,3,Balve,1,0,U1.000|6:12-U1.000|5:44-U1.000|6:19-U1.000|5:53-U1.000|6:16-U1.000|6:04-U0.654|3:45,,"Balve Running",,,3113,,250,3,10255207443,0,168070,250480,30378,,42088730,,,,,,,,,,,,,,,,,,,,,,,,,,,,,,,,,,,,,,,,"5,5",
58628611,53aa6851-fc12-4942-8aa6-15cdb31b571a,1673093844,60,1673092206,,0,0,4.26,1572,1627,88,54,99,67,0,1.8,0.56,1.21,1.12,822,296,130,145,,,,50.58,29.64,52.37,1,58.63,847,38,,2.2,0,,100,,,,,,27,79,10.19,9.94,11.02,-6.7,-21.5,247,247,,1,273,273,,,,,,,,,"34,25,27,12,3,0,0,0,0","1,80,19,0,0","0,14,75,8,3",,,,,103,,,,,,,,,,,,,,,,,,,,,,,,,,,,,,,,,,,,17.9,9,19,180,89,,1012,1,277,0,4,3,Balve,1,0,U1.000|6:03-U1.000|6:30-U1.000|6:20-U1.000|5:45-U0.259|1:35,,"Balve Running",,,3113,,250,3,10260436224,0,168070,250480,30378,,42140382,,,,,,,,,,,,,,,,,,,,,,,,,,,,,,,,,,,,,,,,4,
58702681,b05e69a7-37c6-48cc-a052-dd1e054ffdbe,1673188854,60,1673190833,,0,0,14.57,4997,5242,320,284,331,295,0,3.5,0.68,0.88,0.91,401,1049,144,165,,,,48.6,35.21,50.07,1,58.54,1920,135,,3.6,0,102,96,,,,,,125,79,11.03,11.59,11.86,-22.2,-5.5,275,266,,1,292,291,,,,,,,,,"27,10,9,11,32,11,0,0,0","2,26,69,3,0","7,1,58,34,0",,,,,111,,,,,,,,,,,,,,,,,,,,,,,,,,,,,,,,,,,,44.2,6,17,204,93,,1001,0,322,0,6,3,Balve,1,0,U1.000|4:59-U1.000|4:58-U1.000|12:08-U1.000|6:29-U1.000|6:22-U1.000|6:35-U1.000|5:13-U1.000|4:50-U1.000|4:35-U1.000|4:35-U1.000|4:44-U1.000|4:40-U1.000|4:41-U1.000|4:50-U0.568|3:40,,"Balve Running",,,3113,,250,3,10268839929,0,168070,250480,30378,,42204646,,,,,,,,,,,,,,,,,,,,,,,,,,,,,,,,,,,,,,,,"4,5",
58789158,44961f82-4b2a-4319-a655-144cddc91b22,1673289601,60,1673290674,,0,0,11.23,3506,3673,164,204,179,219,0,1.7,0.51,1.08,1,284,778,145,167,,,,54.07,38.51,54.81,1,58.46,1636,126,,3.5,0,100,97,,,,,,86,78,11.59,11.69,11.77,4.5,5,282,282,,1,290,290,,,,,,,,,"3,4,20,33,34,6,0,0,0","1,31,64,3,0","0,2,63,34,1",,,,,123,,,,,,,,,,,,,,,,,,,,,,,,,,,,,,,,,,,,41.9,5,16,250,91,,1005,0,369,1,4,3,Balve,1,0,U1.000|5:32-U1.000|5:21-U1.000|5:05-U1.000|5:34-U1.000|5:10-U1.000|5:20-U1.000|5:22-U1.000|5:10-U1.000|5:05-U1.000|4:49-U1.000|4:50-U0.229|1:09,,"Balve Running",,,3113,,250,3,10276233713,0,168070,250480,30378,,42279560,,,,,,,,,,,,,,,,,,,,,,,,,,,,,,,,,,,,,,,,5,
58831782,30f54125-699a-42ec-9122-5481407d7baf,1673353423,60,1673354299,,0,0,11.7,3999,4301,356,360,353,363,0,3.9,0.85,0.95,1.09,490,836,149,169,,,,46.59,34.74,48.32,1,58.31,1541,120,,3.4,0,96,94,,,,,,118,79,11.38,11.38,11.56,-10.4,0,267,267,,1,274,274,,,,,,,,,"30,15,9,15,18,13,0,0,0","1,26,57,16,0","1,5,75,18,0",,,,,111,,,,,,,,,,,,,,,,,,,,,,,,,,,,,,,,,,,,53.5,5,17,220,92,,1019,1,308,0,4,3,Balve,1,0,U1.000|6:00-U1.000|5:10-U1.000|6:36-U1.000|6:28-U1.000|6:26-U1.000|6:13-U1.000|7:07-U1.000|4:45-U1.000|4:34-U1.000|4:31-U1.000|4:32-U0.701|4:19,,"Balve Running",,,3113,,250,3,10280510041,0,168070,250480,30378,,42316673,,,,,,,,,,,,,,,,,,,,,,,,,,,,,,,,,,,,,,,,3,
58837120,014750dc-5f77-4cdd-a6b6-a5cbe6de7099,1673363697,60,1673360669,,0,0,1.54,551,551,,,,,0,,,,,,30,72,72,,,,,,,1,58.31,1435,1,,,0,,100,,,,,,1,57,,12.3,,,,44,31,,0,46,42,,,,,,,,,"100,0,0,0,0,0,0","100,0,0,0,0","100,0,0,0,0",,,2096,,,,,,,,,,,,,,,,,,,,,,,,,,,,,,,,,,,,,,0,,,,,,,,,,1,,,1,0,,,"Indoor Cycling",,,3113,,250,3,10281110991,0,168072,,30378,,42321725,,,,,,,,,,,,,,,,,,,,,,,,,,,,,,,,,,,,,,,,,
58928644,f8f9f353-93c7-447b-8076-356457d3acbb,1673463910,60,1673465149,,0,0,1.3,346,346,,,,,0,,,,,,73,145,176,,,,65.85,38.89,65.85,1,58.38,1326,25,,1.5,0.4,,100,,,,,,10,80,,16.05,,12.6,15.9,353,353,,1,437,437,,,,,,,,,"20,3,3,12,11,5,3,38,6","0,49,14,37,0","2,18,25,10,45",,,,,141,,,,,,,,,,,,,,,36,,,,,,,,,,,,,,,,,,,,,24.8,,,,,,,,,,1,,,1,1,U0.416|1:22-U0.355|2:08-U0.413|1:23-U0.119|0:52,,"Treadmill Running",,,3113,,250,3,10289939912,0,168070,250480,30378,,42404880,,,,,,,,,,,,,,,,,,,,,,,,,,,,,,,,,,,,,,,,,
58928645,f8a53a9f-6d91-41f4-88b4-58e307314ca8,1673466000,60,1673465148,,0,0,1.65,492,570,10,19,12,23,0,0,0.25,,0.89,,108,145,154,,,,57.22,35.16,57.27,1,58.38,2071,28,,2,0,101,100,,,,,,12,81,11.99,12.28,12.23,-4.1,-11,296,296,,1,305,305,,,,,,,,,"4,4,4,21,52,13,1,0,0","0,26,74,0,0","0,3,38,59,0",,,,,124,,,,,,,,,,,,,,,31,,,,,,,,,,,,,,,,,,,,,21.9,8,23,222,90,,1013,0,323,1,3,3,"Menden (Sauerland)",1,0,U1.000|5:00-U0.646|3:12,,"Menden (Sauerland) Running",,,3113,,250,3,10289940006,0,168070,250480,30378,,42404881,,,,,,,,,,,,,,,,,,,,,,,,,,,,,,,,,,,,,,,,,
58928646,06514501-2dc8-46ae-b203-c95b77811263,1673461230,60,1673465149,,0,0,7.14,1959,1977,36,52,47,65,0,0,0.21,0.95,0.91,,459,146,161,112,,,62.83,43.47,63.05,1,58.38,1338,108,,3.3,0,100,98,,,,,,53,80,13.09,13.21,13.17,7.5,8.8,329,329,,1,334,334,,,,,,,,,"2,1,2,4,37,50,3,0,0","7,3,89,0,0","0,0,16,83,0",,,,,137,,,,,,,,,,,,,,,32,,,,,,,,,,,,,,,,,,,,,38.8,5,16,231,92,,1013,0,324,1,3,3,"Menden (Sauerland)",1,0,U1.000|4:43-U1.000|4:35-U1.000|4:27-U1.000|4:23-U1.000|4:27-U1.000|4:34-U1.000|4:34-U0.144|0:55,,"Menden (Sauerland) Running",,,3113,,250,3,10289939873,0,168070,250480,30378,,42404882,,,,,,,,,,,,,,,,,,,,,,,,,,,,,,,,,,,,,,,,,
58928648,3e601c09-624d-4ecd-88e5-af55f2b49313,1673464333,60,1673465149,,0,0,3.72,1191,1191,76,72,97,94,0,1.2,0.4,1.01,0.72,250,245,134,178,,,,58.06,34.83,59.61,1,58.38,2088,82,,2.3,2.2,,100,,,,,,25,79,11.55,13.18,13.76,-8.6,-4.7,294,294,,1,366,366,,,,,,,,,"45,4,7,1,1,2,9,30,0","7,65,13,14,0","18,20,13,15,34",,,,,119,,,,,,,,,,,,,,,34,,,,,,,,,,,,,,,,,,,,,26.8,7,22,222,90,,1013,0,323,1,3,3,"Menden (Sauerland)",1,0,U0.390|1:23-U0.270|2:12-U0.400|1:22-U0.260|2:13-U0.410|1:23-U0.240|2:09-U0.410|1:23-U0.220|2:09-U0.400|1:24-U0.260|2:05-U0.400|1:24-U0.060|0:46,,"Menden (Sauerland) Track Running",,,3113,,250,3,10289939956,0,168070,250480,30378,,42404883,,,,,,,,,,,,,,,,,,,,,,,,,,,,,,,,,,,,,,,,5,
58970563,9fa85db0-24b2-4b76-8b5f-5192491ae811,1673530496,60,1673531494,,0,0,13.53,4241,4289,356,347,366,356,0,4.3,0.81,0.95,0.98,580,928,149,167,110,,,51.84,38.89,53.57,1,58.32,2200,143,,3.6,0,99,97,,,,,,117,79,12.07,11.96,12.58,-2.8,10.5,293,293,,1,312,312,,,,,,,,,"13,15,13,16,21,21,2,0,0","2,16,76,6,0","0,3,50,45,2",,,,,121,,,,,,,,,,,,,,,34,,,,,,,,,,,,,,,,,,,,,46.5,8,25,228,94,,1009,0,299,0,6,3,Balve,1,0,U1.000|4:56-U1.000|5:02-U1.000|6:20-U1.000|5:56-U1.000|5:58-U1.000|6:24-U1.000|5:08-U1.000|4:34-U1.000|4:21-U1.000|4:21-U1.000|4:21-U1.000|5:17-U1.000|5:34-U0.529|2:28,,"Balve Running",,,3113,,250,3,10294291954,0,168070,250480,30378,,42441821,,,,,,,,,,,,,,,,,,,,,,,,,,,,,,,,,,,,,,,,"3,4",
59029046,e12870fa-63d3-4295-9bd2-384bf9e7e052,1673596298,60,1673597220,,0,0,13.01,4176,4278,247,256,264,275,0,2.8,0.63,0.96,1.02,682,913,149,169,121,,,50.34,37.71,51.48,1,58.24,2059,132,,3.5,0,95,99,,,,,,113,79,11.42,11.54,11.74,-6.5,-10.2,277,277,,1,290,290,,,,,,,,,"12,10,18,28,22,9,0,0,0","1,14,73,12,0","0,2,72,24,2",,,,,118,,,,,,,,,,,,,,,,,,,,,,,,,,,,,,,,,,,,48.9,5,23,238,87,,1006,0,,0,1,4,Balve,1,0,U1.000|6:05-U1.000|5:21-U1.000|5:49-U1.000|5:37-U1.000|5:22-U1.000|5:27-U1.000|5:05-U1.000|4:54-U1.000|5:25-U1.000|5:38-U1.000|4:31-U1.000|4:35-U1.000|5:46-U0.006|0:03,,"Balve Running",,,3113,,250,3,10298927556,0,168070,250480,30378,,42494199,,,,,,,,,,,,,,,,,,,,,,,,,,,,,,,,,,,,,,,,"5,5,5",
59155932,cd716ada-fa77-4795-ad0d-7de57bc58b29,1673703690,60,1673705892,,0,0,15.29,4708,4941,378,373,391,388,0,4.4,0.85,1.03,1.16,535,1031,148,168,,,,53.49,40.09,55.14,1,58.23,2105,149,,3.7,0,97,99,,,,,,133,79,12.37,12.61,12.65,-5.2,-0.2,299,299,,1,307,307,,,,,,,,,"18,14,14,10,10,22,11,1,0","0,10,88,2,0","0,0,59,40,2",,,,,123,,,,,,,,,,,,,,,,,,,,,,,,,,,,,,,,,,,,43.3,7,29,200,90,,1002,0,,0,6,4,Balve,1,0,U1.000|5:56-U1.000|6:25-U1.000|5:51-U1.000|6:19-U1.000|4:29-U1.000|4:26-U1.000|4:09-U1.000|5:03-U1.000|7:02-U1.000|5:36-U1.000|5:26-U1.000|4:26-U1.000|4:04-U1.000|4:11-U1.000|3:52-U0.292|1:12,,"Balve Running",,,3113,,250,3,10307123058,0,168070,250480,30378,,42608460,,,,,,,,,,,,,,,,,,,,,,,,,,,,,,,,,,,,,,,,"4,4",
59335623,be3be040-d010-4f5c-8147-f3d639898724,1673804510,-300,1673834888,,0,0,12.89,3499,3592,295,257,329,292,0,3.3,0.64,1.09,1.02,510,864,153,178,,,,59.65,45.81,61.56,1,58.28,3190,214,,4.3,0.4,103,101,,,,,,111,81,13.71,13.49,14.07,3.5,1.7,350,350,,1,363,363,,,,,,,,,"1,3,5,10,23,46,11,0,0","0,10,71,18,0","0,1,13,71,15",,,,,136,,,,,,,,,,,,,,,,,,,,,,,,,,,,,,,,,,,,65.4,8,5,275,46,,1020,0,,0,1,4,"Fulton County",1,0,U1.000|4:43-U1.000|4:14-U1.000|4:22-U1.000|4:15-U1.000|4:27-U1.000|4:16-U1.000|4:32-U1.000|4:24-U1.000|4:27-U1.000|4:16-U1.000|4:34-U1.000|5:40-U0.891|4:09,,"Atlanta Running",,,3113,,250,3,10317272509,0,168070,250480,30378,,42771879,,,,,,,,,,,,,,,,,,,,,,,,,,,,,,,,,,,,,,,,"4,5,5,5",
59354810,3527d9fa-ef16-47d7-aeed-5847990cfca9,1673848845,-300,1673870980,,0,0,10.26,3177,3236,134,216,147,227,0,2,0.66,0.99,1.01,391,719,151,165,117,,,51.66,38.62,51.98,1,58.25,2753,125,,3.5,0,99,97,,,,,,97,80,11.65,11.82,11.72,3.4,-0.4,280,280,,1,284,284,,,,,,,,,"4,9,14,28,37,8,0,0,0","1,8,73,18,0","0,4,66,31,0",,,,,121,,,,,,,,,,,,,,,,,,,,,,,,,,,,,,,,,,,,54.8,-1,3,201,77,,1020,0,,1,3,4,"Fulton County",1,0,U1.000|5:35-U1.000|4:52-U1.000|5:11-U1.000|4:57-U1.000|4:52-U1.000|4:54-U1.000|5:20-U1.000|5:00-U1.000|5:48-U1.000|5:17-U0.256|1:10,,"Atlanta Running",,,3113,,250,3,10319122757,0,168070,250480,30378,,42784605,,,,,,,,,,,,,,,,,,,,,,,,,,,,,,,,,,,,,,,,5,
59435551,65d3dd29-1e66-4ca8-97f7-0ce0f34ae005,1673937493,-300,1673958640,,0,0,3.91,1247,1321,16,14,0,1,4,0,0.02,1,,,280,144,155,,,,53.16,35.1,53.46,1,,,,,,,,,,,,,,32,79,11.37,11.54,11.59,4.9,7.7,280,280,,1,288,287,,,,,,,,,"8,9,19,24,27,10,2,0,0","0,30,70,0,0","1,1,65,33,0",,,,,119,,,,,,,,,,,,,,,,,,,,,,,,,,,,,,,,,,,,29.4,10,13,203,76,,1012,0,,1,4,4,"Sandy Springs",1,0,U1.000|5:14-U1.000|4:54-U1.000|5:19-U0.897|5:13-U0.006|0:06,,,,,wahoo_fitness-33,,518,7,,0,168070,250480,30378,,42854884,,,,,,,,,,,,,,,,,,,,,,,,,,,,,,,,,,,,,,,,,
59435552,781ea87f-f4f7-4498-a796-54e2e312ea21,1673935882,-300,1673958640,,0,0,5.53,1591,1591,0,1,38,1,4,0,0,,,,401,157,184,,,,53.49,40.49,53.48,1,,,,,,,,,,,,,,57,79,12.48,14.22,14.21,4.1,-3.2,321,321,,1,379,379,,,,,,,,,"27,4,6,10,8,6,11,21,6","0,10,50,36,4","13,7,32,13,36",,,,,132,,,,,,,,,,,,,,,,,,,,,,,,,,,,,,,,,,,,59.2,10,13,203,76,,1012,0,,1,4,4,"Sandy Springs",1,0,U0.800|2:42-U0.400|2:10-U0.500|1:40-U0.453|3:02-U0.500|1:39-U0.442|3:04-U0.500|1:40-U0.453|3:07-U0.500|1:40-U0.428|3:05-U0.500|1:39-U0.100|1:03,,,,,wahoo_fitness-33,,518,7,,0,168070,250480,30378,,42854885,,,,,,,,,,,,,,,,,,,,,,,,,,,,,,,,,,,,,,,,,
59435554,0cc89b1d-b732-4958-8857-bf54fc506918,1673934315,-300,1673958642,,0,0,3.23,1089,1427,1,0,287,23,4,0,0,,,,244,146,159,,,,48.72,32.45,48.76,1,,,,,,,,,,,,,,29,74,10.72,10.96,10.99,-1.1,-6.6,260,260,,1,269,269,,,,,,,,,"15,13,22,26,18,5,1,0,0","0,16,84,0,0","1,7,79,13,0",,,,,120,,,,,,,,,,,,,,,,,,,,,,,,,,,,,,,,,,,,30.7,10,13,199,68,,1012,0,,1,1,4,"Sandy Springs",1,0,U1.000|5:41-U1.000|5:25-U1.000|5:12-U0.226|1:51,,,,,wahoo_fitness-33,,518,7,,0,168070,250480,30378,,42854887,,,,,,,,,,,,,,,,,,,,,,,,,,,,,,,,,,,,,,,,,
59501770,6464229c-6298-421b-94d9-cf1567f60385,1674020721,-300,1674045101,,0,0,11.4,3608,3942,31,31,262,318,4,0,0.05,,,,769,140,162,,,,55.7,37.94,55.89,1,,,,,,,,,,,,,,85,77,11.4,11.45,11.53,0.6,-0.5,280,280,,1,285,285,,,,,,,,,"8,9,18,32,25,8,1,0,0","1,45,53,0,0","0,2,72,25,1",,,,,123,,,,,,,,,,,,,,,,,,,,,,,,,,,,,,,,,,,,33.2,12,2,208,94,,1016,0,,1,9,4,"Chattahoochee River National Recreation Area",1,0,U1.000|5:41-U1.000|5:16-U1.000|5:32-U1.000|5:03-U1.000|4:59-U1.000|5:21-U1.000|5:37-U1.000|5:00-U1.000|5:13-U1.000|5:07-U1.000|5:14-U0.378|2:04,,,,,wahoo_fitness-33,,518,7,,0,168070,250480,30378,,42909981,,,,,,,,,,,,,,,,,,,,,,,,,,,,,,,,,,,,,,,,,
59578819,12de65b0-af65-4884-9601-a64924cefe0c,1674107198,-300,1674132411,,0,0,14.25,4570,5963,155,153,189,185,0,1.4,0.4,1.04,1,271,978,143,163,108,,,53.29,38.02,54.02,1,58.21,1420,116,,3.4,0,100,100,,,,,,115,78,11.29,11.36,11.59,-0.7,-6.7,277,277,,1,290,290,,,,,,,,,"9,6,21,35,23,4,1,0,0","0,39,60,1,0","1,2,79,17,2",,,,,120,,,,,,,,,,,,,,,,,,,,,,,,,,,,,,,,,,,,35.8,15,19,185,89,,1012,0,,1,4,4,"Chattahoochee River National Recreation Area",1,0,U1.000|5:31-U1.000|5:18-U1.000|5:26-U1.000|5:22-U1.000|5:19-U1.000|5:22-U1.000|5:24-U1.000|5:22-U1.000|5:14-U1.000|5:19-U1.000|5:04-U1.000|5:31-U1.000|5:16-U1.000|5:32-U0.251|1:09,,"Cobb County Running",,,3113,,250,3,10339079394,0,168070,250480,30378,,42978150,,,,,,,,,,,,,,,,,,,,,,,,,,,,,,,,,,,,,,,,5,
59650283,5ba33097-24b3-4db5-b6b5-2c86a8d7636e,1674195760,-300,1674218109,,0,0,13.01,3889,3996,250,260,284,294,0,3.1,0.65,1.08,1,832,865,142,164,103,,,58.66,40.98,60,1,58.2,2025,171,,3.9,0.4,100,100,,,,,,94,81,12.21,12.69,13.1,1.5,5.2,303,303,,1,336,336,,,,,,,,,"6,8,17,28,16,13,10,2,0","0,40,56,3,0","0,1,58,30,11",,,,,124,,,,,,,,,,,,,,,,,,,,,,,,,,,,,,,,,,,,43.7,5,17,312,69,,1019,0,,1,3,4,"Sandy Springs",1,0,U1.000|5:37-U1.000|5:41-U1.000|5:09-U1.000|5:26-U0.430|2:28-U0.286|1:01-U0.194|0:59-U0.528|2:01-U0.226|1:06-U0.702|3:03-U0.186|1:01-U0.277|1:02-U0.220|1:02-U0.490|2:02-U0.205|1:02-U0.734|3:03-U0.205|0:57-U0.240|1:02-U0.217|1:05-U0.513|2:03-U0.162|0:54-U0.623|3:00-U1.000|5:29-U1.000|5:41-U0.570|2:54,,"Atlanta Running",,,3113,,250,3,10345181521,0,168070,250480,30378,,43043400,,,,,,,,,,,,,,,,,,,,,,,,,,,,,,,,,,,,,,,,"4,5",
59815418,429064e1-3488-4e37-ac90-c724859be330,1674370084,-300,1674431160,,0,0,20.05,6343,7058,191,202,225,233,0,1.3,0.4,1.06,0.99,551,1350,143,169,92,,,54.19,39.7,54.79,1,58.18,2020,161,,3.8,0,101,100,,,,,,162,79,11.44,11.43,11.58,2.4,3.4,280,280,,1,288,288,,,,,,,,,"6,6,18,40,27,3,0,0,0","0,28,71,1,0","0,3,71,26,0",,,,,120,,,,,,,,,,,,,,,,,,,,,,,,,,,,,,,,,,,,37.4,4,7,91,94,,1012,0,,1,6,4,"Chattahoochee River National Recreation Area",1,0,U1.000|5:33-U1.000|5:20-U1.000|5:19-U1.000|5:09-U1.000|5:05-U1.000|5:16-U1.000|4:56-U1.000|4:58-U1.000|5:07-U1.000|5:07-U1.000|5:08-U1.000|5:20-U1.000|5:43-U1.000|5:33-U1.000|5:04-U1.000|5:17-U1.000|5:26-U1.000|5:44-U1.000|5:25-U1.000|4:57-U0.050|0:13,,"Cobb County Running",,,3113,,250,3,10362087185,0,168070,250480,30378,,43191192,,,,,,,,,,,,,,,,,,,,,,,,,,,,,,,,,,,,,,,,5,
59815430,dff41fe2-5967-4699-8417-b1bcb9ebeaed,1674289531,-300,1674431233,,0,0,10.01,3139,3280,217,211,243,239,0,3.6,0.75,1.06,1.01,435,687,144,162,,,,54.28,37.99,55.77,1,58.19,1403,113,,3.3,0,103,98,,,,,,83,80,11.76,11.67,12.8,-3.5,-25.2,289,289,,1,320,320,,,,,,,,,"6,8,14,33,31,7,0,0,0","0,32,66,1,0","0,1,63,34,2",,,,,120,,,,,,,,,,,,,,,,,,,,,,,,,,,,,,,,,,,,39.9,4,6,9,69,,1023,0,,1,4,4,"Sandy Springs",1,0,U1.000|5:21-U1.000|5:11-U1.000|4:46-U1.000|5:05-U1.000|5:01-U1.000|5:15-U1.000|5:08-U1.000|5:45-U1.000|5:16-U1.000|5:26-U0.014|0:05,,"Atlanta Running",,,3113,,250,3,10362085070,0,168070,250480,30378,,43191203,,,,,,,,,,,,,,,,,,,,,,,,,,,,,,,,,,,,,,,,"4,4",
59853100,44f4a9c0-3c24-4f31-9139-36653caa716e,1674456130,-300,1674479060,,0,0,9.8,3475,3797,199,222,227,250,0,3.5,0.72,1.13,1.05,414,670,143,162,,,,47.08,32.81,48.12,1,58.17,1462,84,,3,0,95,95,,,,,,88,80,10.39,10.47,11.62,-3.3,13.6,246,246,,1,287,287,,,,,,,,,"22,21,31,18,5,2,1,0,0","0,31,68,1,0","0,12,76,9,2",,,,,106,,,,,,,,,,,,,,,,,,,,,,,,,,,,,,,,,,,,37.2,3,14,306,87,,1018,0,,1,3,4,"Sandy Springs",1,0,U1.000|6:06-U1.000|6:10-U1.000|5:44-U1.000|6:10-U1.000|5:56-U1.000|6:01-U1.000|5:37-U1.000|6:01-U1.000|6:25-U0.798|3:45,,"Atlanta Running",,,3113,,250,3,10364622958,0,168070,250480,30378,,43225181,,,,,,,,,,,,,,,,,,,,,,,,,,,,,,,,,,,,,,,,"4,4",
59853142,44439694-a252-4dd3-be49-556cf0191b4d,1674481698,60,1674479109,,0,0,,932,939,,,,,0,,,,,,135,113,134,,,,,,,1,58.17,1445,12,,0.9,0,,100,,,,,,12,,,,,,,,,,,,,,,,,,,,,,"13,87,0,0,0",,,,,,,,,,,,,,,,,,,,,,,,,,,,,,,,,,,,,,,,,,10,,,,,,,,,,1,,,1,0,,,"Indoor Cycling",,,3113,,250,3,10364627653,0,168072,,30378,,43225212,,,,,,,,,,,,,,,,,,,,,,,,,,,,,,,,,,,,,,,,,
59914997,d7f44d1d-650a-47f8-afe9-e6ecab02e438,1674539209,-300,1674570129,,0,0,3.13,970,997,37,5,40,8,0,0,0.27,1.08,,,219,138,147,,,,58.24,35.76,59.83,1,58.17,816,50,,2.4,0,,100,,,,,,21,79,11.99,11.66,12.06,9.6,12.5,302,302,,1,305,305,,,,,,,,,"2,1,14,47,30,5,0,0,0","0,56,44,0,0","0,0,44,56,0",,,,,123,,,,,,,,,,,,,,,,,,,,,,,,,,,,,,,,,,,,23.8,-2,3,353,86,,1027,0,,1,2,4,"Sandy Springs",1,0,U1.000|5:16-U1.000|5:02-U1.000|5:11-U0.133|0:40,,"Sandy Springs Running",,,3113,,250,3,10371527165,0,168070,250480,30378,,43278191,,,,,,,,,,,,,,,,,,,,,,,,,,,,,,,,,,,,,,,,,
59915003,a92964a1-0d7a-475c-960d-1f06baf2b16d,1674540662,-300,1674570156,,0,0,6.7,1960,2019,31,0,31,0,0,0,0.03,,,691,505,163,183,,,,49.56,40.15,50.12,1,58.17,2592,215,,3.9,2.3,,100,,,,,,78,78,12.45,13.96,14.56,15.5,14.3,326,326,,1,394,394,,,,,,,,,"34,1,1,1,1,6,38,18,0","0,3,37,58,2","17,13,8,9,53",,,,,131,,,,,,,,,,,,,,,,,,,,,,,,,,,,,,,,,,,,78.7,-2,3,353,86,,1027,0,,1,2,4,"Sandy Springs",1,0,U0.790|2:55-U0.100|1:26-U0.800|2:56-U0.120|1:21-U0.800|2:51-U0.130|1:30-U0.800|2:56-U0.100|1:13-U0.800|2:56-U0.110|1:28-U0.800|3:02-U0.300|2:31-U0.410|1:21-U0.200|2:03-U0.400|1:25-U0.040|0:45,,"Sandy Springs Track Running",,,3113,,250,3,10371529717,0,168070,250480,30378,,43278197,,,,,,,,,,,,,,,,,,,,,,,,,,,,,,,,,,,,,,,,5,
60010933,60bd8dcd-2368-43c3-9564-6733d127bb04,1674647510,-300,1674669106,,0,0,10.61,3047,3329,178,143,207,166,0,1.5,0.57,0.96,1.05,269,706,151,184,,,,56.69,42.29,58.09,1,58.08,2834,209,,4.1,1.7,104,97,,,,,,99,80,12.89,13.64,13.68,6.5,3.1,325,325,,1,353,353,,,,,,,,,"8,8,10,22,19,15,12,6,1","1,31,41,19,9","0,3,42,33,21",,,,,131,,,,,,,,,,,,,,,,,,,,,,,,,,,,,,,,,,,,111.3,16,18,227,86,,1008,3,,1,4,4,"Sandy Springs",1,0,U1.000|5:16-U1.000|5:11-U1.000|4:45-U1.000|5:07-U0.371|2:01-U1.000|3:31-U1.000|4:13-U1.000|3:47-U1.000|4:00-U1.000|5:07-U1.000|6:22-U0.240|1:28,,"Atlanta Running",,,3113,,250,3,10379526889,0,168070,250480,30378,,43365293,,,,,,,,,,,,,,,,,,,,,,,,,,,,,,,,,,,,,,,,"5,5",
60049900,d409aed9-2bc2-4815-b895-ebe3bbef1974,1674712030,-300,1674734494,,0,0,13.01,4115,4367,96,106,124,134,0,0.3,0.21,1,0.97,521,889,144,162,,,,53.71,38.36,54.14,1,58.04,2474,125,,3.5,0,98,97,,,,,,108,79,11.45,11.43,11.65,5.7,10.5,281,281,,1,288,288,,,,,,,,,"5,4,12,51,25,3,0,0,0","0,28,71,1,0","0,3,76,20,1",,,,,120,,,,,,,,,,,,,,,,,,,,,,,,,,,,,,,,,,,,42,3,8,314,81,,1018,0,280,1,3,3,"Chattahoochee River National Recreation Area",1,0,U1.000|5:26-U1.000|5:13-U1.000|5:35-U1.000|5:04-U1.000|5:08-U1.000|5:51-U1.000|5:21-U1.000|5:07-U1.000|5:02-U1.000|5:01-U1.000|5:18-U1.000|5:12-U1.000|5:15-U0.005|0:02,,"Cobb County Running",,,3113,,250,3,10383844407,0,168070,250480,30378,,43401491,,,,,,,,,,,,,,,,,,,,,,,,,,,,,,,,,,,,,,,,4,
60113901,cc82aca8-7571-4194-8c6f-7da142ed1e3c,1674798299,-300,1674822361,,0,0,18.53,5047,5783,82,105,95,117,0,0,0.15,1.31,0.96,391,1320,176,203,,,,47.96,46.95,48.15,1,58.03,5760,450,,5,1.2,96,93,,,,,,275,81,13.2,13.41,13.62,5.1,6.5,335,335,,1,353,353,,,,,,,,,"1,1,5,13,29,39,12,1,0","0,5,17,20,58","0,0,25,62,13",,,,,136,,,,,,,,,,,,,,,,,,,,,,,,,,,,,,,,,,,,227.5,-2,9,286,77,,1027,0,,1,2,4,"Chattahoochee River National Recreation Area",1,0,U1.000|5:11-U1.000|5:08-U1.000|4:49-U1.000|4:27-U1.000|4:27-U1.000|4:31-U1.000|4:25-U1.000|4:23-U1.000|4:23-U1.000|4:23-U1.000|4:22-U1.000|4:21-U1.000|4:26-U1.000|3:55-U1.000|3:50-U1.000|4:37-U1.000|5:00-U1.000|4:54-U0.530|2:34,,"Cobb County Running",,,3113,,250,3,10390185073,0,168070,250480,30378,,43461604,,,,,,,,,,,,,,,,,,,,,,,,,,,,,,,,,,,,,,,,5,
60197004,49817105-12b1-4d84-85ac-cf86460654ec,1674888922,-300,1674911848,,0,0,14.59,4442,4773,198,203,218,226,0,2.4,0.51,1.06,0.97,442,955,144,161,,,,56.29,40.47,57.21,1,58.03,4255,141,,3.6,0,102,100,,,,,,116,80,11.98,12.41,12.9,4.9,-0.5,297,297,,1,333,333,,,,,,,,,"16,6,11,15,26,15,6,3,1","0,25,74,0,0","0,8,48,35,9",,,,,123,,,,,,,,,,,,,,,,,,,,,,,,,,,,,,,,,,,,43.1,-1,4,295,83,,1030,0,,1,2,4,"Fulton County",1,0,U1.000|5:05-U1.000|5:17-U1.000|4:27-U1.000|4:57-U1.000|4:59-U1.000|5:37-U1.000|4:38-U1.000|5:25-U1.000|4:48-U1.000|4:47-U1.000|5:06-U1.000|5:39-U1.000|5:23-U1.000|5:10-U0.586|2:46,,"Atlanta Running",,,3113,,250,3,10396770583,0,168070,250480,30378,,43533062,,,,,,,,,,,,,,,,,,,,,,,,,,,,,,,,,,,,,,,,"4,5",
60281249,c6a19753-0726-4faf-8f89-838d15986e63,1675008078,60,1675009346,,0,0,9.93,3035,4805,180,207,194,221,0,2.8,0.73,1.02,1.03,426,669,142,163,,,,57.08,39.13,58.16,1,58.03,2450,98,,3.1,0,100,100,,,,,,74,80,11.97,12.18,12.16,-7.4,-10,292,292,,1,299,299,,,,,,,,,"9,10,12,21,28,15,4,1,0","2,36,62,1,0","0,0,58,42,0",,,,,123,,,,,,,,,,,,,,,,,,,,,,,,,,,,,,,,,,,,35.2,-1,9,223,79,,1025,0,,0,4,4,Balve,1,0,U1.000|5:40-U1.000|4:49-U1.000|5:23-U1.000|5:11-U1.000|4:56-U1.000|5:24-U1.000|5:24-U1.000|3:56-U1.000|4:24-U0.931|5:28,,"Balve Running",,,3113,,250,3,10405161449,0,168070,250480,30378,,43610190,,,,,,,,,,,,,,,,,,,,,,,,,,,,,,,,,,,,,,,,"5,5,5",
60369678,abb93a0d-098e-49e3-9d3f-1d53e940757c,1675081074,60,1675081561,,0,0,13.01,3773,3844,204,215,253,262,0,2.5,0.53,1.04,0.99,535,863,149,172,126,,,57.06,42.45,58.1,1,58.07,2304,157,,3.6,0.4,101,96,,,,,,113,81,12.62,12.65,12.92,3,0.5,302,302,,1,315,315,,,,,,,,,"3,3,7,23,32,28,3,0,0","0,12,83,5,0","0,4,42,50,4",,,,,128,,,,,,,,,,,,,,,,,,,,,,,,,,,,,,,,,,,,53.2,3,25,280,100,,1016,1,297,0,6,3,Balve,1,0,U1.000|4:42-U1.000|5:09-U1.000|4:53-U1.000|4:47-U1.000|5:15-U1.000|4:34-U1.000|4:37-U1.000|4:43-U1.000|4:33-U1.000|4:36-U1.000|4:59-U1.000|5:11-U1.000|4:51-U0.006|0:02,,"Balve Running",,,3113,,250,3,10409498047,0,168070,250480,30378,,43693969,,,,,,,,,,,,,,,,,,,,,,,,,,,,,,,,,,,,,,,,"4,5",
60456707,2892508a-c4ba-41e9-95d2-9d57661804cd,1675171281,60,1675172157,,0,0,13.54,4007,4132,310,331,330,352,0,3.9,0.76,0.96,1.06,537,882,152,171,,,,54.12,41.59,55.55,1,58.1,2016,158,,3.6,0,104,98,,,,,,128,80,12.61,12.94,13.24,-7.8,7.6,296,296,,1,317,317,,,,,,,,,"9,14,14,13,20,16,15,0,0","0,7,76,17,0","0,1,57,37,4",,,,,127,,,,,,,,,,,,,,,,,,,,,,,,,,,,,,,,,,,,57.1,4,23,239,88,,1020,1,,0,4,4,Balve,1,0,U1.000|4:43-U1.000|4:46-U1.000|6:03-U1.000|5:52-U1.000|5:45-U1.000|6:07-U1.000|4:54-U1.000|4:19-U1.000|4:00-U1.000|3:51-U1.000|3:47-U1.000|5:07-U1.000|5:04-U0.544|2:28,,"Balve Running",,,3113,,250,3,10416478289,0,168070,250480,30378,,43772973,,,,,,,,,,,,,,,,,,,,,,,,,,,,,,,,,,,,,,,,"3,5",
60557436,3cfdf7d8-2b23-47c0-8bec-eef207f650b3,1675274096,60,1675276265,,0,0,13.01,4231,4508,181,198,200,226,0,2.1,0.52,1.01,0.99,477,836,136,168,,,,55.9,37.13,56.77,1,58.1,1396,116,,3.3,0,99,100,,,,,,95,79,11.25,11.31,11.47,0.7,3.3,261,261,,1,271,271,,,,,,,,,"11,9,19,32,24,4,1,0,0","1,69,25,5,0","0,7,80,13,0",,,,,117,,,,,,,,,,,,,,,,,,,,,,,,,,,,,,,,,,,,44,4,24,271,89,,1018,0,,1,6,4,Balve,1,0,U1.000|6:00-U1.000|5:44-U0.598|2:58-U1.193|6:09-U0.210|1:17-U1.000|4:57-U1.000|5:31-U1.000|6:11-U1.000|5:26-U1.000|5:17-U1.000|5:00-U1.000|4:54-U1.000|5:33-U1.000|5:29-U0.009|0:03,,"Balve Running",,,3113,,250,3,10425023506,0,168070,250480,30378,,43861511,,,,,,,,,,,,,,,,,,,,,,,,,,,,,,,,,,,,,,,,"4,5",
60622580,16f53830-392a-4854-98c5-e7b642348b1e,1675354381,60,1675356117,,0,0,16.01,4948,5183,351,346,355,349,0,3.8,0.75,0.95,1.05,513,1021,141,158,,,,56.83,40.07,58.39,1,58.09,1589,147,,3.5,0,98,100,,,,,,122,79,12.16,12.89,12.81,-5.8,-17.2,283,283,,1,307,307,,,,,,,,,"14,10,18,18,19,14,2,5,0","0,44,56,0,0","0,2,73,22,4",,,,,123,,,,,,,,,,,,,,,,,,,,,,,,,,,,,,,,,,,,37.9,6,17,270,92,,1024,0,,0,6,4,Balve,1,0,U1.000|5:54-U1.000|6:20-U1.000|5:48-U1.000|6:20-U1.000|4:42-U1.000|4:33-U1.000|4:14-U1.000|5:08-U1.000|6:46-U1.000|5:47-U1.000|4:34-U1.000|4:31-U1.000|4:16-U1.000|3:15-U1.000|5:05-U1.000|5:12-U0.008|0:04,,"Balve Running",,,3113,,250,3,10430713612,0,168070,250480,30378,,43919055,,,,,,,,,,,,,,,,,,,,,,,,,,,,,,,,,,,,,,,,"4,4",
60681815,5462e57b-79ec-4814-9775-e05df9972316,1675436093,60,1675436637,,0,0,14.02,3843,4080,257,222,278,244,0,3,0.56,1.08,0.98,528,539,92,146,,,,,45.58,,1,58.09,700,40,,2.2,0,,100,,,,,,27,81,13.52,13.38,13.75,-3.8,-4.1,328,328,,1,338,338,,,,,,,,,"3,3,5,11,28,38,12,1,0","73,26,1,0,0","0,1,24,68,7",,,,,135,,,,,,,,,,,,,,,21,,,,,,,,,,,,,,,,,,,,,11.1,8,21,331,95,,1025,0,345,0,6,3,Balve,1,0,U1.000|4:38-U1.000|4:48-U1.000|4:22-U1.000|4:09-U1.000|4:57-U1.000|4:25-U1.000|5:01-U1.000|4:22-U1.000|4:13-U1.000|4:13-U1.000|4:20-U1.000|4:40-U1.000|4:38-U1.000|5:10-U0.019|0:06,,"Balve Running",,,3113,,250,3,10436405244,0,168070,250480,30378,,43973709,,,,,,,,,,,,,,,,,,,,,,,,,,,,,,,,,,,,,,,,"4,4,5",
60753276,954f7be1-eac6-4a8e-9a01-f6541d5b25f0,1675538232,60,1675538566,,0,0,10.01,3243,3609,191,173,202,191,0,2.8,0.71,1.06,0.99,634,643,128,144,88,,,60.51,36.56,62.07,1,58.1,1164,87,,3,0,100,101,,,,,,57,78,11.44,11.42,11.72,2,-0.6,267,267,,1,277,277,,,,,,,,,"16,11,16,24,27,5,2,0,0","2,88,10,0,0","0,2,80,16,1",,,,,119,,,,,,,,,,,,,,,,,,,,,,,,,,,,,,,,,,,,22.4,3,3,139,87,,1038,0,,1,4,4,Balve,1,0,U1.000|5:36-U1.000|5:02-U1.000|5:36-U1.000|5:26-U1.000|5:20-U1.000|5:47-U1.000|5:49-U1.000|4:39-U1.000|4:22-U1.000|6:23-U0.005|0:03,,"Balve Running",,,3113,,250,3,10444605650,0,168070,250480,30378,,44037733,,,,,,,,,,,,,,,,,,,,,,,,,,,,,,,,,,,,,,,,"4,5",
60794822,9d8ed4e4-3000-4a1e-b458-05dba0b3f83b,1675603508,60,1675606378,,0,0,15.69,4334,4599,79,73,92,89,0,0,0.19,,0.87,280,961,147,176,,,,61.73,45.58,62.15,1,58.2,1872,193,,3.7,1.7,101,105,,,,,,125,80,13.07,13.35,13.54,-2,-12.7,318,318,,1,336,336,,,,,,,,,"0,1,2,15,50,22,8,2,0","0,13,76,11,0","0,1,31,59,9",,,,,136,,,,,,,,,,,,,,,,,,,,,,,,,,,,,,,,,,,,70.9,5,15,341,94,,1034,1,,0,7,4,Sundern,1,0,U1.000|4:54-U1.000|4:42-U1.000|4:39-U1.000|4:39-U1.000|4:39-U1.000|4:41-U1.000|4:39-U1.000|4:46-U1.000|4:51-U1.000|4:40-U1.000|4:41-U1.000|4:47-U1.000|4:46-U1.000|3:51-U1.000|3:38-U0.687|3:22,,"Sundern (Sauerland) Running",,,3113,,250,3,10449591929,0,168070,250480,30378,,44075391,,,,,,,,,,,,,,,,,,,,,,,,,,,,,,,,,,,,,,,,5,
60898686,86d6156e-966e-4438-81a1-55de4354600c,1675694448,60,1675695111,,0,0,14.01,4105,4182,224,213,245,237,0,2.4,0.51,1.01,1.02,412,877,145,162,,,,58.47,42.18,59.69,1,58.24,1454,135,,3.4,0,101,100,,,,,,107,80,12.54,12.6,12.8,-2.1,-4.3,299,299,,1,309,309,,,,,,,,,"4,4,13,19,31,26,3,0,0","0,24,75,0,0","0,1,54,44,2",,,,,128,,,,,,,,,,,,,,,,,,,,,,,,,,,,,,,,,,,,35.9,3,11,15,88,,1040,1,,0,4,4,Balve,1,0,U1.000|4:36-U1.000|5:09-U1.000|4:40-U1.000|4:21-U1.000|5:28-U1.000|4:49-U1.000|5:28-U1.000|4:50-U1.000|4:34-U1.000|4:34-U1.000|4:30-U1.000|4:59-U1.000|4:59-U1.000|5:27-U0.007|0:02,,"Balve Running",,,3113,,250,3,10455989939,0,168070,250480,30378,,44169930,,,,,,,,,,,,,,,,,,,,,,,,,,,,,,,,,,,,,,,,"4,5,5",
61005225,90c1ccc6-a576-45a9-b1de-c8fc8f6b6a69,1675794744,60,1675799293,,0,0,4.1,1197,1197,47,28,53,32,0,0,0.14,1.04,,,272,147,173,109,,,57.65,39.08,58.8,1,58.24,1106,83,,2.9,0,,100,,,,,,34,78,12.76,12.83,13.11,9.2,6.4,307,307,,1,324,324,,,,,,,,,"9,1,4,7,33,42,4,0,0","4,13,57,26,0","1,8,22,64,4",,,,,132,,,,,,,,,,,,,,,,,,,,,,,,,,,,,,,,,,,,54.9,0,6,110,73,,1040,0,271,1,2,3,"Menden (Sauerland)",1,0,U1.000|4:46-U1.000|4:46-U1.000|4:23-U1.000|4:25-U0.102|1:38,,"Menden (Sauerland) Running",,,3113,,250,3,10464944106,0,168070,250480,30378,,44265810,,,,,,,,,,,,,,,,,,,,,,,,,,,,,,,,,,,,,,,,,
61005238,c82eff2d-db1b-41ef-93a2-3fec3c26dc5b,1675799047,60,1675799295,,0,0,3.29,1048,1048,1,38,1,39,0,0,0.06,,0.89,,203,131,145,,,,60.08,34.75,59.27,1,58.26,2304,35,,2.1,0,104,100,,,,,,20,80,11.03,11.35,11.09,1,0,252,252,,1,256,256,,,,,,,,,"4,4,21,43,29,0,0,0,0","2,97,1,0,0","2,5,94,0,0",,,,,118,,,,,,,,,,,,,,,,,,,,,,,,,,,,,,,,,,,,16.9,0,6,135,73,,1040,0,273,1,2,3,"Menden (Sauerland)",1,0,U1.000|5:15-U1.000|5:10-U1.000|5:24-U0.285|1:39,,"Menden (Sauerland) Running",,,3113,,250,3,10464944618,0,168070,250480,30378,,44265817,,,,,,,,,,,,,,,,,,,,,,,,,,,,,,,,,,,,,,,,,
61005240,43b6af79-a10d-4fd6-ad7a-c6c327c14c3b,1675796166,60,1675799295,,0,0,8.08,2686,2686,19,0,19,1,0,0,0.08,,,,531,147,174,,,,49.12,34.93,49.4,1,58.24,2016,131,,3.2,1.3,,100,,,,,,79,81,10.88,13.23,13.48,16.1,-2.2,291,269,,1,354,347,,,,,,,,,"35,6,5,7,4,4,12,24,4","5,21,57,18,0","18,19,20,11,31",,,,,111,,,,,,,,,,,,,,,,,,,,,,,,,,,,,,,,,,,,47.8,0,6,135,73,,1040,0,273,1,2,3,"Menden (Sauerland)",1,0,U1.000|3:29-U0.390|2:26-U0.200|0:38-U0.200|1:17-U0.200|0:39-U0.200|1:17-U0.200|0:37-U0.200|1:24-U0.200|0:38-U0.210|1:20-U0.200|0:40-U0.390|2:58-U0.200|0:38-U0.200|1:30-U0.190|0:36-U0.210|1:30-U0.200|0:38-U0.200|1:19-U0.200|0:38-U0.200|1:24-U0.200|0:37-U0.280|7:03-U0.990|3:33-U0.400|4:03-U0.990|3:28-U0.030|0:28,,"Menden (Sauerland) Track Running",,,3113,,250,3,10464944541,0,168070,250480,30378,,44265815,,,,,,,,,,,,,,,,,,,,,,,,,,,,,,,,,,,,,,,,,
61065533,b71db6df-943f-45f8-9881-6ed98fd69cf7,1675874784,60,1675876275,,0,0,13.05,4314,4647,391,373,397,384,0,4.5,0.84,0.97,1.04,515,852,141,157,,,,52.3,36.44,54.33,1,58.22,1479,110,,3.2,0,101,98,,,,,,102,79,11.68,11.63,11.87,-13.1,-2.7,266,266,,1,272,272,,,,,,,,,"27,16,12,10,18,15,2,0,0","0,37,63,0,0","0,4,80,16,0",,,,,115,,,,,,,,,,,,,,,,,,,,,,,,,,,,,,,,,,,,33.5,1,6,150,61,,1035,0,,0,2,4,Balve,1,0,U1.000|5:15-U1.000|5:20-U1.000|6:35-U1.000|6:21-U1.000|6:24-U1.000|6:17-U1.000|6:21-U1.000|5:24-U1.000|4:34-U1.000|4:26-U1.000|4:41-U1.000|4:18-U1.000|5:39-U0.047|0:18,,"Balve Running",,,3113,,250,3,10470669672,0,168070,250480,30378,,44320066,,,,,,,,,,,,,,,,,,,,,,,,,,,,,,,,,,,,,,,,"3,4",
61136785,0144642e-5a19-49e4-b21d-f139e49f6b28,1675959876,60,1675960705,,0,0,13.82,4201,4358,355,372,378,398,0,4.8,0.76,1.17,0.98,649,863,143,178,,,,56.93,40.37,58.65,1,58.26,1728,202,,3.7,2.2,100,102,,,,,,111,79,12.56,13.64,14.93,4,-4.9,299,299,,1,380,380,,,,,,,,,"15,6,10,17,20,12,9,9,1","4,43,34,19,0","8,5,42,28,17",,,,,125,,,,,,,,,,,,,,,,,,,,,,,,,,,,,,,,,,,,74.6,1,7,224,63,,1033,0,,0,4,4,Balve,1,0,U1.000|5:42-U1.000|4:51-U1.000|5:03-U1.000|5:04-U1.000|5:13-U0.334|1:34-U1.000|4:13-U1.000|3:24-U0.004|0:02-U0.152|2:01-U1.000|4:15-U1.000|3:26-U0.154|1:58-U1.000|4:20-U1.000|3:29-U1.000|8:14-U1.000|6:11-U0.172|1:02,,"Balve Running",,,3113,,250,3,10477080117,0,168070,250480,30378,,44383464,,,,,,,,,,,,,,,,,,,,,,,,,,,,,,,,,,,,,,,,"4,4,4,4,5",
61196804,d1922a7f-4063-49a5-bda3-c8aefde14e5b,1676049850,60,1676051284,,0,0,15.01,4422,4968,242,213,274,243,0,2.5,0.56,1.01,1.03,295,920,137,154,,,,62.58,42.15,63.98,1,58.34,1396,124,,3.3,0,104,102,,,,,,92,79,12.45,12.42,12.58,-1.8,-2,298,298,,1,303,303,,,,,,,,,"2,3,7,30,36,19,2,0,0","1,58,41,0,0","0,1,48,51,0",,,,,129,,,,,,,,,,,,,,,,,,,,,,,,,,,,,,,,,,,,26.1,3,10,227,79,,1036,0,,1,3,4,Balve,1,0,U1.000|4:36-U1.000|4:41-U1.000|5:12-U1.000|4:58-U1.000|5:00-U1.000|4:59-U1.000|4:56-U1.000|5:02-U1.000|5:12-U1.000|5:03-U1.000|4:38-U1.000|4:41-U1.000|4:31-U1.000|4:43-U1.000|5:28-U0.007|0:02,,"Balve Running",,,3113,,250,3,10483864176,0,168070,250480,30378,,44437698,,,,,,,,,,,,,,,,,,,,,,,,,,,,,,,,,,,,,,,,"5,5",
61258389,5a2f9563-b1eb-4179-8bcd-1c1b19278473,1676138367,60,1676138672,,0,0,10,3538,3694,180,167,201,189,0,2.7,0.64,0.99,1.04,333,642,130,150,76,,,53.28,32.95,54.55,1,58.27,974,62,,2.6,0,96,97,,,,,,63,78,10.39,10.39,10.68,-3.9,-7.3,238,238,,1,249,249,,,,,,,,,"23,16,30,23,7,1,0,0,0","1,84,15,0,0","0,12,81,7,0",,,,,109,,,,,,,,,,,,,,,,,,,,,,,,,,,,,,,,,,,,21.9,6,7,254,89,,1036,0,,1,4,4,Balve,1,0,U1.000|6:11-U1.000|5:36-U1.000|6:04-U1.000|6:02-U1.000|5:50-U1.000|6:16-U1.000|6:27-U1.000|5:03-U1.000|5:13-U1.000|6:15-U0.002|0:01,,"Balve Running",,,3113,,250,3,10490874179,0,168070,250480,30378,,44493192,,,,,,,,,,,,,,,,,,,,,,,,,,,,,,,,,,,,,,,,"4,4",
61305923,922e6a0b-e189-4f7a-84be-50431b0c598f,1676209514,60,1676212639,,0,0,15.6,5136,5664,436,426,443,444,0,4.7,0.83,1.01,1.18,544,957,134,161,,,,56.1,37.14,58.08,1,58.28,1222,101,,3.1,0,99,100,,,,,,99,79,11.83,12.79,12.43,-13.7,-8.5,267,267,,1,281,281,,,,,,,,,"37,13,10,8,6,7,16,4,0","1,73,26,0,0","0,7,72,21,1",,,,,115,,,,,,,,,,,,,,,,,,,,,,,,,,,,,,,,,,,,33.7,9,2,35,79,,1038,2,,0,4,4,Balve,1,0,U1.000|5:46-U1.000|5:52-U1.000|6:47-U1.000|7:43-U1.000|7:19-U1.000|5:35-U1.000|6:46-U1.000|5:58-U1.000|4:59-U1.000|4:38-U1.000|4:07-U1.000|3:43-U1.000|3:40-U1.000|3:41-U1.000|4:35-U0.597|4:28,,"Balve Running",,,3113,,250,3,10496548062,0,168070,250480,30378,,44537110,,,,,,,,,,,,,,,,,,,,,,,,,,,,,,,,,,,,,,,,"4,4,4",
61465867,ee80513c-dcc9-44c1-83c1-bf71e8cafe93,1676316400,60,1676317775,,0,0,13.09,4197,4334,252,241,271,257,0,2.8,0.65,0.99,1.04,636,831,136,153,,,,56.89,37.78,58.31,1,58.29,1222,101,,3.1,0,100,100,,,,,,92,79,11.52,11.57,11.79,-1.9,-4.6,269,269,,1,280,280,,,,,,,,,"10,12,18,28,24,8,1,0,0","0,70,30,0,0","0,3,80,16,1",,,,,118,,,,,,,,,,,,,,,,,,,,,,,,,,,,,,,,,,,,27.5,5,7,162,81,,1036,0,,1,2,4,Balve,1,0,U1.000|5:43-U1.000|4:54-U1.000|5:22-U1.000|5:15-U1.000|5:36-U1.000|5:45-U1.000|5:20-U1.000|4:54-U1.000|5:43-U1.000|5:56-U1.000|4:35-U1.000|4:40-U1.000|5:45-U0.094|0:29,,"Balve Running",,,3113,,250,3,10504712138,0,168070,250480,30378,,44675511,,,,,,,,,,,,,,,,,,,,,,,,,,,,,,,,,,,,,,,,"5,5",
61560775,402b530e-a9f9-4dd9-b39e-4d151d62766b,1676399565,60,1676411989,,0,0,4,1108,1108,13,38,12,39,0,0,0.17,,1.01,,252,146,161,,,,62.09,41.5,61.86,1,58.37,990,69,,2.7,0,104,99,,,,,,31,80,12.82,13.06,12.91,3.4,2.6,307,307,,1,312,312,,,,,,,,,"0,0,1,9,53,33,4,0,0","1,12,86,0,0","0,0,43,57,0",,,,,135,,,,,,,,,,,,,,,,,,,,,,,,,,,,,,,,,,,,41.4,8,5,165,67,,1031,0,,1,2,4,"Menden (Sauerland)",1,0,U1.000|4:46-U1.000|4:44-U1.000|4:33-U1.000|4:24-U0.004|0:02,,"Menden (Sauerland) Running",,,3113,,250,3,10512316580,0,168070,250480,30378,,44763533,,,,,,,,,,,,,,,,,,,,,,,,,,,,,,,,,,,,,,,,,
61560811,55b8ee1d-d734-4305-9edc-537d271e4a6a,1676400929,60,1676412032,,0,0,8.41,2094,2144,29,2,31,3,0,0,0.05,1.45,,,540,156,185,,,,64.54,49.21,65.07,1,58.4,3456,262,,4.1,2.4,102,103,,,,,,73,83,14.59,14.84,15.18,15.7,16.1,368,368,,1,389,389,,,,,,,,,"5,5,7,8,7,5,49,11,1","0,2,68,29,0","0,2,28,21,49",,,,,145,,,,,,,,,,,,,,,,,,,,,,,,,,,,,,,,,,,,74,5,7,171,78,,1032,0,,1,2,4,"Menden (Sauerland)",1,0,U0.800|2:59-U0.400|2:05-U1.200|4:29-U0.400|2:08-U1.600|6:00-U0.000|0:01-U0.400|2:11-U1.200|4:27-U0.400|2:10-U0.800|2:50-U0.210|1:16-U0.200|0:36-U0.200|1:11-U0.200|0:38-U0.200|1:14-U0.200|0:39,,"Menden (Sauerland) Track Running",,,3113,,250,3,10512319687,0,168070,250480,30378,,44763546,,,,,,,,,,,,,,,,,,,,,,,,,,,,,,,,,,,,,,,,,
61560815,2a649563-94b5-4964-b6b5-ab9643a9b6bb,1676403153,60,1676412041,,0,0,3.24,939,939,10,8,11,10,0,0,0.02,,,,211,145,154,,,,59.27,38.77,59.54,1,58.41,4320,53,,2.4,0,103,101,,,,,,25,81,12.42,12.44,12.47,0.8,1.6,298,298,,1,301,301,,,,,,,,,"1,0,5,23,51,19,0,0,0","0,9,91,0,0","0,0,53,47,0",,,,,128,,,,,,,,,,,,,,,,,,,,,,,,,,,,,,,,,,,,30.8,5,7,171,78,,1032,0,,1,2,4,"Menden (Sauerland)",1,0,U1.000|4:45-U1.000|4:55-U1.000|4:48-U0.236|1:12,,"Menden (Sauerland) Running",,,3113,,250,3,10512320378,0,168070,250480,30378,,44763548,,,,,,,,,,,,,,,,,,,,,,,,,,,,,,,,,,,,,,,,,
61603899,4519c6b3-3492-43da-bb15-0c0b78350a0f,1676465814,60,1676465921,,0,0,10.02,3386,3628,336,251,340,260,0,4.2,0.9,0.99,1.06,551,664,141,162,,,,50.9,34.79,53.55,1,58.41,3233,102,,3.1,0,96,97,,,,,,79,79,11.64,11.27,11.99,-7.1,11.4,269,269,,1,280,280,,,,,,,,,"30,14,12,11,20,11,1,0,0","1,58,32,9,0","0,2,78,20,1",,,,,112,,,,,,,,,,,,,,,,,,,,,,,,,,,,,,,,,,,,45.7,12,9,193,49,,1026,2,,0,2,4,Balve,1,0,U1.000|6:03-U1.000|6:33-U1.000|6:18-U1.000|6:37-U1.000|6:48-U1.000|5:13-U1.000|4:59-U1.000|4:46-U1.000|4:34-U1.000|4:30-U0.018|0:05,,"Balve Running",,,3113,,250,3,10515599912,0,168070,250480,30378,,44801153,,,,,,,,,,,,,,,,,,,,,,,,,,,,,,,,,,,,,,,,"4,4",
61686510,58cca58e-eed2-428f-82c6-a787eb1d7259,1676550580,60,1676551815,,0,0,14.35,4698,4792,408,415,432,439,0,4.5,0.8,0.96,0.95,562,957,146,162,,,,50.52,37.13,52.27,1,58.41,2592,150,,3.6,0,102,100,,,,,,122,79,11.63,12.13,12.41,0.8,4.3,268,268,,1,290,290,,,,,,,,,"21,15,12,9,17,19,6,0,1","2,18,79,1,0","5,1,64,28,2",,,,,116,,,,,,,,,,,,,,,,,,,,,,,,,,,,,,,,,,,,40.9,8,14,213,72,,1025,1,309,0,4,3,Balve,1,0,U1.000|4:49-U1.000|4:50-U1.000|6:14-U1.000|6:02-U1.000|5:51-U1.000|5:57-U1.000|6:17-U1.000|5:48-U1.000|4:46-U1.000|4:24-U1.000|4:15-U1.000|4:18-U1.000|4:12-U1.000|5:14-U0.347|5:22,,"Balve Running",,,3113,,250,3,10522319715,0,168070,250480,30378,,44878715,,,,,,,,,,,,,,,,,,,,,,,,,,,,,,,,,,,,,,,,"3,4",
61778382,3589c890-7b18-4fc8-818f-6e71192b85cc,1676660348,60,1676660678,,0,0,9,3086,3534,140,182,150,197,0,2.3,0.68,0.96,1.03,323,582,135,155,,,,52.86,33.93,53.57,1,58.38,1241,74,,2.8,0,99,98,,,,,,66,77,10.57,10.83,10.78,-5.3,-4.6,239,239,,1,247,247,,,,,,,,,"22,13,18,28,18,1,0,0,0","0,75,24,0,0","0,13,85,2,0",,,,,114,,,,,,,,,,,,,,,,,,,,,,,,,,,,,,,,,,,,25.5,10,21,263,88,,1021,0,,1,4,4,Balve,1,0,U1.000|5:32-U1.000|6:08-U1.000|5:41-U1.000|5:35-U1.000|5:48-U1.000|6:23-U1.000|4:51-U1.000|4:53-U1.000|6:32-U0.003|0:02,,"Balve Running",,,3113,,250,3,10530677534,0,168070,250480,30378,,44963783,,,,,,,,,,,,,,,,,,,,,,,,,,,,,,,,,,,,,,,,"4,5",
61820253,91117155-6412-4009-83ee-d17d919bf29d,1676720373,60,1676723476,,0,0,15.72,4345,4487,55,62,89,97,0,0,0.14,,,,1011,158,174,,,,55.68,45.55,55.89,1,58.37,2452,216,,4.2,0.1,103,100,,,,,,148,80,13.02,13.1,13.11,2.4,2.6,316,316,,1,319,319,,,,,,,,,"0,0,2,10,51,34,3,0,0","0,3,59,38,0","0,0,22,78,0",,,,,136,,,,,,,,,,,,,,,,,,,,,,,,,,,,,,,,,,,,60.7,8,26,252,90,,1018,2,,0,6,4,Sundern,1,0,U1.000|4:53-U1.000|4:32-U1.000|4:33-U1.000|4:43-U0.508|2:14-U1.000|4:21-U1.000|4:27-U1.000|4:26-U1.000|4:44-U1.000|4:45-U1.000|4:35-U1.000|4:42-U1.000|4:38-U1.000|4:40-U1.000|4:37-U1.000|4:36-U0.217|1:00,,"Sundern (Sauerland) Running",,,3113,,250,3,10534736267,0,168070,250480,30378,,45003057,,,,,,,,,,,,,,,,,,,,,,,,,,,,,,,,,,,,,,,,,
61914844,9abed149-a717-41a3-a582-509f5bb0f9a8,1676804572,60,1676827537,,0,0,19.4,6977,7132,545,540,577,572,0,5.4,0.8,1,1,523,1335,142,160,,,,46.7,34.05,48.34,1,58.36,2167,153,,3.6,0,98,99,,,,,,165,79,10.74,10.47,11.11,-0.1,6.4,240,240,,1,256,256,,,,,,,,,"30,13,17,24,12,3,1,0,0","0,36,64,0,0","2,19,67,11,0",,,,,106,,,,,,,,,,,,,,,,,,,,,,,,,,,,,,,,,,,,37,9,15,273,91,,1023,1,,0,6,4,Haspe,1,0,U1.000|7:52-U1.000|7:10-U1.000|4:57-U1.000|6:30-U1.000|6:14-U1.000|5:52-U1.000|6:05-U1.000|5:52-U1.000|5:25-U1.000|5:20-U1.000|5:29-U1.000|8:00-U1.000|5:44-U1.000|5:14-U1.000|5:36-U1.000|4:50-U1.000|6:20-U1.000|6:22-U1.000|5:11-U0.395|2:15,,"Hagen Running",,,3113,,250,3,10543932850,0,168070,250480,30378,,45083586,,,,,,,,,,,,,,,,,,,,,,,,,,,,,,,,,,,,,,,,"4,4,4,4,5",
61992801,e10595be-5f1e-45e5-ac69-d58febc54eb1,1676914662,60,1676915275,,0,0,13.01,3974,4124,244,249,264,270,0,2.6,0.69,1.01,1.01,454,820,142,173,,,,57.12,39.96,58.42,1,58.36,1454,152,,3.4,1.7,103,100,,,,,,96,79,12.11,12.56,12.71,0.3,-6.2,285,285,,1,307,307,,,,,,,,,"10,14,15,15,25,13,6,2,0","0,45,47,8,0","0,6,58,31,5",,,,,124,,,,,,,,,,,,,,,,,,,,,,,,,,,,,,,,,,,,53.7,7,19,254,86,,1021,0,,1,4,4,Balve,1,0,U1.000|5:29-U1.000|5:51-U1.000|5:28-U1.000|6:23-U1.000|5:03-U1.000|4:29-U1.000|4:25-U1.000|4:23-U1.000|4:44-U1.000|4:27-U1.000|3:37-U1.000|5:21-U1.000|6:31-U0.005|0:02,,"Balve Running",,,3113,,250,3,10550052476,0,168070,250480,30378,,45152529,,,,,,,,,,,,,,,,,,,,,,,,,,,,,,,,,,,,,,,,4,
62159938,3e075a0f-fd9b-4454-9b68-5de32b41fd82,1677004310,60,1677093096,,0,0,4,1074,1083,12,48,18,56,0,0,0.27,1.02,0.99,,250,151,163,,,,61.6,43.04,61.14,1,58.42,1048,74,,2.8,0,102,99,,,,,,31,80,13.13,13.49,13.24,2.6,-0.5,314,314,,1,319,319,,,,,,,,,"1,1,2,7,27,55,6,1,0","1,9,87,3,0","0,0,32,67,1",,,,,140,,,,,,,,,,,,,,,,,,,,,,,,,,,,,,,,,,,,41.4,9,1,340,90,,1018,0,,1,4,4,"Menden (Sauerland)",1,0,U1.000|4:43-U1.000|4:22-U1.000|4:20-U0.999|4:28,,"Menden (Sauerland) Running",,,3113,,250,3,10564424783,0,168070,250480,30378,,45304661,,,,,,,,,,,,,,,,,,,,,,,,,,,,,,,,,,,,,,,,,
62159939,f3376a27-63d6-4d14-8a9d-cf3e833402c1,1677008681,60,1677093097,,0,0,1.77,620,620,6,12,5,12,0,0,0.12,,0.76,,120,134,144,,,,51.97,29.48,51.97,1,58.44,3631,22,,1.5,0,102,101,,,,,,11,79,10.19,10.36,10.35,2.2,4.5,234,234,,1,240,240,,,,,,,,,"14,22,36,16,12,0,0,0,0","0,79,21,0,0","0,16,82,2,0",,,,,108,,,,,,,,,,,,,,,,,,,,,,,,,,,,,,,,,,,,13.5,8,1,88,91,,1018,0,,1,4,4,"Menden (Sauerland)",1,0,U1.000|5:41-U0.766|4:39,,"Menden (Sauerland) Running",,,3113,,250,3,10564424921,0,168070,250480,30378,,45304662,,,,,,,,,,,,,,,,,,,,,,,,,,,,,,,,,,,,,,,,,
62159942,41a2af2f-5e1a-4736-b3e9-2d16a6ff23ed,1677005665,60,1677093099,,0,0,9.54,2902,2902,26,2,28,4,0,0,0.04,,,1214,634,157,184,,,,49.94,39.23,50.26,1,58.43,3646,310,,3.9,3.4,105,105,,,,,,105,80,11.91,13.93,14.33,19.8,7.4,298,298,,1,372,372,,,,,,,,,"39,3,2,2,2,4,15,30,3","1,23,17,57,2","23,11,13,12,41",,,,,123,,,,,,,,,,,,,,,,,,,,,,,,,,,,,,,,,,,,84.7,8,1,79,91,,1018,0,,1,4,4,"Menden (Sauerland)",1,0,U0.390|1:21-U0.110|0:36-U0.400|1:20-U0.090|0:37-U0.400|1:21-U0.100|0:40-U0.400|1:21-U0.090|0:36-U0.410|1:21-U0.240|2:44-U0.400|1:20-U0.100|0:40-U0.400|1:21-U0.090|0:38-U0.410|1:24-U0.100|0:46-U0.400|1:24-U0.100|0:54-U0.400|1:25-U0.240|2:37-U0.400|1:21-U0.100|0:38-U0.400|1:19-U0.100|0:38-U0.400|1:21-U0.100|0:43-U0.400|1:21-U0.090|0:39-U0.410|1:27-U0.210|3:30-U0.210|0:41-U0.160|1:18-U0.200|0:38-U0.130|1:44-U0.400|1:27-U0.130|2:04-U0.400|1:16-U0.030|1:49,,"Menden (Sauerland) Track Running",,,3113,,250,3,10564424878,0,168070,250480,30378,,45304664,,,,,,,,,,,,,,,,,,,,,,,,,,,,,,,,,,,,,,,,5,
62159944,687c20ef-3cff-4393-854e-b5b0507fe65a,1677091949,60,1677093099,,0,0,13.02,4015,4248,215,197,235,220,0,2.1,0.55,0.92,0.99,301,827,141,163,99,,,56.98,39.52,58.24,1,58.45,2448,123,,3.3,0,100,102,,,,,,90,79,11.95,12.22,12.29,-3.5,-8.2,281,281,,1,295,295,,,,,,,,,"11,8,13,20,33,10,5,1,0","1,43,56,1,0","0,1,67,29,2",,,,,123,,,,,,,,,,,,,,,,,,,,,,,,,,,,,,,,,,,,33.6,8,6,185,85,,1012,0,,1,4,4,Balve,1,0,U1.000|5:53-U1.000|4:53-U1.000|5:25-U1.000|4:52-U1.000|5:04-U1.000|5:15-U1.000|5:19-U1.000|4:55-U1.000|5:38-U1.000|5:35-U1.000|3:50-U1.000|4:27-U1.000|5:44-U0.018|0:05,,"Balve Running",,,3113,,250,3,10564425041,0,168070,250480,30378,,45304665,,,,,,,,,,,,,,,,,,,,,,,,,,,,,,,,,,,,,,,,"4,5",
62191889,a9b678d5-466d-417d-b0d3-14ac4b72a93c,1670230169,60,1677138711,,0,0,,208,208,,,,,0,,,,,,16,,,,,,,,,1,,,,,,,,,,,,,,1,,,,,,,,,,,,,,,,,,,,,,,,,,,,,,,,,,,,,,,,,,,,,,,,,,,,,,,,,,,,,,,,,,,,,,,,,,1,,,1,0,,,,,,,,252,7,,0,168073,,30378,,45334080,,,,,,,,,,,,,,,,,,,,,,,,,,,,,,,,,,,,,,,,,
62192102,51f2d6c6-777c-40e0-9be7-2485faf7fb24,1677142326,60,1677139136,,0,0,,401,401,,,,,0,,,,,,50,,,,,,,,,1,,,,,,,,,,,,,,4,,,,,,,,,,,,,,,,,,,,,,,,,,,,,,,,,,,,,,,,,,,,,,,,,,,,,,,,,,,,,,,,,,,,,,,,,,1,,,1,0,,,,,,,,252,7,,0,168074,,30378,,45334284,,,,,,,,,,,,,,,,,,,,,,,,,,,,,,,,,,,,,,,,,
62241185,a50912e8-2d9b-40f4-be4f-e5b8252751bb,1677164777,60,1677161623,,0,0,,403,403,,,,,0,,,,,,50,,,,,,,,,1,,,,,,,,,,,,,,4,,,,,,,,,,,,,,,,,,,,,,,,,,,,,,,,,,,,,,,,,,,,,,,,,,,,,,,,,,,,,,,,,,,,,,,,,,1,,,1,0,,,,,,,,252,7,,0,168074,,30378,,45380138,,,,,,,,,,,,,,,,,,,,,,,,,,,,,,,,,,,,,,,,,
62277976,60620794-759b-46d2-99eb-cd86a49735c1,1677180231,60,1677179402,,0,0,5.69,1867,2358,73,76,78,83,0,1.4,0.49,0.98,1.01,295,362,132,147,,,,57.39,34.7,58.26,1,58.45,1164,52,,2.4,0,100,100,,,,,,36,78,11.07,11.15,11.28,3.5,5.4,256,256,,1,265,265,,,,,,,,,"12,9,23,31,21,5,0,0,0","3,82,15,0,0","0,3,84,13,0",,,,,117,,,,,,,,,,,,,,,,,,,,,,,,,,,,,,,,,,,,21.2,6,6,314,92,,1015,0,,1,4,4,Balve,1,0,U1.000|5:13-U1.000|5:35-U1.000|5:04-U1.000|5:26-U1.000|6:01-U0.686|3:48,,"Balve Running",,,3113,,250,3,10570859774,0,168070,250480,30378,,45413347,,,,,,,,,,,,,,,,,,,,,,,,,,,,,,,,,,,,,,,,5,
62324971,2c88f70a-1495-419e-8d8a-483fffa4b2d1,1677237866,60,1677239420,,0,0,15.86,4868,5067,402,399,402,404,0,4,0.81,0.97,1.03,531,1014,142,157,,,,56.78,40.36,58.57,1,58.45,1587,148,,3.5,0,103,99,,,,,,93,80,12.26,12.22,12.42,-2.4,2,285,285,,1,293,293,,,,,,,,,"9,17,14,14,15,27,3,0,0","0,40,60,0,0","0,3,59,37,0",,,,,122,,,,,,,,,,,,,,,,,,,,,,,,,,,,,,,,,,,,24.5,3,17,251,84,,1008,1,,0,6,4,Balve,1,0,U1.000|4:45-U1.000|4:50-U1.000|6:06-U1.000|5:58-U1.000|5:48-U1.000|6:06-U1.000|4:50-U1.000|4:19-U1.000|4:11-U1.000|5:59-U1.000|4:45-U1.000|4:31-U1.000|4:17-U1.000|4:54-U1.000|5:19-U0.861|4:29,,"Balve Running",,,3113,,250,3,10574395943,0,168070,250480,30378,,45456643,,,,,,,,,,,,,,,,,,,,,,,,,,,,,,,,,,,,,,,,"4,4,5",
62394761,d815fc4e-1eb3-4155-8b1d-3de162ae37c8,1677319999,60,1677321678,,0,0,14.01,4494,4835,300,282,324,302,0,3.9,0.64,1.11,0.98,497,904,140,162,92,,,54.78,37.96,56.32,1,58.45,1585,143,,3.5,0,98,100,,,,,,102,80,11.61,11.9,12.64,2.5,-16.1,275,275,,1,307,307,,,,,,,,,"16,7,17,20,21,15,5,0,0","1,42,57,0,0","6,5,49,34,5",,,,,117,,,,,,,,,,,,,,,,,,,,,,,,,,,,,,,,,,,,35.5,1,16,341,87,,1009,1,,0,4,4,Balve,1,0,U1.000|5:22-U1.000|5:38-U1.000|5:12-U1.000|4:59-U1.000|5:41-U1.000|4:56-U1.000|5:28-U1.000|5:41-U1.000|8:15-U1.000|4:15-U1.000|4:21-U1.000|5:16-U1.000|4:25-U1.000|5:23-U0.010|0:03,,"Balve Running",,,3113,,250,3,10580098702,0,168070,250480,30378,,45519841,,,,,,,,,,,,,,,,,,,,,,,,,,,,,,,,,,,,,,,,"4,5,5,5",
62484582,ed4a6c63-632f-43b7-bc1d-0759f7a97dc2,1677422399,60,1677425017,,0,0,16.23,5379,6126,558,479,573,499,0,5.8,0.87,1.01,1.08,677,1063,139,162,,,,53.11,36.97,55.69,1,58.46,1396,134,,3.4,0,102,100,,,,,,79,80,11.87,11.53,12.35,-1.4,5.4,272,272,,1,287,287,,,,,,,,,"29,10,12,13,16,16,3,0,0","1,49,50,0,0","0,9,62,27,1",,,,,113,,,,,,,,,,,,,,,,,,,,,,,,,,,,,,,,,,,,16.8,1,18,31,59,,1024,1,,0,3,4,Balve,1,0,U1.000|5:17-U1.000|5:21-U1.000|7:23-U1.669|8:45-U1.000|7:20-U1.000|6:10-U1.000|5:54-U1.000|5:34-U0.330|1:51-U1.000|6:32-U1.000|5:42-U1.000|5:25-U1.000|4:40-U1.000|4:05-U1.000|4:10-U1.000|4:19-U0.228|1:10,,"Balve Running",,,3113,,250,3,10589022878,0,168070,250480,30378,,45601607,,,,,,,,,,,,,,,,,,,,,,,,,,,,,,,,,,,,,,,,"3,4,4",
62549912,f3aa4539-d4a0-4244-b818-142f9357b04c,1677516611,60,1677517102,,0,0,13.02,3695,4035,295,275,313,293,0,3.3,0.73,1.02,1.04,527,796,143,167,,,,61.97,43.53,63.83,1,58.52,1396,132,,3.4,0.2,102,102,,,,,,86,80,13.11,13.21,13.4,0.9,2,314,314,,1,325,325,,,,,,,,,"4,7,11,14,25,26,11,2,0","0,33,65,1,0","0,1,42,54,4",,,,,132,,,,,,,,,,,,,,,,,,,,,,,,,,,,,,,,,,,,33.7,2,12,45,60,,1029,0,,0,4,4,Balve,1,0,U1.000|5:30-U1.000|4:19-U1.000|4:40-U1.000|4:33-U1.000|4:34-U1.000|5:03-U1.000|4:46-U1.000|4:37-U1.000|5:06-U1.000|5:23-U1.000|3:51-U1.000|3:43-U1.000|5:23-U0.020|0:09,,"Balve Running",,,3113,,250,3,10595430805,0,168070,250480,30378,,45661391,,,,,,,,,,,,,,,,,,,,,,,,,,,,,,,,,,,,,,,,"5,5,5,5",
62635333,4bb96a61-60ed-4cbe-ac95-935311156f0a,1677609110,60,1677610479,,0,0,4.01,1090,1090,54,46,60,52,0,0.9,0.47,1.08,0.93,,273,168,189,,,,51.79,42.43,52.78,1,58.52,1282,134,,3.2,1.9,95,95,,,,,,49,80,13.43,13.36,13.72,7.1,-1.6,329,329,,1,341,341,,,,,,,,,"2,1,2,5,37,50,3,0,0","0,8,19,45,28","0,0,27,67,6",,,,,138,,,,,,,,,,,,,,,,,,,,,,,,,,,,,,,,,,,,108.8,1,9,57,67,,1030,0,,1,2,4,"Menden (Sauerland)",1,0,U1.000|4:52-U1.000|4:23-U1.000|4:16-U1.000|4:36-U0.006|0:03,,"Menden (Sauerland) Running",,,3113,,250,3,10603006466,0,168070,250480,30378,,45734561,,,,,,,,,,,,,,,,,,,,,,,,,,,,,,,,,,,,,,,,,
62635337,b92f6ff1-96b8-4545-9612-d8b204bd0fe3,1677610408,60,1677610482,,0,0,0.78,297,297,22,15,30,24,0,0,0,1.34,,,66,153,163,,,,39.28,24.44,41.09,1,58.52,1275,19,,1.3,0,,100,,,,,,9,77,9.74,11.46,11.79,8,13.4,225,225,,1,294,294,,,,,,,,,"64,7,2,1,4,5,5,3,8","0,6,89,5,0","0,55,24,12,9",,,,,102,,,,,,,,,,,,,,,,,,,,,,,,,,,,,,,,,,,,20.3,1,8,57,67,,1030,0,,1,2,4,"Menden (Sauerland)",1,0,,,"Menden (Sauerland) Running",,,3113,,250,3,10603007074,0,168070,250480,30378,,45734564,,,,,,,,,,,,,,,,,,,,,,,,,,,,,,,,,,,,,,,,,
62635361,38992f6f-e7a4-4f94-b539-f307edfda6c0,1677610802,60,1677610515,,0,0,6.43,1839,1839,21,5,22,5,0,0,0.08,,,,413,157,195,,,,53.88,41.14,54.26,1,58.52,2304,131,,3.2,1.4,,100,,,,,,63,81,12.65,14.32,14.82,0,5.8,315,315,,1,393,393,,,,,,,,,"35,9,6,5,2,3,12,23,6","0,17,43,31,9","5,23,25,11,36",,,,,129,,,,,,,,,,,,,,,,,,,,,,,,,,,,,,,,,,,,71.7,1,8,62,69,,1030,0,,1,2,4,"Menden (Sauerland)",1,0,U1.310|4:15-U0.400|2:47-U0.400|1:20-U0.200|1:27-U0.290|0:57-U0.190|1:22-U0.200|0:36-U0.400|2:46-U0.400|1:20-U0.200|1:30-U0.310|0:58-U0.200|1:39-U0.210|0:38-U0.400|2:59-U0.400|1:19-U0.200|1:25-U0.290|0:58-U0.200|1:32-U0.200|0:39-U0.030|0:10,,"Menden (Sauerland) Track Running",,,3113,,250,3,10603011530,0,168070,250480,30378,,45734587,,,,,,,,,,,,,,,,,,,,,,,,,,,,,,,,,,,,,,,,,
62635366,558d0dee-f072-421e-9d4a-f432baccac1d,1677612879,60,1677610526,,0,0,3.27,1038,1038,29,24,31,27,0,0,0.26,1.13,,,218,145,157,,,,52.97,34.88,53.65,1,58.52,2736,46,,2.3,0,,100,,,,,,25,79,11.45,11.45,11.69,0.5,4.8,271,271,,1,280,280,,,,,,,,,"3,7,18,44,26,1,0,0,0","0,12,88,0,0","0,1,80,19,0",,,,,120,,,,,,,,,,,,,,,,,,,,,,,,,,,,,,,,,,,,26.7,0,8,62,69,,1030,0,,1,2,4,"Menden (Sauerland)",1,0,U1.000|5:27-U1.000|5:22-U1.000|4:57-U0.273|1:32,,"Menden (Sauerland) Running",,,3113,,250,3,10603012846,0,168070,250480,30378,,45734593,,,,,,,,,,,,,,,,,,,,,,,,,,,,,,,,,,,,,,,,,
62710565,524a2122-5eea-4059-9b6a-541663d92c9f,1677691699,60,1677692233,,0,0,10.26,3339,3515,181,180,201,200,0,2.6,0.73,1.01,1.02,299,674,143,161,117,,,52.33,36.43,53.48,1,58.52,1588,92,,3,0,98,98,,,,,,87,79,11.26,11.27,11.37,10,10.7,261,261,,1,267,267,,,,,,,,,"13,13,18,27,26,4,1,0,0","0,32,67,0,0","0,1,88,11,0",,,,,117,,,,,,,,,,,,,,,,,,,,,,,,,,,,,,,,,,,,42.6,2,10,50,65,,1025,0,,0,2,4,Balve,1,0,U1.000|5:44-U1.000|4:53-U1.000|5:23-U1.000|5:35-U1.000|5:25-U1.000|5:59-U1.000|5:27-U1.000|4:49-U1.000|5:00-U1.000|5:59-U0.256|1:24,,"Balve Running",,,3113,,250,3,10609252155,0,168070,250480,30378,,45803955,,,,,,,,,,,,,,,,,,,,,,,,,,,,,,,,,,,,,,,,5,
62780322,df656c70-8d5f-4635-b549-9ca56407543c,1677763696,60,1677764374,,0,0,13.51,4093,4213,383,346,414,381,0,4.7,0.82,1,1.04,614,860,141,162,,,,58.24,40.46,60.48,1,58.54,1454,131,,3.4,0,104,98,,,,,,102,80,12.62,12.64,13.07,-1.3,12.9,295,295,,1,309,309,,,,,,,,,"16,13,13,8,13,26,10,0,0","1,38,60,1,0","0,1,55,43,1",,,,,124,,,,,,,,,,,,,,,,,,,,,,,,,,,,,,,,,,,,37.7,8,13,51,48,,1022,2,,0,2,4,Balve,1,0,U1.000|4:45-U1.000|4:55-U1.000|6:16-U1.000|6:05-U1.000|5:54-U1.000|5:46-U1.000|6:09-U1.000|4:51-U1.000|4:05-U1.000|4:05-U1.000|4:00-U1.000|4:06-U1.000|4:27-U0.507|2:49,,"Balve Running",,,3113,,250,3,10614370457,0,168070,250480,30378,,45866526,,,,,,,,,,,,,,,,,,,,,,,,,,,,,,,,,,,,,,,,"3,4",
62874138,825d8135-a944-4089-a7f7-a22baad4bebe,1677870414,60,1677870606,,0,0,10.19,3004,3653,133,110,153,130,0,1.7,0.47,1.05,0.98,,641,142,179,,,,59.68,40.89,60.81,1,58.57,1456,172,,3.4,2.1,101,101,,,,,,68,79,12.48,13.64,13.98,-4,-31.2,300,300,,1,355,355,,,,,,,,,"5,6,23,30,15,3,8,9,1","1,46,38,15,0","0,5,60,20,15",,,,,129,,,,,,,,,,,,,,,,,,,,,,,,,,,,,,,,,,,,59.2,0,4,317,92,,1025,0,377,1,3,3,Balve,1,0,U1.000|5:30-U1.000|5:23-U1.000|5:16-U1.000|5:22-U1.000|5:04-U0.292|1:22-U1.000|3:39-U0.140|0:39-U1.000|3:30-U0.435|2:42-U0.183|0:35-U0.235|1:14-U0.177|0:35-U0.235|1:17-U0.175|0:33-U0.784|4:29-U0.179|0:32-U0.353|2:21,,"Balve Running",,,3113,,250,3,10622804468,0,168070,250480,30378,,45952382,,,,,,,,,,,,,,,,,,,,,,,,,,,,,,,,,,,,,,,,,
62947001,e0ffa03f-ced4-4ce6-afce-d5d6786cc150,1677958666,60,1677958931,,0,0,3.09,966,1003,47,63,54,73,0,1.4,0.6,0.96,1.01,397,193,131,148,,,,61.49,35.36,62.26,1,58.56,702,41,,2.2,0,95,96,,,,,,19,78,11.55,12.19,12.36,2.8,-18.6,268,268,,1,301,301,,,,,,,,,"12,11,16,27,16,11,5,3,0","3,73,24,0,0","0,7,73,16,3",,,,,123,,,,,,,,,,,,,,,,,,,,,,,,,,,,,,,,,,,,22.2,3,11,329,84,,1022,0,,1,4,4,Balve,1,0,U1.000|5:27-U1.000|4:37-U1.000|5:40-U0.094|0:23,,"Balve Running",,,3113,,250,3,10629855087,0,168070,250480,30378,,46019541,,,,,,,,,,,,,,,,,,,,,,,,,,,,,,,,,,,,,,,,5,
62982686,4f370f26-39fe-4643-9f74-bcabef8ded52,1678013491,60,1678015160,,0,0,3.85,1475,2060,31,21,38,31,0,0,0.25,0.88,,,271,131,153,,,,47.85,28.16,48.48,1,58.57,816,54,,2.4,0,102,103,,,,,,27,77,9.53,10.96,11.16,33.9,12,222,222,,1,270,270,,,,,,,,,"41,2,3,6,37,10,0,0,0","1,66,33,0,0","17,22,27,33,0",,,,,102,,,,,,,,,,,,,,,,,,,,,,,,,,,,,,,,,,,,23.3,3,11,276,83,,1018,1,,0,4,4,Flittard,1,0,U1.000|4:52-U1.000|4:40-U1.000|6:41-U0.848|8:21,,"Cologne Running",,,3113,,250,3,10633359949,0,168070,250480,30378,,46046745,,,,,,,,,,,,,,,,,,,,,,,,,,,,,,,,,,,,,,,,,
62982710,6a783f12-5060-4b15-b0e9-b1f67ae54e20,1678015882,60,1678015171,,0,0,10.06,2158,2158,37,37,63,62,0,0,0.15,,,,593,177,186,130,,,63.8,59.26,64.09,1,58.61,4320,280,,4.8,0,103,101,,,,,,113,85,16.78,16.82,16.92,6.4,7.5,432,432,,1,438,438,,,,,,,,,"0,0,0,0,0,1,67,31,1","0,1,3,61,35","0,0,0,16,84",,,,,165,,,,,,,,,,,,,,,,,,,,,,,,,,,,,,,,,,,,129.5,4,10,285,81,,1018,1,,0,4,4,Flittard,1,0,U1.000|3:25-U1.000|3:35-U1.000|3:35-U1.000|3:34-U1.000|3:34-U1.000|3:36-U1.000|3:35-U1.000|3:38-U1.000|3:41-U1.000|3:32-U0.061|0:11,,"Cologne Running",,,3113,,250,3,10633363003,0,168070,250480,30378,,46046766,,,,,,,,,,,,,,,,,,,,,,10,2158,,,0,"41. Straßenlauf ""Rund um das Bayerkreuz""",,,,,,,0,0,30378,62982710,12053,,,
62986120,0390c383-cc9a-4cad-b032-0bf3286328d1,1678019201,60,1678016570,,0,0,1.44,478,552,31,11,32,13,0,0.4,0.29,1.31,1,925,93,132,145,,,,56.57,30.66,59.06,1,58.61,4295,19,,1.3,0,99,99,,,,,,9,81,11.35,11.06,12.88,0.1,23,276,276,,1,325,325,,,,,,,,,"10,8,20,49,8,4,0,0,0","0,87,13,0,0","0,6,78,5,11",,,,,112,,,,,,,,,,,,,,,,,,,,,,,,,,,,,,,,,,,,12,5,11,295,66,,1016,1,426,0,4,3,Flittard,1,0,U1.000|5:34-U0.441|2:23,,"Cologne Running",,,3113,,250,3,10633599651,0,168070,250480,30378,,46050066,,,,,,,,,,,,,,,,,,,,,,,,,,,,,,,,,,,,,,,,5,
63058159,4993011b-1dc0-44bc-b06d-534bd889e83f,1678106505,60,1678107027,,0,0,13.01,3864,4053,264,227,274,239,0,3.2,0.65,1.04,1.06,469,817,140,161,,,,60.24,41.29,61.97,1,58.61,2754,126,,3.3,0,102,101,,,,,,76,79,12.51,12.45,13.17,-6,-15.2,298,298,,1,320,320,,,,,,,,,"7,6,10,22,24,26,4,0,0","1,48,51,0,0","0,0,57,40,2",,,,,128,,,,,,,,,,,,,,,,,,,,,,,,,,,,,,,,,,,,24.4,3,14,258,82,,1006,1,,0,4,4,Balve,1,0,U1.000|5:27-U1.000|4:30-U1.000|4:54-U1.000|4:51-U1.000|4:58-U1.000|5:22-U1.000|5:11-U1.000|4:35-U1.000|5:12-U1.000|5:38-U1.000|4:09-U1.000|4:08-U1.000|5:25-U0.005|0:03,,"Balve Running",,,3113,,250,3,10640656942,0,168070,250480,30378,,46111867,,,,,,,,,,,,,,,,,,,,,,,,,,,,,,,,,,,,,,,,"4,4,5",
63133122,c52f1e2d-5e37-4f4a-8b6d-1f4661bc9bcf,1678204827,60,1678206590,,0,0,14.01,4173,4353,316,290,339,319,0,4,0.69,1.01,1.07,472,913,147,162,110,,,56.24,41.39,57.94,1,58.62,2160,160,,3.7,0,101,100,,,,,,118,80,12.63,12.59,13.04,-5.5,5.4,299,299,,1,310,310,,,,,,,,,"8,8,18,13,19,29,5,0,0","1,18,81,1,0","0,0,48,50,2",,,,,126,,,,,,,,,,,,,,,,,,,,,,,,,,,,,,,,,,,,47.5,1,5,260,93,,997,0,,0,7,4,Balve,1,0,U1.000|4:45-U1.000|4:53-U1.000|6:01-U1.000|5:42-U1.000|5:32-U1.000|5:55-U1.000|4:57-U1.000|4:19-U1.000|4:13-U1.000|4:05-U1.000|4:13-U1.000|5:00-U1.000|5:06-U1.000|4:49-U0.008|0:02,,"Balve Running",,,3113,,250,3,10648575329,0,168070,250480,30378,,46183984,,,,,,,,,,,,,,,,,,,,,,,,,,,,,,,,,,,,,,,,"3,5",
63197021,428568a8-3011-4b66-ae7e-024b052397b5,1678284530,60,1678287402,,0,0,15.15,5479,5946,433,422,431,423,0,4.5,0.79,1.06,1.13,468,1058,143,168,109,,,45.95,33.18,47.62,1,58.58,1747,141,,3.5,0,103,95,,,,,,142,79,10.61,10.62,11.07,1.8,15.2,238,238,,1,256,256,,,,,,,,,"37,14,15,15,14,5,0,0,0","0,40,57,2,0","2,15,74,8,1",,,,,105,,,,,,,,,,,,,,,,,,,,,,,,,,,,,,,,,,,,49.4,3,4,111,85,,992,1,,0,4,4,Balve,1,0,U1.000|5:34-U1.000|6:22-U1.000|6:08-U1.000|6:46-U1.000|6:45-U1.000|5:34-U1.000|6:22-U1.000|5:28-U1.000|5:15-U1.000|7:36-U1.000|7:27-U1.000|5:30-U1.000|4:51-U1.000|4:50-U1.000|6:11-U0.146|0:38,,"Balve Running",,,3113,,250,3,10654769409,0,168070,250480,30378,,46243249,,,,,,,,,,,,,,,,,,,,,,,,,,,,,,,,,,,,,,,,"3,4,5",
63282236,60463751-bdf2-4d16-8919-dd0b67ce9fd2,1678387165,60,1678384322,,0,0,1.95,699,731,55,41,61,46,0,2,0.73,0.92,0.96,711,132,128,149,,,,53.41,28.97,55.75,1,58.58,355,23,,1.6,0,96,99,,,,,,11,78,10.68,10.43,10.95,7.1,4.2,245,245,,1,253,253,,,,,,,,,"36,11,13,30,9,1,0,0,0","8,70,23,0,0","0,12,81,7,0",,,,,107,,,,,,,,,,,,,,,,,,,,,,,,,,,,,,,,,,,,12.3,6,10,201,90,,996,0,,1,4,4,Balve,1,0,U1.000|6:00-U0.953|5:40,,"Balve Running",,,3113,,250,3,10662149813,0,168070,250480,30378,,46321119,,,,,,,,,,,,,,,,,,,,,,,,,,,,,,,,,,,,,,,,4,
63313143,c42d64aa-e976-4297-bf45-bca5e21807fb,1678432993,60,1678435353,,0,0,18.24,5701,5890,427,425,443,439,0,4.3,0.75,1.04,1.1,497,1234,150,167,,,,51.54,39.96,53.04,1,58.57,2023,182,,3.9,0,101,99,,,,,,172,80,12,12.06,12.22,-3.2,5.3,279,279,,1,286,286,,,,,,,,,"14,15,11,15,19,23,2,0,0","0,9,84,7,0","0,4,69,27,0",,,,,120,,,,,,,,,,,,,,,,,,,,,,,,,,,,,,,,,,,,53.4,7,15,207,91,,988,0,,0,6,4,Balve,1,0,U1.000|5:19-U1.000|4:55-U1.000|6:36-U1.000|6:15-U1.000|6:12-U1.000|6:16-U1.000|4:56-U1.000|5:06-U1.000|5:22-U1.000|5:30-U1.000|4:41-U1.000|4:48-U1.000|4:21-U1.000|4:15-U1.000|4:20-U1.000|4:21-U1.000|5:24-U1.000|5:16-U0.243|1:08,,"Balve Running",,,3113,,250,3,10665272332,0,168070,250480,30378,,46350070,,,,,,,,,,,,,,,,,,,,,,,,,,,,,,,,,,,,,,,,"3,4,5",
63385373,07f555ca-f5f4-4408-bfac-5e83e06e1524,1678525070,60,1678528129,,0,0,13.19,4145,5443,259,243,280,269,0,2.4,0.61,1,1.02,289,854,136,155,109,,,58.32,38.7,59.82,1,58.59,1396,118,,3.3,0,97,102,,,,,,91,80,11.75,11.9,12.3,-5,-14.7,276,276,,1,295,295,,,,,,,,,"12,9,12,27,26,10,3,0,0","2,55,43,0,0","0,3,71,24,2",,,,,119,,,,,,,,,,,,,,,,,,,,,,,,,,,,,,,,,,,,29.8,0,10,307,75,,1011,1,,0,3,4,Balve,1,0,U1.000|6:09-U1.000|5:20-U1.000|5:29-U1.000|5:05-U1.000|5:19-U1.000|5:21-U1.000|5:17-U1.000|4:51-U1.000|5:22-U1.000|5:59-U1.000|4:19-U1.000|4:05-U1.000|5:33-U0.188|0:57,,"Balve Running",,,3113,,250,3,10671492043,0,168070,250480,30378,,46414968,,,,,,,,,,,,,,,,,,,,,,,,,,,,,,,,,,,,,,,,"4,4,5",
63448017,bcd84df5-6f86-4aff-9241-0f4c4ca3c49a,1678607568,60,1678609661,,0,0,13.4,4535,5148,434,352,455,374,0,5.2,0.77,0.99,1.11,559,932,144,166,,,,49.41,35.52,51.76,1,58.58,1592,145,,3.5,0.1,100,99,,,,,,114,80,11.59,11.38,12.19,-8.6,5.4,266,266,,1,280,280,,,,,,,,,"32,11,10,15,16,14,2,0,0","0,35,62,3,0","0,4,77,17,1",,,,,111,,,,,,,,,,,,,,,,,,,,,,,,,,,,,,,,,,,,42.9,0,14,182,84,,1010,1,,0,4,4,Balve,1,0,U1.000|4:55-U1.000|5:09-U1.000|5:40-U1.000|7:32-U1.000|6:50-U1.000|6:02-U1.000|6:00-U1.000|6:25-U1.000|6:01-U1.000|4:52-U1.000|4:25-U1.000|4:22-U1.000|4:56-U0.402|2:27,,"Balve Running",,,3113,,250,3,10677621629,0,168070,250480,30378,,46471147,,,,,,,,,,,,,,,,,,,,,,,,,,,,,,,,,,,,,,,,"3,4,5,5",
63563582,9b0e7fbe-2947-443b-86f3-b908569ed343,1678730815,60,1678733315,,0,0,12.95,3740,3887,219,236,249,263,0,2.4,0.56,1,1.06,405,816,144,177,111,,,60.08,42.64,61.24,1,58.61,1454,163,,3.5,1.3,104,100,,,,,,96,80,12.67,13.25,13.15,1.5,-1.3,301,301,,1,317,317,,,,,,,,,"3,8,10,23,26,18,8,3,0","2,36,55,7,0","0,0,55,41,4",,,,,130,,,,,,,,,,,,,,,,,,,,,,,,,,,,,,,,,,,,56.8,12,19,220,79,,994,0,,1,4,4,Balve,1,0,U1.000|5:17-U1.000|4:27-U1.000|5:04-U1.000|4:58-U1.000|4:55-U1.000|5:15-U1.000|4:52-U1.000|4:35-U1.000|5:08-U1.000|5:09-U1.000|3:40-U1.000|3:35-U0.952|5:24,,"Balve Running",,,3113,,250,3,10688364337,0,168070,250480,30378,,46574629,,,,,,,,,,,,,,,,,,,,,,,,,,,,,,,,,,,,,,,,"5,5",
63636824,18d8fa38-aeed-46b9-8989-bc8bdf6476b0,1678818569,60,1678817800,,0,0,4.05,1053,1053,23,51,28,60,0,0.4,0.37,1.01,0.94,,244,148,159,,,,65.91,44.72,65.81,1,58.69,1106,70,,2.7,0,104,102,,,,,,30,81,13.62,13.91,13.75,3.7,1.8,330,330,,1,336,336,,,,,,,,,"1,1,1,3,19,61,14,0,0","2,6,92,0,0","0,1,15,82,2",,,,,142,,,,,,,,,,,,,,,,,,,,,,,,,,,,,,,,,,,,37.7,4,17,297,68,,1007,0,,1,4,4,"Menden (Sauerland)",1,0,U1.000|4:34-U1.000|4:12-U1.000|4:16-U1.000|4:14-U0.046|0:17,,"Menden (Sauerland) Running",,,3113,,250,3,10694702040,0,168070,250480,30378,,46640745,,,,,,,,,,,,,,,,,,,,,,,,,,,,,,,,,,,,,,,,,
63636828,19d4114f-fe87-445f-b125-b2cd4b2f0e97,1678819951,60,1678817801,,0,0,1.24,309,309,4,1,10,9,0,0,0,,,,69,149,166,,,,68.83,41.65,69.31,1,58.69,1097,31,,1.5,0.6,,100,,,,,,9,86,14.47,14.47,14.6,26.1,28.6,360,360,,1,368,368,,,,,,,,,"18,5,5,5,5,5,20,32,6","0,36,27,38,0","0,0,4,86,10",,,,,140,,,,,,,,,,,,,,,,,,,,,,,,,,,,,,,,,,,,25.4,4,16,297,68,,1007,0,,1,4,4,"Menden (Sauerland)",1,0,U0.099|0:19-U0.018|0:08-U0.087|0:18-U0.037|0:15-U0.096|0:19-U0.035|0:10-U0.098|0:20-U0.035|0:13-U0.100|0:21-U0.030|0:12-U0.093|0:21-U0.026|0:13-U0.101|0:21-U0.022|0:11-U0.094|0:21-U0.027|0:12-U0.104|0:20-U0.022|0:10-U0.095|0:22-U0.015|0:03,,"Menden (Sauerland) Running",,,3113,,250,3,10694703108,0,168070,250480,30378,,46640749,,,,,,,,,,,,,,,,,,,,,,,,,,,,,,,,,,,,,,,,,
63636843,bbd0354e-7a4c-4e74-bcf0-aeb8279b7bae,1678820384,60,1678817807,,0,0,0.55,151,151,8,1,11,2,0,1.1,0.63,0.93,0.08,,35,151,160,,,,59.92,34.44,61.95,1,58.69,1094,13,,0.8,0.1,,100,,,,,,4,87,14.67,16.32,17.23,37.6,22.4,369,369,,1,460,460,,,,,,,,,"26,0,1,1,1,3,13,48,8","0,8,92,0,0","21,4,5,7,64",,,,,126,,,,,,,,,,,,,,,,,,,,,,,,,,,,,,,,,,,,13,4,16,297,68,,1007,0,,1,4,4,"Menden (Sauerland)",1,0,U0.510|1:44-U0.040|0:47,,"Menden (Sauerland) Track Running",,,3113,,250,3,10694703776,0,168070,250480,30378,,46640764,,,,,,,,,,,,,,,,,,,,,,,,,,,,,,,,,,,,,,,,,
63703303,385a0d96-d340-4a1a-8daa-98408892964b,1678903852,60,1678902978,,0,0,8.47,2622,2683,101,120,111,130,0,1.3,0.42,0.96,1,,540,140,159,,,,57.24,38.12,57.93,1,58.72,1164,87,,3,0,100,102,,,,,,62,79,11.78,11.89,11.87,-0.7,-4,275,275,,1,280,280,,,,,,,,,"7,8,10,23,45,6,1,0,0","1,55,45,0,0","0,2,80,19,0",,,,,123,,,,,,,,,,,,,,,,,,,,,,,,,,,,,,,,,,,,34.2,3,4,200,74,,1020,0,,0,4,4,Balve,1,0,U1.000|5:41-U1.000|4:42-U1.000|5:18-U1.000|5:06-U1.000|4:57-U1.000|4:42-U1.000|4:50-U1.000|5:14-U0.468|3:11,,"Balve Running",,,3113,,250,3,10701364481,0,168070,250480,30378,,46702559,,,,,,,,,,,,,,,,,,,,,,,,,,,,,,,,,,,,,,,,,
63766107,0aeabf11-f250-400b-99a7-5ef2e4306ca2,1678988179,60,1678984992,,0,0,0.65,237,237,16,7,14,4,0,1.3,0.94,0.95,,,44,125,137,,,,53.78,25.2,56.34,1,58.72,,8,,0.5,0,,100,,,,,,4,79,10.5,9.94,10.53,-0.1,5.1,244,244,,1,248,248,,,,,,,,,"31,12,21,33,3,0,0,0,0","6,94,0,0,0","0,5,95,0,0",,,,,104,,,,,,,,,,,,,,,,,,,,,,,,,,,,,,,,,,,,5.9,7,19,165,63,,1014,0,,0,4,4,Balve,1,0,,,"Balve Running",,,3113,,250,3,10707480577,0,168070,250480,30378,,46761239,,,,,,,,,,,,,,,,,,,,,,,,,,,,,,,,,,,,,,,,,
63841852,67bcff9c-b922-41c3-bf67-aed32aa46b78,1679072183,60,1679073246,,0,0,13.01,4204,4552,375,314,395,342,0,4.2,0.83,1,1.11,456,869,146,167,,,,51.34,37.41,53.47,1,58.7,1408,134,,3.4,0,100,98,,,,,,115,79,11.94,11.82,12.24,-8.3,6.5,276,276,,1,286,286,,,,,,,,,"21,18,12,10,19,18,3,0,0","0,29,65,6,0","0,1,73,26,0",,,,,118,,,,,,,,,,,,,,,,,,,,,,,,,,,,,,,,,,,,50.4,12,14,180,62,,1008,0,,0,4,4,Balve,1,0,U1.000|6:00-U1.000|6:28-U1.000|5:50-U1.000|6:25-U1.000|6:11-U1.000|5:34-U1.000|5:32-U1.000|4:46-U1.000|4:18-U1.000|4:16-U1.000|4:28-U1.000|4:28-U1.000|5:46-U0.007|0:03,,"Balve Running",,,3113,,250,3,10714256985,0,168070,250480,30378,,46830159,,,,,,,,,,,,,,,,,,,,,,,,,,,,,,,,,,,,,,,,3,
63964762,d653bf1e-6125-4e8f-afc9-9ace7e3ee946,1679231903,60,1679234673,,0,0,9.28,3048,3888,290,235,292,248,0,4.1,0.83,1.05,1.16,559,619,143,169,,,,51.74,35.78,54.13,1,58.72,1281,92,,3,0,98,100,,,,,,72,78,12.05,12.11,12.6,-6.6,7.6,276,276,,1,293,293,,,,,,,,,"26,12,16,11,7,19,9,1,0","0,33,64,2,0","0,9,62,27,1",,,,,117,,,,,,,,,,,,,,,,,,,,,,,,,,,,,,,,,,,,36.3,13,11,240,72,,1014,2,,0,6,4,Balve,1,0,U1.000|6:08-U1.000|6:22-U1.000|6:28-U1.000|7:25-U1.000|4:54-U1.000|4:11-U1.000|3:58-U1.000|5:41-U1.000|4:31-U0.278|1:10,,"Balve Running",,,3113,,250,3,10727068590,0,168070,250480,30378,,46943906,,,,,,,,,,,,,,,,,,,,,,,,,,,,,,,,,,,,,,,,"3,4",
63964765,253b2c22-e0c9-4128-b41d-b1143b7df3a8,1679151056,60,1679234675,,0,0,16.33,4952,5486,423,349,435,377,0,4.5,0.73,1,1.05,459,1071,149,171,,,,54,41.03,56.03,1,58.72,1872,175,,3.7,0.4,100,100,,,,,,137,80,12.71,12.3,13.11,-0.1,5.2,300,300,,1,314,314,,,,,,,,,"13,9,11,17,22,22,7,0,0","1,14,74,12,0","0,3,47,47,3",,,,,124,,,,,,,,,,,,,,,,,,,,,,,,,,,,,,,,,,,,52.1,14,12,197,70,,1012,1,,0,4,4,Balve,1,0,U1.000|5:11-U1.000|4:25-U1.000|5:03-U1.000|4:56-U1.000|5:01-U1.000|5:26-U1.000|6:00-U1.000|6:30-U1.000|5:42-U1.000|5:16-U1.000|4:49-U1.000|4:08-U1.000|4:15-U1.000|4:11-U1.000|5:17-U1.000|4:37-U0.330|1:47,,"Balve Running",,,3113,,250,3,10727068475,0,168070,250480,30378,,46943908,,,,,,,,,,,,,,,,,,,,,,,,,,,,,,,,,,,,,,,,"4,4,5",
64044043,d09a07d3-4144-48a1-9dee-7a2131f66c9f,1679333908,60,1679334884,,0,0,13,3939,4154,230,244,246,263,0,2.5,0.69,1,1.07,332,824,143,167,106,,,57.16,40.33,58.33,1,58.72,1338,119,,3.3,0,98,100,,,,,,95,79,12.1,12.49,12.46,-4.8,-9.3,285,285,,1,297,297,,,,,,,,,"7,9,14,28,23,10,9,1,0","0,36,60,3,0","0,1,67,30,2",,,,,125,,,,,,,,,,,,,,,,,,,,,,,,,,,,,,,,,,,,43.7,6,10,226,75,,1019,0,,0,4,4,Balve,1,0,U1.000|5:43-U1.000|4:53-U1.000|5:22-U1.000|5:14-U1.000|5:16-U1.000|5:24-U1.000|4:55-U1.000|4:41-U1.000|5:19-U1.000|5:11-U1.000|3:50-U1.000|3:53-U1.000|5:57-U0.002|0:01,,"Balve Running",,,3113,,250,3,10734604268,0,168070,250480,30378,,47014891,,,,,,,,,,,,,,,,,,,,,,,,,,,,,,,,,,,,,,,,"5,5",
64118358,8ae36467-0ec6-445e-ac03-e39ae3f3b6a4,1679423476,60,1679423646,,0,0,3.33,863,863,12,38,12,39,0,0.1,0.31,,1,,204,150,166,,,,64.95,44.22,64.62,1,58.72,932,63,,2.6,0,,100,,,,,,23,81,13.65,13.97,13.68,6.6,6.3,330,330,,1,331,331,,,,,,,,,"0,0,2,6,20,58,14,0,0","1,9,81,10,0","0,0,9,91,0",,,,,143,,,,,,,,,,,,,,,,,,,,,,,,,,,,,,,,,,,,34.9,10,16,200,74,,1013,0,,0,3,4,"Menden (Sauerland)",1,0,U1.000|4:30-U1.000|4:06-U1.000|4:17-U0.329|1:30,,"Menden (Sauerland) Running",,,3113,,250,3,10741907310,0,168070,250480,30378,,47081701,,,,,,,,,,,,,,,,,,,,,,,,,,,,,,,,,,,,,,,,,
64118448,fd683895-eeca-4ad0-b6a8-d4ea62c58427,1679424695,60,1679423710,,0,0,7.81,2434,2434,58,56,92,88,0,0,0.21,1.05,0.52,,530,150,183,,,,51.73,37.62,52.22,1,58.73,2434,189,,3.3,2.7,106,99,,,,,,68,80,11.79,13.67,14.19,20,10.1,291,289,,1,370,369,,,,,,,,,"38,8,6,1,1,2,10,27,6","0,29,43,25,3","18,23,14,8,38",,,,,120,,,,,,,,,,,,,,,,,,,,,,,,,,,,,,,,,,,,61.7,10,16,199,75,,1013,0,,1,3,4,"Menden (Sauerland)",1,0,U0.140|0:25-U0.190|1:19-U0.140|0:27-U0.170|1:19-U0.320|1:49-U0.140|0:29-U0.170|2:15-U1.200|4:07-U0.210|1:35-U0.600|2:05-U0.210|1:31-U0.600|2:04-U0.210|1:36-U0.610|2:06-U0.520|3:43-U0.300|0:56-U0.100|0:57-U0.300|0:57-U0.140|2:59-U0.300|0:55-U0.410|3:06-U0.800|2:47-U0.030|1:06,,"Menden (Sauerland) Track Running",,,3113,,250,3,10741916078,0,168070,250480,30378,,47081776,,,,,,,,,,,,,,,,,,,,,,,,,,,,,,,,,,,,,,,,,
64119863,496e845d-bcd0-4900-aea0-c97053373630,1679427386,60,1679425059,,0,0,3.33,1010,1072,29,37,40,49,0,0.9,0.5,1.17,0.8,,224,147,155,121,,,55,36.84,55.43,1,58.73,3168,56,,2.5,0,103,101,,,,,,26,80,11.84,11.96,12.18,6.2,14.9,281,281,,1,294,294,,,,,,,,,"3,2,4,35,52,3,0,0,0","0,8,92,0,0","1,1,75,22,0",,,,,124,,,,,,,,,,,,,,,,,,,,,,,,,,,,,,,,,,,,30.2,10,16,197,76,,1013,0,,1,3,4,"Menden (Sauerland)",1,0,U1.000|5:17-U1.000|4:54-U1.000|4:56-U0.332|1:44,,"Menden (Sauerland) Running",,,3113,,250,3,10742101934,0,168070,250480,30378,,47083097,,,,,,,,,,,,,,,,,,,,,,,,,,,,,,,,,,,,,,,,,
64184389,728e36f5-4ade-4b80-b9f1-3e9f2ca04882,1679505967,60,1679508018,,0,0,16.01,5013,5569,365,359,393,388,0,3.5,0.71,,,472,1148,,,,,,,39.46,,1,58.73,1788,35,,2.1,0,,100,,,,,,118,79,11.98,12.08,12.13,,,278,278,,1,283,283,,,,,,,,,"13,12,16,19,18,17,4,0,0",,"0,3,68,28,0",,,,,121,,,,,,,,,,,,,,,,,,,,,,,,,,,,,,,,,,,,,11,20,205,75,,1008,0,,0,4,4,Balve,1,0,U1.000|4:43-U1.000|4:53-U1.000|6:04-U1.000|5:58-U1.000|5:57-U1.000|6:13-U1.000|4:53-U1.000|5:08-U1.000|5:36-U1.000|4:57-U1.000|4:14-U1.000|4:29-U1.000|4:19-U1.000|4:49-U1.000|5:46-U1.000|5:32-U0.010|0:04,,"Balve Running",,,3113,,250,3,10748719400,0,168070,250480,30378,,47143479,,,,,,,,,,,,,,,,,,,,,,,,,,,,,,,,,,,,,,,,"4,5,5",
64262968,507f953a-3357-4177-8ede-2761bdd4edd2,1679594891,60,1679598872,,0,0,13.19,3786,4200,129,120,155,146,0,0.7,0.36,1.01,1.01,,827,149,179,,,,57.79,43,58.53,1,58.73,1872,205,,3.8,2,97,100,,,,,,111,80,12.67,13.74,13.78,7.5,2.4,306,306,,1,345,345,,,,,,,,,"4,5,20,26,16,4,17,7,0","0,24,53,23,0","1,2,63,20,15",,,,,131,,,,,,,,,,,,,,,,,,,,,,,,,,,,,,,,,,,,82.8,11,16,204,76,,1006,0,,0,4,4,Balve,1,0,U1.000|5:36-U1.000|5:05-U1.000|5:11-U1.000|5:09-U1.000|4:57-U1.000|3:38-U1.000|3:39-U1.000|4:56-U1.000|5:23-U0.538|2:56-U1.000|3:33-U1.000|3:40-U1.000|5:54-U0.656|3:30,,"Balve Running",,,3113,,250,3,10755930858,0,168070,250480,30378,,47215947,,,,,,,,,,,,,,,,,,,,,,,,,,,,,,,,,,,,,,,,,
64316065,0bc923e0-6c53-4882-aa91-b65f88e3dad5,1679681596,60,1679679258,,0,0,4.01,1074,1074,12,41,17,46,0,0,0.1,,,,254,147,161,,,,64.13,43.17,63.8,1,58.78,1164,76,,2.8,0,104,100,,,,,,31,80,13.24,13.52,13.31,10.8,13.3,319,319,,1,322,322,,,,,,,,,"1,1,3,2,34,50,9,0,0","1,16,82,1,0","0,1,16,83,0",,,,,140,,,,,,,,,,,,,,,,,,,,,,,,,,,,,,,,,,,,40.7,11,19,235,71,,1004,0,,0,4,4,"Menden (Sauerland)",1,0,U1.000|4:39-U1.000|4:21-U1.000|4:22-U1.000|4:28-U0.014|0:04,,"Menden (Sauerland) Running",,,3113,,250,3,10761564193,0,168070,250480,30378,,47263693,,,,,,,,,,,,,,,,,,,,,,,,,,,,,,,,,,,,,,,,,
64318574,222fac94-19f8-448b-82e2-7ba4a940e04e,1679683120,60,1679682583,,0,0,7.71,2720,2720,16,19,17,20,0,0,0.08,,,,544,145,174,102,,,46.5,32.45,46.6,1,58.78,2016,144,,3.2,2.1,,100,,,,,,76,77,10.2,13.19,13.4,8,1.8,252,252,,1,346,346,,,,,,,,,"50,1,1,1,2,2,9,30,4","2,28,49,21,0","36,12,8,9,34",,,,,110,,,,,,,,,,,,,,,,,,,,,,,,,,,,,,,,,,,,50.8,10,19,231,79,,1004,0,,1,4,4,"Menden (Sauerland)",1,0,U0.380|1:22-U0.120|0:56-U0.400|1:20-U0.100|0:56-U0.400|1:21-U0.110|0:59-U0.390|1:21-U0.100|0:59-U0.400|1:22-U0.150|6:01-U0.400|1:17-U0.100|0:57-U0.390|1:16-U0.110|1:03-U0.400|1:17-U0.100|1:05-U0.400|1:17-U0.100|1:04-U0.400|1:18-U0.300|5:00-U0.400|1:15-U0.110|1:13-U0.400|1:18-U0.100|1:24-U0.400|1:19-U0.100|1:18-U0.400|1:21-U0.100|1:14-U0.400|1:23-U0.050|1:24,,"Menden (Sauerland) Track Running",,,3113,,250,3,10761894686,0,168070,250480,30378,,47266041,,,,,,,,,,,,,,,,,,,,,,,,,,,,,,,,,,,,,,,,,
64320561,aecbea92-2099-435b-b948-37e3ec02d261,1679686428,60,1679683969,,0,0,3.14,1045,1045,25,12,35,23,0,0,0.28,1.01,,,214,145,162,,,,49.97,32.89,50.72,1,58.77,2309,39,,2.2,0,96,98,,,,,,28,78,10.96,10.85,11.06,-6.2,-2.7,257,257,,1,261,261,,,,,,,,,"4,9,41,40,5,2,0,0,0","0,49,48,2,0","0,0,96,4,0",,,,,116,,,,,,,,,,,,,,,,,,,,,,,,,,,,,,,,,,,,37.9,9,19,227,79,,1004,0,,1,4,4,"Menden (Sauerland)",1,0,U1.000|5:31-U1.000|5:37-U1.000|5:29-U0.138|0:47,,"Menden (Sauerland) Running",,,3113,,250,3,10762021228,0,168070,250480,30378,,47267968,,,,,,,,,,,,,,,,,,,,,,,,,,,,,,,,,,,,,,,,,
64384035,6ca4e03b-ec88-4dac-8d87-219e35fbd809,1679763890,60,1679765270,,0,0,9.09,2917,3113,169,128,188,149,0,2,0.58,0.98,0.98,308,597,141,161,107,,,54.25,36.72,55.8,1,58.78,1338,87,,3,0,102,100,,,,,,71,79,11.56,11.43,11.77,3,2,273,273,,1,281,281,,,,,,,,,"9,7,19,37,21,6,1,0,0","1,36,63,0,0","0,3,75,21,0",,,,,118,,,,,,,,,,,,,,,,,,,,,,,,,,,,,,,,,,,,36.5,8,25,251,80,,1006,0,,0,11,4,Balve,1,0,U1.000|5:37-U1.000|5:42-U1.000|5:11-U1.000|4:51-U1.000|5:27-U1.000|4:54-U1.000|5:14-U1.000|5:34-U1.000|5:37-U0.090|0:30,,"Balve Running",,,3113,,250,3,10768298433,0,168070,250480,30378,,47324881,,,,,,,,,,,,,,,,,,,,,,,,,,,,,,,,,,,,,,,,"5,5",
64420245,25d37486-5f46-4c6f-bfda-33b03272fab5,1679831014,120,1679827799,,0,0,15.3,3767,3923,46,30,61,45,0,0,0.07,,,,968,157,186,,,,64.83,51.97,65.16,1,58.81,4320,319,,5,0,104,100,,,,,,132,82,14.69,14.72,14.8,13.9,13.2,367,367,,1,372,372,,,,,,,,,"1,0,0,2,9,51,33,4,0","1,23,14,61,2","0,0,3,87,10",,,,,149,,,,,,,,,,,,,,,,,,,,,,,,,,,,,,,,,,,,83.9,7,10,174,85,,1003,2,,0,6,4,Sundern,1,0,U1.000|4:29-U1.000|4:14-U1.000|4:05-U1.000|4:08-U1.000|3:58-U1.000|4:04-U1.000|3:55-U1.000|4:02-U1.000|4:16-U1.000|3:57-U1.000|4:08-U1.000|4:04-U1.000|4:06-U1.000|4:05-U1.000|3:59-U0.304|1:16,,"Sundern (Sauerland) Running",,,3113,,250,3,10772471057,0,168070,250480,30378,,47358896,,,,,,,,,,,,,,,,,,,,,,,,,,,,,,,,,,,,,,,,,
64522708,368a075b-05ab-4a53-bf8f-54be4e5a8204,1679940616,120,1679944488,,0,0,13.03,4052,4493,389,351,391,356,0,4,0.89,0.98,1.09,452,837,143,165,,,,55.35,39.13,57.6,1,58.8,2598,123,,3.3,0,100,98,,,,,,99,80,12.46,13.07,12.97,-8.7,-2.4,288,288,,1,301,301,,,,,,,,,"21,15,19,8,12,7,12,5,0","1,27,71,1,0","0,3,61,34,2",,,,,121,,,,,,,,,,,,,,,,,,,,,,,,,,,,,,,,,,,,39.4,3,16,311,71,,1022,0,,0,3,4,Balve,1,0,U1.000|5:58-U1.000|6:11-U1.000|5:52-U1.000|6:23-U1.000|6:22-U1.000|5:42-U1.000|5:32-U1.000|5:30-U1.000|4:49-U1.000|4:14-U1.000|3:52-U1.000|3:36-U1.000|3:24-U0.027|0:07,,"Balve Running",,,3113,,250,3,10782364151,0,168070,250480,30378,,47449326,,,,,,,,,,,,,,,,,,,,,,,,,,,,,,,,,,,,,,,,3,
64584188,64341a82-f173-4950-bddb-ad111a53d590,1680028468,120,1680022617,,0,0,4.07,1112,1125,36,34,36,38,0,0,0.17,1.01,,,261,149,165,105,,,61.42,42.22,62.13,1,58.84,1338,80,,2.9,0,103,101,,,,,,33,80,13.27,13.27,13.43,6.1,8.3,323,323,,1,329,329,,,,,,,,,"3,2,2,8,28,52,6,0,0","1,19,74,5,0","0,1,16,81,3",,,,,137,,,,,,,,,,,,,,,,,,,,,,,,,,,,,,,,,,,,43.4,8,11,196,57,,1022,0,,0,4,4,"Menden (Sauerland)",1,0,U1.000|4:51-U1.000|4:22-U1.000|4:20-U1.000|4:29-U0.066|0:30,,"Menden (Sauerland) Running",,,3113,,250,3,10788150476,0,168070,250480,30378,,47505095,,,,,,,,,,,,,,,,,,,,,,,,,,,,,,,,,,,,,,,,,
64587980,a29f6f4a-ed90-473e-aa69-3274462594f7,1680029997,120,1680026198,,0,0,1.81,773,773,53,36,70,52,0,1.4,0.43,1.31,0.51,1538,134,130,158,,,,42.23,23.4,44.26,1,58.84,1322,35,,1.7,0.7,,100,,,,,,15,76,8.43,12.92,19.92,39.9,52.7,211,211,,1,556,556,,,,,,,,,"69,7,2,3,1,2,3,3,10","5,65,30,0,0","29,35,19,6,11",,,,,92,,,,,,,,,,,,,,,,,,,,,,,,,,,,,,,,,,,,18.1,7,10,196,57,,1022,0,,0,4,4,"Menden (Sauerland)",1,0,U1.000|5:36-U0.811|7:17,,"Menden (Sauerland) Running",,,3113,,250,3,10788680804,0,168070,250480,30378,,47508674,,,,,,,,,,,,,,,,,,,,,,,,,,,,,,,,,,,,,,,,4,
64590978,a312cf34-0d19-4b1a-beea-938e96a8e28d,1680030832,120,1680027798,,0,0,7.65,2520,2520,0,2,0,1,0,0,0,,,,525,148,169,,,,49.21,35.18,49.2,1,58.84,2160,108,,3,1,,100,,,,,,72,79,10.93,13.18,13.17,16.1,-1.3,265,265,,1,338,338,,,,,,,,,"54,5,4,1,1,1,4,19,10","0,26,58,16,0","15,36,12,8,28",,,,,115,,,,,,,,,,,,,,,,,,,,,,,,,,,,,,,,,,,,43.3,7,10,190,59,,1022,0,,0,4,4,"Menden (Sauerland)",1,0,U0.800|2:39-U0.400|2:44-U0.400|1:15-U0.210|1:47-U0.400|1:18-U0.190|1:32-U0.400|1:17-U0.200|1:38-U0.400|1:17-U0.400|3:08-U0.200|0:34-U0.200|1:39-U0.200|0:35-U0.200|1:53-U0.200|0:35-U0.200|1:49-U0.200|0:36-U0.200|1:42-U0.200|0:34-U0.200|1:51-U0.210|0:34-U0.390|4:12-U0.410|1:12-U0.400|3:18-U0.400|1:09-U0.040|1:09,,"Menden (Sauerland) Track Running",,,3113,,250,3,10788915612,0,168070,250480,30378,,47511384,,,,,,,,,,,,,,,,,,,,,,,,,,,,,,,,,,,,,,,,,
64590984,31ed0af6-59de-4d37-a05d-57bb2fceb613,1680033677,120,1680027803,,0,0,3.29,1014,1101,51,60,53,61,0,1.6,0.69,1.27,0.96,,220,151,168,,,,51.95,36.12,52.77,1,58.84,2736,55,,2.4,0,,100,,,,,,31,80,11.71,11.82,12.61,-8.4,-26.5,278,278,,1,311,311,,,,,,,,,"3,2,11,48,33,3,1,0,0","1,11,74,14,0","0,2,71,17,11",,,,,122,,,,,,,,,,,,,,,,,,,,,,,,,,,,,,,,,,,,41.7,6,9,187,60,,1022,0,,1,4,4,"Menden (Sauerland)",1,0,U1.000|5:26-U1.000|5:04-U1.000|5:00-U0.289|1:25,,"Menden (Sauerland) Running",,,3113,,250,3,10788916849,0,168070,250480,30378,,47511391,,,,,,,,,,,,,,,,,,,,,,,,,,,,,,,,,,,,,,,,,
64660287,0807cded-6970-423f-b247-a0c3ec75bf6f,1680113516,120,1680112171,,0,0,13.01,4622,5470,371,325,383,337,0,4,0.86,0.93,0.89,450,834,132,154,,,,52.03,33.47,54.09,1,58.82,1593,93,,3,0,101,98,,,,,,87,78,10.7,11.37,11.75,5.3,4.3,248,248,,1,274,274,,,,,,,,,"30,11,15,13,18,12,1,0,0","7,54,39,0,0","7,2,73,17,0",,,,,108,,,,,,,,,,,,,,,,,,,,,,,,,,,,,,,,,,,,27.6,12,10,194,77,,1013,0,,0,4,4,Balve,1,0,U1.000|5:09-U1.000|5:14-U1.000|6:26-U1.000|6:07-U1.000|6:13-U1.000|6:00-U1.000|6:29-U1.000|5:39-U1.000|10:14-U1.000|4:33-U1.000|4:37-U1.000|4:20-U1.000|5:55-U0.008|0:03,,"Balve Running",,,3113,,250,3,10795556913,0,168070,250480,30378,,47571524,,,,,,,,,,,,,,,,,,,,,,,,,,,,,,,,,,,,,,,,"3,5",
64727140,24c06a71-78c5-4cc7-b8ef-e1e398cb4660,1680201880,120,1680199377,,0,0,14.01,4383,4594,229,226,259,258,0,2.5,0.58,0.98,1,417,884,139,155,,,,57.03,39.08,58.2,1,58.82,1342,109,,3.2,0,103,98,,,,,,97,79,11.72,11.71,11.84,-0.9,-0.8,275,275,,1,280,280,,,,,,,,,"6,9,15,30,30,10,1,0,0","0,53,47,0,0","0,2,73,25,0",,,,,121,,,,,,,,,,,,,,,,,,,,,,,,,,,,,,,,,,,,27.6,12,18,241,76,,1009,0,,0,3,4,Balve,1,0,U1.000|5:14-U1.000|5:33-U1.000|5:06-U1.000|5:02-U1.000|5:45-U1.000|5:08-U1.000|5:32-U1.000|4:55-U1.000|4:46-U1.000|4:46-U1.000|4:57-U1.000|5:26-U1.000|5:21-U1.000|5:32-U0.007|0:02,,"Balve Running",,,3113,,250,3,10802201435,0,168070,250480,30378,,47631704,,,,,,,,,,,,,,,,,,,,,,,,,,,,,,,,,,,,,,,,"5,5,5",
64804230,33a32351-bac4-4915-9df8-8b2c978e13a8,1680289979,120,1680287175,,0,0,13.02,4060,4314,239,243,251,256,0,2.8,0.59,1.04,1.05,662,828,139,157,,,,57.26,39.01,58.54,1,58.82,1280,108,,3.2,0,99,100,,,,,,79,79,11.79,11.94,12.36,-4.9,-12,276,276,,1,295,295,,,,,,,,,"10,10,13,23,29,12,2,1,0","0,55,45,0,0","0,2,73,23,2",,,,,122,,,,,,,,,,,,,,,,,,,,,,,,,,,,,,,,,,,,23.7,9,17,210,86,,995,0,,0,6,4,Balve,1,0,U1.000|5:46-U1.000|5:01-U1.000|5:35-U1.000|5:12-U1.000|5:22-U1.000|5:21-U1.000|5:10-U1.000|4:48-U1.000|5:27-U1.000|5:42-U1.000|4:05-U1.000|4:23-U1.000|5:45-U0.017|0:06,,"Balve Running",,,3113,,250,3,10808347400,0,168070,250480,30378,,47703316,,,,,,,,,,,,,,,,,,,,,,,,,,,,,,,,,,,,,,,,"4,4",
64930939,944dfc8a-208d-4dfb-a142-e990b1b4e753,1680366784,120,1680448108,,0,0,0.67,405,407,9,8,8,6,0,0.3,0.39,1.87,0.66,,61,120,144,,,,30.1,,30.67,1,58.85,1032,10,,0.5,0.2,,100,,,,,,5,71,5.95,9.45,10.07,48,41.1,132,132,,1,257,257,,,,,,,,,"80,9,1,1,0,1,2,5,1","0,92,8,0,0","55,23,14,5,3",,,,,70,,,,,,,,,,,,,,,,,,,,,,,,,,,,,,,,,,,,5.5,10,11,247,90,,999,1,,0,6,4,"Menden (Sauerland)",1,0,,,"Menden (Sauerland) Running",,,3113,,250,3,10820823204,0,168070,250480,30378,,47820148,,,,,,,,,,,,,,,,,,,,,,,,,,,,,,,,,,,,,,,,,
64930941,a4be827d-9dc1-4220-91f3-760c53835942,1680365085,120,1680448108,,0,0,3.79,1038,1038,22,51,28,58,0,0.6,0.45,0.82,0.97,,243,153,164,,,,59,41.89,58.86,1,58.85,1048,69,,2.7,0,103,102,,,,,,30,79,13,13.28,13.03,3.1,-1.8,309,309,,1,312,312,,,,,,,,,"2,4,2,6,27,53,5,0,0","1,6,86,8,0","0,1,36,63,0",,,,,139,,,,,,,,,,,,,,,,,,,,,,,,,,,,,,,,,,,,40,10,11,245,89,,999,2,,0,6,4,"Menden (Sauerland)",1,0,U1.000|4:30-U1.000|4:27-U1.000|4:28-U0.789|3:54,,"Menden (Sauerland) Running",,,3113,,250,3,10820823143,0,168070,250480,30378,,47820150,,,,,,,,,,,,,,,,,,,,,,,,,,,,,,,,,,,,,,,,,
64930942,44e21b76-ab5a-4d73-88bb-3ba2c5c137ce,1680452796,120,1680448108,,0,0,1.98,616,1257,23,13,26,16,0,0.2,0.36,,0.41,,128,141,159,145,,,56.36,34.17,57.52,1,58.89,816,54,,2.4,0,101,103,,,,,,14,79,11.59,12.3,12.52,15.9,4.9,291,283,,1,307,306,,,,,,,,,"7,3,5,13,55,14,3,0,0","1,30,69,0,0","8,2,30,60,0",,,,,122,,,,,,,,,,,,,,,,,,,,,,,,,,,,,,,,,,,,23.6,7,15,49,61,,1023,2,,0,4,4,Sundern,1,0,U1.000|4:46-U0.976|5:31,,"Sundern (Sauerland) Running",,,3113,,250,3,10820823273,0,168070,250480,30378,,47820151,,,,,,,,,,,,,,,,,,,,,,,,,,,,,,,,,,,,,,,,,
65016590,8d302068-bae0-423c-b073-87b3049f4163,1680547060,120,1680544788,,0,0,14.17,4327,4464,412,400,438,426,0,4.9,0.8,1.06,1.02,542,951,152,173,,,,52.07,40.24,53.99,1,58.89,1728,160,,3.7,0,104,98,,,,,,126,80,12.54,12.52,13.07,4.8,17.5,292,292,,1,307,307,,,,,,,,,"13,14,14,13,14,25,7,0,0","0,7,70,22,0","0,1,57,39,3",,,,,123,,,,,,,,,,,,,,,,,,,,,,,,,,,,,,,,,,,,63.1,4,13,59,58,,1030,0,,0,3,4,Balve,1,0,U1.000|4:44-U1.000|4:47-U1.000|6:00-U1.000|5:45-U1.000|5:45-U1.000|5:44-U1.000|5:56-U1.000|5:45-U1.000|4:34-U1.000|4:17-U1.000|4:09-U1.000|4:15-U1.000|4:10-U1.000|5:19-U0.168|0:57,,"Balve Running",,,3113,,250,3,10828319797,0,168070,250480,30378,,47892710,,,,,,,,,,,,,,,,,,,,,,,,,,,,,,,,,,,,,,,,"3,5,5",
65069947,b8c2f5e3-0af9-4e1f-8cfd-db31b71a4ce1,1680621125,120,1680616967,,0,0,12.92,2407,2407,145,235,200,264,0,1.8,0.53,,,547,189,,,,,,,,,1,,,,,,,,,150,,,,,28,59,,33.37,,,,113,101,,0,153,148,,,,,,,,,"28,16,9,8,13,3,23",,"55,45,0,0,0",,,,,,,,,,,,,,,,,,,,,,,,,,,,,,,,,,,,,,,,,,,,,,,,,,0,1,,,1,1,,,,,,315-0,,,7,,0,168072,,30378,,47941081,,,,,,,,,,,,,,,,,,,,,,,,,,,,,,,,,,,,,,,,"5,5",
65087404,15c4b185-34e9-45b7-8875-bf57899a5bc0,1680633231,120,1680632428,,0,0,5.01,1561,1962,41,51,51,62,0,0.4,0.28,1.03,1.01,,311,142,160,,,,55.74,36.63,56.16,1,58.94,1106,81,,2.7,0.6,101,103,,,,,,36,76,11.6,12.7,12.79,13.4,-11.4,273,273,,1,315,315,,,,,,,,,"26,1,1,4,20,42,4,1,2","2,31,68,0,0","8,16,19,50,7",,,,,127,,,,,,,,,,,,,,,,,,,,,,,,,,,,,,,,,,,,34,7,8,36,56,,1026,0,,0,4,4,"Menden (Sauerland)",1,0,U1.000|4:45-U1.000|4:17-U1.000|4:22-U1.000|4:32-U1.000|8:00-U0.007|0:05,,"Menden (Sauerland) Running",,,3113,,250,3,10835665945,0,168070,250480,30378,,47957305,,,,,,,,,,,,,,,,,,,,,,,,,,,,,,,,,,,,,,,,,
65087435,2679205c-cf20-4b1f-8db3-806ddccf2d6c,1680635391,120,1680632459,,0,0,8.04,2328,2371,0,2,0,1,0,0,0,,,,526,156,176,114,,,53.56,41.1,53.55,1,58.95,3520,214,,3.3,3,109,110,,,,,,76,83,12.42,14.19,14.18,13.8,-4,309,308,,1,362,362,,,,,,,,,"41,2,2,1,1,3,10,37,3","0,21,27,52,0","10,25,12,11,43",,,,,125,,,,,,,,,,,,,,,,,,,,,,,,,,,,,,,,,,,,55.7,6,7,38,60,,1026,0,,0,4,4,"Menden (Sauerland)",1,0,U0.400|1:22-U0.100|0:41-U0.400|1:20-U0.100|0:36-U0.400|1:19-U0.100|0:43-U0.390|1:20-U0.100|0:47-U0.400|1:20-U0.400|3:19-U0.400|1:20-U0.100|0:48-U0.400|1:20-U0.100|0:44-U0.400|1:19-U0.090|0:52-U0.400|1:21-U0.100|0:57-U0.400|1:20-U0.410|4:13-U0.400|1:19-U0.100|0:46-U0.400|1:18-U0.100|0:41-U0.400|1:19-U0.100|0:51-U0.400|1:17-U0.100|1:05-U0.400|1:13-U0.050|1:57,,"Menden (Sauerland) Track Running",,,3113,,250,3,10835670771,0,168070,250480,30378,,47957333,,,,,,,,,,,,,,,,,,,,,,,,,,,,,,,,,,,,,,,,,
65087441,74f62dce-986b-4cc7-bc3f-bf8df9dab13c,1680637959,120,1680632464,,0,0,2.4,757,787,36,18,36,17,0,0.5,0.35,1.1,0.95,,159,140,147,,,,55.93,34.27,57.49,1,58.95,4320,36,,2.1,0,100,102,,,,,,16,80,11.72,11.49,12.01,-6.9,-17.7,280,280,,1,291,291,,,,,,,,,"4,1,10,59,25,0,0,0,0","0,50,50,0,0","0,0,73,27,0",,,,,119,,,,,,,,,,,,,,,,,,,,,,,,,,,,,,,,,,,,19.1,5,7,38,60,,1026,0,,0,4,4,"Menden (Sauerland)",1,0,U1.000|5:26-U1.000|5:04-U0.404|2:07,,"Menden (Sauerland) Running",,,3113,,250,3,10835671710,0,168070,250480,30378,,47957339,,,,,,,,,,,,,,,,,,,,,,,,,,,,,,,,,,,,,,,,,
65168562,3e2b05e8-50de-46e9-b11d-c9deb55b6f9c,1680722595,120,1680718690,,0,0,9.74,3096,3233,272,234,288,255,0,4.1,0.92,1.06,1.02,493,628,136,155,,,,57.5,37.31,59.77,1,58.95,2867,87,,3,0,99,100,,,,,,66,78,11.87,11.62,12.55,-0.3,0.9,279,279,,1,301,301,,,,,,,,,"12,9,15,22,34,7,1,0,0","1,69,30,0,0","0,2,73,21,5",,,,,121,,,,,,,,,,,,,,,,,,,,,,,,,,,,,,,,,,,,28.3,6,4,42,61,,1020,0,,0,3,4,Balve,1,0,U1.000|5:50-U1.000|4:53-U1.000|5:12-U1.000|5:31-U1.000|5:08-U1.000|5:45-U1.000|5:27-U1.000|4:26-U1.000|4:41-U0.743|4:43,,"Balve Running",,,3113,,250,3,10842632543,0,168070,250480,30378,,48031194,,,,,,,,,,,,,,,,,,,,,,,,,,,,,,,,,,,,,,,,"4,4,5,5,5,5",
65227796,15cf8798-d6a4-4cad-9cbf-b3bd94795b61,1680805800,120,1680802611,,0,0,13.26,3845,3938,233,220,256,246,0,2.9,0.56,1.01,1.01,407,849,149,164,,,,57.07,42.52,58.38,1,58.95,2448,149,,3.5,0.1,100,100,,,,,,90,79,12.74,12.74,13.06,-0.7,-3.8,304,304,,1,315,315,,,,,,,,,"5,4,10,19,28,28,5,0,0","1,12,86,2,0","0,1,49,49,2",,,,,131,,,,,,,,,,,,,,,,,,,,,,,,,,,,,,,,,,,,30.4,8,14,191,65,,1016,0,,0,4,4,Balve,1,0,U1.000|5:05-U1.000|5:24-U1.000|4:44-U1.000|4:18-U1.000|5:18-U1.000|4:39-U1.000|5:01-U1.000|4:32-U1.000|4:28-U1.000|4:18-U1.000|4:33-U1.000|4:58-U1.000|5:18-U0.257|1:27,,"Balve Running",,,3113,,250,3,10848822388,0,168070,250480,30378,,48082199,,,,,,,,,,,,,,,,,,,,,,,,,,,,,,,,,,,,,,,,"4,5,5",
65274624,0b8f0e89-1872-4373-88c0-b6040349b808,1680867153,120,1680862185,,0,0,6.27,1877,1897,113,111,121,119,0,2.2,0.6,1.01,1.05,485,412,146,161,,,,56.42,38.92,57.7,1,58.96,1584,94,,3,0.5,103,100,,,,,,48,80,12.35,12.83,12.85,-0.6,-3.9,292,292,,1,307,307,,,,,,,,,"8,6,14,31,23,6,6,5,0","1,17,81,1,0","0,1,63,34,3",,,,,125,,,,,,,,,,,,,,,,,,,,,,,,,,,,,,,,,,,,32.4,8,4,177,85,,1016,2,,0,6,4,Balve,1,0,U1.000|5:33-U1.000|4:20-U1.000|4:43-U1.000|5:14-U1.000|5:04-U1.000|5:07-U0.267|1:16,,"Balve Running",,,3113,,250,3,10852430096,0,168070,250480,30378,,48123341,,,,,,,,,,,,,,,,,,,,,,,,,,,,,,,,,,,,,,,,4,
65384396,6c19823c-f803-4029-8870-bb251e3f8ea0,1680950047,120,1680982922,,0,0,2.64,892,1194,36,14,43,12,0,0.8,0.45,1.01,0.33,,192,148,171,101,,,47.7,31.89,48.99,1,58.96,932,55,,2.4,0,,100,,,,,,25,78,11.25,12.31,13.33,29.4,-0.1,272,271,,1,344,343,,,,,,,,,"33,1,3,8,18,24,10,3,0","0,30,38,31,0","14,10,24,49,3",,,,,114,,,,,,,,,,,,,,,,,,,,,,,,,,,,,,,,,,,,41,6,3,34,82,,1025,2,,0,4,4,Paderborn,1,0,U1.000|4:37-U1.000|4:29-U0.637|5:45,,"Paderborn Running",,,3113,,250,3,10863232059,0,168070,250480,30378,,48222009,,,,,,,,,,,,,,,,,,,,,,,,,,,,,,,,,,,,,,,,,
65384397,93c5f91d-bf88-4cef-a663-e498fb5950c7,1680954197,120,1680982922,,0,0,1.95,612,616,14,8,19,13,0,0,0.21,0.96,,,124,142,149,,,,55.24,33.78,55.94,1,58.97,2142,24,,1.7,0,100,98,,,,,,15,80,11.65,11.59,11.71,8.8,11.9,277,277,,1,279,279,,,,,,,,,"7,2,13,37,30,9,1,0,0","0,14,86,0,0","0,3,73,23,0",,,,,119,,,,,,,,,,,,,,,,,,,,,,,,,,,,,,,,,,,,22.4,7,7,40,82,,1025,3,,0,4,4,Paderborn,1,0,U1.049|5:32-U0.003|0:01-U0.896|4:39,,"Paderborn Running",,,3113,,250,3,10863232146,0,168070,250480,30378,,48222011,,,,,,,,,,,,,,,,,,,,,,,,,,,,,,,,,,,,,,,,,
65384398,713eb026-7178-4fce-8172-68cede93de35,1680951626,120,1680982922,,0,0,5.05,1058,1058,21,35,22,35,0,0,0.16,1.4,1.02,,290,174,184,120,,,67.56,58.4,67.67,1,58.97,2160,144,,3.5,0,104,100,,,,,,54,86,17.07,17.3,17.49,11.1,16.4,440,440,,1,457,457,,,,,,,,,"0,0,1,0,0,1,51,41,6","1,3,5,55,36","0,0,0,9,91",,,,,167,,,,,,,,,,,,,,,,,,,,,,,,,,,,,,,,,,,,116.7,7,7,40,83,,1025,2,,0,4,4,Paderborn,1,0,,,"Paderborn Running",,,3113,,250,3,10863232110,0,168070,250480,30378,,48222010,,,,,,,,,,,,,,,,,,,,,,5,1058,,,0,"75. Paderborner Osterlauf",,,,,,,0,0,30378,65384398,12377,,,
65424973,07c4641c-fc0d-4114-bba1-a8dfa1de0dde,1681036719,120,1681036145,,0,0,18.01,5783,6292,590,571,632,615,0,5.9,0.8,0.97,1.13,657,1176,144,174,,,,52.72,38.69,54.92,1,58.97,1872,159,,3.6,0.7,100,100,,,,,,155,79,12.27,13.17,12.92,-8.9,-9,277,277,,1,297,297,,,,,,,,,"33,10,8,9,15,7,9,9,0","0,40,50,9,0","0,9,58,32,2",,,,,118,,,,,,,,,,,,,,,,,,,,,,,,,,,,,,,,,,,,70.6,8,8,144,71,,1026,2,,0,3,4,Balve,1,0,U1.000|4:51-U1.000|5:12-U1.000|5:33-U1.000|4:59-U1.000|5:39-U1.000|6:01-U1.000|9:21-U1.000|7:22-U1.000|6:53-U1.000|6:01-U1.000|5:20-U1.000|4:46-U0.231|1:18-U1.000|3:37-U1.000|3:29-U1.000|3:21-U1.000|3:25-U1.000|3:42-U0.778|5:33,,"Balve Running",,,3113,,250,3,10866485584,0,168070,250480,30378,,48258928,,,,,,,,,,,,,,,,,,,,,,,,,,,,,,,,,,,,,,,,"1,4,5,5",
65508862,8ecd0438-8fcf-429e-8d64-9aa927e9c92d,1681137551,120,1681136475,,0,0,15.01,4838,5147,456,429,505,482,0,4.9,0.75,1,1.11,573,979,141,157,,,,53.95,37.96,56.1,1,58.96,1401,126,,3.3,0,100,99,,,,,,119,79,12.03,12.18,12.72,-11.5,-7.5,278,278,,1,299,299,,,,,,,,,"23,15,16,11,10,18,7,0,0","1,39,61,0,0","1,3,66,27,3",,,,,118,,,,,,,,,,,,,,,,,,,,,,,,,,,,,,,,,,,,33.8,15,23,175,45,,1016,3,,0,4,4,Balve,1,0,U1.000|6:03-U1.000|6:24-U1.000|5:56-U1.000|6:20-U1.000|7:32-U1.000|4:32-U1.000|5:00-U1.000|6:30-U1.000|5:29-U1.000|5:03-U1.000|4:07-U1.000|4:02-U1.000|4:11-U1.000|4:06-U1.000|5:21-U0.005|0:03,,"Balve Running",,,3113,,250,3,10875093836,0,168070,250480,30378,,48331865,,,,,,,,,,,,,,,,,,,,,,,,,,,,,,,,,,,,,,,,"3,4,4",
65612837,a7331129-e6be-4508-a9a9-40a75c97c476,1681237773,120,1681238847,,0,0,4.03,1090,1090,12,29,24,41,0,0,0.16,,1.05,,248,143,154,,,,65.77,42.69,65.67,1,59.01,932,66,,2.6,0,104,104,,,,,,25,80,13.17,13.39,13.27,-0.6,-4.6,318,318,,1,323,323,,,,,,,,,"0,0,2,10,44,34,10,0,0","2,20,78,0,0","0,1,26,72,2",,,,,139,,,,,,,,,,,,,,,,,,,,,,,,,,,,,,,,,,,,27.7,12,13,257,52,,1013,,,0,5,1,"Menden (Sauerland)",1,0,U1.000|4:42-U1.000|4:43-U1.000|4:25-U1.000|4:13-U0.026|0:07,,"Menden (Sauerland) Running",,,3113,,250,3,10883903706,0,168070,250480,30378,,48424735,,,,,,,,,,,,,,,,,,,,,,,,,,,,,,,,,,,,,,,,,
65612840,556371ad-a190-494c-807f-7a27b81705a7,1681239219,120,1681238848,,0,0,0.59,279,279,31,4,34,8,0,1.5,0.66,0.96,,348,50,129,145,,,,37.57,18.36,42.2,1,59.01,923,8,,0.6,0,,100,,,,,,4,66,8.93,10.81,13.81,12,28.5,220,220,,1,370,370,,,,,,,,,"79,0,1,0,2,1,3,2,11","0,87,13,0,0","18,51,10,5,16",,,,,96,,,,,,,,,,,,,,,,,,,,,,,,,,,,,,,,,,,,6.3,12,13,257,52,,1013,,,0,5,1,"Menden (Sauerland)",1,0,,,"Menden (Sauerland) Running",,,3113,,250,3,10883903762,0,168070,250480,30378,,48424737,,,,,,,,,,,,,,,,,,,,,,,,,,,,,,,,,,,,,,,,5,
65612842,6f821542-05f7-46d3-9f66-16a7320fb810,1681242211,120,1681238848,,0,0,3.27,1027,1027,26,20,49,43,0,0.1,0.26,1.06,,,208,134,142,,,,59.46,35.31,60.18,1,59.05,2592,37,,2.1,0,103,102,,,,,,17,79,11.57,11.52,11.63,1.8,3.1,274,274,,1,277,277,,,,,,,,,"1,4,13,60,17,4,0,0,0","0,99,1,0,0","0,0,88,12,0",,,,,121,,,,,,,,,,,,,,,,,,,,,,,,,,,,,,,,,,,,14.1,10,9,234,57,,1013,0,,0,4,4,"Menden (Sauerland)",1,0,U1.000|5:24-U1.000|5:12-U1.000|5:07-U0.273|1:25,,"Menden (Sauerland) Running",,,3113,,250,3,10883903939,0,168070,250480,30378,,48424739,,,,,,,,,,,,,,,,,,,,,,,,,,,,,,,,,,,,,,,,,
65612843,c7df54af-5901-4d65-9298-1728ec1c11e9,1681239609,120,1681238852,,0,0,8.03,2150,2150,0,2,0,1,0,0,0,,,,519,160,180,122,,,56.84,45.06,56.82,1,59.04,2304,241,,3.6,3,105,103,,,,,,83,84,13.45,15.15,15.14,14.7,0.3,339,339,,1,389,389,,,,,,,,,"25,4,3,2,1,2,25,38,0","0,21,16,63,0","11,11,12,5,60",,,,,133,,,,,,,,,,,,,,,,,,,,,,,,,,,,,,,,,,,,74.7,11,12,250,52,,1013,0,,0,3,4,"Menden (Sauerland)",1,0,U0.990|3:29-U1.000|3:31-U0.410|2:31-U1.010|3:29-U0.400|2:35-U1.010|3:32-U0.080|2:51-U1.010|3:24-U0.400|3:13-U1.010|3:32-U0.180|1:44-U0.510|1:42-U0.020|0:18,,"Menden (Sauerland) Track Running",,,3113,,250,3,10883903873,0,168070,250480,30378,,48424740,,,,,,,,,,,,,,,,,,,,,,,,,,,,,,,,,,,,,,,,,
65696024,40b4111d-6107-431a-b001-331a8dfa099c,1681323811,120,1681323774,,0,0,15.3,5040,5282,398,377,403,384,0,4.3,0.86,1.02,1.21,516,976,139,170,,,,53.51,37.06,55.32,1,59.03,1596,104,,3.1,0,98,98,,,,,,108,78,11.62,12.09,11.91,-7.5,-5.9,264,264,,1,271,271,,,,,,,,,"33,16,9,7,13,14,9,0,0","0,52,47,1,0","0,3,85,13,0",,,,,117,,,,,,,,,,,,,,,,,,,,,,,,,,,,,,,,,,,,32.8,8,15,254,80,,999,0,,0,6,4,Balve,1,0,U1.000|6:22-U1.000|7:02-U1.000|6:37-U1.000|6:51-U1.000|5:05-U1.000|4:45-U1.000|4:32-U1.000|5:32-U1.000|7:13-U1.000|6:13-U1.000|6:00-U1.000|4:37-U1.000|4:05-U1.000|4:01-U1.000|3:48-U0.302|1:18,,"Balve Running",,,3113,,250,3,10891177313,0,168070,250480,30378,,48499024,,,,,,,,,,,,,,,,,,,,,,,,,,,,,,,,,,,,,,,,"4,4",
65779364,81007b67-b360-445b-bf32-20cf20a117f5,1681412282,120,1681409974,,0,0,13.01,4050,4137,273,306,296,329,0,3.3,0.72,0.96,1.02,408,839,144,160,,,,54.77,39.08,56.02,1,59.02,1399,120,,3.3,0.1,99,100,,,,,,99,78,11.81,12.13,12.1,-2.8,-5.1,274,274,,1,285,285,,,,,,,,,"9,11,14,29,23,7,5,1,0","0,33,66,0,0","0,3,70,26,1",,,,,124,,,,,,,,,,,,,,,,,,,,,,,,,,,,,,,,,,,,34.5,9,6,255,68,,1007,0,,0,4,4,Balve,1,0,U1.000|5:49-U1.000|4:55-U1.000|5:23-U1.000|5:12-U1.000|5:19-U1.000|5:27-U1.000|5:21-U1.000|4:53-U1.000|5:39-U1.000|5:41-U1.000|3:48-U1.000|4:12-U1.000|5:45-U0.014|0:05,,"Balve Running",,,3113,,250,3,10897849616,0,168070,250480,30378,,48571220,,,,,,,,,,,,,,,,,,,,,,,,,,,,,,,,,,,,,,,,"4,5,5",
65850653,cf0c5c1b-5821-4c92-a1e8-bff2c1c7ab3d,1681497794,120,1681497407,,0,0,13.35,4150,4884,197,181,236,225,0,1.7,0.42,0.89,0.72,401,866,145,179,,,,54.36,39.23,55.43,1,59.02,1728,202,,3.7,2.2,97,100,,,,,,113,77,11.78,13.71,13.91,16.1,-5.4,283,283,,1,354,354,,,,,,,,,"20,11,9,13,17,7,9,14,0","3,36,43,18,0","11,10,36,25,18",,,,,125,,,,,,,,,,,,,,,,,,,,,,,,,,,,,,,,,,,,70.3,11,5,61,60,,1008,0,,0,3,4,Balve,1,0,U1.000|5:26-U1.000|5:16-U1.000|4:46-U1.000|4:48-U1.000|4:21-U0.330|1:37-U0.576|2:01-U0.520|2:00-U0.302|1:01-U0.200|2:01-U0.543|2:01-U0.510|2:01-U0.302|1:00-U0.205|2:02-U0.540|2:01-U0.484|2:03-U0.298|1:02-U0.153|2:01-U0.530|2:01-U0.476|2:03-U0.304|1:03-U1.000|7:17-U1.000|7:42-U0.081|1:36,,"Balve Running",,,3113,,250,3,10904403530,0,168070,250480,30378,,48629340,,,,,,,,,,,,,,,,,,,,,,,,,,,,,,,,,,,,,,,,"5,5",
65879388,b54b03b4-0e2c-4d74-83c9-8cf60c482da7,1681552789,120,1681549967,,0,0,13,4061,4292,244,233,256,247,0,2.5,0.66,0.98,1.05,325,848,144,160,,,,54.54,38.92,55.86,1,59,1598,124,,3.3,0,99,98,,,,,,103,79,11.78,11.82,11.98,0.2,4.3,276,276,,1,284,284,,,,,,,,,"9,8,12,26,33,11,0,0,0","1,31,68,0,0","0,1,76,23,0",,,,,122,,,,,,,,,,,,,,,,,,,,,,,,,,,,,,,,,,,,39.5,8,14,5,74,,1011,2,,0,4,4,Balve,1,0,U1.000|5:27-U1.000|4:41-U1.000|5:10-U1.000|5:09-U1.000|5:18-U1.000|5:34-U1.000|5:21-U1.000|5:01-U1.000|5:36-U1.000|5:42-U1.000|4:22-U1.000|4:37-U1.000|5:41-U0.004|0:01,,"Balve Running",,,3113,,250,3,10907299012,0,168070,250480,30378,,48653091,,,,,,,,,,,,,,,,,,,,,,,,,,,,,,,,,,,,,,,,"4,5,5",
65956338,cddd1044-28e4-486b-90c9-3af9970ef48e,1681646215,120,1681646036,,0,0,20.01,6323,6564,513,494,528,512,0,4.6,0.84,0.96,1.12,557,1343,143,165,,,,54.27,39.75,56.06,1,58.98,1881,179,,3.8,0,98,99,,,,,,152,80,12.04,12.15,12.24,-10.3,-3.4,278,278,,1,283,283,,,,,,,,,"17,14,15,13,13,23,3,0,0","0,34,65,1,0","0,1,78,21,0",,,,,119,,,,,,,,,,,,,,,,,,,,,,,,,,,,,,,,,,,,40.3,9,14,353,82,,1022,3,,0,4,4,Balve,1,0,U1.000|6:06-U1.000|6:19-U1.000|5:54-U1.000|6:22-U1.000|6:18-U1.000|4:31-U1.000|5:23-U1.000|4:53-U1.000|4:26-U1.000|5:49-U1.000|5:13-U1.000|4:52-U1.000|5:46-U1.000|6:27-U1.000|4:36-U1.000|4:22-U1.000|4:19-U1.000|4:17-U1.000|4:22-U1.000|5:06-U0.007|0:02,,"Balve Running",,,3113,,250,3,10915743557,0,168070,250480,30378,,48724305,,,,,,,,,,,,,,,,,,,,,,,,,,,,,,,,,,,,,,,,"4,4",
66033494,b7f0a0a8-5b21-42ea-a816-8d5c6efadb98,1681737186,120,1681733977,,0,0,13.01,3866,3942,240,253,275,287,0,2.6,0.63,0.97,1.04,260,849,150,167,,,,54.86,41.26,56.04,1,58.99,1728,149,,3.6,0,100,100,,,,,,107,79,12.32,12.34,12.41,1.9,4.5,291,291,,1,295,295,,,,,,,,,"5,7,9,19,36,23,1,0,0","0,13,75,12,0","0,0,65,35,0",,,,,128,,,,,,,,,,,,,,,,,,,,,,,,,,,,,,,,,,,,49.1,12,17,48,57,,1026,3,,0,4,4,Balve,1,0,U1.000|5:21-U1.000|4:29-U1.000|5:00-U1.000|4:56-U1.000|4:55-U1.000|5:01-U1.000|4:54-U1.000|4:38-U1.000|5:11-U1.000|5:26-U1.000|4:16-U1.000|4:34-U1.000|5:43-U0.006|0:01,,"Balve Running",,,3113,,250,3,10922593834,0,168070,250480,30378,,48791814,,,,,,,,,,,,,,,,,,,,,,,,,,,,,,,,,,,,,,,,"4,5,5",
66101517,2d86cf9b-f5c0-4c36-ab92-4d1e218ef613,1681830314,120,1681826018,,0,0,19.9,2416,2416,404,333,512,370,0,3.5,0.68,,,842,250,,,,,,,,,1,,,,,,,,,150,,,,,30,70,,48.06,,,,104,103,,0,125,125,,,,,,,,,"8,27,19,13,11,4,18",,"58,39,3,0,0",,,,,,,,,,,,,,,,,,,,,,,,,,,,,,,,,,,,,,,,,,,,,,,,,,0,1,,,1,1,,,,,,315-0,,,7,,0,168072,,30378,,48852167,,,,,,,,,,,,,,,,,,,,,,,,,,,,,,,,,,,,,,,,"4,4,5",
66122719,e3a82b91-d11b-4320-b68c-93e7b3005626,1681842704,120,1681842301,,0,0,4.11,1203,1566,34,35,48,50,0,0,0.08,1.21,,,264,143,161,,,,59.65,38.97,60.24,1,59.01,932,65,,2.6,0,104,101,,,,,,29,78,12.35,12.89,13.08,11.6,-1.4,297,297,,1,324,324,,,,,,,,,"12,0,0,3,52,30,1,1,1","2,24,74,0,0","3,7,23,64,2",,,,,131,,,,,,,,,,,,,,,,,,,,,,,,,,,,,,,,,,,,32.2,13,16,58,63,,1026,0,,0,3,4,Fröndenberg,1,0,U1.000|4:30-U1.000|4:36-U1.000|4:36-U1.000|5:47-U0.108|0:35,,"Fröndenberg/Ruhr Running",,,3113,,250,3,10932383483,0,168070,250480,30378,,48871910,,,,,,,,,,,,,,,,,,,,,,,,,,,,,,,,,,,,,,,,,
66122769,11a105ea-d3f6-4fac-9c5e-80b01cdbc1a1,1681844313,120,1681842351,,0,0,7.77,2242,2242,0,7,5,12,0,0,0,,,,544,163,186,,,,50.4,41.18,50.35,1,59.01,3936,279,,3.7,3.3,97,100,,,,,,89,83,12.45,14.19,14.16,14.1,-5.8,308,308,,1,362,362,,,,,,,,,"39,4,5,4,3,2,6,20,16","0,14,21,56,9","10,22,18,13,36",,,,,125,,,,,,,,,,,,,,,,,,,,,,,,,,,,,,,,,,,,84.2,12,17,60,62,,1026,0,,0,3,4,Frondenberg/Ruhr,1,0,U0.980|3:24-U0.390|2:22-U0.210|0:34-U0.090|0:42-U0.200|0:36-U0.110|0:41-U0.200|0:37-U0.100|0:44-U0.190|0:36-U0.100|0:38-U0.210|0:36-U0.410|2:57-U0.200|0:36-U0.090|0:39-U0.200|0:35-U0.100|0:41-U0.210|0:36-U0.100|0:41-U0.200|0:36-U0.100|0:41-U0.200|0:36-U0.400|4:01-U0.210|0:35-U0.090|0:41-U0.200|0:35-U0.110|0:42-U0.200|0:36-U0.100|0:42-U0.200|0:35-U0.100|0:43-U0.200|0:36-U0.330|3:33-U1.000|3:09-U0.040|0:48,,"Fröndenberg/Ruhr Track Running",,,3113,,250,3,10932391199,0,168070,250480,30378,,48871958,,,,,,,,,,,,,,,,,,,,,,,,,,,,,,,,,,,,,,,,,
66122775,2d7ee810-bea8-4d28-8e71-876bdb9622c6,1681846992,120,1681842361,,0,0,2.88,888,899,37,20,43,25,0,0.3,0.28,1.45,,,195,157,174,,,,49.11,35.74,50.25,1,59.01,4320,47,,2.3,0,,100,,,,,,29,80,11.89,11.67,12.69,7.1,21.6,286,286,,1,313,313,,,,,,,,,"2,2,8,49,39,1,0,0,0","1,5,57,37,0","0,1,86,5,8",,,,,122,,,,,,,,,,,,,,,,,,,,,,,,,,,,,,,,,,,,47.8,12,15,60,63,,1026,0,,0,2,4,Frondenberg/Ruhr,1,0,U1.000|5:10-U1.000|5:18-U0.876|4:21,,"Fröndenberg/Ruhr Running",,,3113,,250,3,10932392916,0,168070,250480,30378,,48871964,,,,,,,,,,,,,,,,,,,,,,,,,,,,,,,,,,,,,,,,,
66181653,06db3e1a-08a2-4f7d-8a36-f66e2fa27d7d,1681926525,120,1681924662,,0,0,15.31,4631,4902,426,396,449,432,0,4.7,0.85,0.99,1.08,543,1007,145,162,95,,,56.22,40.94,58.3,1,59.01,3744,156,,3.6,0,100,100,,,,,,92,79,12.67,12.64,12.91,1.8,5.6,295,295,,1,304,304,,,,,,,,,"10,16,14,13,9,27,10,0,0","0,24,76,0,0","0,1,56,42,1",,,,,126,,,,,,,,,,,,,,,,,,,,,,,,,,,,,,,,,,,,28.9,11,19,40,44,,1023,0,,0,3,4,Balve,1,0,U1.000|5:53-U1.000|6:14-U1.000|5:45-U1.000|6:03-U1.000|4:36-U1.000|4:11-U1.000|4:00-U1.000|4:58-U1.000|6:33-U1.000|5:34-U1.000|5:16-U1.000|4:26-U1.000|4:11-U1.000|4:10-U1.000|4:06-U0.308|1:16,,"Balve Running",,,3113,,250,3,10939056471,0,168070,250480,30378,,48926060,,,,,,,,,,,,,,,,,,,,,,,,,,,,,,,,,,,,,,,,"4,4,4",
66258621,101192f2-955e-4ec3-9239-9f9da9a8d522,1682017938,120,1682015333,,0,0,12.68,4112,4501,182,187,215,223,0,2.1,0.56,0.98,1.04,421,835,142,158,,,,53.05,37.18,53.97,1,59,2454,117,,3.3,0,97,98,,,,,,96,78,11.32,11.45,11.54,-2,-4.2,263,263,,1,272,272,,,,,,,,,"10,9,22,25,28,5,1,0,0","0,34,66,0,0","1,2,84,12,0",,,,,119,,,,,,,,,,,,,,,,,,,,,,,,,,,,,,,,,,,,32.5,7,12,73,73,,1016,0,,0,4,4,Balve,1,0,U1.000|5:30-U1.000|5:44-U1.000|5:04-U1.000|4:43-U1.000|5:48-U1.000|5:12-U1.000|6:17-U1.000|4:59-U1.000|5:01-U1.000|5:04-U1.000|5:40-U1.000|5:17-U0.676|4:14,,"Balve Running",,,3113,,250,3,10946580010,0,168070,250480,30378,,48989922,,,,,,,,,,,,,,,,,,,,,,,,,,,,,,,,,,,,,,,,5,
66319327,eb47f3fd-1da9-48cb-9e2d-e242de9391ad,1682103157,120,1682100995,,0,0,7.89,2888,3175,255,207,260,216,0,3.8,0.92,,,551,512,126,144,82,,,53.02,31.1,55.55,1,58.98,1178,55,,2.4,0,99,98,,,,,,44,77,10.64,10.2,10.92,-4.6,14.9,242,242,,1,252,252,,,,,,,,,"42,13,12,19,12,0,0,0,0","2,95,3,0,0","0,17,74,9,0",,,,,106,,,,,,,,,,,,,,,,,,,,,,,,,,,,,,,,,,,,18.4,14,9,130,72,,1011,0,,0,3,4,Balve,1,0,U1.000|6:48-U1.000|7:08-U1.000|6:36-U1.000|7:08-U1.000|4:59-U1.000|5:16-U1.000|5:19-U0.887|4:55,,"Balve Running",,,3113,,250,3,10953142497,0,168070,250480,30378,,49046062,,,,,,,,,,,,,,,,,,,,,,,,,,,,,,,,,,,,,,,,"4,4,5",
66354317,ed7e8b7e-4c98-46a2-af45-c314b0e1ffbc,1682160479,120,1682158856,,0,0,17.32,5371,5447,448,445,488,485,0,4.1,0.7,0.98,1.06,593,1167,150,176,,,,52.04,40.17,53.72,1,58.97,2167,197,,3.9,0.8,99,99,,,,,,119,79,12.14,12.06,12.34,-5.5,-2,282,282,,1,291,291,,,,,,,,,"14,11,10,19,27,19,2,0,0","0,12,80,7,0","0,2,68,28,1",,,,,122,,,,,,,,,,,,,,,,,,,,,,,,,,,,,,,,,,,,44.1,16,16,163,59,,1008,3,,0,4,4,Balve,1,0,U1.000|5:40-U1.000|4:43-U1.000|5:09-U1.000|5:09-U1.000|5:13-U1.000|5:24-U1.000|5:58-U1.000|6:48-U1.000|5:49-U1.000|4:46-U1.000|5:01-U1.000|4:25-U1.000|4:28-U1.000|4:23-U1.000|4:24-U1.000|5:25-U1.000|5:13-U0.315|1:32,,"Balve Running",,,3113,,250,3,10956891406,0,168070,250480,30378,,49079165,,,,,,,,,,,,,,,,,,,,,,,,,,,,,,,,,,,,,,,,"3,5,5",
66427151,044b6ea4-b7a3-455d-b973-f16cd6387a3e,1682252103,120,1682250432,,0,0,20.1,5240,5359,136,150,218,233,0,0.1,0.19,,,302,1272,159,176,,,,59.29,49.71,59.74,1,59,4320,301,,4.9,0.7,102,100,,,,,,192,80,13.79,14.01,14.09,5,1.9,340,340,,1,350,350,,,,,,,,,"2,0,1,3,21,56,17,1,0","0,2,56,42,0","1,0,5,86,7",,,,,144,,,,,,,,,,,,,,,,,,,,,,,,,,,,,,,,,,,,77,15,16,205,62,,1007,3,,0,4,4,Sundern,1,0,U1.000|4:29-U1.000|4:20-U1.000|4:24-U1.000|4:28-U1.000|4:19-U1.000|4:18-U1.000|4:11-U1.000|4:19-U1.000|4:09-U1.000|4:11-U1.000|4:26-U1.000|4:15-U1.000|4:19-U1.000|4:13-U1.000|4:15-U1.000|4:11-U1.000|4:10-U1.000|4:08-U1.000|4:15-U1.000|4:27-U0.095|1:32,,"Sundern (Sauerland) Running",,,3113,,250,3,10965074307,0,168070,250480,30378,,49141908,,,,,,,,,,,,,,,,,,,,,,,,,,,,,,,,,,,,,,,,5,
66504274,a7524151-afb0-410d-8eb2-e48972966004,1682361214,120,1682358092,,0,0,12.96,3856,4009,248,256,266,272,0,2.5,0.64,0.99,1.09,360,813,142,158,,,,59,41.19,60.36,1,59.01,2592,120,,3.3,0,101,101,,,,,,98,79,12.36,12.67,12.57,-2,-1.2,292,292,,1,299,299,,,,,,,,,"8,9,8,22,31,14,8,1,0","1,34,65,0,0","0,1,58,41,0",,,,,128,,,,,,,,,,,,,,,,,,,,,,,,,,,,,,,,,,,,35.1,9,16,273,72,,1008,0,,0,4,4,Balve,1,0,U1.000|5:27-U1.000|4:39-U1.000|5:06-U1.000|5:04-U1.000|5:00-U1.000|5:20-U1.000|4:57-U1.000|4:38-U1.000|5:27-U1.000|5:24-U1.000|3:46-U1.000|4:01-U0.959|5:27,,"Balve Running",,,3113,,250,3,10973898584,0,168070,250480,30378,,49212132,,,,,,,,,,,,,,,,,,,,,,,,,,,,,,,,,,,,,,,,"5,5",
66577343,fd146d61-a9f9-46b4-9b40-1d86ac7fe5ae,1682447323,120,1682441320,,0,0,4.04,1139,1139,18,21,28,31,0,0,0.13,1.1,,,257,142,154,,,,63.06,40.68,63.35,1,59.05,1280,63,,2.6,0,105,99,,,,,,27,79,12.75,12.8,12.83,11.9,14.8,308,308,,1,311,311,,,,,,,,,"1,1,0,6,75,17,0,0,0","2,13,85,0,0","0,0,39,61,0",,,,,135,,,,,,,,,,,,,,,,,,,,,,,,,,,,,,,,,,,,29.3,9,16,314,59,,1016,0,,0,3,4,Frondenberg/Ruhr,1,0,U1.000|4:45-U1.000|4:37-U1.000|4:37-U1.000|4:46-U0.041|0:13,,"Fröndenberg/Ruhr Running",,,3113,,250,3,10980535075,0,168070,250480,30378,,49277100,,,,,,,,,,,,,,,,,,,,,,,,,,,,,,,,,,,,,,,,,
66581536,84133e45-8119-4e90-b684-9104b534d2fb,1682448823,120,1682443799,,0,0,2.33,826,1020,34,21,47,33,0,0.3,0.29,1.04,0.13,,163,136,153,,,,50.26,29.83,51.51,1,59.05,1258,31,,2,0,,100,,,,,,17,79,10.3,13.79,14.19,26.9,1,248,248,,1,371,371,,,,,,,,,"51,15,5,2,2,2,4,8,10","2,60,38,0,0","15,20,41,6,18",,,,,107,,,,,,,,,,,,,,,,,,,,,,,,,,,,,,,,,,,,20.2,8,15,314,59,,1016,0,,0,3,4,Fröndenberg,1,0,U0.688|3:35-U0.335|1:45-U0.320|2:03-U0.707|3:39-U0.276|2:45,,"Fröndenberg/Ruhr Running",,,3113,,250,3,10980890098,0,168070,250480,30378,,49281132,,,,,,,,,,,,,,,,,,,,,,,,,,,,,,,,,,,,,,,,,
66585406,2dcade49-82c6-468d-8a80-6a0ebb209850,1682449877,120,1682445962,,0,0,6.95,1991,1991,4,11,4,11,0,0,0.03,,,,447,151,176,100,,,56.86,41.25,56.83,1,59.05,2912,170,,3.2,2.5,95,106,,,,,,61,81,12.53,14.31,14.27,12.1,0,309,309,,1,365,365,,,,,,,,,"40,6,4,2,2,2,8,36,3","0,28,33,39,0","9,26,15,9,41",,,,,129,,,,,,,,,,,,,,,,,,,,,,,,,,,,,,,,,,,,53.8,7,14,314,67,,1016,0,,0,3,4,Frondenberg/Ruhr,1,0,U0.390|1:19-U0.200|1:11-U0.410|1:17-U0.200|1:15-U0.410|1:17-U0.400|3:05-U0.400|1:17-U0.200|1:25-U0.400|1:19-U0.200|1:18-U0.400|1:17-U0.400|3:07-U0.400|1:20-U0.200|1:18-U0.400|1:16-U0.200|1:20-U0.400|1:16-U0.270|3:21-U1.010|3:30-U0.060|0:44,,"Fröndenberg/Ruhr Track Running",,,3113,,250,3,10981207894,0,168070,250480,30378,,49284764,,,,,,,,,,,,,,,,,,,,,,,,,,,,,,,,,,,,,,,,,
66585422,cf8af1e7-5f80-4097-9c15-3b256c9c29ce,1682452202,120,1682445970,,0,0,2.81,840,840,18,4,21,8,0,0,0.17,1.19,,,182,140,149,,,,59.76,36.97,60.61,1,59.06,3744,42,,2.2,0,100,102,,,,,,18,80,12.23,12.09,12.46,-5.4,-12.7,295,295,,1,304,304,,,,,,,,,"1,1,5,37,50,6,0,0,0","0,48,52,0,0","0,0,77,23,0",,,,,125,,,,,,,,,,,,,,,,,,,,,,,,,,,,,,,,,,,,21.5,6,13,314,67,,1016,0,,0,3,4,Frondenberg/Ruhr,1,0,U1.000|5:11-U1.000|4:50-U0.808|3:59,,"Fröndenberg/Ruhr Running",,,3113,,250,3,10981209384,0,168070,250480,30378,,49284774,,,,,,,,,,,,,,,,,,,,,,,,,,,,,,,,,,,,,,,,,
66670820,8f32e3b9-bf5d-488f-8a30-a9e0cf641c00,1682533806,120,1682532177,,0,0,14.05,4298,5143,418,363,419,369,0,4.6,0.87,1.03,1.06,522,918,145,172,104,,,55.45,40.13,57.76,1,59.05,2739,141,,3.5,0,99,99,,,,,,109,79,12.63,12.58,12.99,-1.5,11.3,295,295,,1,306,306,,,,,,,,,"18,16,12,9,11,23,11,1,0","1,23,68,8,0","0,2,55,41,2",,,,,124,,,,,,,,,,,,,,,,,,,,,,,,,,,,,,,,,,,,51.7,7,7,333,59,,1019,0,,0,4,4,Balve,1,0,U1.000|5:57-U1.000|6:28-U1.000|5:59-U1.000|6:10-U1.000|6:02-U1.000|5:26-U1.000|4:57-U1.000|5:13-U1.000|4:47-U1.000|4:11-U1.000|3:59-U1.000|4:03-U1.000|4:00-U1.000|4:12-U0.048|0:14,,"Balve Running",,,3113,,250,3,10988260197,0,168070,250480,30378,,49363632,,,,,,,,,,,,,,,,,,,,,,,,,,,,,,,,,,,,,,,,"3,4",
66770482,,1682593560,120,1682672884,1682672972,0,0,18,5400,5400,450,450,450,450,0,,,,,,1256,,,,,,,41.87,,1,,,,,,,,,,,,,,127,,,,,,,,,,,,,,,,,,,,,,,,,,,,,,,,,,,,,,,,,,,,,,,,,,,,,,,,,,,,,,,,,,,,,,,,,,1,,,0,0,,,Run,,,connect,,,3,10998678966,0,168070,250480,30378,,49453267,,,,,,,,,,,,,,,,,,,,,,,,,,,,,,,,,,,,,,,,,
66790773,94452662-8feb-417e-8618-977af8ecbeb4,1682697839,120,1682695999,,0,0,13.41,4112,5017,248,213,287,254,0,2.7,0.55,0.99,1.04,461,856,142,159,,,,56.85,39.87,58.33,1,59.05,1280,111,,3.2,0,100,100,,,,,,97,79,12.07,11.99,12.41,3.1,-3.5,286,286,,1,300,300,,,,,,,,,"8,5,13,26,32,15,0,0,0","0,33,67,0,0","0,1,66,31,2",,,,,124,,,,,,,,,,,,,,,,,,,,,,,,,,,,,,,,,,,,31,16,13,251,79,,1010,2,,0,4,4,Balve,1,0,U1.000|5:08-U1.000|5:19-U1.000|4:46-U1.000|4:38-U1.000|5:36-U1.000|4:48-U1.000|5:30-U1.000|5:01-U1.000|4:49-U1.000|4:44-U1.000|5:02-U1.000|5:42-U1.000|5:07-U0.410|2:22,,"Balve Running",,,3113,,250,3,11000813327,0,168070,250480,30378,,49471245,,,,,,,,,,,,,,,,,,,,,,,,,,,,,,,,,,,,,,,,"5,5,5,5,5",
66876915,,1682798520,120,1682802158,,0,0,13,3900,3900,,,,,0,,,,,,835,,,,,,,40.8,,1,,,,,,,,,,,,,,92,,,,,,,,,,,,,,,,,,,,,,,,,,,,,,,,,,,,,,,,,,,,,,,,,,,,,,,,,,,,,,,,,,,,,,,,,,1,,,0,0,,,Laufen,,,connect,,,3,11009688471,0,168070,250480,30378,,49547415,,,,,,,,,,,,,,,,,,,,,,,,,,,,,,,,,,,,,,,,,
66911648,cbc28770-d47e-4138-99e5-9d1e81d20faa,1682851587,120,1682849473,,0,0,15.13,3763,3780,89,97,148,155,0,0,0.17,,,,942,166,181,,,,58.88,51.32,59.27,1,59.07,3744,325,,4.8,2.2,102,98,,,,,,153,81,14.47,14.79,14.8,3.7,-1,359,359,,1,372,372,,,,,,,,,"0,1,1,4,17,38,33,6,0","0,1,18,80,1","0,0,11,71,18",,,,,149,,,,,,,,,,,,,,,,,,,,,,,,,,,,,,,,,,,,99.4,12,8,47,65,,1024,4,,0,2,4,Sundern,1,0,U1.000|4:05-U1.000|4:03-U1.000|4:08-U1.000|4:13-U1.000|4:09-U1.000|4:04-U1.000|4:02-U1.000|3:56-U1.000|3:56-U1.000|4:02-U1.000|4:45-U1.000|4:24-U1.000|3:33-U1.000|3:46-U1.000|4:59-U0.127|0:36,,"Sundern (Sauerland) Running",,,3113,,250,3,11012604504,0,168070,250480,30378,,49578438,,,,,,,,,,,,,,,,,,,,,,,,,,,,,,,,,,,,,,,,,
66927457,c66e23bb-0260-4972-a5d3-2f1809fa324e,1682867908,120,1682861960,,0,0,1.39,1216,1216,20,16,22,18,0,0.9,0.56,,,,70,,,,,,,,,1,59.07,3516,3,,0.1,0,,100,,,,,,16,57,,4.37,,,,,,,,,,,,,,,,,,"97,3,0,0,0,0",,,,,,,,,,,,,,,,,,,,,,,,,,,,,,,,,,,,,,,,,,,,16,11,45,53,,1021,4,,0,3,4,Balve,1,0,,,"Balve Hiking",,,3113,,250,3,11014309976,0,168075,,30378,,49591315,,,,,,,,,,,,,,,,,,,,,,,,,,,,,,,,,,,,,,,,,
67027903,,1682926440,120,1683005723,,0,0,13,4140,4140,,,,,0,,,,,,886,,,,,,,38.05,,1,,,,,,,,,,,,,,98,,,,,,,,,,,,,,,,,,,,,,,,,,,,,,,,,,,,,,,,,,,,,,,,,,,,,,,,,,,,,,,,,,,,,,,,,,1,,,0,0,,,Run,,,connect,,,3,11026146695,0,168070,250480,30378,,49682983,,,,,,,,,,,,,,,,,,,,,,,,,,,,,,,,,,,,,,,,,
67054502,529528c9-fe4a-4bc8-875b-1506cf263ee7,1683039850,120,1683032696,,0,0,0.14,39,39,11,0,0,0,0,1.4,1,,,,1,,,,,,,,,1,,,,,,,,,150,,,,,0,58,,13.11,,,,44,36,,0,47,44,,,,,,,,,"85,15,0,0,0,0,0",,"100,0,0,0,0",,,,,,,,,,,,,,,,,,,,,,,,,,,,,,,,,,,,,,,,,,,,,,,,,,0,1,,,1,1,U0.043|0:14-U0.100|0:25,,,,,315-0,,,7,,0,168072,,30378,,49704225,,,,,,,,,,,,,,,,,,,,,,,,,,,,,,,,,,,,,,,,,
67056485,9cf2fb6e-fd6a-4be5-8f30-a5df3859a068,1683039925,120,1683035804,,0,0,14.87,1884,1884,8,12,36,23,0,0,0,,,,115,76,94,,,,,,,1,,,,,,,,,150,,,,,6,73,,28.62,,,,62,61,,0,66,66,,,,,,,,,"0,0,2,68,26,4,0","100,0,0,0,0","96,3,0,0,0",,,,,,,,,,,,,,,,,,,,,,,,,,,,,,,,,,,,,,,,,0.5,,,,,,,,,0,1,,,1,1,U7.161|15:27-U7.709|15:57,,,,,315-0,,,7,,0,168072,,30378,,49706080,,,,,,,,,,,,,,,,,,,,,,,,,,,,,,,,,,,,,,,,,
67079211,fb82eae1-3fde-41f7-a9a1-7c6f3c994b42,1683052253,120,1683052823,,0,0,4.04,1143,1143,30,34,36,40,0,0,0.26,,0.9,,266,142,151,97,,,62.79,40.51,63.29,1,59.12,1106,73,,2.8,0,104,102,,,,,,25,79,12.74,12.78,12.79,6.6,9.8,307,307,,1,309,309,,,,,,,,,"0,1,1,12,65,21,0,0,0","1,28,71,0,0","0,0,29,71,0",,,,,134,,,,,,,,,,,,,,,,,,,,,,,,,,,,,,,,,,,,26.1,11,7,345,60,,1027,0,,0,3,4,Fröndenberg,1,0,U1.000|4:51-U1.000|4:43-U1.000|4:39-U1.000|4:36-U0.044|0:13,,"Fröndenberg/Ruhr Running",,,3113,,250,3,11030907686,0,168070,250480,30378,,49727129,,,,,,,,,,,,,,,,,,,,,,,,,,,,,,,,,,,,,,,,,
67079212,0234eb90-e569-4b62-98cb-668ea9ab7e99,1683055417,120,1683052823,,0,0,5.33,1702,1702,36,25,73,61,0,0,0.16,1.2,,,352,139,153,99,,,55.6,35.71,56.21,1,59.11,1879,56,,2.5,0,100,99,,,,,,35,78,11.37,11.33,11.59,-0.7,5,269,269,,1,277,277,,,,,,,,,"2,2,16,71,10,1,0,0,0","0,58,42,0,0","0,0,93,6,1",,,,,120,,,,,,,,,,,,,,,,,,,,,,,,,,,,,,,,,,,,22,11,8,359,59,,1027,0,,0,3,4,Frondenberg/Ruhr,1,0,U1.000|5:08-U1.000|5:12-U1.000|5:30-U1.000|5:24-U1.000|5:19-U0.334|1:50,,"Fröndenberg/Ruhr Running",,,3113,,250,3,11030907890,0,168070,250480,30378,,49727130,,,,,,,,,,,,,,,,,,,,,,,,,,,,,,,,,,,,,,,,,
67079213,c9ad419d-6355-471f-b53e-e4914fb7706b,1683053787,120,1683052823,,0,0,4.41,1348,1348,0,0,0,8,0,0,0,,,,281,144,173,,,,56.02,37.19,56.02,1,59.12,1396,94,,2.5,2,100,100,,,,,,33,80,11.78,14.26,14.26,24.6,5.7,290,290,,1,370,370,,,,,,,,,"43,13,3,1,1,1,3,21,13","1,50,30,20,0","15,22,23,7,34",,,,,123,,,,,,,,,,,,,,,,,,,,,,,,,,,,,,,,,,,,32.5,11,7,355,60,,1027,0,,0,3,4,Frondenberg/Ruhr,1,0,U0.190|0:36-U0.200|1:15-U0.300|0:53-U0.200|1:21-U0.190|0:34-U0.420|3:00-U1.000|3:10-U0.410|3:17-U0.400|1:17-U0.460|4:26-U0.600|1:48-U0.040|0:49,,"Fröndenberg/Ruhr Track Running",,,3113,,250,3,11030907790,0,168070,250480,30378,,49727131,,,,,,,,,,,,,,,,,,,,,,,,,,,,,,,,,,,,,,,,,
67146623,a3c97efd-3217-4333-95af-ca8a1a6f7bf9,1683137888,120,1683136867,,0,0,16.18,4893,5141,443,423,453,442,0,4.5,0.85,1.05,1.19,552,1008,142,179,,,,57.83,41.13,59.88,1,59.12,1585,144,,3.5,0.4,100,100,,,,,,112,80,12.72,14.15,13.67,-6.4,-12.5,295,295,,1,317,317,,,,,,,,,"21,13,17,12,10,11,2,13,2","0,60,26,13,0","0,2,62,31,6",,,,,124,,,,,,,,,,,,,,,,,,,,,,,,,,,,,,,,,,,,68.6,14,10,51,53,,1025,1,,0,2,4,Balve,1,0,U1.000|6:09-U1.000|6:26-U1.000|6:06-U1.000|6:38-U1.000|4:50-U1.000|4:26-U1.000|4:23-U1.000|5:30-U1.000|6:50-U1.000|5:39-U1.000|5:19-U0.448|2:06-U1.000|3:15-U1.000|3:20-U1.000|3:11-U1.000|3:08-U0.735|4:17,,"Balve Running",,,3113,,250,3,11038197637,0,168070,250480,30378,,49787086,,,,,,,,,,,,,,,,,,,,,,,,,,,,,,,,,,,,,,,,"4,4",
67207342,af686754-976f-4ec3-a2fc-80e4dcb8dff0,1683223415,120,1683217089,,0,0,1.37,570,793,10,21,14,29,0,1,0.54,0.87,1.13,,90,119,131,,,,48.32,23.48,48.28,1,59.12,234,12,,0.8,0,,100,,,,,,6,76,8.64,9.3,9,-8.3,-3.1,186,186,,1,197,197,,,,,,,,,"56,15,16,10,3,1,0,0,0","5,95,0,0,0","0,60,40,0,0",,,,,95,,,,,,,,,,,,,,,,,,,,,,,,,,,,,,,,,,,,5.8,20,11,144,44,,1017,1,,0,4,4,Balve,1,0,U1.000|7:20-U0.372|2:10,,"Balve Running",,,3113,,250,3,11044758449,0,168070,250480,30378,,49841142,,,,,,,,,,,,,,,,,,,,,,,,,,,,,,,,,,,,,,,,,
67217240,6254a365-a9c0-41ee-9fa2-8333188ccf61,1683224582,120,1683222748,,0,0,12.52,3998,5096,298,273,331,306,0,3.2,0.64,0.97,1.03,416,807,141,170,,,,54.58,37.82,56.32,1,59.11,1344,100,,3.1,0,100,99,,,,,,57,78,11.59,11.72,12.04,-5.1,-16.7,271,271,,1,289,289,,,,,,,,,"14,9,15,24,27,8,2,0,0","0,45,53,2,0","0,3,82,13,2",,,,,120,,,,,,,,,,,,,,,,,,,,,,,,,,,,,,,,,,,,16.2,18,10,143,48,,1017,0,,0,4,4,Balve,1,0,U1.000|5:18-U1.000|4:55-U1.000|5:17-U1.000|5:28-U1.000|5:19-U1.000|5:51-U1.000|5:13-U1.000|5:22-U1.000|5:51-U1.000|5:13-U1.000|4:21-U1.000|5:01-U0.520|3:30,,"Balve Running",,,3113,,250,3,11045560251,0,168070,250480,30378,,49850137,,,,,,,,,,,,,,,,,,,,,,,,,,,,,,,,,,,,,,,,"4,5,5",
67217533,,1683229735,120,1683222821,,0,0,0.5,180,180,,,,,0,,,,,,34,,,,,,,24.93,,1,,,,,,,,,,,,,,3,,,,,,,,,,,,,,,,,,,,,,,,,,,,,,,,,,,,,,,,,,,,,,,,,,,,,,,,,,,,,,,,,,,,,,,,,,1,,,0,0,,,Run,,,connect,,,3,11045559479,0,168070,250480,30378,,49850418,,,,,,,,,,,,,,,,,,,,,,,,,,,,,,,,,,,,,,,,,
67270148,86dc499b-c0bd-4188-83c8-1275d19a86b0,1683294749,120,1683292111,,0,0,13.5,4349,4485,323,312,344,337,0,3.6,0.74,0.97,1.06,438,889,142,160,,,,53.49,37.66,55.13,1,59.09,1407,120,,3.3,0,103,98,,,,,,51,79,11.75,11.78,11.86,-6.9,2.7,271,271,,1,274,274,,,,,,,,,"20,14,15,14,18,19,1,0,0","0,38,61,0,0","0,3,81,16,0",,,,,118,,,,,,,,,,,,,,,,,,,,,,,,,,,,,,,,,,,,13.3,18,10,258,66,,1017,4,,0,4,4,Balve,1,0,U1.000|5:03-U1.000|5:14-U1.000|6:40-U1.000|6:15-U1.000|6:17-U1.000|6:10-U1.000|5:01-U1.000|4:32-U1.000|4:18-U1.000|4:17-U1.000|4:28-U1.000|5:51-U1.000|5:55-U0.498|2:29,,"Balve Running",,,3113,,250,3,11050742640,0,168070,250480,30378,,49897966,,,,,,,,,,,,,,,,,,,,,,,,,,,,,,,,,,,,,,,,"4,5",
67375610,,1683368280,120,1683447549,,0,0,13,3900,3900,,,,,0,,,,,,835,,,,,,,40.8,,1,,,,,,,,,,,,,,46,,,,,,,,,,,,,,,,,,,,,,,,,,,,,,,,,,,,,,,,,,,,,,,,,,,,,,,,,,,,,,,,,,,,,,,,,,1,,,0,0,,,Run,,,connect,,,3,11062645511,0,168070,250480,30378,,49993260,,,,,,,,,,,,,,,,,,,,,,,,,,,,,,,,,,,,,,,,,
67387155,d30fdbcd-4f67-48b9-846e-c2f0551c6bf2,1683461006,120,1683457853,,0,0,15.25,3861,3901,78,84,112,118,0,0,0.15,,,,974,166,179,,,,57.6,50.31,57.93,1,59.09,3459,312,,4.7,2.1,103,98,,,,,,37,80,14.22,14.41,14.45,5.8,5.1,352,352,,1,361,361,,,,,,,,,"0,1,1,6,17,42,31,2,0","0,1,21,78,0","0,0,8,82,10",,,,,148,,,,,,,,,,,,,,,,,,,,,,,,,,,,,,,,,,,,14.5,17,4,130,72,,1018,3,,0,4,4,Sundern,1,0,U1.000|4:15-U1.000|4:06-U1.000|4:07-U1.000|4:14-U1.000|4:02-U1.000|4:11-U1.000|3:53-U1.000|4:03-U1.000|4:09-U1.000|4:11-U1.000|5:01-U1.000|4:40-U1.000|3:58-U1.000|4:30-U1.000|3:49-U0.245|1:12,,"Sundern (Sauerland) Running",,,3113,,250,3,11064157927,0,168070,250480,30378,,50004020,,,,,,,,,,,,,,,,,,,,,,,,,,,,,,,,,,,,,,,,,
67405259,35684dff-a7c8-4587-a8ea-52713a3f9fa4,1683478282,120,1683472311,,0,0,1.42,1198,1198,25,26,31,33,0,1.2,0.71,1.07,0.92,,75,94,113,,,,25.3,,25.85,1,59.09,3217,3,,0.2,0,,100,,,,,,0,54,4.34,4.44,4.55,9.5,16.8,85,85,,1,91,91,,,,,,,,,"100,0,0,0,0,0,0,0,0","69,31,0,0,0","82,18,0,0,0",,,,,66,,,,,,,,,,,,,,,,,,,,,,,,,,,,,,,,,,,,0,18,4,91,67,,1018,2,,0,4,4,Balve,1,0,U1.000|13:43-U0.423|6:16,,"Balve Running",,,3113,,250,3,11066187186,0,168070,250480,30378,,50020375,,,,,,,,,,,,,,,,,,,,,,,,,,,,,,,,,,,,,,,,,
67482786,6a51cce7-7923-439e-99fc-55d1a2697278,1683570600,120,1683568299,,0,0,13.01,4143,4399,216,221,251,256,0,2,0.62,0.95,1.09,241,826,136,162,97,,,57.37,38.06,58.52,1,59.09,1872,101,,3.1,0,98,100,,,,,,1,78,11.55,12.3,12.04,-2.4,-8.5,268,268,,1,283,283,,,,,,,,,"15,12,18,25,18,3,5,3,0","0,68,31,1,0","0,2,83,14,1",,,,,121,,,,,,,,,,,,,,,,,,,,,,,,,,,,,,,,,,,,0.2,18,5,161,67,,1020,1,,0,4,4,Balve,1,0,U1.000|5:52-U1.000|4:59-U1.000|5:33-U1.000|5:26-U1.000|5:41-U1.000|5:49-U1.000|5:22-U1.000|5:24-U1.000|5:53-U1.000|5:23-U1.000|3:29-U1.000|4:02-U1.000|6:09-U0.008|0:02,,"Balve Running",,,3113,,250,3,11074055588,0,168070,250480,30378,,50087986,,,,,,,,,,,,,,,,,,,,,,,,,,,,,,,,,,,,,,,,"5,5,5",
67550282,82cc2b87-f84c-46fd-bfba-1589c782d9a8,1683657089,120,1683658161,,0,0,4.04,1135,1135,8,21,13,26,0,0,0.1,,,,252,138,149,92,,,65.74,40.84,65.64,1,59.15,990,59,,2.5,0,105,102,,,,,,23,79,12.69,12.83,12.78,5,7,305,305,,1,309,309,,,,,,,,,"1,0,1,10,66,21,1,0,0","3,33,64,0,0","0,0,46,54,0",,,,,135,,,,,,,,,,,,,,,,,,,,,,,,,,,,,,,,,,,,21.7,16,9,220,88,,1009,1,,0,6,4,Frondenberg/Ruhr,1,0,U1.000|4:49-U1.000|4:44-U1.000|4:38-U1.000|4:33-U0.036|0:11,,"Fröndenberg/Ruhr Running",,,3113,,250,3,11081767240,0,168070,250480,30378,,50149582,,,,,,,,,,,,,,,,,,,,,,,,,,,,,,,,,,,,,,,,,
67550283,6d4070ce-d12a-4ce9-b305-2fddafb21510,1683658717,120,1683658161,,0,0,0.7,215,215,20,8,20,8,0,1.3,0.89,1.31,0.66,,43,132,147,,,,62.27,30.93,65.81,1,59.15,984,9,,0.6,0,,100,,,,,,4,81,12.11,13.22,15.32,47.3,52.5,309,309,,1,411,411,,,,,,,,,"53,4,0,7,0,5,2,10,19","7,70,22,0,0","6,15,38,24,17",,,,,121,,,,,,,,,,,,,,,,,,,,,,,,,,,,,,,,,,,,7.2,16,8,239,88,,1009,1,,0,6,4,Frondenberg/Ruhr,1,0,U0.141|0:39-U0.096|0:17-U0.037|0:19-U0.095|0:17-U0.031|0:18-U0.095|0:19-U0.031|0:19-U0.095|0:19-U0.079|0:48,,"Fröndenberg/Ruhr Running",,,3113,,250,3,11081767765,0,168070,250480,30378,,50149580,,,,,,,,,,,,,,,,,,,,,,,,,,,,,,,,,,,,,,,,,
67550321,4a31f2ba-df99-4a4d-bbeb-11a5f3b8ef02,1683658974,120,1683658191,,0,0,5.92,1694,1694,0,7,0,6,0,0,0.03,,,,374,151,183,,,,56.94,40.91,56.86,1,59.16,2350,158,,3,2.6,106,112,,,,,,52,79,12.57,15.09,15.06,6.4,-0.3,316,315,,1,391,390,,,,,,,,,"35,3,3,2,3,7,10,23,14","0,33,30,37,1","25,10,9,7,50",,,,,133,,,,,,,,,,,,,,,,,,,,,,,,,,,,,,,,,,,,60.3,16,8,243,88,,1009,1,,0,6,4,Frondenberg/Ruhr,1,0,U0.790|2:32-U0.200|2:01-U0.800|2:38-U0.220|2:01-U0.790|2:40-U0.210|2:02-U0.800|2:41-U0.290|3:32-U0.800|2:39-U0.200|2:15-U0.800|2:40-U0.020|0:32,,"Fröndenberg/Ruhr Track Running",,,3113,,250,3,11081771313,0,168070,250480,30378,,50149619,,,,,,,,,,,,,,,,,,,,,,,,,,,,,,,,,,,,,,,,,
67550330,2d338e52-7dbe-4819-9aa7-7e58149428d4,1683660869,120,1683658203,,0,0,3.54,1112,1414,8,9,33,14,0,0,0.06,,,,227,138,160,102,,,57.27,35.5,57.41,1,59.16,2880,47,,2.3,0,100,101,,,,,,22,80,11.43,11.62,11.62,6.4,11.5,269,269,,1,277,277,,,,,,,,,"6,1,18,55,12,1,3,2,2","1,59,40,0,0","0,2,91,5,2",,,,,119,,,,,,,,,,,,,,,,,,,,,,,,,,,,,,,,,,,,20,15,8,243,88,,1009,1,,0,6,4,Frondenberg/Ruhr,1,0,U0.146|0:38-U0.039|0:19-U0.121|0:36-U0.102|0:21-U0.023|0:18-U0.091|0:19-U1.000|5:27-U1.000|5:18-U1.000|5:11-U0.016|0:05,,"Fröndenberg/Ruhr Running",,,3113,,250,3,11081773082,0,168070,250480,30378,,50149627,,,,,,,,,,,,,,,,,,,,,,,,,,,,,,,,,,,,,,,,,
67643446,,1683720060,120,1683799408,,0,0,13,4200,4200,300,300,300,300,0,,,,,,860,,,,,,,37.42,,1,,,,,,,,,,,,,,36,,,,,,,,,,,,,,,,,,,,,,,,,,,,,,,,,,,,,,,,,,,,,,,,,,,,,,,,,,,,,,,,,,,,,,,,,,1,,,0,0,,,"Run hoechster Punkt Balver Wald und zurueck",,,connect,,,3,11092522309,0,168070,250480,30378,,50233183,,,,,,,,,,,,,,,,,,,,,,,,,,,,,,,,,,,,,,,,,
67677510,,1683833880,120,1683833948,,0,0,15,4800,4800,,,,,0,,,,,,983,,,,,,,38.27,,1,,,,,,,,,,,,,,41,,,,,,,,,,,,,,,,,,,,,,,,,,,,,,,,,,,,,,,,,,,,,,,,,,,,,,,,,,,,,,,,,,,,,,,,,,1,,,0,0,,,RUn,,,connect,,,3,11096355968,0,168070,250480,30378,,50264148,,,,,,,,,,,,,,,,,,,,,,,,,,,,,,,,,,,,,,,,,
67714432,382259ac-8ec4-4822-a0cd-1c1f88ab300a,1683898692,120,1683895926,,0,0,13.73,4385,4416,352,350,639,303,4,4,0.71,1.04,0.97,496,1107,160,188,,,,45.73,38.09,47.19,1,,,,,,,,,190,,,,,98,79,11.97,11.83,12.19,-5.7,2.1,275,275,,1,282,282,,,,,,,,,"22,14,12,12,16,18,5,0,0","0,16,23,58,3","0,5,69,25,1",,,,,119,,,,,,,,,,,,,,,,,,,,,,,,,,,,,,,,,,,,65.3,18,14,72,62,,1017,4,,0,4,4,Balve,1,0,U1.000|5:26-U1.000|5:25-U1.000|6:56-U1.000|6:35-U1.000|6:14-U1.000|6:20-U1.000|4:52-U1.000|4:13-U1.000|4:08-U1.000|4:11-U1.000|4:30-U1.000|5:28-U1.000|5:25-U0.698|3:22,,,,,wahoo_fitness-33,,518,7,,0,168070,250480,30378,,50297690,,,,,,,,,,,,,,,,,,,,,,,,,,,,,,,,,,,,,,,,"3,5",
67759879,0a2ea23d-61dd-4d3e-a4f5-3ca9aa930836,1683957268,120,1683956363,,0,0,17.28,5560,5924,392,374,419,399,0,3.9,0.65,0.99,1.05,558,1146,142,161,,,,53.57,38.47,55.14,1,59.14,1598,150,,3.6,0,98,100,,,,,,48,80,11.76,11.71,11.96,-3.6,4.5,271,271,,1,276,276,,,,,,,,,"19,12,11,22,21,14,1,0,0","0,34,66,0,0","0,1,83,15,0",,,,,117,,,,,,,,,,,,,,,,,,,,,,,,,,,,,,,,,,,,9.9,9,3,80,77,,1020,0,,0,2,4,Balve,1,0,U1.000|5:54-U1.000|4:57-U1.000|5:22-U1.000|5:17-U1.000|5:23-U1.000|5:39-U1.000|6:12-U1.000|6:58-U1.000|6:09-U1.000|5:34-U1.000|5:23-U1.000|4:26-U1.000|4:11-U1.000|4:17-U1.000|4:39-U1.000|5:34-U1.000|5:25-U0.279|1:19,,"Balve Running",,,3113,,250,3,11104615872,0,168070,250480,30378,,50336675,,,,,,,,,,,,,,,,,,,,,,,,,,,,,,,,,,,,,,,,"3,5",
67858540,fdd212df-fbf4-489e-b018-ed537eb318ec,1684076787,120,1684082015,,0,0,14,4274,5432,221,198,259,239,0,2.2,0.49,1.01,1,370,916,137,150,,,,59.88,40.21,61.17,1,59.16,1396,131,,3.4,0,103,100,,,,,,82,78,12.08,12.05,12.2,0.6,3,285,285,,1,289,289,,,,,,,,,"8,6,8,29,33,14,1,0,0","1,64,35,0,0","0,2,68,30,0",,,,,126,,,,,,,,,,,,,,,,,,,,,,,,,,,,,,,,,,,,22.2,18,11,31,55,,1016,3,,0,4,4,Balve,1,0,U1.000|5:30-U1.000|5:06-U1.000|4:39-U1.000|4:55-U1.000|5:08-U1.000|5:18-U1.000|5:18-U1.000|5:04-U1.000|5:12-U1.000|4:32-U1.000|5:53-U1.000|4:38-U1.000|5:10-U1.000|4:49-U0.001|0:01,,"Balve Running",,,3113,,250,3,11116471384,0,168070,250480,30378,,50428522,,,,,,,,,,,,,,,,,,,,,,,,,,,,,,,,,,,,,,,,"4,5,5",
67919958,8c3ad3cd-8acd-48ec-a3b8-2b9bc537a31b,1684174337,120,1684172333,,0,0,15.27,4708,4968,421,383,439,401,0,4.4,0.88,0.99,1.15,548,1000,143,164,,,,55.94,40.03,58.03,1,59.13,1474,138,,3.5,0,99,99,,,,,,97,79,12.47,12.68,12.85,-3.2,4.8,290,290,,1,303,303,,,,,,,,,"17,13,15,12,11,19,12,1,0","1,38,59,2,0","0,0,67,31,2",,,,,123,,,,,,,,,,,,,,,,,,,,,,,,,,,,,,,,,,,,32.7,16,13,321,60,,1012,1,,0,3,4,Balve,1,0,U1.000|6:07-U1.000|6:39-U1.000|5:57-U1.000|6:30-U1.000|4:54-U1.000|4:12-U1.000|4:17-U1.000|5:00-U1.000|6:22-U1.000|5:30-U1.000|5:24-U1.000|4:15-U1.000|3:51-U1.000|4:07-U1.000|4:05-U0.270|1:17,,"Balve Running",,,3113,,250,3,11123115056,0,168070,250480,30378,,50483102,,,,,,,,,,,,,,,,,,,,,,,,,,,,,,,,,,,,,,,,"4,4",
68036887,6e4193f4-917b-4f4f-8fc8-55d41922090f,1684342891,120,1684339793,,0,0,5.8,1761,1821,156,149,161,157,0,3,0.78,1.01,1.01,541,367,137,159,91,,,60.29,38.1,62.39,1,59.17,991,70,,2.7,0.1,102,101,,,,,,33,78,12.57,12.29,12.96,-0.8,12.9,294,294,,1,307,307,,,,,,,,,"13,5,12,24,19,19,8,0,0","1,57,42,0,0","0,3,45,50,1",,,,,127,,,,,,,,,,,,,,,,,,,,,,,,,,,,,,,,,,,,24.8,12,13,0,50,,1026,2,,0,3,4,Balve,1,0,U0.843|4:43-U1.000|5:11-U1.000|6:25-U1.000|4:34-U1.000|4:25-U0.953|4:03,,"Balve Running",,,3113,,250,3,11136757369,0,168070,250480,30378,,50591609,,,,,,,,,,,,,,,,,,,,,,,,,,,,,,,,,,,,,,,,4,
68047403,7006e825-5716-4983-8198-2884847d7d59,1662922028,120,1684348321,,0,0,26.14,3713,3921,398,397,394,391,4,2.7,0.5,,,829,595,,,,,,,,,1,,,,,,,,,190,,,,,50,87,,31.02,,,,185,162,,0,199,189,,,,,,,,,"20,17,16,15,13,7,11",,"22,41,34,3,0",,,,,,,,,,,,,,,,,,,,,52,,,,,,,,,,,,,,,,,,,,,15,3,321,80,,1019,0,296,0,3,3,Balve,1,0,,,,,,wahoo_fitness-43,,258,7,,0,168072,,30378,,50601643,,,,,,,,,,,,,,,,,,,,,,,,,,,,,,,,,,,,,,,,4,
68076435,9409845b-c29a-4e6a-948c-240da47df75c,1684397391,120,1684391879,,0,0,3.64,1179,1356,76,61,75,62,0,1.8,0.77,1.03,1.01,,244,137,154,,,,55.66,34.3,57.38,1,59.15,944,52,,2.4,0,99,99,,,,,,5,80,11.36,11.35,11.7,4.1,-0.3,268,268,,1,280,280,,,,,,,,,"10,9,21,29,28,3,0,0,0","1,49,50,0,0","0,10,61,28,0",,,,,116,,,,,,,,,,,,,,,,,,,,,,,,,,,,,,,,,,,,2.5,7,5,58,71,,1028,1,,0,2,4,Balve,1,0,U1.000|5:28-U1.000|4:47-U1.000|5:23-U0.641|4:00,,"Balve Running",,,3113,,250,3,11140482497,0,168070,250480,30378,,50627936,,,,,,,,,,,,,,,,,,,,,,,,,,,,,,,,,,,,,,,,,
68101538,37e2737b-74b6-4406-aba9-49335007a8b8,1684411324,120,1684413564,,0,0,56.18,9217,9415,255,250,192,208,4,0,0.13,,,321,447,,,,,,,,,1,,,,,,,,,190,,,,,0,71,,22.89,,,,59,50,,0,64,59,,,,,,,,,"7,18,50,23,2,0,0",,"95,5,0,0,0",,,,,,,,,,,,,,,,,,,,,99,,,,,,,,,,,,,,,,,,,,,13,7,35,51,,1027,4,,0,3,4,Junkersdorf,1,0,,,,,,wahoo_fitness-43,,258,7,,0,168072,,30378,,50650489,,,,,,,,,,,,,,,,,,,,,,,,,,,,,,,,,,,,,,,,5,
68216276,0bc510e0-ae0b-4f7e-abd9-ea271899a986,1684519081,120,1684572313,,0,0,17.46,5355,5935,472,398,490,432,0,4.4,0.65,0.99,1.07,488,1127,142,161,,,,56.83,40.71,59.03,1,59.15,1588,151,,3.6,0,98,100,,,,,,28,79,12.4,12.15,15.87,-1,44.5,294,294,,1,445,445,,,,,,,,,"10,11,11,17,28,21,2,0,0","1,38,62,0,0","0,2,61,35,2",,,,,124,,,,,,,,,,,,,,,,,,,,,,,,,,,,,,,,,,,,5.7,17,14,52,47,,1023,1,,0,4,4,Balve,1,0,U1.000|5:23-U1.000|4:34-U1.000|4:57-U1.000|4:53-U1.000|4:58-U1.000|5:22-U1.000|5:47-U1.000|6:43-U1.000|5:48-U1.000|5:13-U1.000|5:10-U1.000|4:12-U1.000|4:14-U1.000|4:23-U1.000|4:42-U1.000|5:35-U1.000|4:46-U0.458|2:34,,"Balve Running",,,3113,,250,3,11155109483,0,168070,250480,30378,,50753374,,,,,,,,,,,,,,,,,,,,,,,,,,,,,,,,,,,,,,,,"3,5,5",
68216297,da079c94-a1e8-4024-9953-e292100c8aa2,1684573940,120,1684572338,,0,0,14.14,4171,4303,312,313,501,335,4,2.9,0.49,1.01,0.95,389,972,149,175,,,,55.87,41.89,57.39,1,,,,,,,,,190,,,,,49,81,12.89,12.66,13.25,-5.5,-6.9,304,304,,1,321,321,,,,,,,,,"9,9,15,16,22,15,11,4,0","0,19,63,17,0","0,8,40,43,9",,,,,126,,,,,,,,,,,,,,,,,,,,,,,,,,,,,,,,,,,,23,13,16,65,69,,1021,2,,0,4,4,Balve,1,0,U1.000|5:13-U1.000|5:30-U1.000|5:09-U1.000|4:42-U1.000|4:42-U1.000|5:27-U1.000|5:37-U1.000|5:42-U1.000|4:42-U1.000|4:57-U1.000|4:36-U1.000|3:41-U1.000|3:45-U1.000|5:10-U0.115|0:38,,,,,wahoo_fitness-33,,518,7,,0,168070,250480,30378,,50753393,,,,,,,,,,,,,,,,,,,,,,,,,,,,,,,,,,,,,,,,"4,4",
68246744,a9b73447-5b8b-42e7-8c76-5e2275024cc4,1684605720,120,1684603324,,0,0,36.3,4756,4780,628,627,349,349,4,3.7,0.6,,,820,391,,,,,,,,,1,,,,,,,,,190,,,,,3,87,,30.2,,,,94,83,,0,97,92,,,,,,,,,"9,18,11,16,27,11,8",,"64,36,0,0,0",,,,,,,,,,,,,,,,,,,,,100,,,,,,,,,,,,,,,,,,,,,17,14,59,66,,1019,1,,0,4,4,Balve,1,0,,,,,,wahoo_fitness-43,,258,7,,0,168072,,30378,,50780471,,,,,,,,,,,,,,,,,,,,,,,,,,,,,,,,,,,,,,,,"4,4,5,5,5,5",
68288591,d7752e93-0b6b-4acc-bf54-210999bb16a8,1684667136,120,1684664430,,0,0,15.22,3920,3969,60,55,85,79,0,0,0.07,,,,970,162,182,114,,,58.53,49.31,58.84,1,59.16,3456,274,,4.7,1.2,104,98,,,,,,134,80,13.99,14.24,14.35,4.1,-2.7,346,346,,1,360,360,,,,,,,,,"0,0,1,8,23,42,22,2,0","0,4,27,68,0","0,0,12,79,9",,,,,146,,,,,,,,,,,,,,,,,,,,,,,,,,,,,,,,,,,,74.5,18,8,39,71,,1016,4,,0,4,4,Sundern,1,0,U1.000|4:20-U1.000|4:07-U1.000|4:19-U1.000|4:31-U1.000|4:15-U1.000|4:18-U1.000|4:15-U1.000|4:10-U1.000|4:01-U1.000|4:00-U1.000|5:00-U1.000|4:25-U1.000|3:38-U1.000|4:31-U1.000|4:25-U0.222|1:05,,"Sundern (Sauerland) Running",,,3113,,250,3,11163276990,0,168070,250480,30378,,50817209,,,,,,,,,,,,,,,,,,,,,,,,,,,,,,,,,,,,,,,,,
68371773,a17b307f-b2b1-4aa7-a15d-57bcf45b3f3e,1684762176,120,1684759606,,0,0,13.2,4174,4292,400,373,433,407,0,4.6,0.78,0.95,1.07,518,862,143,166,,,,54.22,38.42,56.4,1,59.15,2312,118,,3.3,0,103,97,,,,,,16,79,12.21,12.38,12.39,-11.8,-0.9,281,281,,1,285,285,,,,,,,,,"25,10,11,13,15,13,11,1,0","0,38,60,1,0","0,0,71,29,0",,,,,120,,,,,,,,,,,,,,,,,,,,,,,,,,,,,,,,,,,,3.9,22,6,295,65,,1014,5,,0,3,4,Balve,1,0,U1.000|5:11-U1.000|5:00-U1.000|5:58-U1.000|6:18-U1.000|6:04-U1.000|6:09-U1.000|6:31-U1.000|5:32-U1.000|4:19-U1.000|4:06-U1.000|4:03-U1.000|3:55-U1.000|5:20-U0.202|1:07,,"Balve Running",,,3113,,250,3,11171556991,0,168070,250480,30378,,50890211,,,,,,,,,,,,,,,,,,,,,,,,,,,,,,,,,,,,,,,,"3,4,5",
68467362,c4b0852d-0be5-42ae-8146-89fb36f18706,1684866629,120,1684867645,,0,0,5.25,1503,1873,60,28,68,35,0,0,0.08,1.04,,590,328,140,163,,160,22,63.04,40.6,64.41,1,59.25,1222,83,,2.9,0.5,104,102,,,,,,6,80,12.92,13.35,16.39,4.3,-57.7,317,317,,1,440,440,,,,,,,,,"18,1,2,6,34,20,12,2,4","2,41,54,3,0","0,12,16,66,6",,,,,131,,,,,,,,,,,,,,,,,,,,,,,,,,,,,,,,,,,,4,14,10,340,65,,1021,1,,0,4,4,Fröndenberg,1,0,U1.000|4:50-U1.000|4:48-U1.000|4:25-U0.993|4:01-U0.098|0:17-U0.128|1:20-U0.097|0:18-U0.450|2:28-U0.132|0:58-U0.240|1:15-U0.100|0:19-U0.013|0:03,,"Fröndenberg/Ruhr Running",,,3113,,250,3,11181596893,0,168070,250480,30378,,50971347,,,,,,,,,,,,,,,,,,,,,,,,,,,,,,,,,,,,,,,,5,
68467476,d572fbc3-ffcb-4630-95f0-f75eaee8feef,1684868666,120,1684867709,,0,0,8.34,2770,2770,0,9,0,8,0,0,0.02,,,,492,137,173,,163,50,53.97,35.05,53.89,1,59.25,2711,120,,2.8,2.4,,100,,,,,,9,81,10.84,13.32,13.28,14.8,-11.1,264,263,,1,340,339,,,,,,,,,"53,6,4,1,1,2,6,18,9","4,52,39,5,0","16,34,14,8,29",,,,,112,,,,,,,,,,,,,,,,,,,,,,,,,,,,,,,,,,,,3.9,14,12,345,62,,1021,1,,0,4,4,Frondenberg/Ruhr,1,0,U0.490|1:40-U0.200|1:18-U0.300|0:58-U0.210|1:30-U0.290|0:57-U0.200|1:22-U0.510|1:40-U0.800|6:03-U0.500|1:41-U0.200|1:18-U0.300|0:57-U0.190|1:19-U0.300|0:57-U0.200|1:19-U0.510|1:38-U0.800|6:32-U0.500|1:28-U0.200|1:50-U0.310|1:00-U0.200|1:41-U0.300|1:01-U0.190|1:45-U0.500|1:28-U0.140|4:47,,"Fröndenberg/Ruhr Track Running",,,3113,,250,3,11181606037,0,168070,250480,30378,,50971410,,,,,,,,,,,,,,,,,,,,,,,,,,,,,,,,,,,,,,,,,
68467489,306d658c-0ae8-47af-862a-7691c194d192,1684871522,120,1684867719,,0,0,2.81,941,941,21,14,37,29,0,0.5,0.36,1.08,,,190,136,155,,155,22,53.92,32.38,54.58,1,59.25,3171,34,,2.1,0,101,99,,,,,,1,79,10.85,10.8,10.95,4.4,5.2,253,253,,1,257,257,,,,,,,,,"6,8,36,45,6,0,0,0,0","0,83,17,0,0","0,1,96,3,0",,,,,113,,,,,,,,,,,,,,,,,,,,,,,,,,,,,,,,,,,,0.5,14,14,345,59,,1022,0,,0,4,4,Frondenberg/Ruhr,1,0,U1.000|5:41-U1.000|5:30-U0.809|4:30,,"Fröndenberg/Ruhr Running",,,3113,,250,3,11181607446,0,168070,250480,30378,,50971414,,,,,,,,,,,,,,,,,,,,,,,,,,,,,,,,,,,,,,,,,
68534832,d1855635-2fc6-4f9a-af2c-6d79eae05323,1684951310,120,1684949577,,0,0,14.02,4577,4786,345,307,354,317,0,3.9,0.76,0.98,1.06,536,904,135,153,,144,14,56.16,37.19,58.06,1,59.22,2035,104,,3.2,0,99,97,,,,,,97,78,11.71,11.82,11.97,-10.4,-2.4,269,269,,1,278,278,,,,,,,,,"27,15,13,5,17,19,4,0,0","2,74,24,0,0","0,4,79,16,0",,,,,118,,,,,,,,,,,,,,,,,,,,,,,,,,,,,,,,,,,,28.3,13,9,3,68,,1023,1,,0,4,4,Balve,1,0,U1.000|6:34-U1.000|7:05-U1.000|6:32-U1.000|7:01-U1.000|5:24-U1.000|5:16-U1.000|6:07-U1.000|5:47-U1.000|4:18-U1.000|4:24-U1.000|4:20-U1.000|4:34-U1.000|4:34-U1.000|4:16-U0.018|0:06,,"Balve Running",,,3113,,250,3,11188436628,0,168070,250480,30378,,51030448,,,,,,,,,,,,,,,,,,,,,,,,,,,,,,,,,,,,,,,,"4,4,5",
68595424,7ce0d5ad-2929-48e8-b318-45bf8dcdc5c4,1685038782,120,1685036573,,0,0,10.04,3294,3563,226,194,238,212,0,2.9,0.61,1.1,1.03,584,619,132,158,90,158,25,57.4,36.03,59.22,1,59.21,1228,83,,2.9,0.2,99,100,,,,,,53,78,11.4,11.31,12.48,9.1,17.4,268,268,,1,306,306,,,,,,,,,"16,6,20,26,23,8,1,0,0","3,79,18,0,0","3,4,74,16,3",,,,,117,,,,,,,,,,,,,,,,,,,,,,,,,,,,,,,,,,,,20.4,16,11,21,59,,1026,1,,0,3,4,Balve,1,0,U1.000|5:40-U1.000|5:52-U1.000|6:28-U1.000|4:49-U0.813|4:00-U0.186|0:53-U0.231|2:07-U0.201|0:53-U1.000|5:28-U1.000|4:57-U1.000|5:21-U1.000|5:14-U0.608|3:12,,"Balve Running",,,3113,,250,3,11195708226,0,168070,250480,30378,,51085063,,,,,,,,,,,,,,,,,,,,,,,,,,,,,,,,,,,,,,,,"4,5",
68641812,a13b9e39-6752-4881-b4b4-5e631e0323c8,1685107249,120,1685104830,,0,0,13.58,4313,4444,320,298,335,318,0,3.7,0.78,0.98,1.04,429,902,146,160,,156,20,52.45,38.31,54.08,1,59.17,1480,128,,3.4,0,100,98,,,,,,85,79,11.85,11.89,12.06,-7.5,0.5,275,275,,1,282,282,,,,,,,,,"14,17,13,16,20,17,2,0,0","0,20,79,0,0","0,2,78,20,0",,,,,120,,,,,,,,,,,,,,,,,,,,,,,,,,,,,,,,,,,,23.3,15,14,32,58,,1028,6,,0,2,4,Balve,1,0,U1.000|5:16-U1.000|5:17-U1.000|6:30-U1.000|6:11-U1.000|6:13-U1.000|6:16-U1.000|4:49-U1.000|4:18-U1.000|4:17-U1.000|4:26-U1.000|4:34-U1.000|5:35-U1.000|5:28-U0.579|2:43,,"Balve Running",,,3113,,250,3,11200646703,0,168070,250480,30378,,51126569,,,,,,,,,,,,,,,,,,,,,,,,,,,,,,,,,,,,,,,,"4,5",
68704404,71203f1b-0e84-45f5-a38f-292c6e3f2ae1,1685186341,120,1685187735,,0,0,7.14,1762,1762,134,134,146,147,0,2,0.46,1,1.02,520,467,172,182,,179,14,56.22,49.25,57.52,1,59.12,2192,191,,3.9,0.6,100,99,,,,,,81,81,15.09,15.3,15.36,-0.9,10.3,371,371,,1,381,381,,,,,,,,,"4,2,3,6,4,29,41,11,0","0,1,1,95,4","0,0,4,76,20",,,,,150,,,,,,,,,,,,,,,,,,,,,,,,,,,,,,,,,,,,96.9,16,7,80,56,,1026,5,,0,2,4,Balve,1,0,U1.000|3:57-U1.000|4:28-U1.000|4:55-U1.000|4:05-U1.000|3:39-U1.000|3:43-U1.000|4:00-U0.143|0:35,,"Balve Running",,,3113,,250,3,11207428984,0,168070,250480,30378,,51185602,,,,,,,,,,,,,,,,,,,,,,,,,,,,,,,,,,,,,,,,4,
68704405,5926d221-00b1-4e7d-b3ed-23d5c62c42c4,1685189950,120,1685187736,,0,0,10.55,2539,2539,251,257,259,265,0,3.2,0.82,1.02,1.03,609,687,173,183,131,177,15,57.45,51.96,59.1,1,59.1,4682,301,,4.9,1.5,101,99,,,,,,120,84,15.67,15.83,15.79,0.8,13.8,385,385,,1,388,388,,,,,,,,,"0,0,1,9,22,18,28,21,1","0,1,3,90,5","0,0,6,61,33",,,,,148,,,,,,,,,,,,,,,,,,,,,,,,,,,,,,,,,,,,106.6,18,8,62,51,,1026,7,,0,2,4,Balve,1,0,U1.000|4:09-U1.000|4:51-U1.000|4:36-U1.000|4:46-U1.000|4:21-U1.000|3:20-U1.000|3:26-U1.000|3:32-U1.000|3:30-U1.000|3:39-U0.549|2:08,,"Balve Running",,,3113,,250,3,11207429140,0,168070,250480,30378,,51185601,,,,,,,,,,,,,,,,,,,,,,,,,,,,,,,,,,,,,,,,4,
68796783,eb533156-b4b6-4b88-85ab-3f0ad3129ccd,1685298338,120,1685295381,,0,0,12.02,3775,3873,178,177,219,220,0,2,0.59,0.98,1.04,397,765,139,160,,160,26,56.76,38.44,57.8,1,59.11,2951,98,,3.1,0,98,100,,,,,,63,78,11.63,11.66,11.75,1.3,5,273,273,,1,278,278,,,,,,,,,"7,7,17,27,36,6,1,0,0","0,53,47,0,0","0,1,82,17,0",,,,,122,,,,,,,,,,,,,,,,,,,,,,,,,,,,,,,,,,,,19,20,13,31,51,,1019,1,,0,3,4,Balve,1,0,U1.000|5:49-U1.000|4:54-U1.000|5:26-U1.000|5:08-U1.000|5:19-U1.000|5:37-U1.000|5:21-U1.000|5:01-U1.000|4:54-U1.000|4:40-U1.000|4:45-U1.000|5:56-U0.018|0:05,,"Balve Running",,,3113,,250,3,11217919135,0,168070,250480,30378,,51269186,,,,,,,,,,,,,,,,,,,,,,,,,,,,,,,,,,,,,,,,5,
68837257,03a10c56-d38f-428e-943f-27baf5731da8,1685366515,120,1685364614,,0,0,12.01,3901,4339,330,289,346,311,0,4,0.83,1,1.1,517,781,137,154,,146,17,55.47,36.96,57.59,1,59.1,2167,103,,3.2,0,100,99,,,,,,83,79,11.85,11.73,11.99,-11.2,0.9,273,273,,1,278,278,,,,,,,,,"20,17,17,8,19,17,2,0,0","1,52,47,0,0","0,3,73,24,0",,,,,117,,,,,,,,,,,,,,,,,,,,,,,,,,,,,,,,,,,,30.3,17,16,20,58,,1023,4,,0,4,4,Balve,1,0,U1.000|6:08-U1.000|6:19-U1.000|5:52-U1.000|6:22-U1.000|6:37-U1.000|5:25-U1.000|4:33-U1.000|4:24-U1.000|4:20-U1.000|4:15-U1.000|4:39-U1.000|6:01-U0.014|0:05,,"Balve Running",,,3113,,250,3,11222763212,0,168070,250480,30378,,51306850,,,,,,,,,,,,,,,,,,,,,,,,,,,,,,,,,,,,,,,,"3,5",
68851009,5fd33247-dcb8-49ad-9ee3-7a9feb885c49,1685376917,120,1685377764,,0,0,50.83,7743,8034,1032,1032,708,700,4,4.5,0.63,,,722,550,,,,,,,,,1,,,,,,,,,190,,,,,101,81,,28.67,,,,86,71,,0,94,87,,,,,,,,,"22,22,14,17,11,5,9",,"77,23,0,0,0",,,,,,,,,,,,,,,,,,,,,100,,,,,,,,,,,,,,,,,,,,,18,16,20,54,,1023,3,,0,4,4,Balve,1,0,,,,,,wahoo_fitness-43,,258,7,,0,168072,,30378,,51319643,,,,,,,,,,,,,,,,,,,,,,,,,,,,,,,,,,,,,,,,"4,4,4,5,5,5,5",
68903252,283b1d88-dd7e-4448-9fa7-f0080babb371,1685458975,120,1685451840,,0,0,0.72,73,73,17,296,1,4,0,1.6,0.86,,,3060,9,,,,,,,,,1,,,,,,,,,150,,,,,1,90,,44.8,,,,152,152,,0,153,153,,,,,,,,,"0,0,0,0,9,78,14",,"0,98,2,0,0",,,,,,,,,,,,,,,,,,,,,,,,,,,,,,,,,,,,,,,,,,,,,,,,,,0,1,,,1,1,,,,,,315-0,,,7,,0,168072,,30378,,51366639,,,,,,,,,,,,,,,,,,,,,,,,,,,,,,,,,,,,,,,,5,
68904593,f8526cfd-6bbf-4fce-a52b-c6b29de5af50,1685459090,120,1685454072,,0,0,16.81,2060,2060,48,45,63,59,0,0,0.1,,,,309,,,,,,,,,1,,,,,,,,,150,,,,,27,90,,30.9,,,,150,150,,0,150,150,,,,,,,,,"0,11,9,28,37,9,6",,"0,100,0,0,0",,,,,,,,,,,,,,,,,,,,,,,,,,,,,,,,,,,,,,,,,,,,,,,,,,0,1,,,1,1,U7.616|16:07-U9.192|18:13,,,,,315-0,,,7,,0,168072,,30378,,51367842,,,,,,,,,,,,,,,,,,,,,,,,,,,,,,,,,,,,,,,,,
68921355,3ae447e5-6526-4b48-b4e6-80695ef46572,1685471575,120,1685471282,,0,0,4.2,1182,1219,9,18,19,28,0,0,0.1,,0.96,,271,143,156,,149,7,62.62,40.87,62.62,1,59.17,1164,71,,2.8,0,104,102,,,,,,29,79,12.76,12.84,12.77,5.3,5.9,307,307,,1,308,308,,,,,,,,,"0,0,1,14,56,27,2,0,0","2,19,79,0,0","0,0,31,69,0",,,,,135,,,,,,,,,,,,,,,,,,,,,,,,,,,,,,,,,,,,31.5,17,14,40,57,,1024,1,,0,3,4,Frondenberg/Ruhr,1,0,U1.000|4:50-U1.000|4:45-U1.000|4:33-U1.000|4:39-U0.203|0:55,,"Fröndenberg/Ruhr Running",,,3113,,250,3,11232862864,0,168070,250480,30378,,51383634,,,,,,,,,,,,,,,,,,,,,,,,,,,,,,,,,,,,,,,,,
68921400,bc1e86ca-2963-40c9-b20b-52d0e184fa17,1685473232,120,1685471337,,0,0,8.46,2538,2538,0,0,0,7,0,0,0,,,,547,152,182,,173,49,53.22,39.55,53.22,1,59.17,4128,219,,3.3,3.1,96,100,,,,,,79,80,12.01,13.96,13.96,20.1,1.8,296,296,,1,358,358,,,,,,,,,"41,8,4,4,2,2,4,21,14","0,30,34,35,1","13,23,20,11,34",,,,,125,,,,,,,,,,,,,,,,,,,,,,,,,,,,,,,,,,,,65.7,18,15,41,59,,1025,1,,0,3,4,Frondenberg/Ruhr,1,0,U0.200|0:35-U0.100|0:36-U0.310|0:55-U0.090|0:35-U0.200|0:36-U0.400|2:25-U0.200|0:35-U0.100|0:35-U0.300|0:56-U0.100|0:34-U0.210|0:36-U0.400|3:00-U0.600|1:58-U0.200|1:15-U0.400|1:16-U0.100|0:48-U0.400|1:17-U0.310|2:33-U0.400|1:17-U0.200|1:42-U0.610|1:57-U0.400|4:08-U0.200|0:36-U0.100|0:40-U0.300|0:54-U0.100|0:48-U0.210|0:36-U0.400|3:43-U0.200|0:35-U0.100|0:52-U0.300|0:52-U0.100|0:58-U0.200|0:36-U0.020|0:58,,"Fröndenberg/Ruhr Track Running",,,3113,,250,3,11232871272,0,168070,250480,30378,,51383676,,,,,,,,,,,,,,,,,,,,,,,,,,,,,,,,,,,,,,,,,
68921413,ee282745-b7d9-4f65-8dec-1f49ef3f1db9,1685476052,120,1685471346,,0,0,2.2,745,745,14,16,25,26,0,0,0.19,,,,147,135,140,,139,6,53.68,31.31,54.04,1,59.17,4113,26,,1.8,0,97,98,,,,,,14,78,10.57,10.65,10.62,-1.3,-2,244,244,,1,246,246,,,,,,,,,"8,6,46,37,3,0,0,0,0","0,100,0,0,0","0,1,99,0,0",,,,,114,,,,,,,,,,,,,,,,,,,,,,,,,,,,,,,,,,,,15.6,18,14,39,62,,1025,0,,0,3,4,Frondenberg/Ruhr,1,0,U1.000|5:42-U1.000|5:31-U0.195|1:12,,"Fröndenberg/Ruhr Running",,,3113,,250,3,11232872656,0,168070,250480,30378,,51383689,,,,,,,,,,,,,,,,,,,,,,,,,,,,,,,,,,,,,,,,,
68993112,ff888b6c-d78e-4b20-b9f1-c5ba443821e9,1685554032,120,1685553790,,0,0,13.77,4321,4443,325,317,352,344,0,3.5,0.71,0.93,1.04,533,883,140,156,118,144,20,56.29,38.89,57.97,1,59.17,2749,112,,3.2,0,104,98,,,,,,20,78,12,12.15,12.13,-6.9,-0.5,278,278,,1,283,283,,,,,,,,,"18,13,12,12,22,18,4,0,0","0,46,54,0,0","0,1,75,24,0",,,,,123,,,,,,,,,,,,,,,,,,,,,,,,,,,,,,,,,,,,3.4,22,14,41,47,,1022,2,,0,2,4,Balve,1,0,U1.000|5:00-U1.000|5:12-U1.000|6:25-U1.000|6:18-U1.000|6:19-U1.000|6:11-U1.000|5:01-U1.000|4:35-U1.000|4:26-U1.000|4:24-U1.000|4:22-U1.000|5:23-U1.000|4:33-U0.770|3:52,,"Balve Running",,,3113,,250,3,11239865627,0,168070,250480,30378,,51450922,,,,,,,,,,,,,,,,,,,,,,,,,,,,,,,,,,,,,,,,4,
69085139,aa01402e-d981-4fa4-b7e5-0341ee856b0b,1685643621,120,1685641781,,0,0,15.28,4844,5235,414,382,411,384,0,4.4,0.9,1,1.11,561,955,135,156,,126,28,58.23,38.75,60.34,1,59.17,1730,115,,3.2,0,101,100,,,,,,16,79,12.03,11.99,12.32,2.6,6,279,279,,1,288,288,,,,,,,,,"18,13,14,14,13,25,2,0,0","1,65,35,0,0","1,1,71,27,0",,,,,120,,,,,,,,,,,,,,,,,,,,,,,,,,,,,,,,,,,,2.9,18,13,345,57,,1019,1,,0,2,4,Balve,1,0,U1.000|5:56-U1.000|6:13-U1.000|5:59-U1.000|6:11-U1.000|4:36-U1.000|4:22-U1.000|4:16-U1.000|5:18-U1.000|6:39-U1.000|5:46-U1.000|5:30-U1.000|4:33-U1.000|4:25-U1.000|4:31-U1.000|4:28-U0.280|2:01,,"Balve Running",,,3113,,250,3,11247589528,0,168070,250480,30378,,51531554,,,,,,,,,,,,,,,,,,,,,,,,,,,,,,,,,,,,,,,,"4,4",
69158299,595aae75-c17e-4019-9bd6-0e48d1ba4824,1685729440,120,1685727494,,0,0,16.82,4959,5116,379,375,394,400,0,4.2,0.7,0.96,1.07,545,1065,141,161,,154,20,60.23,42.5,61.93,1,59.19,1742,151,,3.6,0,100,101,,,,,,17,79,12.73,12.81,13.06,-6.2,-1.7,300,300,,1,309,309,,,,,,,,,"10,8,11,11,28,22,9,0,0","0,39,61,0,0","0,0,54,43,3",,,,,129,,,,,,,,,,,,,,,,,,,,,,,,,,,,,,,,,,,,3,17,13,44,55,,1020,1,,0,3,4,Balve,1,0,U1.000|5:31-U1.000|4:39-U1.000|4:50-U1.000|4:50-U1.000|4:49-U1.000|5:16-U1.000|5:55-U1.000|6:29-U1.000|5:42-U1.000|4:46-U1.000|4:08-U1.000|4:04-U1.000|3:50-U1.000|4:10-U1.000|5:09-U1.000|4:29-U0.822|4:02,,"Balve Running",,,3113,,250,3,11254517869,0,168070,250480,30378,,51599739,,,,,,,,,,,,,,,,,,,,,,,,,,,,,,,,,,,,,,,,"4,4,5",
69190664,46e936e6-45bd-429b-bd63-869a869757d1,1685792513,120,1685788248,,0,0,8.55,2595,2600,114,125,136,148,0,1.6,0.44,0.93,0.98,313,554,143,172,,155,22,57.04,39.04,57.89,1,59.19,1338,103,,3.1,0,98,100,,,,,,11,78,11.93,12.32,12.31,-1.9,-8.3,281,281,,1,296,296,,,,,,,,,"7,7,16,28,24,11,6,1,0","0,38,55,6,0","0,1,68,28,3",,,,,127,,,,,,,,,,,,,,,,,,,,,,,,,,,,,,,,,,,,7.2,17,13,64,45,,1021,6,,0,2,4,Balve,1,0,U1.000|5:58-U1.000|5:02-U1.000|5:19-U1.000|5:19-U1.000|5:02-U1.000|4:32-U1.000|4:22-U1.000|4:23-U0.552|3:18,,"Balve Running",,,3113,,250,3,11258764872,0,168070,250480,30378,,51629912,,,,,,,,,,,,,,,,,,,,,,,,,,,,,,,,,,,,,,,,4,
69253218,93a27c5d-6728-4ec6-aafb-54c6e36ffd69,1685874801,120,1685879126,,0,0,21.43,5681,5964,187,149,250,215,0,0.6,0.22,0.94,1.02,557,1364,158,170,,157,20,58.63,49.01,59.39,1,59.21,4320,305,,5,0.4,103,100,,,,,,174,80,13.77,13.88,13.97,-1,-2.5,338,338,,1,345,345,,,,,,,,,"2,2,4,9,18,47,16,2,0","0,5,50,45,0","0,0,16,79,5",,,,,141,,,,,,,,,,,,,,,,,,,,,,,,,,,,,,,,,,,,55,18,10,72,41,,1022,5,,0,2,4,Balve,1,0,U1.000|4:41-U1.000|4:54-U1.000|5:05-U1.000|4:20-U1.000|4:26-U1.000|4:20-U1.000|4:23-U1.000|4:21-U1.000|4:01-U1.000|4:09-U1.000|4:20-U1.000|4:13-U1.000|4:11-U1.000|4:09-U1.000|4:14-U1.000|4:27-U1.000|4:10-U1.000|4:09-U1.000|5:08-U1.000|3:42-U1.000|5:10-U0.427|2:08,,"Balve Running",,,3113,,250,3,11267171480,0,168070,250480,30378,,51686782,,,,,,,,,,,,,,,,,,,,,,,,,,,,,,,,,,,,,,,,"5,5",
69277759,345945d8-c53a-4f6c-bb17-94a1153bc027,1685900465,120,1685898043,,0,0,31.54,4448,4596,609,608,311,307,4,3.5,0.54,,,810,332,,,,,,,,,1,,,,,,,,,190,,,,,43,85,,29.19,,,,86,75,,0,92,86,,,,,,,,,"13,23,8,20,23,6,6",,"75,25,0,0,0",,,,,,,,,,,,,,,,,,,,,100,,,,,,,,,,,,,,,,,,,,,21,13,36,37,,1020,2,,0,2,4,Balve,1,0,,,,,,wahoo_fitness-43,,258,7,,0,168072,,30378,,51709790,,,,,,,,,,,,,,,,,,,,,,,,,,,,,,,,,,,,,,,,"4,5,5,5,5,5,5",
69338496,3df36954-086a-427b-ad7f-80503e267130,1685990314,120,1685988722,,0,0,13.01,4402,5261,234,239,266,276,0,2.1,0.69,0.94,1.04,158,818,130,149,,149,26,56.29,35.45,57.52,1,59.2,2409,74,,2.8,0,99,98,,,,,,72,78,10.83,11,10.98,-4.2,-3.4,249,249,,1,254,254,,,,,,,,,"18,15,23,25,14,3,1,0,0","1,90,9,0,0","0,6,90,4,0",,,,,114,,,,,,,,,,,,,,,,,,,,,,,,,,,,,,,,,,,,15.7,22,11,34,38,,1019,1,,0,2,4,Balve,1,0,U1.000|6:05-U1.000|5:05-U1.000|5:35-U1.000|5:40-U1.000|5:50-U1.000|6:07-U1.000|6:00-U1.000|5:32-U1.000|5:51-U1.000|6:17-U1.000|4:30-U1.000|4:46-U1.000|6:02-U0.007|0:02,,"Balve Running",,,3113,,250,3,11276998413,0,168070,250480,30378,,51764554,,,,,,,,,,,,,,,,,,,,,,,,,,,,,,,,,,,,,,,,5,
69399117,8490f796-d65c-4201-b01c-94e3a2647640,1686076234,120,1686071764,,0,0,5.67,1794,2169,18,16,39,36,0,0,0.04,,,,371,142,162,,162,28,54.69,36.23,54.93,1,59.19,2618,113,,2.7,2.3,102,100,,,,,,42,78,11.4,12.67,13,8.6,-31.6,271,271,,1,331,331,,,,,,,,,"23,0,5,20,41,4,1,1,4","1,21,78,1,0","2,17,65,10,6",,,,,122,,,,,,,,,,,,,,,,,,,,,,,,,,,,,,,,,,,,27.4,23,12,56,47,,1019,1,,0,4,4,Frondenberg/Ruhr,1,0,U1.000|4:52-U1.000|5:02-U1.000|4:55-U1.000|5:00-U0.197|1:03-U0.118|0:22-U0.147|1:14-U0.114|0:22-U0.152|1:19-U0.117|0:21-U0.156|1:26-U0.114|0:21-U0.154|1:19-U0.114|0:21-U0.158|1:30-U0.114|0:22-U0.015|0:05,,"Fröndenberg/Ruhr Running",,,3113,,250,3,11284006204,0,168070,250480,30378,,51820491,,,,,,,,,,,,,,,,,,,,,,,,,,,,,,,,,,,,,,,,,
69401084,3f405803-4873-487d-a2ec-11cf5515e7f1,1686078580,120,1686073437,,0,0,6.3,1988,1988,0,0,0,0,0,0,0,,,,441,157,186,,179,48,47.73,36.57,47.73,1,59.19,5760,214,,3.2,3.1,94,100,,,,,,57,80,11.41,13.66,13.66,11,-11.1,280,280,,1,349,349,,,,,,,,,"47,7,4,2,2,2,4,16,16","0,26,18,51,5","20,20,16,12,31",,,,,119,,,,,,,,,,,,,,,,,,,,,,,,,,,,,,,,,,,,59.6,22,10,56,50,,1019,1,,0,3,4,Fröndenberg,1,0,U0.080|0:35-U0.200|0:36-U0.100|0:37-U0.200|0:36-U0.100|0:35-U0.190|0:35-U0.110|0:35-U0.200|0:36-U0.400|3:27-U0.200|0:34-U0.100|0:40-U0.200|0:36-U0.100|0:40-U0.200|0:35-U0.090|0:41-U0.200|0:35-U0.120|0:45-U0.200|0:36-U0.400|3:05-U0.200|0:35-U0.090|0:40-U0.200|0:37-U0.100|0:37-U0.200|0:39-U0.100|0:40-U0.190|0:37-U0.110|0:45-U0.200|0:36-U0.410|4:55-U1.000|3:13-U0.110|2:17,,"Fröndenberg/Ruhr Track Running",,,3113,,250,3,11284268092,0,168070,250480,30378,,51822328,,,,,,,,,,,,,,,,,,,,,,,,,,,,,,,,,,,,,,,,,
69403847,62204483-adb0-441a-bb40-1297e1d59d2b,1686080910,120,1686075088,,0,0,2,666,666,26,14,32,20,0,0,0.17,1.23,,909,135,138,143,106,143,5,53.29,31.63,54.55,1,59.19,5733,26,,1.8,0,96,98,,,,,,9,77,11.06,10.86,11.54,7.5,15.4,261,261,,1,276,276,,,,,,,,,"5,4,42,38,11,0,0,0,0","0,83,17,0,0","0,3,82,16,0",,,,,117,,,,,,,,,,,,,,,,,,,,,,,,,,,,,,,,,,,,7.7,22,9,56,50,,1019,1,,0,3,4,Frondenberg/Ruhr,1,0,U1.000|5:33-U1.000|5:33,,"Fröndenberg/Ruhr Running",,,3113,,250,3,11284540280,0,168070,250480,30378,,51824994,,,,,,,,,,,,,,,,,,,,,,,,,,,,,,,,,,,,,,,,5,
69479825,adc9fddf-57c3-4c38-a500-ee9e25c5e8e2,1686162258,120,1686159375,,0,0,12.93,4062,4257,217,209,246,238,0,2.2,0.61,0.93,1.04,241,829,139,161,,159,26,56.74,38.65,57.96,1,59.19,4331,107,,3.2,0,98,100,,,,,,55,79,11.68,11.84,11.85,-0.5,-0.6,273,273,,1,279,279,,,,,,,,,"11,9,14,25,30,8,3,0,0","1,57,42,0,0","0,0,82,18,0",,,,,121,,,,,,,,,,,,,,,,,,,,,,,,,,,,,,,,,,,,14.3,19,8,47,76,,1018,1,,0,10,4,Balve,1,0,U1.000|5:52-U1.000|4:49-U1.000|5:09-U1.000|5:13-U1.000|5:21-U1.000|5:34-U1.000|5:04-U1.000|5:09-U1.000|5:49-U1.000|5:33-U1.000|4:23-U1.000|4:25-U0.930|5:21,,"Balve Running",,,3113,,250,3,11291698404,0,168070,250480,30378,,51896837,,,,,,,,,,,,,,,,,,,,,,,,,,,,,,,,,,,,,,,,"5,5,5",
69523438,35a9407b-3870-4800-bd60-0984b9d47c67,1686218538,120,1686216372,,0,0,13.01,4552,4846,375,349,394,370,0,4,0.81,0.92,1.05,437,904,142,163,119,156,24,48.31,34.08,50.15,1,59.19,3383,107,,3.2,0,100,96,,,,,,73,79,10.99,10.93,11.16,-7.2,6.3,248,248,,1,254,254,,,,,,,,,"38,10,9,14,23,5,0,0,0","0,37,62,1,0","0,9,87,4,0",,,,,109,,,,,,,,,,,,,,,,,,,,,,,,,,,,,,,,,,,,24.7,20,10,66,68,,1017,4,,0,3,4,Balve,1,0,U1.000|5:20-U1.000|5:32-U1.000|7:12-U1.000|6:58-U1.000|6:49-U1.000|6:10-U1.000|6:44-U1.000|5:51-U1.000|4:50-U1.000|4:41-U1.000|4:50-U1.000|4:51-U1.000|6:02-U0.011|0:04,,"Balve Running",,,3113,,250,3,11295880092,0,168070,250480,30378,,51936229,,,,,,,,,,,,,,,,,,,,,,,,,,,,,,,,,,,,,,,,3,
69540692,6f532422-e065-4916-8b20-b5e3f7bad35f,1686234331,120,1686234400,,0,0,48.22,6990,7227,918,916,670,679,4,4,0.56,,,659,585,,,,,,,,,1,,,,,,,,,190,,,,,49,84,,30.6,,,,97,84,,0,102,95,,,,,,,,,"17,22,17,16,13,4,10",,"60,39,0,0,0",,,,,,,,,,,,,,,,,,,,,93,,,,,,,,,,,,,,,,,,,,,22,9,73,57,,1015,4,,0,3,4,Balve,1,0,,,,,,wahoo_fitness-43,,258,7,,0,168072,,30378,,51952011,,,,,,,,,,,,,,,,,,,,,,,,,,,,,,,,,,,,,,,,"4,4,4,5,5,5",
69617085,1a0aebd6-a0d6-475e-864f-bc2a09bb5810,1686336409,120,1686337607,,0,0,16.48,5294,6002,407,319,422,346,0,4.3,0.79,0.96,1.06,571,1047,134,155,98,147,24,57.82,38.39,59.98,1,59.18,2160,128,,3.4,0,99,100,,,,,,78,78,11.79,11.63,12.06,0.3,9.2,276,276,,1,285,285,,,,,,,,,"16,15,9,17,28,14,0,0,0","1,71,28,0,0","0,1,77,21,1",,,,,120,,,,,,,,,,,,,,,,,,,,,,,,,,,,,,,,,,,,19.1,22,10,68,50,,1014,1,,0,2,4,Balve,1,0,U1.000|5:29-U1.000|4:39-U1.000|5:04-U1.000|5:07-U1.000|5:09-U1.000|5:35-U1.000|6:30-U1.000|6:56-U1.000|6:15-U1.000|5:10-U1.000|4:31-U1.000|4:27-U1.000|4:28-U1.000|4:43-U1.000|6:08-U1.000|5:26-U0.478|2:36,,"Balve Running",,,3113,,250,3,11306904209,0,168070,250480,30378,,52019261,,,,,,,,,,,,,,,,,,,,,,,,,,,,,,,,,,,,,,,,"3,5",
69641702,7b5c8429-8cdf-4186-81b1-14e3137f9d22,1686388943,120,1686386092,,0,0,13.01,4050,4155,228,227,267,268,0,1.7,0.73,0.92,1.05,198,866,148,165,,160,25,52.77,39.08,53.92,1,59.15,2169,131,,3.4,0,97,100,,,,,,89,79,11.77,11.93,11.9,-0.2,0.5,276,276,,1,281,281,,,,,,,,,"12,6,13,26,29,13,2,0,0","0,17,77,6,0","0,1,82,17,0",,,,,122,,,,,,,,,,,,,,,,,,,,,,,,,,,,,,,,,,,,30.8,22,7,74,57,,1016,4,,0,2,4,Balve,1,0,U1.000|5:43-U1.000|4:46-U1.000|5:11-U1.000|5:06-U1.000|5:18-U1.000|5:31-U1.000|5:19-U1.000|4:51-U1.000|5:30-U1.000|5:49-U1.000|4:09-U1.000|4:33-U1.000|5:44-U0.005|0:02,,"Balve Running",,,3113,,250,3,11309855174,0,168070,250480,30378,,52042382,,,,,,,,,,,,,,,,,,,,,,,,,,,,,,,,,,,,,,,,"4,5",
69728786,0af7e610-ff2e-41fc-8af5-2945d45a4830,1686479964,120,1686483957,,0,0,4.33,3754,3754,116,134,156,166,0,1.8,0.62,,,246,253,86,120,,108,31,,,,1,59.18,661,4,,0.2,0,,100,,,,,,0,56,,4.88,,-14.3,,,,,,,,,,,,,,,,"70,29,1,0,0,0","89,11,0,0,0",,,,,,,,,,,,,,,,,,,,,,,,,,,,,,,,,,,,,,,,,,0,24,13,124,45,,1018,5,,0,2,4,Balve,1,0,,,"Balve Hiking",,,3113,,250,3,11319014267,0,168075,,30378,,52120397,,,,,,,,,,,,,,,,,,,,,,,,,,,,,,,,,,,,,,,,5,
69730759,6a2de74c-0c7a-4d05-a28b-9a8d474d97df,1686485245,120,1686485480,,0,0,18,5666,5734,341,341,400,397,0,3.6,0.62,0.92,1.04,580,1165,143,163,,157,20,54.53,39.59,55.81,1,59.13,1730,139,,3.5,0,99,100,,,,,,46,79,11.84,11.98,11.93,-2.9,0.9,275,275,,1,279,279,,,,,,,,,"19,9,11,15,25,20,1,0,0","0,43,56,1,0","0,0,81,19,0",,,,,121,,,,,,,,,,,,,,,,,,,,,,,,,,,,,,,,,,,,11.1,24,14,120,41,,1018,6,,0,2,4,Balve,1,0,U1.000|5:36-U1.000|4:36-U1.000|5:12-U1.000|5:18-U1.000|5:27-U1.000|5:48-U1.000|6:22-U1.000|7:13-U1.000|6:04-U1.000|5:20-U1.000|4:35-U1.000|4:33-U1.000|4:25-U1.000|4:42-U1.000|4:24-U1.000|4:20-U1.000|4:28-U1.000|6:03-U0.001|0:01,,"Balve Running",,,3113,,250,3,11319216989,0,168070,250480,30378,,52122259,,,,,,,,,,,,,,,,,,,,,,,,,,,,,,,,,,,,,,,,"4,5",
69801538,31e4ed03-c8dc-4bdc-bd0f-0445ef6b742d,1686592443,120,1686589262,,0,0,13.01,3902,3949,236,226,271,265,0,2.6,0.62,0.94,1.04,289,815,141,162,,157,20,58.97,40.82,60.35,1,59.13,1280,116,,3.2,0,100,101,,,,,,61,79,12.25,12.35,12.39,-0.5,1,290,290,,1,295,295,,,,,,,,,"7,6,11,21,34,18,2,0,0","0,43,56,0,0","0,1,60,40,0",,,,,127,,,,,,,,,,,,,,,,,,,,,,,,,,,,,,,,,,,,18.5,25,13,87,36,,1015,2,,0,2,4,Balve,1,0,U1.000|5:42-U1.000|4:43-U1.000|5:00-U1.000|4:55-U1.000|5:13-U1.000|5:17-U1.000|5:03-U1.000|4:40-U1.000|5:15-U1.000|5:34-U1.000|4:06-U1.000|4:18-U1.000|5:12-U0.012|0:03,,"Balve Running",,,3113,,250,3,11328037288,0,168070,250480,30378,,52186015,,,,,,,,,,,,,,,,,,,,,,,,,,,,,,,,,,,,,,,,"5,5,5",
69862226,43dd231d-11a5-4004-9aa7-c9fb41a8531c,1686668441,120,1686665947,,0,0,18.37,2223,2223,44,41,66,59,0,0,0.09,,,,333,,,,,,,,,1,,,,,,,,,150,,,,,14,90,,31.05,,,,150,150,,0,150,150,,,,,,,,,"0,7,14,5,62,6,6",,"0,100,0,0,0",,,,,,,,,,,,,,,,,,,,,,,,,,,,,,,,,,,,,,,,,,,,,,,,,,0,1,,,1,1,U9.187|18:40-U9.184|18:23,,,,,315-0,,,7,,0,168072,,30378,,52239960,,,,,,,,,,,,,,,,,,,,,,,,,,,,,,,,,,,,,,,,,
69878607,6b83be87-5193-4713-8622-3f52bb27cd27,1686681085,120,1686681042,,0,0,5.34,1767,2001,32,42,35,45,0,0,0.06,,0.2,,343,131,154,,151,38,57.33,34.23,57.62,1,59.18,1048,87,,2.8,0.7,105,100,,,,,,29,77,10.74,12.86,12.88,20.4,-18.1,260,260,,1,321,321,,,,,,,,,"27,1,2,10,30,23,2,2,3","9,61,30,0,0","12,13,21,49,4",,,,,118,,,,,,,,,,,,,,,,,,,,,,,,,,,,,,,,,,,,20.7,23,15,54,38,,1013,1,,0,2,4,Fröndenberg,1,0,U1.000|4:57-U1.000|4:45-U1.000|4:40-U1.000|4:18-U0.149|0:42-U0.113|0:23-U0.151|1:22-U0.118|0:23-U0.157|1:27-U0.116|0:23-U0.146|1:21-U0.115|0:23-U0.144|3:58-U0.114|0:20-U0.018|0:07,,"Fröndenberg/Ruhr Running",,,3113,,250,3,11336391969,0,168070,250480,30378,,52255220,,,,,,,,,,,,,,,,,,,,,,,,,,,,,,,,,,,,,,,,,
69878650,776e87c6-dcf0-4a3e-b481-b129fe0d51c3,1686685259,120,1686681084,,0,0,3.89,1243,1245,18,14,45,39,0,0,0.11,,,,259,140,147,,147,10,55.04,35.01,55.43,1,59.19,4321,47,,2.3,0,100,99,,,,,,25,78,11.31,11.32,11.34,-4.8,-4.8,266,266,,1,267,267,,,,,,,,,"1,6,19,60,14,0,0,0,0","0,64,36,0,0","0,0,100,0,0",,,,,120,,,,,,,,,,,,,,,,,,,,,,,,,,,,,,,,,,,,18.8,23,14,55,39,,1013,0,,0,2,4,Fröndenberg,1,0,U1.000|5:32-U1.000|5:22-U1.000|5:12-U0.894|4:37,,"Fröndenberg/Ruhr Running",,,3113,,250,3,11336398812,0,168070,250480,30378,,52255263,,,,,,,,,,,,,,,,,,,,,,,,,,,,,,,,,,,,,,,,,
69878652,a98290af-5a6b-48cf-ae30-7d532cc65b15,1686683260,120,1686681084,,0,0,5.93,1757,1757,0,0,0,0,0,0,0,,,,390,153,180,,179,53,53.54,39.27,53.54,1,59.19,4128,211,,3,3.3,109,107,,,,,,55,79,12.14,14.24,14.24,6.5,-3.7,300,300,,1,366,366,,,,,,,,,"38,7,5,2,2,2,7,26,9","0,33,19,48,0","19,14,19,8,39",,,,,128,,,,,,,,,,,,,,,,,,,,,,,,,,,,,,,,,,,,53.3,23,14,55,39,,1013,0,,0,2,4,Fröndenberg,1,0,U1.000|3:22-U0.400|2:48-U0.200|0:34-U0.100|0:40-U0.200|0:35-U0.110|0:37-U0.200|0:36-U0.100|0:40-U0.200|0:37-U0.100|0:43-U0.200|0:38-U0.400|3:44-U1.000|3:24-U0.400|3:06-U0.300|0:55-U0.100|0:52-U0.290|0:54-U0.200|1:56-U0.310|0:50-U0.120|1:45,,"Fröndenberg/Ruhr Track Running",,,3113,,250,3,11336398650,0,168070,250480,30378,,52255265,,,,,,,,,,,,,,,,,,,,,,,,,,,,,,,,,,,,,,,,,
69916575,f69688d7-41f8-4177-89b4-80a9cd25b041,1686747909,120,1686744676,,0,0,13.01,3875,3932,217,231,264,280,0,2.5,0.64,0.92,1.04,290,820,143,162,,157,24,58.38,41.15,59.51,1,59.19,3228,120,,3.3,0,100,100,,,,,,53,79,12.24,12.43,12.38,3.9,5.8,289,289,,1,295,295,,,,,,,,,"7,8,9,15,36,23,2,0,0","0,38,61,0,0","0,1,60,39,0",,,,,127,,,,,,,,,,,,,,,,,,,,,,,,,,,,,,,,,,,,14.3,21,15,82,41,,1017,6,,0,2,4,Balve,1,0,U1.000|5:22-U1.000|4:35-U1.000|5:02-U1.000|4:46-U1.000|4:55-U1.000|5:12-U1.000|4:59-U1.000|4:43-U1.000|5:17-U1.000|5:27-U1.000|4:16-U1.000|4:23-U1.000|5:35-U0.012|0:03,,"Balve Running",,,3113,,250,3,11341235019,0,168070,250480,30378,,52289471,,,,,,,,,,,,,,,,,,,,,,,,,,,,,,,,,,,,,,,,"5,5",
69978541,024c6b6f-5273-42d5-a047-b24cc8afcaeb,1686813467,120,1686833987,,0,0,14.01,4225,4343,191,173,215,204,0,1.7,0.41,0.99,0.9,535,936,148,169,,156,16,54.88,40.79,55.89,1,59.19,3168,170,,3.8,0,98,101,,,,,,70,80,12.21,12,12.34,2.9,0.5,291,291,,1,298,298,,,,,,,,,"5,5,10,17,54,9,1,0,0","0,12,85,3,0","2,4,46,48,0",,,,,124,,,,,,,,,,,,,,,,,,,,,,,,,,,,,,,,,,,,21.2,16,5,76,67,,1019,1,,0,2,4,Sint-Martens-Voeren,1,0,U1.000|5:06-U1.000|4:53-U1.000|4:49-U1.000|4:51-U1.000|4:55-U1.000|4:46-U1.000|4:44-U1.000|4:47-U1.000|5:30-U1.000|5:34-U1.000|4:37-U1.000|5:45-U1.000|5:22-U1.000|4:42-U0.011|0:04,,"Voeren Running",,,3113,,250,3,11349001123,0,168070,250480,30378,,52347526,,,,,,,,,,,,,,,,,,,,,,,,,,,,,,,,,,,,,,,,4,
70022339,ba9cd35d-5e91-413e-88d0-4bbd4d775231,1686901094,120,1686899162,,0,0,14.31,4094,4414,137,101,180,140,0,0.6,0.28,1.05,1,,918,144,158,,158,13,60.79,43.44,61.7,1,59.22,2736,159,,3.6,0,104,100,,,,,,76,80,12.76,12.65,12.87,-3.5,-8.3,309,309,,1,314,314,,,,,,,,,"1,2,4,15,55,22,1,0,0","0,20,80,0,0","0,0,37,62,1",,,,,131,,,,,,,,,,,,,,,,,,,,,,,,,,,,,,,,,,,,20.5,16,4,96,69,,1019,1,,0,2,4,Sint-Martens-Voeren,1,0,U1.000|4:40-U1.000|4:40-U1.000|4:41-U1.000|4:38-U1.000|4:49-U1.000|5:03-U1.000|4:54-U1.000|4:40-U1.000|4:41-U1.000|4:43-U1.000|4:50-U1.000|4:43-U1.000|4:37-U1.000|4:51-U0.312|1:44,,"Voeren Running",,,3113,,250,3,11354335497,0,168070,250480,30378,,52387102,,,,,,,,,,,,,,,,,,,,,,,,,,,,,,,,,,,,,,,,,
70087500,f91c4c00-bb2a-4c89-852e-90a147a3f8ce,1687001040,120,1686998495,,0,0,15.01,4542,4612,138,151,199,211,0,0.8,0.33,0.92,1.02,,955,143,160,,159,20,57.25,40.86,57.84,1,59.23,1872,133,,3.4,0,99,100,,,,,,84,80,11.95,12.07,12.02,0.5,0.1,282,282,,1,286,286,,,,,,,,,"5,5,8,26,45,9,1,0,0","0,26,73,0,0","0,0,76,24,0",,,,,124,,,,,,,,,,,,,,,,,,,,,,,,,,,,,,,,,,,,23.1,23,11,303,40,,1016,6,,0,2,4,Balve,1,0,U1.000|5:44-U1.000|4:44-U1.000|5:11-U1.000|5:10-U1.000|5:02-U1.000|5:07-U1.000|4:51-U1.000|4:50-U1.000|4:57-U1.000|5:05-U1.000|4:47-U1.000|4:50-U1.000|4:26-U1.000|4:44-U1.000|6:11-U0.008|0:03,,"Balve Running",,,3113,,250,3,11362315211,0,168070,250480,30378,,52445535,,,,,,,,,,,,,,,,,,,,,,,,,,,,,,,,,,,,,,,,,
70168558,c209f845-f2ed-4442-86c7-ac03dacc184b,1687108904,120,1687102154,,0,0,0.29,106,112,0,2,1,3,0,0,0,,,,19,127,141,,,,52.63,23.48,52.18,1,59.23,152,4,,0.2,0,,100,,,,,,1,80,9.67,9.76,9.56,8.3,10.4,219,219,,1,215,215,,,,,,,,,"26,14,49,10,0,0,0,0,0","8,89,4,0,0","0,18,82,0,0",,,,,103,,,,,,,,,,,,,,,,,,,,,,,,,,,,,,,,,,,,1.4,27,5,137,36,,1012,3,,0,4,4,Balve,1,0,,,"Balve Running",,,3113,,250,3,11372105993,0,168070,250480,30378,,52516433,,,,,,,,,,,,,,,,,,,,,,,,,,,,,,,,,,,,,,,,,
70178995,1240edfd-8bdc-45eb-85f6-3e2c9cd5dac7,1687110023,120,1687110998,,0,0,46.96,7246,7921,1029,1028,872,873,4,5.1,0.68,,,730,1549,,,,,,,,,1,,,,,,,,,190,,,,,55,,,30.09,,,,145,116,,1,179,168,,,,,,,,,"29,25,12,5,7,6,15",,"45,35,17,3,0",,,,,,,,,,,,,,,,,,,,,,,,,,,,,,,,,,,,,,,,,,25,5,125,42,,1012,1,,0,4,4,Balve,1,0,,,,,,wahoo_fitness-43,,258,7,,0,168072,,30378,,52525236,,,,,,,,,,,,,,,,,,,,,,,,,,,,,,,,,,,,,,,,"3,4,4,4,4,5,5,5",
70209965,ee7f110e-4734-4ce8-af0d-1b6b9d099137,1687181610,120,1687174953,,0,0,1.14,388,414,13,12,13,14,0,0,0.19,0.96,1.06,,72,124,139,,132,13,59.09,29.02,59.99,1,59.23,,13,,0.9,0,,100,,,,,,6,80,10.54,10.76,10.69,-1.8,4.1,242,242,,1,247,247,,,,,,,,,"20,13,19,30,19,0,0,0,0","5,95,0,0,0","0,2,95,3,0",,,,,110,,,,,,,,,,,,,,,,,,,,,,,,,,,,,,,,,,,,7.2,24,13,249,55,,1014,4,,0,4,4,Balve,1,0,U1.000|5:42-U0.135|0:46,,"Balve Running",,,3113,,250,3,11377108435,0,168070,250480,30378,,52552976,,,,,,,,,,,,,,,,,,,,,,,,,,,,,,,,,,,,,,,,,
70234747,51f64c7c-b584-475f-8ed3-043cb93149c8,1687196025,120,1687197866,,0,0,61.58,8810,9011,1170,1168,917,921,4,4.3,0.56,,,743,1631,,,,,,,,,1,,,,,,,,,190,,,,,109,82,,30.54,,,,210,187,,0,689,661,,,,,,,,,"11,31,15,18,7,4,14",,"66,24,0,0,10",,,,,,,,,,,,,,,,,,,,,90,,,,,,,,,,,,,,,,,,,,,23,6,285,50,,1013,2,,0,4,4,Balve,1,0,,,,,,wahoo_fitness-43,,258,7,,0,168072,,30378,,52574832,,,,,,,,,,,,,,,,,,,,,,,,,,,,,,,,,,,,,,,,"3,4,4,4,5,5",
70298824,6eb6aae7-0e8e-47a0-9b62-b46ed7fb5b98,1687288634,120,1687287343,,0,0,4.01,1188,1190,0,0,0,0,0,0,0,,,,281,162,186,,186,50,49.25,38.36,49.25,1,59.3,3572,170,,3.2,2.6,101,104,,,,,,48,79,12.14,14.63,14.63,22.1,2.2,301,301,,1,377,377,,,,,,,,,"40,3,3,2,1,1,14,37,1","0,20,17,36,27","18,21,9,4,48",,,,,128,,,,,,,,,,,,,,,,,,,,,,,,,,,,,,,,,,,,85.4,27,10,239,55,,1010,0,,0,4,4,Frondenberg/Ruhr,1,0,U1.000|3:28-U0.410|2:52-U1.000|3:25-U0.400|3:32-U1.000|3:22-U0.200|3:08,,"Fröndenberg/Ruhr Track Running",,,3113,,250,3,11387718382,0,168070,250480,30378,,52631371,,,,,,,,,,,,,,,,,,,,,,,,,,,,,,,,,,,,,,,,,
70298825,a1942817-791f-442e-9099-ed646ec86a6b,1687286244,120,1687287343,,0,0,6.6,1950,2261,30,23,48,42,0,0,0.03,,,,431,148,175,,175,50,56.28,39.65,56.67,1,59.3,1943,137,,3,2.3,104,102,,,,,,52,78,12.21,13.74,13.91,12.3,-21.1,295,295,,1,356,356,,,,,,,,,"17,3,5,6,32,29,1,1,5","0,13,82,4,0","3,12,22,56,6",,,,,130,,,,,,,,,,,,,,,,,,,,,,,,,,,,,,,,,,,,36.8,28,7,209,53,,1010,1,,0,4,4,Fröndenberg,1,0,U1.000|4:47-U1.000|4:38-U1.000|4:31-U1.000|4:25-U1.000|5:02-U1.000|5:18-U0.600|3:48,,"Fröndenberg/Ruhr Running",,,3113,,250,3,11387718228,0,168070,250480,30378,,52631374,,,,,,,,,,,,,,,,,,,,,,,,,,,,,,,,,,,,,,,,,
70298826,c229673b-2549-477d-8dd8-1cbd937c2ff7,1687289897,120,1687287343,,0,0,3.4,1151,1163,26,15,37,26,0,0,0.12,1.08,,,241,145,160,,147,11,48.93,32.41,49.59,1,59.3,4325,46,,2.3,0,96,95,,,,,,28,79,10.76,10.69,10.81,-1.5,-2.4,250,250,,1,253,253,,,,,,,,,"6,15,37,38,5,0,0,0,0","0,22,78,0,0","0,0,100,0,0",,,,,112,,,,,,,,,,,,,,,,,,,,,,,,,,,,,,,,,,,,28.3,27,9,239,55,,1010,0,,0,4,4,Fröndenberg,1,0,U1.000|5:55-U1.000|5:25-U1.000|5:33-U0.398|2:18,,"Fröndenberg/Ruhr Running",,,3113,,250,3,11387718482,0,168070,250480,30378,,52631372,,,,,,,,,,,,,,,,,,,,,,,,,,,,,,,,,,,,,,,,,
70357574,2e0046f9-91a0-47d4-8b9a-05bcad174968,1687375087,120,1687372905,,0,0,14.78,4313,4676,160,129,191,163,0,0.9,0.32,0.96,1.03,,919,141,161,,152,15,61,42.56,61.98,1,59.31,2880,128,,3.4,0,100,102,,,,,,87,79,12.51,12.52,12.62,1.8,1.6,300,300,,1,305,305,,,,,,,,,"4,2,8,17,48,17,3,0,0","1,38,61,1,0","0,0,51,49,0",,,,,130,,,,,,,,,,,,,,,,,,,,,,,,,,,,,,,,,,,,32.5,23,4,315,58,,1018,0,,0,3,4,Balve,1,0,U1.000|5:22-U1.000|4:36-U1.000|5:14-U1.000|5:07-U1.000|5:08-U1.000|4:59-U1.000|4:44-U1.000|4:42-U1.000|4:43-U1.000|4:53-U1.000|4:42-U1.000|4:27-U1.000|4:17-U1.000|4:16-U0.782|4:44,,"Balve Running",,,3113,,250,3,11395051387,0,168070,250480,30378,,52685921,,,,,,,,,,,,,,,,,,,,,,,,,,,,,,,,,,,,,,,,,
70400516,2534929a-6ad7-4350-bc8c-f40e2e21a9a6,1687438058,120,1687435675,,0,0,13.75,4288,4448,309,292,319,306,0,3.4,0.75,0.97,1.06,504,895,144,165,,155,21,54.65,39.17,56.25,1,59.31,2310,123,,3.3,0,102,98,,,,,,20,79,12.09,12.14,12.22,-8.3,-4.4,281,281,,1,286,286,,,,,,,,,"18,14,12,11,17,24,5,0,0","0,33,66,2,0","0,1,72,27,0",,,,,122,,,,,,,,,,,,,,,,,,,,,,,,,,,,,,,,,,,,5.2,25,11,79,65,,1016,5,,0,4,4,Balve,1,0,U1.000|5:03-U1.000|4:55-U1.000|6:28-U1.000|6:25-U1.000|6:22-U1.000|6:11-U1.000|4:59-U1.000|4:23-U1.000|4:13-U1.000|4:08-U1.000|4:18-U1.000|5:08-U1.000|5:12-U0.749|3:44,,"Balve Running",,,3113,,250,3,11399510623,0,168070,250480,30378,,52724431,,,,,,,,,,,,,,,,,,,,,,,,,,,,,,,,,,,,,,,,"4,5",
70452087,c733a9fe-29fb-4b1f-98aa-d79e3ffae5b0,1687509486,120,1687508030,,0,0,14,4238,4446,148,162,188,204,0,1.4,0.43,0.96,1,378,920,149,162,124,160,22,54.12,40.61,54.76,1,59.29,2025,145,,3.5,0,98,99,,,,,,44,80,11.97,12.05,12.02,0.4,0.9,282,282,,1,285,285,,,,,,,,,"5,4,8,24,49,9,0,0,0","0,7,92,1,0","0,1,73,26,0",,,,,124,,,,,,,,,,,,,,,,,,,,,,,,,,,,,,,,,,,,8.5,15,19,321,90,,1020,2,,0,6,4,Balve,1,0,U1.000|5:38-U1.000|4:35-U1.000|5:00-U1.000|4:58-U1.000|5:06-U1.000|5:07-U1.000|4:47-U1.000|4:41-U1.000|4:49-U1.000|5:08-U1.000|4:50-U1.000|5:29-U1.000|5:19-U1.000|5:09-U0.001|0:01,,"Balve Running",,,3113,,250,3,11405106558,0,168070,250480,30378,,52770670,,,,,,,,,,,,,,,,,,,,,,,,,,,,,,,,,,,,,,,,5,
70516082,9dff35ac-3bd8-48e0-93eb-f37c000d7175,1687605977,120,1687604389,,0,0,16.46,5078,5493,374,324,400,349,0,3.7,0.67,0.93,1.02,538,1114,151,171,,169,21,51.89,40.24,53.55,1,59.27,2030,180,,3.8,0.1,99,99,,,,,,62,79,12.25,12.17,12.38,0,2.8,287,287,,1,292,292,,,,,,,,,"13,11,10,14,27,22,3,0,0","0,12,71,17,0","0,2,63,34,0",,,,,123,,,,,,,,,,,,,,,,,,,,,,,,,,,,,,,,,,,,17,21,8,249,60,,1025,7,,0,2,4,Balve,1,0,U1.000|5:30-U1.000|4:40-U1.000|4:48-U1.000|4:52-U1.000|5:09-U1.000|5:19-U1.000|6:03-U1.000|6:55-U1.000|5:49-U1.000|5:02-U1.000|4:22-U1.000|4:16-U1.000|4:12-U1.000|4:25-U1.000|5:10-U1.000|5:52-U0.462|2:14,,"Balve Running",,,3113,,250,3,11412667067,0,168070,250480,30378,,52828240,,,,,,,,,,,,,,,,,,,,,,,,,,,,,,,,,,,,,,,,"4,5",
70585782,d7fd0916-8eb7-47e1-a33f-a38c3a897744,1687701469,120,1687700833,,0,0,18.62,5701,6192,532,442,604,525,0,4.5,0.75,0.92,1.01,581,1214,149,168,,149,17,53.36,41,55.57,1,59.26,2022,176,,3.8,0.2,104,98,,,,,,54,79,12.54,12.55,12.83,-0.1,0.4,294,294,,1,305,305,,,,,,,,,"16,13,14,13,10,26,9,0,0","0,10,83,7,0","0,0,57,42,2",,,,,124,,,,,,,,,,,,,,,,,,,,,,,,,,,,,,,,,,,,12.4,27,4,188,43,,1018,6,,0,3,4,Balve,1,0,U1.000|4:52-U1.000|5:01-U1.000|6:17-U1.000|5:57-U1.000|6:06-U1.000|5:43-U1.000|4:22-U1.000|4:14-U1.000|4:24-U1.000|5:46-U1.000|6:41-U1.000|6:04-U1.000|5:05-U1.000|4:04-U1.000|4:08-U1.000|4:06-U1.000|4:02-U1.000|4:17-U0.617|3:50,,"Balve Running",,,3113,,250,3,11421447752,0,168070,250480,30378,,52889940,,,,,,,,,,,,,,,,,,,,,,,,,,,,,,,,,,,,,,,,"4,4,5",
70660400,3c2948b9-1c83-4bd0-b3aa-7194cabdadce,1687803095,120,1687800656,,0,0,12.76,3978,4211,207,229,221,249,0,2.3,0.57,0.93,1.04,205,795,136,158,,152,21,58.9,38.96,59.95,1,59.27,1280,96,,3.1,0,99,100,,,,,,44,80,11.73,12.18,12.04,-4.7,-7.9,274,274,,1,284,284,,,,,,,,,"14,8,14,27,21,8,7,2,0","1,69,31,0,0","0,2,76,21,1",,,,,120,,,,,,,,,,,,,,,,,,,,,,,,,,,,,,,,,,,,14.1,20,18,299,45,,1018,1,,0,4,4,Balve,1,0,U1.000|5:39-U1.000|4:52-U1.000|5:26-U1.000|5:24-U1.000|5:21-U1.000|5:43-U1.000|5:15-U1.000|5:20-U1.000|6:02-U1.000|4:59-U1.000|3:50-U1.000|3:55-U0.756|4:31,,"Balve Running",,,3113,,250,3,11429666201,0,168070,250480,30378,,52954868,,,,,,,,,,,,,,,,,,,,,,,,,,,,,,,,,,,,,,,,"5,5",
70730606,09770ca4-a83b-45e6-b89e-943569712c99,1687878806,120,1687876345,,0,0,18.15,4725,4725,157,152,246,208,0,0.7,0.33,,,275,437,,,,,,,,,1,,,,,,,,,150,,,,,22,90,,24.3,,,,150,92,,0,150,132,,,,,,,,,"28,10,20,22,7,5,8",,"38,62,0,0,0",,,,,,,,,,,,,,,,,,,,,,,,,,,,,,,,,,,,,,,,,,,,,,,,,,0,1,,,1,1,U0.079|0:21-U17.656|46:30-U0.414|31:56,,,,,315-0,,,7,,0,168072,,30378,,53019623,,,,,,,,,,,,,,,,,,,,,,,,,,,,,,,,,,,,,,,,5,
70810798,4714c021-5133-4be1-97af-76e72f9345c8,1687890692,120,1687975663,,0,0,5.55,1590,1883,26,29,42,44,0,0,0.11,1.07,,,340,141,156,,143,15,62.4,40.7,62.72,1,59.36,1048,99,,2.8,1.7,103,104,,,,,,21,80,12.58,13.49,13.66,3.1,-24.7,303,303,,1,347,347,,,,,,,,,"10,6,4,7,37,30,1,2,3","2,27,71,0,0","0,8,23,64,5",,,,,131,,,,,,,,,,,,,,,,,,,,,,,,,,,,,,,,,,,,12.5,21,8,290,52,,1018,1,,0,4,4,Frondenberg/Ruhr,1,0,U1.000|4:43-U1.000|4:32-U1.000|4:28-U1.000|4:30-U0.591|3:23-U0.410|2:11-U0.402|2:15-U0.144|0:27,,"Fröndenberg/Ruhr Running",,,3113,,250,3,11444882871,0,168070,250480,30378,,53092350,,,,,,,,,,,,,,,,,,,,,,,,,,,,,,,,,,,,,,,,,
70810799,7f88ec3a-62eb-45df-a425-b12651ac452d,1687892800,120,1687975665,,0,0,8.15,2182,2182,0,0,0,0,0,0,0,,,,543,163,185,,177,51,55.28,45.11,55.28,1,59.38,4896,330,,3.8,3.6,106,104,,,,,,70,82,13.44,15.08,15.08,7,2.5,337,337,,1,390,390,,,,,,,,,"30,5,2,2,1,2,11,42,5","0,19,16,58,7","11,16,13,7,53",,,,,137,,,,,,,,,,,,,,,,,,,,,,,,,,,,,,,,,,,,64,19,13,308,54,,1018,1,,0,4,4,Frondenberg/Ruhr,1,0,U1.210|3:59-U0.390|2:57-U0.810|2:39-U0.190|1:53-U0.400|1:18-U0.100|0:49-U0.400|1:18-U0.110|0:51-U0.400|1:16-U0.100|0:57-U0.400|1:17-U0.100|0:57-U0.400|1:18-U0.100|1:00-U0.400|1:15-U0.400|3:16-U0.800|2:43-U0.200|1:42-U1.200|4:11-U0.040|0:47,,"Fröndenberg/Ruhr Track Running",,,3113,,250,3,11444883131,0,168070,250480,30378,,53092351,,,,,,,,,,,,,,,,,,,,,,,,,,,,,,,,,,,,,,,,,
70810803,01822704-70df-42a4-b4ee-f702459a86ff,1687978029,120,1687975668,,0,0,14.35,4327,4493,292,275,301,288,0,3.3,0.71,0.88,0.99,455,918,143,161,,149,16,57.5,40.88,59.03,1,59.38,3436,142,,3.4,0.6,103,98,,,,,,61,80,12.47,12.76,12.73,-11.1,-10.6,292,292,,1,303,303,,,,,,,,,"16,13,12,11,14,22,11,2,0","0,32,68,0,0","0,1,64,33,3",,,,,124,,,,,,,,,,,,,,,,,,,,,,,,,,,,,,,,,,,,18.2,19,4,258,67,,1018,1,,0,4,4,Balve,1,0,U1.000|4:54-U1.000|5:04-U1.000|6:20-U1.000|6:05-U1.000|6:17-U1.000|6:27-U1.000|4:58-U1.000|4:25-U1.000|4:16-U1.000|4:18-U1.000|4:21-U0.151|0:44-U1.000|3:39-U1.000|3:48-U1.000|5:28-U0.193|1:04,,"Balve Running",,,3113,,250,3,11444883632,0,168070,250480,30378,,53092356,,,,,,,,,,,,,,,,,,,,,,,,,,,,,,,,,,,,,,,,"4,5",
70810811,dcec6d0c-0b53-4332-ab4b-dbc187dbfd67,1687895350,120,1687975677,,0,0,3.01,956,956,30,16,43,29,0,0,0.07,1.16,,910,199,138,145,102,143,7,56.5,34.64,57.52,1,59.38,4866,39,,2.1,0,100,100,,,,,,13,80,11.53,11.4,11.72,-0.1,3.1,273,273,,1,279,279,,,,,,,,,"3,7,18,43,29,1,0,0,0","0,76,24,0,0","0,0,95,5,0",,,,,118,,,,,,,,,,,,,,,,,,,,,,,,,,,,,,,,,,,,10.4,20,9,299,56,,1018,0,,0,4,4,Frondenberg/Ruhr,1,0,U1.000|5:27-U1.000|5:23-U1.000|5:02-U0.012|0:04,,"Fröndenberg/Ruhr Running",,,3113,,250,3,11444883278,0,168070,250480,30378,,53092363,,,,,,,,,,,,,,,,,,,,,,,,,,,,,,,,,,,,,,,,5,
70888366,592e96a0-1190-45e8-a53d-db7b4fe5ec29,1688067465,120,1688064202,,0,0,11.54,3345,3550,164,155,184,177,0,2.1,0.58,0.97,1.03,250,716,143,161,,158,23,60.37,42.09,61.49,1,59.4,2304,117,,3.3,0,102,102,,,,,,23,80,12.69,12.75,12.82,1.9,2.6,303,303,,1,309,309,,,,,,,,,"6,5,8,18,28,28,7,0,0","0,33,66,0,0","0,0,50,49,0",,,,,129,,,,,,,,,,,,,,,,,,,,,,,,,,,,,,,,,,,,6.3,20,5,247,74,,1013,0,,0,4,4,Balve,1,0,U1.000|5:19-U1.000|4:32-U1.000|4:59-U1.000|4:57-U1.000|5:00-U1.000|5:14-U1.000|4:46-U1.000|4:28-U0.333|1:32-U1.000|4:00-U1.000|4:17-U1.000|5:22-U0.212|1:18,,"Balve Running",,,3113,,250,3,11452331314,0,168070,250480,30378,,53162091,,,,,,,,,,,,,,,,,,,,,,,,,,,,,,,,,,,,,,,,5,
70929857,fd1db047-8b0a-485e-ac7d-9b15267b5803,1688134756,120,1688132091,,0,0,13.64,4315,4449,331,309,368,350,0,3.6,0.69,0.96,1.03,476,892,143,158,,154,17,54.2,38.5,55.93,1,59.38,1736,122,,3.3,0,103,98,,,,,,28,79,11.91,11.86,12.09,-4.3,5.8,277,277,,1,283,283,,,,,,,,,"15,15,13,12,28,16,1,0,0","0,34,66,0,0","0,1,76,22,0",,,,,120,,,,,,,,,,,,,,,,,,,,,,,,,,,,,,,,,,,,5.4,19,12,308,55,,1013,5,,0,3,4,Balve,1,0,U1.000|5:03-U1.000|5:07-U1.000|6:32-U1.000|6:12-U1.000|6:03-U1.000|6:01-U1.000|5:02-U1.000|4:24-U1.000|4:24-U1.000|4:21-U1.000|4:39-U1.000|5:36-U1.000|5:27-U0.644|3:04,,"Balve Running",,,3113,,250,3,11456958694,0,168070,250480,30378,,53198559,,,,,,,,,,,,,,,,,,,,,,,,,,,,,,,,,,,,,,,,"4,5",
70979447,6e63571c-4b8d-4ba3-aee5-54082a8ab947,1688207091,120,1688204925,,0,0,11.77,3696,4697,311,251,322,263,0,3.5,0.75,0.92,1.02,490,763,138,157,,147,17,57.3,38.39,59.53,1,59.36,1352,104,,3.1,0,103,97,,,,,,24,80,12.2,12.07,12.53,-17.6,-19.1,286,286,,1,298,298,,,,,,,,,"16,15,12,13,21,20,2,0,0","1,43,56,0,0","0,0,74,24,2",,,,,119,,,,,,,,,,,,,,,,,,,,,,,,,,,,,,,,,,,,5.9,16,20,212,75,,1006,3,,0,4,4,Balve,1,0,U1.000|4:52-U1.000|5:00-U1.000|6:16-U1.000|6:16-U1.000|6:03-U1.000|6:03-U1.000|4:51-U1.000|4:30-U1.000|4:34-U1.000|4:21-U1.000|4:25-U0.768|4:27,,"Balve Running",,,3113,,250,3,11462142528,0,168070,250480,30378,,53244334,,,,,,,,,,,,,,,,,,,,,,,,,,,,,,,,,,,,,,,,"4,5",
71065455,72d5ccbe-7754-4834-9cd4-1819d4153fa3,1688312705,120,1688312109,,0,0,20.34,6046,6475,485,462,533,510,0,4.5,0.72,0.95,1.07,560,1260,141,169,,162,22,59.63,42.74,61.47,1,59.36,1584,158,,3.6,0,100,100,,,,,,89,80,12.76,13.19,13.33,-7.6,-13.5,299,299,,1,319,319,,,,,,,,,"13,14,15,10,12,16,18,1,0","1,43,52,4,0","0,1,58,40,2",,,,,126,,,,,,,,,,,,,,,,,,,,,,,,,,,,,,,,,,,,29.3,20,20,264,52,,1011,3,,0,3,4,Balve,1,0,U1.000|6:03-U1.000|6:20-U1.000|5:54-U1.000|6:35-U1.000|4:53-U1.000|4:40-U1.000|4:35-U1.000|5:02-U1.000|6:02-U1.000|5:41-U1.000|6:02-U1.000|4:42-U1.000|4:48-U1.000|4:38-U1.000|3:53-U1.000|3:45-U1.000|3:47-U1.000|4:01-U1.000|3:50-U1.000|3:52-U0.344|1:46,,"Balve Running",,,3113,,250,3,11472048654,0,168070,250480,30378,,53322766,,,,,,,,,,,,,,,,,,,,,,,,,,,,,,,,,,,,,,,,"4,4,4,5",
71138207,bb879c30-e11b-4d07-885a-66cab1c09167,1688405854,120,1688403178,,0,0,15.09,4030,4413,116,113,179,178,0,0.5,0.25,1.07,0.94,512,917,146,159,,148,20,64.96,47.25,65.6,1,59.45,1872,164,,3.7,0,102,102,,,,,,88,81,13.59,13.56,13.74,-0.6,-2.8,332,332,,1,340,340,,,,,,,,,"2,1,1,6,28,48,12,1,0","0,12,88,0,0","0,2,12,82,4",,,,,139,,,,,,,,,,,,,,,,,,,,,,,,,,,,,,,,,,,,26.7,19,20,248,53,,1011,2,,0,4,4,Sundern,1,0,U1.000|4:31-U1.000|4:24-U1.000|4:20-U1.000|4:22-U1.000|4:37-U1.000|4:25-U1.000|4:22-U1.000|4:27-U1.000|4:25-U1.000|4:23-U1.000|4:10-U1.000|4:14-U1.000|4:18-U1.000|4:23-U1.000|5:17-U0.087|0:31,,"Sundern (Sauerland) Running",,,3113,,250,3,11479127191,0,168070,250480,30378,,53390321,,,,,,,,,,,,,,,,,,,,,,,,,,,,,,,,,,,,,,,,5,
71210678,a06fac8b-316a-4ec2-a436-ecfe904a9c20,1688495575,120,1688492254,,0,0,6.46,1896,2243,56,54,60,56,0,0,0.16,,0.51,1800,408,143,166,,166,46,59.45,39.91,60.11,1,59.51,1621,117,,2.8,2.2,104,101,,,,,,41,79,12.22,14.01,16.07,9.6,-58.7,298,298,,1,438,438,,,,,,,,,"15,2,7,7,40,18,1,4,5","1,25,71,4,0","3,13,28,47,9",,,,,129,,,,,,,,,,,,,,,,,,,,,,,,,,,,,,,,,,,,26.6,19,12,263,52,,1013,2,,0,4,4,Frondenberg/Ruhr,1,0,U1.000|4:44-U1.000|4:29-U1.000|4:46-U1.000|4:37-U0.398|2:00-U0.180|0:33-U0.628|3:40-U0.408|2:02-U0.410|2:01-U0.435|2:45,,"Fröndenberg/Ruhr Running",,,3113,,250,3,11487104247,0,168070,250480,30378,,53457348,,,,,,,,,,,,,,,,,,,,,,,,,,,,,,,,,,,,,,,,5,
71212396,e6c37fb3-f738-4d88-bff5-295bcd639e95,1688497885,120,1688493031,,0,0,7.12,2189,2199,4,11,4,0,0,0,0.03,,,,463,151,178,,175,49,52.11,38,52.09,1,59.53,3744,182,,3.4,2.3,103,104,,,,,,53,80,11.69,14.13,14.09,18.3,-7.3,288,288,,1,359,359,,,,,,,,,"35,6,6,3,2,3,21,21,3","0,39,14,47,0","21,11,16,10,41",,,,,122,,,,,,,,,,,,,,,,,,,,,,,,,,,,,,,,,,,,57.2,21,8,267,51,,1012,0,,0,4,4,Frondenberg/Ruhr,1,0,U0.180|0:35-U0.100|0:31-U0.200|0:37-U0.100|0:33-U0.200|0:38-U0.090|0:37-U0.210|0:38-U0.100|0:34-U0.190|0:40-U0.400|2:39-U1.010|3:35-U0.400|2:43-U1.000|3:40-U1.000|3:38-U0.840|10:14-U1.000|3:15-U0.100|1:22,,"Fröndenberg/Ruhr Track Running",,,3113,,250,3,11487224178,0,168070,250480,30378,,53459009,,,,,,,,,,,,,,,,,,,,,,,,,,,,,,,,,,,,,,,,,
71215688,0466e61f-cd5f-4a9a-a574-fd50a8f99dca,1688500332,120,1688494197,,0,0,3.19,992,992,37,27,44,32,0,0.5,0.28,1.22,,1329,217,141,158,,157,20,56.39,35.66,57.42,1,59.53,4320,47,,2.3,0,100,100,,,,,,14,79,11.72,11.66,12.26,3,12.1,279,279,,1,297,297,,,,,,,,,"4,2,11,55,24,3,0,0,0","0,48,52,0,0","0,1,84,12,3",,,,,122,,,,,,,,,,,,,,,,,,,,,,,,,,,,,,,,,,,,10.5,21,5,271,55,,1012,0,,0,4,4,Fröndenberg,1,0,U1.000|5:13-U1.000|5:08-U1.000|5:08-U0.193|1:02,,"Fröndenberg/Ruhr Running",,,3113,,250,3,11487423479,0,168070,250480,30378,,53462236,,,,,,,,,,,,,,,,,,,,,,,,,,,,,,,,,,,,,,,,5,
71277279,1b8bc0a9-df70-4154-b1a0-4cbd5750fbde,1688580846,120,1688582341,,0,0,16.44,4290,4313,86,78,138,133,0,0,0.1,,0.99,505,1075,163,194,,187,35,57.06,48.86,57.46,1,59.55,4320,337,,5,1.7,101,100,,,,,,142,81,13.89,13.96,14.02,10.1,10.4,342,342,,1,347,347,,,,,,,,,"3,0,2,6,18,49,20,2,0","0,6,34,40,20","0,1,9,86,4",,,,,142,,,,,,,,,,,,,,,,,,,,,,,,,,,,,,,,,,,,127.2,17,19,244,68,,1013,1,,0,3,4,Sundern,1,0,U1.000|4:34-U1.000|4:17-U1.000|4:09-U1.000|4:05-U1.000|4:11-U1.000|4:10-U1.000|4:11-U1.000|4:16-U1.000|4:16-U1.000|4:17-U1.000|4:07-U1.000|4:27-U1.000|4:14-U1.000|4:18-U1.000|4:20-U1.000|4:50-U0.444|2:49,,"Sundern (Sauerland) Running",,,3113,,250,3,11494871498,0,168070,250480,30378,,53516962,,,,,,,,,,,,,,,,,,,,,,,,,,,,,,,,,,,,,,,,5,
71362056,990bc3e0-d038-46f0-ae0e-c634cae70489,1688672716,120,1688669659,,0,0,12.53,3763,3974,163,162,194,193,0,1.8,0.45,0.97,0.98,,809,146,163,,158,23,56.2,40.64,57.11,1,59.55,2791,135,,3.4,0.5,98,101,,,,,,91,79,12.14,12.38,12.49,0.7,0.8,289,289,,1,301,301,,,,,,,,,"8,6,8,17,41,18,1,1,0","0,26,71,2,0","1,1,55,42,2",,,,,126,,,,,,,,,,,,,,,,,,,,,,,,,,,,,,,,,,,,35.9,20,3,259,55,,1019,0,,0,2,4,Balve,1,0,U1.000|5:59-U1.000|5:08-U1.000|5:15-U1.000|4:41-U1.000|4:43-U1.000|4:49-U1.000|4:47-U1.000|4:33-U1.000|4:39-U1.000|4:35-U1.000|5:25-U1.000|4:22-U0.532|3:47,,"Balve Running",,,3113,,250,3,11502389716,0,168070,250480,30378,,53576496,,,,,,,,,,,,,,,,,,,,,,,,,,,,,,,,,,,,,,,,,
71417228,52c03fc1-2988-47fb-b366-5ea846bef77f,1688753752,120,1688752411,,0,0,13.51,4570,5788,384,212,413,243,0,4.2,0.64,1,1.04,447,935,142,163,,154,17,50.36,35.57,52.93,1,59.52,2313,141,,3.5,0,100,99,,,,,,100,79,11.49,10.96,12.09,-0.1,-3.1,271,271,,1,289,289,,,,,,,,,"23,12,17,22,19,7,1,0,0","0,31,68,0,0","1,2,80,15,2",,,,,112,,,,,,,,,,,,,,,,,,,,,,,,,,,,,,,,,,,,30.2,27,6,113,35,,1019,1,,0,2,4,Balve,1,0,U1.000|5:40-U1.000|4:58-U1.000|5:30-U1.000|5:26-U1.000|5:29-U1.000|5:47-U1.000|6:15-U1.000|7:08-U1.000|6:08-U1.000|5:17-U1.000|4:43-U1.000|5:44-U1.000|5:44-U0.510|2:21,,"Balve Running",,,3113,,250,3,11509075029,0,168070,250480,30378,,53628213,,,,,,,,,,,,,,,,,,,,,,,,,,,,,,,,,,,,,,,,"4,4,4,5,5",
71417307,,1688759602,120,1688752443,,0,0,4,960,960,,,,,0,,,,,,268,,,,,,,49.03,,1,,,,,,,,,,,,,,7,,,,,,,,,,,,,,,,,,,,,,,,,,,,,,,,,,,,,,,,,,,,,,,,,,,,,,,,,,,,,,,,,,,,,,,,,,1,,,0,0,,,"Uhr war gestoppt",,,connect,,,3,11509079190,0,168070,250480,30378,,53628280,,,,,,,,,,,,,,,,,,,,,,,,,,,,,,,,,,,,,,,,,
71441216,a79a1f26-0926-4cb3-b919-ab1ec082e11d,1688804198,120,1688801613,,0,0,13.46,4238,4553,207,155,249,200,0,2.4,0.52,0.95,0.94,464,883,143,162,,161,18,54.51,38.67,55.81,1,59.51,2023,116,,3.3,0,97,99,,,,,,19,80,11.83,11.76,12.01,-6.3,-11.3,279,279,,1,287,287,,,,,,,,,"10,11,15,25,25,11,3,0,0","0,35,64,0,0","0,5,70,25,0",,,,,119,,,,,,,,,,,,,,,,,,,,,,,,,,,,,,,,,,,,3.3,23,8,144,54,,1018,2,,0,2,4,Balve,1,0,U1.000|5:30-U1.000|5:49-U1.000|5:20-U1.000|4:57-U1.000|5:16-U1.000|5:32-U1.000|5:50-U1.000|5:42-U1.000|5:03-U1.000|4:43-U1.000|4:31-U1.000|4:18-U1.000|5:26-U0.463|2:42,,"Balve Running",,,3113,,250,3,11512105659,0,168070,250480,30378,,53650492,,,,,,,,,,,,,,,,,,,,,,,,,,,,,,,,,,,,,,,,"4,5",
71470044,5a89921d-309e-493a-aae7-5a71fb6e17a5,1688832492,120,1688831872,,0,0,41.89,6073,6553,913,912,805,804,4,4.8,0.65,,,795,2150,,,,,,,,,1,,,,,,,,,190,,,,,0,82,,31.77,,,,1015,357,,0,1102,829,,,,,,,,,"30,19,9,10,8,6,19",,"66,1,1,0,32",,,,,,,,,,,,,,,,,,,,,10,,,,,,,,,,,,,,,,,,,,,30,7,157,36,,1018,4,,0,2,4,Balve,1,0,,,,,,wahoo_fitness-43,,258,7,,0,168072,,30378,,53676707,,,,,,,,,,,,,,,,,,,,,,,,,,,,,,,,,,,,,,,,"3,4,4,4,4,5",
71506028,93df1cc4-11ba-46b1-b017-fef9196f29ea,1688897560,120,1688893327,,0,0,8.96,2791,2846,123,115,162,154,0,1.5,0.53,0.91,1.03,602,595,145,164,,164,19,54.22,37.99,55.2,1,59.49,1296,98,,3.1,0,98,99,,,,,,18,78,11.73,11.8,11.84,0.8,-1.3,276,276,,1,281,281,,,,,,,,,"9,10,13,18,40,9,1,0,0","0,27,70,2,0","0,0,81,19,0",,,,,123,,,,,,,,,,,,,,,,,,,,,,,,,,,,,,,,,,,,7.8,28,6,193,51,,1020,5,,0,2,4,Balve,1,0,U1.000|5:49-U1.000|4:57-U1.000|5:28-U1.000|5:21-U1.000|4:59-U1.000|4:40-U1.000|4:44-U1.000|4:55-U0.962|5:38,,"Balve Running",,,3113,,250,3,11520075613,0,168070,250480,30378,,53709213,,,,,,,,,,,,,,,,,,,,,,,,,,,,,,,,,,,,,,,,5,
71590791,141d352d-422c-48ef-9ae1-0cba9fa816cd,1689010229,120,1689008555,,0,0,16.73,5149,5431,337,326,376,372,0,3.4,0.67,0.93,1.08,568,1052,138,156,,146,20,58.74,40.41,60.25,1,59.47,1342,123,,3.3,0,102,100,,,,,,95,79,12.15,12.51,12.42,-6.5,-3.7,283,283,,1,291,291,,,,,,,,,"13,10,14,21,17,14,9,1,0","1,60,39,0,0","0,1,75,24,0",,,,,123,,,,,,,,,,,,,,,,,,,,,,,,,,,,,,,,,,,,23.9,23,9,288,46,,1021,1,,0,2,4,Balve,1,0,U1.000|5:37-U1.000|4:49-U1.000|5:10-U1.000|5:07-U1.000|5:15-U1.000|5:33-U1.000|5:58-U1.000|7:18-U1.000|6:04-U1.000|5:19-U1.000|4:10-U1.000|4:05-U1.000|3:54-U1.000|3:54-U1.000|5:08-U1.000|5:12-U0.732|3:16,,"Balve Running",,,3113,,250,3,11530445186,0,168070,250480,30378,,53786586,,,,,,,,,,,,,,,,,,,,,,,,,,,,,,,,,,,,,,,,4,
71647290,d0d2ab29-1d03-480a-86e7-b8ac1d52a1ab,1689087568,120,1689080437,,0,0,0.2,31,31,0,0,0,0,0,0,0,,,,5,,,,,,,,,1,,,,,,,,,150,,,,,0,90,,23.51,,,,150,150,,0,150,150,,,,,,,,,"0,20,30,50,0,0,0",,"0,100,0,0,0",,,,,,,,,,,,,,,,,,,,,,,,,,,,,,,,,,,,,,,,,,,,,,,,,,0,1,,,1,1,,,,,,315-0,,,7,,0,168072,,30378,,53837525,,,,,,,,,,,,,,,,,,,,,,,,,,,,,,,,,,,,,,,,,
71651131,c58d7984-110b-41dd-afe8-e248e11d67ec,1689087639,120,1689085160,,0,0,20.07,4706,4706,216,196,283,254,0,1.5,0.41,,,586,426,,,,,,,,,1,,,,,,,,,150,,,,,49,90,,28.33,,,,150,90,,0,150,132,,,,,,,,,"30,7,12,18,13,9,10",,"40,60,0,0,0",,,,,,,,,,,,,,,,,,,,,,,,,,,,,,,,,,,,,,,,,,,,,,,,,,0,1,,,1,1,U0.000|0:02-U20.060|1:18:24,,,,,315-0,,,7,,0,168072,,30378,,53841046,,,,,,,,,,,,,,,,,,,,,,,,,,,,,,,,,,,,,,,,4,
71660856,c842c738-7ff5-4f2d-a771-a8bd6cea3b90,1689100445,120,1689095481,,0,0,6.43,1930,2169,43,38,98,93,0,0,0.2,1.23,0.59,,413,145,173,,171,48,56.76,38.86,57.28,1,59.53,2450,128,,2.9,2.3,103,106,,,,,,44,78,12.01,13.94,14.4,14.5,-32.9,289,289,,1,379,379,,,,,,,,,"20,4,6,8,30,23,2,2,5","1,28,62,9,0","5,13,25,50,7",,,,,128,,,,,,,,,,,,,,,,,,,,,,,,,,,,,,,,,,,,32.1,32,8,257,42,,1010,1,,0,3,4,Frondenberg/Ruhr,1,0,U1.000|4:55-U1.000|4:32-U1.000|4:32-U1.000|4:31-U0.053|0:22-U0.416|2:24-U0.426|2:17-U0.152|0:27-U0.258|1:54-U0.156|0:27-U0.266|2:03-U0.180|0:31-U0.231|1:52-U0.173|0:32-U0.123|0:52,,"Fröndenberg/Ruhr Running",,,3113,,250,3,11538117483,0,168070,250480,30378,,53850039,,,,,,,,,,,,,,,,,,,,,,,,,,,,,,,,,,,,,,,,,
71664419,bf6c5395-f18a-40b3-b920-92449361cfd3,1689102850,120,1689098263,,0,0,6.57,2503,2538,0,0,0,0,0,0,0,,,,498,148,178,,176,58,41.12,29.28,41.12,1,59.53,5760,221,,3,3.4,97,97,,,,,,50,75,9.44,11.66,11.66,7.2,-18.5,230,225,,1,296,294,,,,,,,,,"59,4,5,4,3,2,2,6,14","0,40,25,35,0","28,28,16,8,19",,,,,105,,,,,,,,,,,,,,,,,,,,,,,,,,,,,,,,,,,,31.5,30,7,248,47,,1009,0,,0,4,4,Fröndenberg,1,0,U0.190|1:19-U0.190|0:34-U0.210|1:28-U0.200|0:34-U0.200|1:29-U0.190|0:34-U0.410|3:56-U0.200|0:34-U0.200|1:21-U0.200|0:34-U0.210|1:27-U0.200|0:35-U0.200|1:32-U0.200|0:34-U0.410|4:38-U0.200|0:35-U0.200|1:36-U0.200|0:36-U0.200|1:44-U0.200|0:35-U0.200|1:48-U0.200|0:36-U0.230|3:45-U0.210|0:35-U0.200|1:36-U0.200|0:34-U0.190|1:36-U0.200|0:34-U0.200|1:39-U0.210|0:34-U0.120|2:08,,"Fröndenberg/Ruhr Track Running",,,3113,,250,3,11538505527,0,168070,250480,30378,,53853438,,,,,,,,,,,,,,,,,,,,,,,,,,,,,,,,,,,,,,,,,
71668114,8ff8b51b-8918-487d-8545-4668dea0cdcd,1689105732,120,1689100196,,0,0,2.43,833,833,11,4,27,21,0,0,0.08,,,,164,137,143,102,142,5,51.9,31.14,52.38,1,59.52,5734,29,,2,0,97,98,,,,,,9,79,10.59,10.63,10.71,-5.6,-6.8,246,246,,1,251,251,,,,,,,,,"12,10,44,25,9,1,0,0,0","0,81,19,0,0","0,7,91,2,0",,,,,111,,,,,,,,,,,,,,,,,,,,,,,,,,,,,,,,,,,,6.9,29,8,260,50,,1009,0,,0,4,4,Frondenberg/Ruhr,1,0,U1.000|6:01-U1.000|5:33-U0.427|2:18,,"Fröndenberg/Ruhr Running",,,3113,,250,3,11538789269,0,168070,250480,30378,,53856545,,,,,,,,,,,,,,,,,,,,,,,,,,,,,,,,,,,,,,,,,
71726651,a5fd1d1c-e9ab-47bd-9926-e6657439d3dd,1689184449,120,1689181690,,0,0,13.01,4277,4405,222,236,272,288,0,2.6,0.64,0.95,1.06,591,829,134,152,,152,20,56.2,36.67,57.31,1,59.52,4371,85,,3,0,98,98,,,,,,74,79,11.1,11.3,11.26,-4.3,-3.6,256,256,,1,262,262,,,,,,,,,"16,12,21,25,20,5,1,0,0","0,74,26,0,0","0,2,91,7,0",,,,,116,,,,,,,,,,,,,,,,,,,,,,,,,,,,,,,,,,,,19.7,22,16,260,48,,1013,1,,0,4,4,Balve,1,0,U1.000|6:00-U1.000|5:12-U1.000|5:34-U1.000|5:43-U1.000|5:49-U1.000|5:52-U1.000|5:26-U1.000|5:08-U1.000|5:40-U1.000|5:48-U1.000|4:28-U1.000|4:42-U1.000|5:54-U0.005|0:02,,"Balve Running",,,3113,,250,3,11545639488,0,168070,250480,30378,,53909937,,,,,,,,,,,,,,,,,,,,,,,,,,,,,,,,,,,,,,,,"5,5",
71798427,2dc25130-c3a4-4192-a56f-7ad6e40477cc,1689273871,120,1689271323,,0,0,13.58,4004,4304,339,349,343,362,0,3.8,0.82,0.93,1.08,539,877,149,180,,156,12,55.9,41.78,57.58,1,59.52,4034,178,,3.7,0.6,103,98,,,,,,50,82,13.06,14.61,13.99,-10,-9.3,302,302,,1,326,326,,,,,,,,,"20,14,15,11,10,5,5,17,2","0,29,48,23,0","0,3,50,41,7",,,,,124,,,,,,,,,,,,,,,,,,,,,,,,,,,,,,,,,,,,44,20,9,276,58,,1018,1,,0,3,4,Balve,1,0,U1.000|4:55-U1.000|5:13-U1.000|6:17-U1.000|6:04-U1.000|5:56-U1.000|5:42-U1.000|6:13-U1.000|5:11-U1.000|3:13-U1.000|3:25-U1.000|3:18-U1.000|3:13-U1.000|3:32-U0.578|4:33,,"Balve Running",,,3113,,250,3,11553319710,0,168070,250480,30378,,53975315,,,,,,,,,,,,,,,,,,,,,,,,,,,,,,,,,,,,,,,,3,
71859993,76ac74e5-3906-40f9-9522-8f23cde3b4b7,1689356915,120,1689354609,,0,0,11.34,3895,4482,145,124,184,166,0,1.5,0.47,0.98,1.05,,711,127,150,,150,20,56.82,34.45,57.85,1,59.51,2648,70,,2.7,0,97,99,,,,,,21,78,10.66,10.64,10.88,2.3,6.7,247,247,,1,255,255,,,,,,,,,"12,20,32,23,13,0,0,0,0","1,93,6,0,0","0,1,96,3,0",,,,,112,,,,,,,,,,,,,,,,,,,,,,,,,,,,,,,,,,,,4.4,24,11,184,45,,1012,2,,0,3,4,Balve,1,0,U1.000|5:52-U1.000|4:55-U1.000|5:27-U1.000|5:23-U1.000|5:33-U1.000|6:11-U1.000|5:51-U1.000|5:48-U1.000|5:50-U1.000|6:27-U1.000|5:48-U0.343|1:51,,"Balve Running",,,3113,,250,3,11560072799,0,168070,250480,30378,,54030168,,,,,,,,,,,,,,,,,,,,,,,,,,,,,,,,,,,,,,,,,
71948355,df7df0d8-f4de-4cc1-b9b6-35f2fc1aff71,1689414413,120,1689495377,,0,0,14.12,4762,4887,374,370,397,399,0,4,0.84,0.89,1.07,414,995,149,169,,164,19,47.36,35.82,48.93,1,59.5,2456,135,,3.4,0,101,96,,,,,,76,80,11.35,11.5,11.5,-14.4,-3.9,257,257,,1,262,262,,,,,,,,,"34,11,9,12,18,14,1,0,0","0,22,67,12,0","0,3,89,8,0",,,,,111,,,,,,,,,,,,,,,,,,,,,,,,,,,,,,,,,,,,23.6,23,18,197,55,,1008,3,,0,4,4,Balve,1,0,U1.000|5:10-U1.000|5:15-U1.000|6:36-U1.000|6:48-U1.000|6:38-U1.000|6:26-U1.000|6:50-U1.000|6:18-U1.000|4:56-U1.000|4:37-U1.000|4:33-U1.000|4:35-U1.000|4:22-U1.000|5:36-U0.122|0:42,,"Balve Running",,,3113,,250,3,11570714109,0,168070,250480,30378,,54112188,,,,,,,,,,,,,,,,,,,,,,,,,,,,,,,,,,,,,,,,3,
71948357,22c3c702-cebd-4c5e-beb1-d5d5f59052ea,1689496880,120,1689495377,,0,0,16.79,5422,5537,360,356,407,404,0,4.1,0.74,0.99,1.09,452,1148,151,168,111,163,26,49.05,38.21,50.36,1,59.47,2182,161,,3.7,0.1,97,98,,,,,,93,80,11.55,11.55,11.68,-9.1,-2.2,266,266,,1,271,271,,,,,,,,,"16,11,18,22,20,13,1,0,0","0,9,79,11,0","0,1,86,13,0",,,,,116,,,,,,,,,,,,,,,,,,,,,,,,,,,,,,,,,,,,27.9,17,21,223,65,,1014,2,,0,2,4,Balve,1,0,U1.000|5:50-U1.000|5:00-U1.000|5:29-U1.000|5:23-U1.000|5:26-U1.000|5:40-U1.000|6:21-U1.000|7:11-U1.000|6:00-U1.000|5:26-U1.000|4:28-U1.000|4:28-U1.000|4:23-U1.000|4:34-U1.000|5:21-U1.000|5:31-U0.788|3:51,,"Balve Running",,,3113,,250,3,11570714254,0,168070,250480,30378,,54112190,,,,,,,,,,,,,,,,,,,,,,,,,,,,,,,,,,,,,,,,"4,5,5,5",
72055526,4dbfaecf-6944-409a-addb-eab808c84825,1689616456,120,1689613190,,0,0,10.01,3035,3315,174,142,204,179,0,2.4,0.57,0.96,1,485,637,139,157,95,156,16,59.28,39.52,60.79,1,59.5,1222,94,,3,0,100,102,,,,,,7,80,12.14,12.06,12.27,5.9,5.9,289,289,,1,294,294,,,,,,,,,"6,7,11,18,42,15,0,0,0","1,51,48,0,0","0,1,68,31,0",,,,,124,,,,,,,,,,,,,,,,,,,,,,,,,,,,,,,,,,,,1.2,19,17,272,53,,1019,2,,0,3,4,Balve,1,0,U1.000|5:23-U1.000|4:35-U1.000|5:02-U1.000|4:57-U1.000|4:52-U1.000|4:54-U1.000|4:54-U1.000|5:09-U1.000|5:28-U1.000|5:18-U0.008|0:02,,"Balve Running",,,3113,,250,3,11581562234,0,168070,250480,30378,,54206989,,,,,,,,,,,,,,,,,,,,,,,,,,,,,,,,,,,,,,,,4,
72138834,b74489f2-2355-4979-af61-cdb84da32cde,1689709995,120,1689706962,,0,0,1.17,513,513,28,4,39,15,0,0.8,0.35,1.31,,1101,91,130,139,100,135,16,40.88,21.7,43.14,1,59.51,2638,14,,0.9,0,,100,,,,,,1,76,8.76,8.43,10.03,14.2,27.1,202,202,,1,234,234,,,,,,,,,"60,39,2,0,0,0,0,0,0","2,98,0,0,0","7,25,62,5,0",,,,,90,,,,,,,,,,,,,,,,,,,,,,,,,,,,,,,,,,,,0.5,23,7,315,46,,1016,0,,0,2,4,Frondenberg/Ruhr,1,0,U1.000|7:03-U0.166|1:31,,"Fröndenberg/Ruhr Running",,,3113,,250,3,11590366442,0,168070,250480,30378,,54284041,,,,,,,,,,,,,,,,,,,,,,,,,,,,,,,,,,,,,,,,5,
72138835,14774acb-a5e0-4ffa-a87f-9be04d45e868,1689705027,120,1689706963,,0,0,6.55,1911,2329,44,62,61,78,0,0,0.14,,0.59,,440,154,171,,171,34,54.06,40.23,54.33,1,59.51,1244,130,,3.1,2,104,100,,,,,,24,79,12.2,13.73,13.76,18.4,-8.7,294,294,,1,346,346,,,,,,,,,"17,1,4,8,19,38,7,2,3","0,8,64,28,0","4,15,11,64,6",,,,,130,,,,,,,,,,,,,,,,,,,,,,,,,,,,,,,,,,,,13.4,25,8,287,39,,1016,1,,0,2,4,Frondenberg/Ruhr,1,0,U1.000|4:32-U1.000|4:28-U1.000|4:21-U1.000|4:17-U0.213|0:56-U0.361|2:10-U0.415|2:11-U0.414|2:09-U0.408|2:01-U0.415|2:18-U0.323|2:27,,"Fröndenberg/Ruhr Running",,,3113,,250,3,11590366188,0,168070,250480,30378,,54284042,,,,,,,,,,,,,,,,,,,,,,,,,,,,,,,,,,,,,,,,,
72138836,3def83f1-a90a-44ac-8444-91cec2f4ea2a,1689707402,120,1689706964,,0,0,6.92,2195,2195,0,0,0,0,0,0,0,,,,485,155,184,,178,50,48.31,36.56,48.31,1,59.51,2654,184,,3.3,2.7,98,99,,,,,,38,79,11.34,14.31,14.31,20.3,3.4,288,281,,1,373,370,,,,,,,,,"38,5,7,3,2,1,7,33,3","0,28,26,43,4","25,13,16,5,40",,,,,120,,,,,,,,,,,,,,,,,,,,,,,,,,,,,,,,,,,,31.6,23,7,315,46,,1016,0,,0,2,4,Frondenberg/Ruhr,1,0,U0.800|2:38-U0.490|3:13-U0.800|2:37-U0.470|3:27-U0.800|2:40-U0.380|3:39-U0.800|2:40-U0.280|4:00-U0.800|2:40-U0.380|4:33-U0.800|2:40-U0.120|1:47,,"Fröndenberg/Ruhr Track Running",,,3113,,250,3,11590366362,0,168070,250480,30378,,54284043,,,,,,,,,,,,,,,,,,,,,,,,,,,,,,,,,,,,,,,,,
72200408,3f916fcb-9112-4cd8-a46e-57c6e6c51da6,1689788806,120,1689787391,,0,0,16.58,4742,4820,391,386,420,420,0,3.9,0.84,1.01,1.13,466,1068,151,167,,160,24,56.97,43.97,58.66,1,59.51,2593,176,,3.8,0,100,100,,,,,,130,80,13.1,13.26,13.2,-3.6,2,310,310,,1,313,313,,,,,,,,,"5,7,15,13,20,24,15,1,0","0,13,76,10,0","0,0,37,63,0",,,,,131,,,,,,,,,,,,,,,,,,,,,,,,,,,,,,,,,,,,40.7,21,17,285,56,,1012,2,,0,4,4,Balve,1,0,U1.000|6:02-U1.000|5:45-U1.000|5:31-U1.000|5:00-U1.000|5:14-U1.000|4:46-U1.000|4:44-U1.000|4:39-U1.000|4:36-U1.000|4:48-U1.000|4:18-U1.000|3:49-U1.000|3:49-U1.000|4:04-U1.000|4:43-U1.000|4:32-U0.584|2:41,,"Balve Running",,,3113,,250,3,11597207947,0,168070,250480,30378,,54341249,,,,,,,,,,,,,,,,,,,,,,,,,,,,,,,,,,,,,,,,4,
72279166,e758eac5-b468-42ba-88f8-e0d0b1ed642e,1689874674,120,1689872987,,0,0,14.18,4531,5431,395,359,411,383,0,4.3,0.77,0.96,1.11,470,942,141,159,,159,23,54.54,38.17,56.59,1,59.5,1735,115,,3.2,0,101,99,,,,,,31,80,12.11,12.32,12.82,-13.3,-17,280,280,,1,303,303,,,,,,,,,"25,13,13,11,11,14,11,1,0","0,39,60,0,0","0,1,79,18,2",,,,,117,,,,,,,,,,,,,,,,,,,,,,,,,,,,,,,,,,,,7.4,20,5,305,54,,1014,2,,0,3,4,Balve,1,0,U1.000|4:59-U1.000|5:20-U1.000|6:30-U1.000|6:23-U1.000|6:12-U1.000|6:05-U1.000|6:35-U1.000|6:09-U1.000|4:29-U1.000|4:15-U1.000|4:04-U1.000|4:08-U1.000|3:53-U1.000|5:29-U0.183|0:59,,"Balve Running",,,3113,,250,3,11604580969,0,168070,250480,30378,,54411132,,,,,,,,,,,,,,,,,,,,,,,,,,,,,,,,,,,,,,,,"3,4",
72334061,a7f1b64c-0761-4807-9e65-0b392bcca142,1689942291,120,1689940633,,0,0,14.18,4665,4835,392,391,414,412,0,4.1,0.82,0.92,1.09,424,959,145,163,115,150,23,50.69,36.89,52.43,1,59.47,1604,129,,3.4,0,102,96,,,,,,49,79,11.65,11.83,11.79,-9.8,1.5,265,265,,1,267,267,,,,,,,,,"29,13,11,11,15,19,2,0,0","0,29,69,2,0","0,1,89,10,0",,,,,115,,,,,,,,,,,,,,,,,,,,,,,,,,,,,,,,,,,,10.7,19,11,260,62,,1011,4,,0,4,4,Balve,1,0,U1.000|5:03-U1.000|5:06-U1.000|6:31-U1.000|6:35-U1.000|6:15-U1.000|6:23-U1.000|6:44-U1.000|6:06-U1.000|4:52-U1.000|4:31-U1.000|4:18-U1.000|4:18-U1.000|4:14-U1.000|5:46-U0.181|1:02,,"Balve Running",,,3113,,250,3,11609684848,0,168070,250480,30378,,54463475,,,,,,,,,,,,,,,,,,,,,,,,,,,,,,,,,,,,,,,,3,
72385004,35974656-157d-41e6-8fc2-21e49df1e96c,1690017110,120,1690012969,,0,0,6.73,2140,2378,64,44,91,73,0,0.2,0.28,1.04,0.99,,442,141,160,114,160,17,54.86,36.39,55.71,1,59.45,1117,66,,2.6,0,101,98,,,,,,32,79,11.46,11.34,11.52,2,1.6,271,271,,1,274,274,,,,,,,,,"4,6,17,48,22,3,0,0,0","1,33,66,0,0","0,1,85,14,0",,,,,119,,,,,,,,,,,,,,,,,,,,,,,,,,,,,,,,,,,,13.1,15,5,185,69,,1015,2,,0,4,4,"Wahlkreis Bonn I",1,0,U1.000|5:16-U1.000|5:02-U1.000|5:36-U1.000|5:29-U1.000|5:21-U1.000|5:16-U0.725|3:39,,"Bonn Running",,,3113,,250,3,11615087656,0,168070,250480,30378,,54510921,,,,,,,,,,,,,,,,,,,,,,,,,,,,,,,,,,,,,,,,,
72479803,937b75ad-d3a0-434b-9dc5-c0012a3a3ab8,1690140232,120,1690135177,,0,0,3.36,1149,1196,108,102,108,101,0,2.5,0.94,,,593,218,130,151,,138,19,55.56,32,57.9,1,59.45,647,34,,2.1,0,100,99,,,,,,20,79,11.11,10.87,11.59,-2,17.1,255,255,,1,273,273,,,,,,,,,"27,14,12,23,20,4,0,0,0","1,65,34,0,0","0,23,45,31,0",,,,,111,,,,,,,,,,,,,,,,,,,,,,,,,,,,,,,,,,,,18.6,20,18,213,69,,1008,0,,0,4,4,Balve,1,0,U1.000|5:53-U1.000|6:10-U1.000|5:23-U0.358|1:44,,"Balve Running",,,3113,,250,3,11626977904,0,168070,250480,30378,,54597367,,,,,,,,,,,,,,,,,,,,,,,,,,,,,,,,,,,,,,,,4,
72536415,6b8fdb8d-a80a-4118-9cae-de095c389dd7,1690222025,120,1690219363,,0,0,13,4340,4445,233,237,253,259,0,2.7,0.7,0.95,1.03,290,854,140,159,,157,23,52.15,36.01,53.28,1,59.41,1244,97,,3.1,0,98,98,,,,,,86,80,10.99,11.02,11.11,2.8,6.1,253,253,,1,259,259,,,,,,,,,"15,10,21,35,18,2,0,0,0","0,52,48,0,0","0,2,91,7,0",,,,,112,,,,,,,,,,,,,,,,,,,,,,,,,,,,,,,,,,,,24.4,18,17,255,75,,1003,1,,0,3,4,Balve,1,0,U1.000|5:48-U1.000|5:06-U1.000|5:35-U1.000|5:27-U1.000|5:37-U1.000|5:49-U1.000|5:37-U1.000|5:14-U1.000|5:54-U1.000|6:22-U1.000|4:49-U1.000|4:54-U1.000|6:07-U0.002|0:01,,"Balve Running",,,3113,,250,3,11633337978,0,168070,250480,30378,,54649932,,,,,,,,,,,,,,,,,,,,,,,,,,,,,,,,,,,,,,,,"5,5,5",
72662074,62b1f99e-b9f9-4bfa-9cbd-f02143d09121,1690309860,120,1690373971,,0,0,6.2,1910,2267,60,57,76,70,0,0,0.19,1.09,0.55,407,408,143,165,,152,38,56,37.59,56.7,1,59.46,1164,99,,3,0.9,104,101,,,,,,17,79,11.68,13.33,14.01,16.3,-28.6,282,282,,1,361,361,,,,,,,,,"19,5,4,5,27,33,2,4,2","3,24,69,5,0","9,7,22,56,6",,,,,123,,,,,,,,,,,,,,,,,,,,,,,,,,,,,,,,,,,,7.8,17,13,314,58,,1008,1,,0,4,4,Frondenberg/Ruhr,1,0,U1.000|4:45-U1.000|4:32-U1.000|4:26-U1.000|4:20-U0.420|4:36-U0.814|4:01-U0.407|2:12-U0.560|2:59,,"Fröndenberg/Ruhr Running",,,3113,,250,3,11646224296,0,168070,250480,30378,,54755880,,,,,,,,,,,,,,,,,,,,,,,,,,,,,,,,,,,,,,,,5,
72662082,d012a93b-8894-4219-b978-fdd19fac49b0,1690312226,120,1690373985,,0,0,2.97,988,988,0,0,0,0,0,0,0,,,,217,147,181,,173,57,49.08,32.77,49.08,1,59.47,1861,135,,2.9,2.5,105,105,,,,,,15,82,10.81,14.55,14.55,49.4,17.7,271,271,,1,375,375,,,,,,,,,"41,2,1,2,1,2,24,28,1","1,36,32,31,1","35,5,6,4,51",,,,,110,,,,,,,,,,,,,,,,,,,,,,,,,,,,,,,,,,,,29.1,16,14,317,59,,1008,1,,0,4,4,Frondenberg/Ruhr,1,0,U0.990|3:29-U0.500|1:46-U0.290|4:22-U1.000|3:30-U0.100|0:24-U0.090|2:57,,"Fröndenberg/Ruhr Track Running",,,3113,,250,3,11646225962,0,168070,250480,30378,,54755886,,,,,,,,,,,,,,,,,,,,,,,,,,,,,,,,,,,,,,,,,
72662091,5b4b79ab-8eb2-4489-8837-b2a72a7528d2,1690313456,120,1690373996,,0,0,5.03,1479,1538,28,34,57,64,0,0,0,,,,333,147,154,,154,9,57.15,39.24,57.46,1,59.47,2592,73,,2.8,0,100,100,,,,,,13,81,12.2,12.28,12.24,-0.4,-0.6,291,291,,1,293,293,,,,,,,,,"1,1,4,27,62,5,0,0,0","0,3,97,0,0","0,0,67,33,0",,,,,126,,,,,,,,,,,,,,,,,,,,,,,,,,,,,,,,,,,,5.3,16,13,320,60,,1008,0,,0,4,4,Frondenberg/Ruhr,1,0,U1.000|4:58-U1.000|4:51-U1.000|4:49-U1.000|4:52-U1.000|5:01-U0.028|0:10,,"Fröndenberg/Ruhr Running",,,3113,,250,3,11646227426,0,168070,250480,30378,,54755894,,,,,,,,,,,,,,,,,,,,,,,,,,,,,,,,,,,,,,,,,
72679782,c086a208-a624-4bbf-80a6-6bcf94b1aa44,1690391587,120,1690388915,,0,0,13.39,4156,4186,219,219,250,252,0,2.3,0.57,0.97,1.04,561,865,143,158,,153,19,55.48,39.31,56.61,1,59.46,1734,115,,3.2,0,100,98,,,,,,77,80,11.82,11.86,11.92,1.5,0.6,277,277,,1,282,282,,,,,,,,,"8,6,15,27,31,12,1,0,0","0,33,67,0,0","0,3,72,26,0",,,,,121,,,,,,,,,,,,,,,,,,,,,,,,,,,,,,,,,,,,21.3,17,14,268,67,,1013,2,,0,2,4,Balve,1,0,U1.000|5:03-U1.000|5:26-U1.000|5:01-U1.000|4:49-U1.000|5:37-U1.000|4:54-U1.000|5:39-U1.000|5:08-U1.000|4:49-U1.000|4:44-U1.000|4:59-U1.000|5:24-U1.000|5:27-U0.392|2:15,,"Balve Running",,,3113,,250,3,11647964428,0,168070,250480,30378,,54772522,,,,,,,,,,,,,,,,,,,,,,,,,,,,,,,,,,,,,,,,"5,5,5",
72769752,43437959-214e-49f9-8454-41e00cdbcc35,1690484209,120,1690482459,,0,0,16.94,5323,5352,332,326,351,346,0,3.5,0.72,0.97,1.08,582,1148,145,166,,164,24,53.64,39.48,54.96,1,59.44,1886,160,,3.7,0,97,99,,,,,,109,81,11.84,11.84,11.96,-4.8,2,275,275,,1,280,280,,,,,,,,,"13,8,15,22,26,14,1,0,0","0,30,66,4,0","0,2,79,19,0",,,,,118,,,,,,,,,,,,,,,,,,,,,,,,,,,,,,,,,,,,38.1,18,17,240,85,,1006,0,,0,6,4,Balve,1,0,U1.000|5:28-U1.000|4:44-U1.000|5:06-U1.000|5:09-U1.000|5:16-U1.000|5:27-U1.000|6:03-U1.000|6:56-U1.000|5:55-U1.000|5:26-U1.000|4:24-U1.000|4:24-U1.000|4:23-U1.000|4:38-U1.000|5:08-U1.000|5:28-U0.940|4:46,,"Balve Running",,,3113,,250,3,11656083361,0,168070,250480,30378,,54858061,,,,,,,,,,,,,,,,,,,,,,,,,,,,,,,,,,,,,,,,4,
72816140,c77c2796-198f-4055-92f0-2db538961b74,1690550683,120,1690547783,,0,0,13.24,4118,4256,354,331,369,344,0,3.8,0.83,0.94,1.06,467,899,149,172,,161,18,52.34,39.18,54.18,1,59.42,1885,146,,3.5,0,103,97,,,,,,68,81,12.32,12.31,12.46,-4.6,8.8,285,285,,1,292,292,,,,,,,,,"17,14,12,13,15,25,4,0,0","0,22,71,6,0","0,1,67,32,1",,,,,119,,,,,,,,,,,,,,,,,,,,,,,,,,,,,,,,,,,,24.1,19,13,243,81,,1009,4,,0,4,4,Balve,1,0,U1.000|4:48-U1.000|4:59-U1.000|6:11-U1.000|5:49-U1.000|5:49-U1.000|5:41-U1.000|6:09-U1.000|5:22-U1.000|4:27-U1.000|4:13-U1.000|4:17-U1.000|4:09-U1.000|5:25-U0.238|1:18,,"Balve Running",,,3113,,250,3,11660659025,0,168070,250480,30378,,54895416,,,,,,,,,,,,,,,,,,,,,,,,,,,,,,,,,,,,,,,,"4,5",
72877283,ab14096c-a5cb-4f02-81f0-ce0fe2b468c7,1690628968,120,1690625593,,0,0,11.09,3278,3592,225,263,247,286,0,3.1,0.69,0.99,1,456,736,154,178,140,164,21,53.2,41.02,54.31,1,59.4,1596,140,,3.4,0.2,100,98,,,,,,67,81,12.53,12.53,12.86,0,-5.1,294,294,,1,309,309,,,,,,,,,"7,5,9,20,33,19,8,0,0","0,14,51,34,0","0,7,48,41,4",,,,,125,,,,,,,,,,,,,,,,,,,,,,,,,,,,,,,,,,,,42.9,20,14,245,73,,1008,4,,0,4,4,Sundern,1,0,U1.000|5:23-U1.000|5:04-U1.000|4:46-U1.000|4:43-U1.000|5:26-U1.000|4:39-U1.000|4:38-U1.000|5:54-U1.000|4:36-U1.000|4:13-U1.000|4:49-U0.091|0:26,,"Sundern (Sauerland) Running",,,3113,,250,3,11666731216,0,168070,250480,30378,,54951860,,,,,,,,,,,,,,,,,,,,,,,,,,,,,,,,,,,,,,,,"4,4",
72890427,39d7a8aa-d334-44da-bcc3-2d5bc7083a66,1690635451,120,1690640918,,0,0,12.56,11241,11241,323,264,401,345,0,3.4,0.63,,,148,857,97,133,69,120,39,,,,1,59.47,1361,17,,1.2,0,,100,,,,,,25,56,,5.76,,23.8,,,,,,,,,,,,,,,,"71,29,0,0,0,0","66,34,0,0,0",,,,,,,,,,,,,,,,,,,,,,,,,,,,,,,,,,,,,,,,,,2.4,22,16,245,64,,1008,5,,0,4,4,Balve,1,0,,,"Balve Hiking",,,3113,,250,3,11668626588,0,168075,,30378,,54963641,,,,,,,,,,,,,,,,,,,,,,,,,,,,,,,,,,,,,,,,"4,5",
72930840,6a72623a-b5db-4f9d-8f12-201534d6d59c,1690709287,120,1690708136,,0,0,17.02,5232,5712,378,366,385,382,0,4,0.68,0.97,1.07,627,1094,145,164,,162,21,55.11,40.52,56.68,1,59.4,1587,143,,3.5,0,100,100,,,,,,54,81,12.24,12.35,12.57,-3.2,4.9,286,286,,1,296,296,,,,,,,,,"14,11,11,20,19,21,5,0,0","0,31,66,3,0","0,0,69,29,1",,,,,120,,,,,,,,,,,,,,,,,,,,,,,,,,,,,,,,,,,,11.5,15,17,232,78,,1012,2,,0,4,4,Balve,1,0,U1.000|5:31-U1.000|4:42-U1.000|5:15-U1.000|5:13-U1.000|5:20-U1.000|5:31-U1.000|6:14-U1.000|6:54-U1.000|5:48-U1.000|4:58-U1.000|4:13-U1.000|4:14-U1.000|4:09-U1.000|4:20-U1.000|5:01-U1.000|4:56-U1.000|4:48-U0.016|0:04,,"Balve Running",,,3113,,250,3,11673454874,0,168070,250480,30378,,55000979,,,,,,,,,,,,,,,,,,,,,,,,,,,,,,,,,,,,,,,,4,
73039424,c8e20991-35e7-42fb-a143-3e1fb6a11f8d,1690829356,120,1690827652,,0,0,13.11,4321,4845,366,334,357,333,0,3.9,0.88,1,1.17,426,857,139,160,97,159,24,53.47,36.58,55.48,1,59.36,1305,108,,3.2,0,96,99,,,,,,73,80,11.61,11.71,11.86,-11.5,2.2,266,266,,1,274,274,,,,,,,,,"27,14,16,11,9,17,5,0,0","1,50,50,0,0","0,4,82,14,0",,,,,114,,,,,,,,,,,,,,,,,,,,,,,,,,,,,,,,,,,,22.3,17,17,212,86,,1006,0,,0,6,4,Balve,1,0,U1.000|6:03-U1.000|6:16-U1.000|6:03-U1.000|6:43-U1.000|6:40-U1.000|5:52-U1.000|5:35-U1.000|5:32-U1.000|5:34-U1.000|4:29-U1.000|4:14-U1.000|4:20-U1.000|4:13-U0.108|0:28,,"Balve Running",,,3113,,250,3,11684660520,0,168070,250480,30378,,55094207,,,,,,,,,,,,,,,,,,,,,,,,,,,,,,,,,,,,,,,,3,
73118784,4843fece-d1a5-4701-9da1-b8e0a432cfc2,1690914758,120,1690923985,,0,0,5.49,1644,2067,33,29,46,40,0,0,0.04,,,,336,136,148,,141,31,61.9,38.6,62.42,1,59.42,932,67,,2.6,0.3,102,102,,,,,,28,79,12.08,13.8,14.42,6.4,-44.3,291,291,,1,381,381,,,,,,,,,"18,3,2,6,51,14,0,1,5","2,50,48,0,0","3,11,36,44,5",,,,,127,,,,,,,,,,,,,,,,,,,,,,,,,,,,,,,,,,,,19.2,19,18,256,67,,1002,1,,0,3,4,Frondenberg/Ruhr,1,0,U1.000|4:52-U1.000|4:41-U1.000|4:37-U1.000|4:41-U0.214|1:09-U0.368|2:04-U0.158|0:29-U0.208|1:36-U0.358|2:33-U0.189|0:42,,"Fröndenberg/Ruhr Running",,,3113,,250,3,11693300745,0,168070,250480,30378,,55167563,,,,,,,,,,,,,,,,,,,,,,,,,,,,,,,,,,,,,,,,,
73118791,3ffd536e-c2e7-4364-9307-bc6cda52dc1c,1690918204,120,1690924006,,0,0,0.01,23,234,0,2,0,0,0,1.2,1,,,,4,121,128,109,,,,,,1,59.42,2027,9,,0.6,0,,100,,,,,,0,66,2.93,2.22,2.94,88.4,17.6,21,21,,1,21,21,,,,,,,,,"100,0,0,0,0,0,0,0,0","4,96,0,0,0","100,0,0,0,0",,,,,20,,,,,,,,,,,,,,,,,,,,,,,,,,,,,,,,,,,,,18,18,257,67,,1002,1,,0,2,4,Fröndenberg,1,0,,,"Fröndenberg/Ruhr Running",,,3113,,250,3,11693302397,0,168070,250480,30378,,55167567,,,,,,,,,,,,,,,,,,,,,,,,,,,,,,,,,,,,,,,,,
73118793,dede5364-9194-4de6-9dbe-e578341e76be,1690916997,120,1690924005,,0,0,3.49,987,987,0,0,0,0,0,0,0,,,,224,150,174,77,172,57,58.31,40.11,58.31,1,59.42,2034,130,,2.7,2.5,107,104,,,,,,27,80,12.74,14.7,14.7,30.2,17.2,317,317,,1,377,377,,,,,,,,,"27,5,4,2,2,5,25,28,1","0,30,35,35,0","14,14,12,13,47",,,,,133,,,,,,,,,,,,,,,,,,,,,,,,,,,,,,,,,,,,41.8,18,18,257,67,,1002,1,,0,2,4,Fröndenberg,1,0,U0.590|2:01-U0.400|1:29-U0.210|1:28-U0.590|1:59-U0.200|1:32-U0.600|2:08-U0.200|1:43-U0.600|2:10-U0.100|1:57,,"Fröndenberg/Ruhr Track Running",,,3113,,250,3,11693302198,0,168070,250480,30378,,55167569,,,,,,,,,,,,,,,,,,,,,,,,,,,,,,,,,,,,,,,,,
73242308,d9fd6f79-b4c9-46ab-9d15-a0aff6ae6220,1691004869,120,1691086285,,0,0,15.35,4773,5012,384,371,389,376,0,3.9,0.86,0.94,1.04,518,985,142,162,92,161,18,55.88,39.65,57.67,1,59.4,1413,123,,3.3,0,97,99,,,,,,109,80,12.29,12.5,12.41,-2.7,-0.2,284,284,,1,287,287,,,,,,,,,"17,16,13,12,13,18,11,0,0","1,26,73,0,0","0,0,72,28,0",,,,,121,,,,,,,,,,,,,,,,,,,,,,,,,,,,,,,,,,,,31.1,18,16,235,80,,993,0,,0,6,4,Balve,1,0,U1.000|5:58-U1.000|6:30-U1.000|6:01-U1.000|6:40-U1.000|4:51-U1.000|4:40-U1.000|4:22-U1.000|5:05-U1.000|6:47-U1.000|5:37-U1.000|5:12-U1.000|4:23-U1.000|3:58-U1.000|4:09-U1.000|3:56-U0.351|1:27,,"Balve Running",,,3113,,250,3,11707162033,0,168070,250480,30378,,55275442,,,,,,,,,,,,,,,,,,,,,,,,,,,,,,,,,,,,,,,,"4,4",
73242347,1ded9438-1b1a-457e-9d67-6f0c2f251a31,1691089411,120,1691086323,,0,0,11.81,3624,3832,152,159,160,172,0,1.6,0.44,0.96,1.01,476,740,139,154,115,154,23,58.41,39.45,59.29,1,59.41,1222,91,,3,0,99,100,,,,,,76,79,11.85,11.98,11.98,-1.1,-1.6,279,279,,1,284,284,,,,,,,,,"7,5,12,27,37,10,2,0,0","1,49,50,0,0","0,1,73,26,0",,,,,124,,,,,,,,,,,,,,,,,,,,,,,,,,,,,,,,,,,,29.1,16,15,270,84,,1005,0,,0,4,4,Balve,1,0,U1.000|5:33-U1.000|4:55-U1.000|5:20-U1.000|4:59-U1.000|5:21-U1.000|5:33-U1.000|5:19-U1.000|5:04-U1.000|4:40-U1.000|4:28-U1.000|4:23-U0.806|4:48,,"Balve Running",,,3113,,250,3,11707167210,0,168070,250480,30378,,55275481,,,,,,,,,,,,,,,,,,,,,,,,,,,,,,,,,,,,,,,,5,
73306804,5410b46b-b61b-48f2-ad58-2bbd0cf5defe,1691170327,120,1691170338,,0,0,18.01,5743,5924,471,447,498,477,0,4.4,0.83,0.96,1.06,479,1195,140,166,,162,27,55.18,39,57.06,1,59.39,1595,152,,3.6,0,98,99,,,,,,31,80,11.93,11.78,12.06,-3.8,3.6,275,275,,1,281,281,,,,,,,,,"15,14,16,14,22,17,1,0,0","0,44,54,1,0","0,3,73,24,0",,,,,118,,,,,,,,,,,,,,,,,,,,,,,,,,,,,,,,,,,,6.7,18,11,302,71,,1014,1,,0,4,4,Balve,1,0,U1.000|5:36-U1.000|6:10-U1.000|5:51-U1.000|6:15-U1.000|6:11-U1.000|4:52-U1.000|5:37-U1.000|5:07-U1.000|4:34-U1.000|5:51-U1.000|6:16-U1.000|5:23-U1.000|5:06-U1.000|4:33-U1.000|4:30-U1.000|4:20-U1.000|4:28-U1.000|4:59-U0.005|0:02,,"Balve Running",,,3113,,250,3,11713947998,0,168070,250480,30378,,55333619,,,,,,,,,,,,,,,,,,,,,,,,,,,,,,,,,,,,,,,,"3,4",
73335808,b2bf1f0b-e12c-4862-bb83-4ee5b4f7472e,1691226517,120,1691224090,,0,0,14.44,4573,4612,216,208,248,242,0,2.8,0.63,0.95,1.05,366,965,145,166,,157,24,53.13,38.62,54.14,1,59.37,1598,131,,3.4,0,98,98,,,,,,18,80,11.64,11.64,11.69,-2.3,-0.4,271,271,,1,274,274,,,,,,,,,"12,5,14,31,29,9,1,0,0","0,25,74,1,0","0,0,86,14,0",,,,,118,,,,,,,,,,,,,,,,,,,,,,,,,,,,,,,,,,,,3.1,15,6,195,82,,1015,2,,0,4,4,Balve,1,0,U1.000|5:03-U1.000|5:04-U1.000|4:58-U1.000|5:09-U1.000|5:18-U1.000|5:36-U1.000|5:25-U1.000|5:00-U1.000|5:17-U1.000|4:54-U1.000|5:02-U1.000|7:25-U1.000|4:57-U1.000|4:40-U0.440|2:26,,"Balve Running",,,3113,,250,3,11717250546,0,168070,250480,30378,,55360571,,,,,,,,,,,,,,,,,,,,,,,,,,,,,,,,,,,,,,,,"4,4",
73432894,26e29540-3c44-4d1c-b4b1-1f3a1ddce6f0,1691333049,120,1691347175,,0,0,20.52,6363,6842,449,446,455,464,0,4.1,0.72,0.96,1.05,552,1305,140,166,,154,23,57.12,40.71,58.68,1,59.35,1738,161,,3.7,0,98,99,,,,,,107,80,12.15,12.22,12.25,-2.2,3.6,282,282,,1,286,286,,,,,,,,,"15,15,13,11,17,27,2,0,0","0,48,51,1,0","0,0,77,23,0",,,,,121,,,,,,,,,,,,,,,,,,,,,,,,,,,,,,,,,,,,24.4,16,16,282,84,,1006,3,,0,6,4,Balve,1,0,U1.000|5:42-U1.000|6:16-U1.000|5:53-U1.000|6:31-U1.000|4:46-U1.000|4:38-U1.000|4:26-U1.000|5:20-U1.000|6:22-U1.000|5:57-U1.000|6:18-U1.000|5:19-U1.000|5:19-U1.000|5:04-U1.000|4:29-U1.000|4:17-U1.000|4:12-U1.000|4:16-U1.000|4:23-U1.000|4:21-U0.516|2:15,,"Balve Running",,,3113,,250,3,11728962220,0,168070,250480,30378,,55449398,,,,,,,,,,,,,,,,,,,,,,,,,,,,,,,,,,,,,,,,"4,4,5",
73476703,a8945e8b-48d8-482f-940a-2c18bc4a4d27,1691411646,120,1691422903,,0,0,13.1,3938,4003,197,214,218,237,0,2.4,0.57,0.96,1.08,347,857,149,170,,159,22,54.58,40.73,55.51,1,59.34,1465,130,,3.4,0,97,99,,,,,,21,80,12.11,12.36,12.28,-2.9,-1.3,284,284,,1,291,291,,,,,,,,,"8,8,11,18,31,18,5,0,0","0,15,80,5,0","0,0,70,29,0",,,,,125,,,,,,,,,,,,,,,,,,,,,,,,,,,,,,,,,,,,5.6,14,19,284,86,,1015,4,,0,4,4,Balve,1,0,U1.000|5:24-U1.000|4:48-U1.000|5:05-U1.000|5:00-U1.000|5:15-U1.000|5:25-U1.000|5:07-U1.000|4:31-U1.000|5:11-U1.000|5:38-U1.000|4:08-U1.000|4:13-U1.000|5:20-U0.101|0:35,,"Balve Running",,,3113,,250,3,11734269595,0,168070,250480,30378,,55488062,,,,,,,,,,,,,,,,,,,,,,,,,,,,,,,,,,,,,,,,5,
73533815,3606bc0a-be16-4274-9430-c05a9d2a9ece,1691506814,120,1691499637,,0,0,0.08,15,15,0,0,0,0,0,0,0,,,,2,,,,,,,,,1,,,,,,,,,150,,,,,0,90,,18,,,,150,150,,0,150,150,,,,,,,,,"27,33,40,0,0,0,0",,"0,100,0,0,0",,,,,,,,,,,,,,,,,,,,,,,,,,,,,,,,,,,,,,,,,,,,,,,,,,0,1,,,1,1,,,,,,315-0,,,7,,0,168072,,30378,,55540214,,,,,,,,,,,,,,,,,,,,,,,,,,,,,,,,,,,,,,,,,
73561428,eec866b6-ddb7-462c-8fc5-2249b0eff066,1691519545,120,1691521273,,0,0,5.05,1362,1611,33,24,49,40,0,0,0.13,,,,318,146,157,,152,6,64.18,43.46,64.84,1,59.41,1106,81,,2.9,0,104,102,,,,,,13,81,13.43,13.64,14.48,0.2,-24.9,329,329,,1,371,371,,,,,,,,,"3,6,2,3,23,57,2,4,1","1,19,80,0,0","0,2,9,84,5",,,,,137,,,,,,,,,,,,,,,,,,,,,,,,,,,,,,,,,,,,7.6,18,17,260,63,,1013,1,,0,4,4,Frondenberg/Ruhr,1,0,U1.000|4:40-U1.000|4:22-U1.000|4:20-U1.000|4:22-U0.666|3:10-U0.205|0:58-U0.182|0:50,,"Fröndenberg/Ruhr Running",,,3113,,250,3,11743662269,0,168070,250480,30378,,55564444,,,,,,,,,,,,,,,,,,,,,,,,,,,,,,,,,,,,,,,,,
73561429,39a5338d-27bc-497d-8363-b828e58fccf4,1691524401,120,1691521273,,0,0,2.67,946,946,30,14,42,25,0,0,0.16,1.18,,829,189,136,152,,149,15,50.3,30.18,51.37,1,59.43,3456,33,,2.1,0,97,100,,,,,,4,78,10.4,10.17,11.62,-4,16,243,243,,1,277,277,,,,,,,,,"16,21,43,17,3,0,0,0,0","0,81,19,0,0","0,3,91,2,3",,,,,109,,,,,,,,,,,,,,,,,,,,,,,,,,,,,,,,,,,,1.8,17,13,258,66,,1013,0,,0,4,4,Frondenberg/Ruhr,1,0,U1.000|6:14-U1.000|5:49-U0.671|3:43,,"Fröndenberg/Ruhr Running",,,3113,,250,3,11743662519,0,168070,250480,30378,,55564445,,,,,,,,,,,,,,,,,,,,,,,,,,,,,,,,,,,,,,,,5,
73561430,987c176c-5dcc-4ef4-b17e-fa06d2b94d94,1691521197,120,1691521273,,0,0,8.84,2596,2596,0,0,0,0,0,0,0,,,,604,154,184,,173,52,53.63,40.68,53.63,1,59.43,2880,215,,3.8,2.1,104,100,,,,,,48,80,12.27,14.41,14.41,19.1,9.7,305,305,,1,367,367,,,,,,,,,"26,2,2,3,4,16,30,17,0","2,21,31,45,1","19,6,10,31,35",,,,,128,,,,,,,,,,,,,,,,,,,,,,,,,,,,,,,,,,,,42.7,17,16,262,64,,1013,1,,0,4,4,Frondenberg/Ruhr,1,0,U1.610|5:30-U0.480|3:42-U1.600|5:53-U0.400|2:56-U1.600|6:09-U0.210|6:02-U0.910|4:33-U1.200|4:40-U0.400|1:32-U0.400|1:23-U0.030|0:56,,"Fröndenberg/Ruhr Track Running",,,3113,,250,3,11743662439,0,168070,250480,30378,,55564447,,,,,,,,,,,,,,,,,,,,,,,,,,,,,,,,,,,,,,,,,
73626435,610075e8-7b1f-498e-be5b-985c260ad6b6,1691604087,120,1691599056,,0,0,6.68,2113,2125,95,93,124,122,0,1.7,0.62,0.97,1.04,,425,136,152,,149,21,57.85,36.6,58.89,1,59.43,2110,58,,2.5,0,100,100,,,,,,8,78,11.52,11.59,11.62,-0.4,-1.7,270,270,,1,274,274,,,,,,,,,"4,6,30,24,31,6,0,0,0","1,74,25,0,0","0,1,86,13,0",,,,,122,,,,,,,,,,,,,,,,,,,,,,,,,,,,,,,,,,,,1.9,18,10,275,64,,1018,2,,0,3,4,Balve,1,0,U1.000|5:43-U1.000|4:48-U1.000|5:21-U1.000|5:09-U1.000|5:32-U1.000|5:25-U0.679|3:15,,"Balve Running",,,3113,,250,3,11750222344,0,168070,250480,30378,,55623858,,,,,,,,,,,,,,,,,,,,,,,,,,,,,,,,,,,,,,,,,
73706537,1d0d138d-fda3-4112-a43f-87c89d97b7c8,1691690034,120,1691702900,,0,0,16.63,5162,5589,342,309,357,330,0,3.7,0.72,0.96,1.06,601,1061,140,160,,158,22,57.05,39.99,58.64,1,59.42,1461,128,,3.4,0,98,100,,,,,,27,79,12.09,12.21,12.34,-6.1,-4.7,283,283,,1,292,292,,,,,,,,,"14,10,14,20,20,18,5,0,0","0,50,50,0,0","0,1,74,24,2",,,,,122,,,,,,,,,,,,,,,,,,,,,,,,,,,,,,,,,,,,4.9,19,5,1,63,,1021,1,,0,2,4,Balve,1,0,U1.000|5:40-U1.000|4:47-U1.000|5:21-U1.000|5:11-U1.000|5:18-U1.000|5:33-U1.000|6:09-U1.000|6:53-U1.000|6:02-U1.000|4:42-U1.000|4:13-U1.000|4:18-U1.000|4:11-U1.000|4:25-U1.000|5:14-U1.000|5:11-U0.625|2:55,,"Balve Running",,,3113,,250,3,11759931936,0,168070,250480,30378,,55697514,,,,,,,,,,,,,,,,,,,,,,,,,,,,,,,,,,,,,,,,4,
73764131,f34bed3d-7b1e-4657-965c-ed3e83358de7,1691771427,120,1691784185,,0,0,16.56,5123,5480,343,315,382,355,0,3.4,0.69,0.99,1.09,432,1073,146,166,,156,32,54.18,40.13,55.68,1,59.41,1460,140,,3.5,0.1,99,100,,,,,,61,80,12.13,12.29,12.42,-1.4,1.4,284,284,,1,293,293,,,,,,,,,"13,10,10,23,20,19,5,0,0","0,23,74,3,0","1,1,66,32,0",,,,,121,,,,,,,,,,,,,,,,,,,,,,,,,,,,,,,,,,,,15.3,26,9,218,51,,1020,3,,0,4,4,Balve,1,0,U1.000|5:33-U1.000|4:43-U1.000|5:12-U1.000|5:11-U1.000|5:20-U1.000|5:42-U1.000|6:26-U1.000|6:28-U1.000|6:53-U1.000|4:36-U1.000|4:16-U1.000|4:09-U1.000|4:07-U1.000|4:20-U1.000|4:47-U1.000|5:02-U0.556|2:38,,"Balve Running",,,3113,,250,3,11766823710,0,168070,250480,30378,,55750611,,,,,,,,,,,,,,,,,,,,,,,,,,,,,,,,,,,,,,,,"4,5",
73875148,ba085107-9f54-48ce-b9f8-52effb6ad905,1691920876,120,1691930229,,0,0,27.16,8461,9073,634,583,675,635,0,4.4,0.7,1,1.1,473,1794,152,175,,165,26,50.8,41.34,52.38,1,59.38,2894,252,,4.5,0.3,98,98,,,,,,216,81,12.09,12.08,12.27,1.3,2.6,282,282,,1,289,289,,,,,,,,,"14,12,15,14,21,21,4,0,0","0,13,68,19,0","0,1,69,29,0",,,,,119,,,,,,,,,,,,,,,,,,,,,,,,,,,,,,,,,,,,46.1,20,6,203,67,,1018,4,,0,4,4,Balve,1,0,U1.000|5:37-U1.000|6:14-U1.000|5:48-U1.000|6:11-U1.000|6:04-U1.000|4:44-U1.000|5:38-U1.000|5:01-U1.000|4:22-U1.000|5:46-U1.000|5:28-U1.000|4:57-U1.000|4:31-U1.000|4:10-U1.000|4:39-U1.000|4:34-U1.000|4:19-U1.000|4:26-U1.000|4:56-U1.000|5:13-U1.000|5:18-U1.000|6:16-U1.000|6:09-U1.000|5:37-U1.000|4:30-U1.000|4:28-U1.000|5:15-U0.156|0:52,,"Balve Running",,,3113,,250,3,11778952034,0,168070,250480,30378,,55851367,,,,,,,,,,,,,,,,,,,,,,,,,,,,,,,,,,,,,,,,"3,4,5,5",
73982749,d652891b-c9bc-49b6-a7fc-abfcebfb726a,1692035654,120,1692048238,,0,0,15.21,4941,5137,386,357,396,368,0,4.2,0.86,1.01,1.15,489,979,141,158,112,147,15,53.44,37.65,55.24,1,59.35,1473,109,,3.2,0,97,97,,,,,,107,79,11.76,12.12,12.02,-2.7,-1.5,269,269,,1,276,276,,,,,,,,,"28,14,13,10,12,14,9,1,0","1,41,59,0,0","0,1,87,13,0",,,,,117,,,,,,,,,,,,,,,,,,,,,,,,,,,,,,,,,,,,29.5,24,11,194,71,,1014,1,,0,3,4,Balve,1,0,U1.000|6:17-U1.000|6:38-U1.000|6:18-U1.000|6:39-U1.000|5:07-U1.000|4:46-U1.000|4:36-U1.000|5:39-U1.000|7:01-U1.000|6:07-U1.000|5:46-U1.000|4:20-U1.000|3:55-U1.000|4:09-U1.000|4:03-U0.206|0:59,,"Balve Running",,,3113,,250,3,11789926079,0,168070,250480,30378,,55945305,,,,,,,,,,,,,,,,,,,,,,,,,,,,,,,,,,,,,,,,"4,4",
74069267,31df53ac-db49-4d5a-827e-46c3fd9d2d9f,1692124496,120,1692125601,,0,0,14.02,4418,4804,97,85,143,119,0,0,0.15,1.22,0.38,,941,151,184,,168,47,50.55,38.76,51.04,1,59.35,2992,233,,3.6,2.8,104,97,,,,,,115,79,11.58,14.03,14.5,13.6,7.7,278,278,,1,379,379,,,,,,,,,"21,4,6,22,16,17,3,5,5","1,14,64,21,0","15,4,41,30,10",,,,,121,,,,,,,,,,,,,,,,,,,,,,,,,,,,,,,,,,,,49.3,24,4,259,67,,1017,1,,0,2,4,Fröndenberg,1,0,U1.000|4:28-U1.000|4:19-U1.000|4:16-U1.000|4:09-U0.556|7:04-U0.100|0:19-U0.104|0:39-U0.105|0:19-U0.095|0:36-U0.099|0:19-U0.109|0:34-U0.103|0:19-U0.103|0:29-U0.090|0:18-U0.109|0:35-U0.096|0:17-U0.110|0:36-U0.095|0:18-U0.406|2:52-U0.823|2:38-U0.427|4:03-U0.202|0:37-U0.111|0:56-U0.200|0:35-U0.114|1:00-U0.202|0:35-U0.107|1:14-U0.192|0:35-U0.104|1:02-U0.209|0:34-U0.127|1:38-U1.000|5:21-U1.000|5:06-U1.000|5:03-U1.000|5:02-U0.925|4:54,,"Fröndenberg/Ruhr Running",,,3113,,250,3,11797302882,0,168070,250480,30378,,56022337,,,,,,,,,,,,,,,,,,,,,,,,,,,,,,,,,,,,,,,,,
74100721,9f081c13-4519-46ed-b2b1-62d677f1334a,1692178557,120,1692176458,,0,0,11.3,3995,4119,298,289,309,298,0,3.6,0.84,0.91,1.11,408,763,140,163,,151,21,48.59,33.29,50.22,1,59.33,2105,81,,2.9,0,95,96,,,,,,74,79,10.95,11.21,11.1,-15.8,-0.6,244,244,,1,247,247,,,,,,,,,"46,7,7,11,14,13,1,0,0","0,44,56,0,0","0,6,91,3,0",,,,,107,,,,,,,,,,,,,,,,,,,,,,,,,,,,,,,,,,,,23.9,19,7,37,86,,1021,2,,0,4,4,Balve,1,0,U1.000|6:40-U1.000|7:17-U1.000|6:57-U1.000|7:24-U1.000|7:06-U1.000|6:18-U1.000|4:51-U1.000|4:37-U1.000|4:42-U1.000|4:22-U1.000|4:40-U0.296|1:41,,"Balve Running",,,3113,,250,3,11800829127,0,168070,250480,30378,,56051242,,,,,,,,,,,,,,,,,,,,,,,,,,,,,,,,,,,,,,,,3,
74159121,cedc9870-84a9-436a-9f6d-7eb3540a153e,1692259945,120,1692254279,,0,0,3.65,1285,1376,17,10,26,19,0,0,0.11,,0.49,,247,128,148,,128,37,54.61,31.07,55.05,1,59.33,932,42,,2.2,0,102,100,,,,,,5,79,10.23,10.88,11.01,12.8,4.5,241,241,,1,261,261,,,,,,,,,"16,5,18,43,18,1,0,0,0","9,70,21,0,0","8,8,76,8,0",,,,,108,,,,,,,,,,,,,,,,,,,,,,,,,,,,,,,,,,,,2.3,17,11,38,86,,1019,0,,0,4,4,Neerijse,1,0,U1.000|5:00-U1.000|5:33-U1.000|7:13-U0.654|3:40,,"Huldenberg Running",,,3113,,250,3,11807942214,0,168070,250480,30378,,56103796,,,,,,,,,,,,,,,,,,,,,,,,,,,,,,,,,,,,,,,,,
74290342,0d3241af-64dc-402c-a503-52f4671281a1,1692389011,120,1692384605,,0,0,4.33,1513,1891,28,23,31,25,0,0,0.18,1.03,,,280,133,149,,143,12,52.61,31.68,53.11,1,59.33,643,38,,2.1,0,96,100,,,,,,8,79,10.41,10.37,10.48,2.9,0.2,240,240,,1,243,243,,,,,,,,,"11,24,38,21,5,1,0,0,0","1,89,9,0,0","0,4,96,0,0",,,,,109,,,,,,,,,,,,,,,,,,,,,,,,,,,,,,,,,,,,3.4,26,7,80,73,,1013,0,,0,2,4,Neerijse,1,0,U1.000|5:47-U1.000|5:37-U1.000|5:49-U1.000|6:07-U0.332|1:53,,"Huldenberg Running",,,3113,,250,3,11820056697,0,168070,250480,30378,,56223518,,,,,,,,,,,,,,,,,,,,,,,,,,,,,,,,,,,,,,,,,
74362247,41ab72d3-8ca9-4ca2-b62c-f1a0d873a64d,1692468375,120,1692473958,,0,0,7.01,2145,2223,81,77,92,87,0,1.3,0.44,0.93,1.06,391,450,143,174,,167,31,56.47,38.18,57.31,1,59.37,1164,98,,3,0.5,100,102,,,,,,19,79,12.02,12.98,12.84,4.1,-13.8,283,283,,1,313,313,,,,,,,,,"20,6,9,14,31,7,9,3,1","0,54,31,15,0","0,5,72,17,7",,,,,124,,,,,,,,,,,,,,,,,,,,,,,,,,,,,,,,,,,,18.5,25,7,259,74,,1019,1,,0,4,4,Balve,1,0,U1.000|5:41-U1.000|4:42-U1.000|4:52-U0.891|4:22-U0.101|0:22-U0.191|0:49-U0.152|0:29-U0.181|1:06-U0.167|0:35-U0.214|1:17-U1.000|3:44-U1.000|6:58-U0.108|0:48,,"Balve Running",,,3113,,250,3,11827994398,0,168070,250480,30378,,56289365,,,,,,,,,,,,,,,,,,,,,,,,,,,,,,,,,,,,,,,,5,
74415598,9c68db25-fa70-4f79-951d-295175cb1549,1692519199,120,1692537327,,0,0,4.26,1933,2382,27,24,36,32,0,0,0.05,0.8,0.27,,300,127,155,,144,36,40.29,23.02,40.64,1,59.4,874,50,,2.3,0.1,101,102,,,,,,8,75,7.96,11.13,11.34,42.7,-13.4,184,184,,1,279,279,,,,,,,,,"48,2,3,8,25,11,2,1,1","8,54,38,0,0","41,8,26,24,1",,,,,88,,,,,,,,,,,,,,,,,,,,,,,,,,,,,,,,,,,,4.4,19,4,126,93,,1022,0,,0,2,4,Phönix-West,1,0,U1.000|5:05-U1.000|4:36-U1.000|4:56-U1.000|15:09-U0.258|2:27,,"Dortmund Running",,,3113,,250,3,11833012659,0,168070,250480,30378,,56330113,,,,,,,,,,,,,,,,,,,,,,,,,,,,,,,,,,,,,,,,,
74415608,e69507c5-4278-40bf-b89a-6a1586480a56,1692522001,120,1692537335,,0,0,5.02,1126,1126,16,20,16,19,0,0,0.04,,,,309,176,184,,178,6,60.94,53.91,61.12,1,59.39,2024,142,,3.5,0.1,103,99,,,,,,43,85,16.03,16.22,16.29,11.9,15.7,409,409,,1,418,418,,,,,,,,,"0,0,0,0,0,8,76,14,0","0,3,3,66,28","0,0,0,50,50",,,,,157,,,,,,,,,,,,,,,,,,,,,,,,,,,,,,,,,,,,74.6,20,4,118,89,,1022,1,,0,2,4,Phönix-West,1,0,U1.000|3:32-U1.000|3:43-U1.000|3:42-U1.000|3:52-U1.000|3:53-U0.017|0:04,,"Dortmund Running",,,3113,,250,3,11833014041,0,168070,250480,30378,,56330121,,,,,,,,,,,,,,,,,,,,,,5,1126,,,0,"DO IT FAST",,,,,,,0,0,30378,74415608,16927,,,
74415615,933a7462-f014-4033-840b-9f1428bb8d11,1692523830,120,1692537340,,0,0,0.56,294,294,17,7,18,7,0,1.1,0.63,1.36,0.67,,43,122,135,,125,25,35.23,16.08,37.36,1,59.4,2009,6,,0.3,0,,100,,,,,,1,71,7.11,7.41,8.96,40.8,49.9,166,166,,1,216,216,,,,,,,,,"93,4,1,1,0,0,0,0,0","3,97,0,0,0","29,29,37,5,0",,,,,80,,,,,,,,,,,,,,,,,,,,,,,,,,,,,,,,,,,,0.4,21,3,90,86,,1023,3,,0,2,4,Phönix-West,1,0,,,"Dortmund Running",,,3113,,250,3,11833014508,0,168070,250480,30378,,56330126,,,,,,,,,,,,,,,,,,,,,,,,,,,,,,,,,,,,,,,,,
74562835,f680959f-73f0-4057-99db-67fcfca71a60,1692708554,120,1692704579,,0,0,7.66,2375,3168,119,94,148,123,0,1.8,0.51,1.06,0.99,301,500,143,162,,160,21,55.56,37.8,56.85,1,59.37,1222,93,,3,0.4,97,102,,,,,,28,78,11.86,12.28,12.93,3.3,-23.2,283,283,,1,325,325,,,,,,,,,"13,9,10,17,30,17,4,0,0","0,29,70,1,0","1,3,72,19,4",,,,,124,,,,,,,,,,,,,,,,,,,,,,,,,,,,,,,,,,,,11.4,24,8,298,60,,1021,5,,0,4,4,Balve,1,0,U1.000|6:08-U1.000|4:38-U1.000|4:42-U1.000|4:55-U1.000|4:29-U0.540|3:27-U1.000|4:44-U1.000|5:55-U0.122|0:38,,"Balve Running",,,3113,,250,3,11847210816,0,168070,250480,30378,,56459292,,,,,,,,,,,,,,,,,,,,,,,,,,,,,,,,,,,,,,,,5,
74562846,3b73a39d-c1d8-4c7a-a3bc-8632fc9ea0f0,1692641571,120,1692704580,,0,0,15.42,4867,4954,317,308,331,320,0,3.2,0.68,0.98,1.11,531,1007,142,182,,148,20,54.86,38.98,56.29,1,59.37,1604,148,,3.6,0,99,98,,,,,,79,79,11.94,12.51,12.4,-7.5,-8.1,277,277,,1,293,293,,,,,,,,,"23,15,13,11,13,10,14,1,0","1,52,33,13,1","0,5,69,24,2",,,,,120,,,,,,,,,,,,,,,,,,,,,,,,,,,,,,,,,,,,60.8,25,7,2,64,,1022,1,,0,2,4,Balve,1,0,U1.000|6:20-U1.000|6:48-U1.000|6:26-U1.000|6:53-U1.000|5:19-U1.000|5:06-U1.000|6:06-U1.000|5:40-U1.000|4:47-U1.000|4:43-U0.605|2:34-U1.000|3:53-U1.000|3:56-U1.000|3:53-U1.000|3:44-U0.812|4:58,,"Balve Running",,,3113,,250,3,11847210697,0,168070,250480,30378,,56459297,,,,,,,,,,,,,,,,,,,,,,,,,,,,,,,,,,,,,,,,4,
74567882,9f0add6c-82b3-43af-bc12-5dd7731160bd,1692716389,120,1692709219,,0,0,0.16,22,22,0,0,0,0,0,0,0,,,,5,,,,,,,,,1,,,,,,,,,150,,,,,0,90,,25.69,,,,220,220,,0,220,220,,,,,,,,,"0,14,27,27,32,0,0",,"0,0,100,0,0",,,,,,,,,,,,,,,,,,,,,,,,,,,,,,,,,,,,,,,,,,,,,,,,,,0,1,,,1,1,,,,,,315-0,,,7,,0,168072,,30378,,56464081,,,,,,,,,,,,,,,,,,,,,,,,,,,,,,,,,,,,,,,,,
74649798,ab6501ac-69b4-44e9-8dca-66ea513a37c6,1692802894,120,1692800414,,0,0,13.7,4142,4377,352,305,361,314,0,3.8,0.73,0.93,1.03,505,932,155,170,,153,19,51.26,40.6,53.11,1,59.35,1744,169,,3.7,0.5,103,96,,,,,,26,80,12.52,12.55,12.76,-3.2,3.5,295,295,,1,303,303,,,,,,,,,"12,14,13,12,17,27,6,0,0","0,5,66,29,0","0,0,58,41,1",,,,,124,,,,,,,,,,,,,,,,,,,,,,,,,,,,,,,,,,,,6.7,25,8,277,52,,1020,5,,0,2,4,Balve,1,0,U1.000|4:41-U1.000|4:47-U1.000|6:13-U1.000|5:55-U1.000|5:54-U1.000|6:10-U1.000|4:57-U1.000|4:11-U1.000|4:10-U1.000|4:05-U1.000|4:12-U1.000|5:16-U1.000|5:14-U0.704|3:20,,"Balve Running",,,3113,,250,3,11856310005,0,168070,250480,30378,,56538150,,,,,,,,,,,,,,,,,,,,,,,,,,,,,,,,,,,,,,,,"4,5,5",
74694995,d328d346-0a87-4a52-9648-4212d86cca87,1692861877,120,1692860473,,0,0,16.73,5224,5452,331,307,348,326,0,3.4,0.65,0.93,1.04,590,1110,149,165,,163,15,52.09,39.73,53.45,1,59.32,1886,155,,3.6,0,98,99,,,,,,19,81,11.97,12.01,12.05,-5.9,-1.2,279,279,,1,283,283,,,,,,,,,"13,10,15,18,24,19,2,0,0","0,10,87,3,0","0,0,75,24,0",,,,,119,,,,,,,,,,,,,,,,,,,,,,,,,,,,,,,,,,,,3.2,16,6,143,86,,1017,0,,0,4,4,Balve,1,0,U1.000|5:27-U1.000|4:37-U1.000|5:03-U1.000|5:04-U1.000|5:15-U1.000|5:32-U1.000|6:08-U1.000|7:08-U1.000|5:51-U1.000|5:06-U1.000|4:24-U1.000|4:25-U1.000|4:22-U1.000|4:28-U1.000|5:07-U1.000|5:34-U0.733|3:32,,"Balve Running",,,3113,,250,3,11861299901,0,168070,250480,30378,,56578452,,,,,,,,,,,,,,,,,,,,,,,,,,,,,,,,,,,,,,,,4,
74757446,de13e99d-c964-43a9-bdb1-7f719581353b,1692946501,120,1692943558,,0,0,14.16,4003,4092,85,67,116,103,0,0,0.12,,,,912,150,163,,162,13,58.34,44.01,58.86,1,59.34,1872,163,,3.7,0,104,100,,,,,,44,80,12.8,12.81,12.88,1.4,3.4,310,310,,1,313,313,,,,,,,,,"1,1,5,20,41,28,4,0,0","0,2,97,1,0","0,0,35,65,0",,,,,133,,,,,,,,,,,,,,,,,,,,,,,,,,,,,,,,,,,,9.5,20,6,179,76,,1012,0,,0,3,4,Planegg,1,0,U1.000|4:38-U1.000|4:47-U1.000|4:40-U1.000|4:46-U1.000|4:41-U1.000|4:57-U1.000|4:53-U1.000|4:44-U1.000|4:46-U1.000|4:42-U1.000|4:32-U1.000|4:38-U1.000|4:32-U1.000|4:37-U0.158|0:49,,"Planegg Running",,,3113,,250,3,11868327256,0,168070,250480,30378,,56634996,,,,,,,,,,,,,,,,,,,,,,,,,,,,,,,,,,,,,,,,,
74856961,85065f1f-5258-4df2-8458-55992ccb79e0,1693075704,120,1693074040,,0,0,12.72,4085,5394,86,47,98,59,0,0.1,0.2,1.06,,709,809,134,161,,130,61,57.84,37.62,58.55,1,59.39,1222,97,,3.1,0,101,99,,,,,,30,79,11.35,11.65,11.9,-1.5,-4,269,269,,1,288,288,,,,,,,,,"9,15,29,18,10,17,2,0,0","1,74,25,0,0","0,1,71,27,1",,,,,118,,,,,,,,,,,,,,,,,,,,,,,,,,,,,,,,,,,,11.7,18,8,292,87,,1013,0,,0,6,4,Planegg,1,0,U1.000|4:31-U1.000|4:19-U1.000|5:21-U0.597|3:23-U1.000|5:50-U1.000|5:44-U1.000|5:40-U1.000|5:49-U1.000|6:10-U1.000|5:47-U1.000|5:44-U1.000|4:48-U1.000|4:20-U0.127|0:39,,"Planegg Running",,,3113,,250,3,11880156055,0,168070,250480,30378,,56723842,,,,,,,,,,,,,,,,,,,,,,,,,,,,,,,,,,,,,,,,5,
74875456,0feb8de6-eb19-4fe4-9ab0-48127348aa15,1693123191,120,1693120220,,0,0,13.87,4045,4090,51,49,64,61,0,0,0.08,,,,862,146,163,,153,14,58.27,42.38,58.54,1,59.39,1396,121,,3.3,0.2,98,100,,,,,,94,81,12.37,12.56,12.54,-5.9,-9.3,297,297,,1,304,304,,,,,,,,,"4,5,9,24,30,20,6,1,0","0,12,87,1,0","0,0,56,42,1",,,,,127,,,,,,,,,,,,,,,,,,,,,,,,,,,,,,,,,,,,34.6,16,8,12,94,,1009,1,,0,4,4,Planegg,1,0,U1.000|5:00-U1.000|5:14-U1.000|5:08-U1.000|4:59-U1.000|5:06-U1.000|5:07-U1.000|5:09-U1.000|5:03-U1.000|5:02-U1.000|4:27-U1.000|4:23-U1.000|4:26-U1.000|4:15-U0.868|4:06,,"Planegg Running",,,3113,,250,3,11882605711,0,168070,250480,30378,,56739791,,,,,,,,,,,,,,,,,,,,,,,,,,,,,,,,,,,,,,,,,
75004817,1cd621cd-5472-4c7e-aaa9-8b7bbd1196af,1693250264,120,1693247522,,0,0,10,3308,3697,243,234,243,232,0,3.2,0.78,0.94,1.03,468,634,129,148,76,142,15,58.42,35.67,60.25,1,59.34,1076,77,,2.8,0,96,98,,,,,,48,79,11.4,11.31,11.54,-7.5,7.9,262,262,,1,268,268,,,,,,,,,"20,10,19,18,25,6,0,0,0","1,81,18,0,0","0,5,80,15,0",,,,,115,,,,,,,,,,,,,,,,,,,,,,,,,,,,,,,,,,,,17.9,16,4,342,73,,1012,0,,0,4,4,Balve,1,0,U1.000|5:59-U1.000|6:32-U1.000|5:56-U1.000|6:27-U1.000|5:26-U1.000|4:55-U1.000|5:12-U1.000|4:48-U1.000|4:40-U1.000|5:11-U0.004|0:02,,"Balve Running",,,3113,,250,3,11894393322,0,168070,250480,30378,,56859969,,,,,,,,,,,,,,,,,,,,,,,,,,,,,,,,,,,,,,,,4,
75154431,f70b0848-6b9a-48dc-8710-70c753ed10c8,1693424434,120,1693418996,,0,0,4.22,1398,1408,71,71,84,85,0,1.5,0.56,0.99,1.08,358,271,135,158,,158,22,55.15,33.71,56.3,1,59.34,700,41,,2.2,0,100,100,,,,,,4,79,11.29,11.2,11.4,-4.8,3.6,259,259,,1,264,264,,,,,,,,,"17,10,21,27,21,4,0,1,0","1,79,20,0,0","0,10,79,11,0",,,,,115,,,,,,,,,,,,,,,,,,,,,,,,,,,,,,,,,,,,2.5,13,10,257,86,,1007,0,,0,4,4,Balve,1,0,U1.000|5:17-U1.000|5:56-U1.000|5:19-U1.000|5:24-U0.216|1:22,,"Balve Running",,,3113,,250,3,11909264301,0,168070,250480,30378,,56995428,,,,,,,,,,,,,,,,,,,,,,,,,,,,,,,,,,,,,,,,5,
75232964,8177309a-84ac-4835-8dff-0dd9f6cfbc09,1693509098,120,1693506766,,0,0,13.65,4370,4497,297,289,320,315,0,3.5,0.71,0.97,1.06,481,895,144,159,,153,24,52.91,37.97,54.37,1,59.31,1361,118,,3.3,0,102,97,,,,,,114,80,11.73,11.78,11.9,-7.1,1.5,271,271,,1,277,277,,,,,,,,,"20,12,12,15,27,14,1,0,0","0,26,74,0,0","0,1,81,18,0",,,,,117,,,,,,,,,,,,,,,,,,,,,,,,,,,,,,,,,,,,37.7,15,7,233,74,,1012,0,,0,4,4,Balve,1,0,U1.000|4:56-U1.000|5:00-U1.000|6:33-U1.000|6:19-U1.000|6:18-U1.000|6:27-U1.000|5:00-U1.000|4:32-U1.000|4:29-U1.000|4:26-U1.000|4:36-U1.000|5:37-U1.000|5:26-U0.646|3:11,,"Balve Running",,,3113,,250,3,11916833911,0,168070,250480,30378,,57063414,,,,,,,,,,,,,,,,,,,,,,,,,,,,,,,,,,,,,,,,"4,4",
75469056,e2bd3e81-dcd7-4257-9cfb-ece050cabf35,1693651203,120,1693742676,,0,0,6.05,8579,8579,127,155,138,162,0,2.1,0.66,0.92,0.79,73,468,77,118,,88,34,15.1,,15.44,1,59.31,,4,,0.2,0,,100,,,,,,31,52,2.67,17.43,16.11,-35.5,,57,50,,1,363,357,,,,,,,,,"99,0,0,0,0,0,0,0,0","95,5,0,0,0","88,11,0,0,0",,,,,41,,,,,,,,,,,,,,,,,,,,,,,,,,,,,,,,,,,,3.3,18,5,196,83,,1021,3,,0,4,4,Altena,1,0,U1.000|14:22-U1.000|36:33-U1.000|27:12-U1.000|28:04-U1.000|16:00-U1.000|20:47-U0.045|0:02,,"Neuenrade Running",,,3113,,250,3,11936593461,0,168070,250480,30378,,57265743,,,,,,,,,,,,,,,,,,,,,,,,,,,,,,,,,,,,,,,,4,
75469059,bfa5974c-bd2a-439b-97a5-70a37f772728,1693737216,120,1693742679,,0,0,2.93,782,796,33,31,40,37,0,0.3,0.36,1.17,1.07,,191,149,165,,154,8,63.22,42.29,64.16,1,59.31,1016,63,,2.6,0,,100,,,,,,23,79,13.66,13.82,13.81,13.7,11.6,334,334,,1,337,337,,,,,,,,,"1,0,0,3,52,32,11,1,0","0,13,77,9,0","0,0,15,84,1",,,,,142,,,,,,,,,,,,,,,,,,,,,,,,,,,,,,,,,,,,38.2,17,4,33,78,,1028,3,,0,4,4,Balve,1,0,U1.000|4:28-U1.000|4:17-U0.925|4:16,,"Balve Running",,,3113,,250,3,11936594456,0,168070,250480,30378,,57265746,,,,,,,,,,,,,,,,,,,,,,,,,,,,,,,,,,,,,,,,,
75469075,44c96cf6-f71b-4867-8b1d-829e03d2d67d,1693738572,120,1693742700,,0,0,10.35,2555,2555,201,197,221,215,0,2.7,0.58,1.05,1.03,655,687,179,190,150,188,16,52.65,50.37,53.94,1,59.27,4341,322,,4.9,2.2,96,98,,,,,,142,82,15.01,15.23,15.62,10.5,17.3,371,371,,1,393,393,,,,,,,,,"1,0,8,9,12,22,33,15,1","0,1,3,32,63","0,0,6,71,22",,,,,148,,,,,,,,,,,,,,,,,,,,,,,,,,,,,,,,,,,,145.7,17,4,33,78,,1028,3,,0,4,4,Balve,1,0,U1.000|4:18-U1.000|4:42-U1.000|3:28-U1.000|3:49-U1.000|3:51-U1.000|4:37-U1.000|3:33-U1.000|4:48-U1.000|4:15-U1.000|3:58-U0.345|1:18,,"Balve Running",,,3113,,250,3,11936597638,0,168070,250480,30378,,57265759,,,,,,,,,,,,,,,,,,,,,,,,,,,,,,,,,,,,,,,,"4,5",
75594147,d6bea4a9-4f37-4284-899d-adcf176f8f89,1693854723,120,1693852192,,0,0,10.04,3496,3580,245,224,253,236,0,3.3,0.83,0.97,1,452,652,135,154,,152,19,51.87,33.59,53.57,1,59.25,2392,72,,2.8,0,97,96,,,,,,64,78,10.89,10.71,11,-3,7.5,248,248,,1,254,254,,,,,,,,,"33,12,11,23,17,2,0,0,0","1,79,20,0,0","0,11,84,5,0",,,,,110,,,,,,,,,,,,,,,,,,,,,,,,,,,,,,,,,,,,22.8,20,6,112,70,,1024,0,,0,4,4,Balve,1,0,U1.000|6:25-U1.000|7:13-U1.000|6:38-U1.000|6:47-U1.000|5:29-U1.000|5:04-U1.000|5:09-U1.000|5:13-U1.000|5:15-U1.000|4:53-U0.035|0:10,,"Balve Running",,,3113,,250,3,11946817720,0,168070,250480,30378,,57372831,,,,,,,,,,,,,,,,,,,,,,,,,,,,,,,,,,,,,,,,4,
75721487,f4124bfe-c622-4738-9269-8f84c43025f9,1693938876,120,1693991219,,0,0,5.06,1515,2420,31,32,36,38,0,0,0.04,0.87,,,334,147,159,113,157,24,55.89,38.43,56.29,1,59.29,1338,92,,2.9,0.9,103,100,,,,,,25,78,12.05,12.93,13.34,14.2,-17.5,288,288,,1,341,341,,,,,,,,,"19,1,2,3,39,33,1,1,3","1,15,84,0,0","3,13,18,63,3",,,,,128,,,,,,,,,,,,,,,,,,,,,,,,,,,,,,,,,,,,16.2,24,5,133,65,,1020,0,,0,2,4,Fröndenberg,1,0,U1.000|4:36-U1.000|4:30-U1.000|4:34-U1.000|4:38-U1.000|6:38-U0.061|0:19,,"Fröndenberg/Ruhr Running",,,3113,,250,3,11958611299,0,168070,250480,30378,,57483808,,,,,,,,,,,,,,,,,,,,,,,,,,,,,,,,,,,,,,,,,
75721488,d91fdcee-060e-4b65-9c0a-4f9322936c91,1693943059,120,1693991219,,0,0,2.66,867,867,8,13,11,15,0,0,0.16,1.04,,,185,148,158,,158,13,49.86,33.28,49.93,1,59.28,3750,38,,2.2,0,95,95,,,,,,14,80,11.03,11.19,11.16,0,2.5,257,257,,1,262,262,,,,,,,,,"4,4,34,41,13,3,0,0,0","0,5,95,0,0","0,1,92,6,0",,,,,115,,,,,,,,,,,,,,,,,,,,,,,,,,,,,,,,,,,,13,25,4,140,62,,1020,0,,0,2,4,Fröndenberg,1,0,U1.000|5:25-U1.000|5:23-U0.663|3:38,,"Fröndenberg/Ruhr Running",,,3113,,250,3,11958611385,0,168070,250480,30378,,57483809,,,,,,,,,,,,,,,,,,,,,,,,,,,,,,,,,,,,,,,,,
75721490,437a79a0-1afb-4302-a994-ca7750ef3981,1693941548,120,1693991220,,0,0,4.21,1132,1132,0,0,0,0,0,0,0,,,,281,162,187,,183,46,55.5,43.12,55.5,1,59.29,3154,172,,3.2,2.8,98,100,,,,,,34,81,13.39,14.78,14.78,11.9,10.3,334,334,,1,380,380,,,,,,,,,"26,6,4,3,2,3,19,37,1","0,11,31,38,20","9,15,14,16,46",,,,,138,,,,,,,,,,,,,,,,,,,,,,,,,,,,,,,,,,,,61.3,25,4,140,62,,1020,0,,0,2,4,Frondenberg/Ruhr,1,0,U0.990|3:23-U0.210|1:42-U0.400|1:18-U0.200|1:40-U0.400|1:19-U0.200|1:36-U0.400|1:17-U0.400|2:51-U1.000|3:41-U0.010|0:04,,"Fröndenberg/Ruhr Track Running",,,3113,,250,3,11958611356,0,168070,250480,30378,,57483810,,,,,,,,,,,,,,,,,,,,,,,,,,,,,,,,,,,,,,,,,
75767339,5d975460-8240-487f-a361-6fa5d06935c6,1694021522,120,1694019638,,0,0,14,4410,4932,344,372,355,385,0,3.9,0.88,1.01,1.11,543,899,146,168,122,164,15,52.98,38.77,54.46,1,59.27,2749,126,,3.4,0,97,97,,,,,,105,79,12.03,12.36,12.23,-1.1,5.5,275,275,,1,280,280,,,,,,,,,"21,16,11,9,16,18,9,0,0","0,20,76,4,0","0,0,80,20,0",,,,,121,,,,,,,,,,,,,,,,,,,,,,,,,,,,,,,,,,,,37.1,27,6,104,51,,1020,1,,0,2,4,Balve,1,0,U1.000|5:58-U1.000|6:23-U1.000|6:10-U1.000|6:32-U1.000|4:59-U1.000|4:42-U1.000|4:35-U1.000|5:29-U1.000|7:06-U1.000|5:11-U1.000|4:06-U1.000|4:09-U1.000|4:06-U1.000|4:02-U0.004|0:02,,"Balve Running",,,3113,,250,3,11961871786,0,168070,250480,30378,,57525179,,,,,,,,,,,,,,,,,,,,,,,,,,,,,,,,,,,,,,,,"4,4",
75769810,,1694027760,120,1694020960,,0,0,1.5,600,600,,,,,0,,,,,,89,,,,,,,24.83,,1,,,,,,,,,,,,,,13,,,,,,,,,,,,,,,,,,,,,,,,,,,,,,,,,,,,,,,,,,,,,,,,,,,,,,,,,,,,,,,,,,,,,,,,,,1,,,0,0,,,"missed 1.5k",,,connect,,,3,11962045120,0,168070,250480,30378,,57527363,,,,,,,,,,,,,,,,,,,,,,,,,,,,,,,,,,,,,,,,,
75848929,58d77934-68ac-4d47-a624-2d9fa0daa20d,1694111741,120,1694109276,,0,0,14.34,4256,4285,187,193,220,227,0,1.7,0.37,0.93,0.99,411,936,145,161,115,147,79,57.55,41.64,58.45,1,59.3,2448,162,,3.8,0,104,99,,,,,,90,80,12.42,12.26,12.47,6.9,9.1,294,294,,1,297,297,,,,,,,,,"5,4,8,21,41,20,1,0,0","1,18,82,0,0","0,4,47,49,0",,,,,126,,,,,,,,,,,,,,,,,,,,,,,,,,,,,,,,,,,,31.3,25,7,109,59,,1019,0,,0,2,4,Sundern,1,0,U1.000|5:05-U1.000|4:45-U1.000|4:40-U1.000|4:44-U1.000|4:43-U1.000|4:40-U1.000|4:39-U1.000|5:23-U1.000|5:36-U1.000|5:29-U1.000|5:04-U1.000|4:30-U1.000|4:32-U1.000|4:51-U0.335|2:14,,"Sundern (Sauerland) Running",,,3113,,250,3,11970171911,0,168070,250480,30378,,57599638,,,,,,,,,,,,,,,,,,,,,,,,,,,,,,,,,,,,,,,,4,
75889094,bc110958-518f-4693-98ed-09e76a963e3f,1694165460,120,1694159220,,0,0,,928,928,,,,,0,,,,,,72,,,,,,,,,1,,,,,,,,,200,,,,,4,,,,,,,,,,,,,,,,,,,,,,,,,,,,,,,,,,,,,,,,,,,,,,,,,,,,,,,,,,,,,,,,,,,,,,,,,,1,,,1,0,,,,,,,,252,7,,0,168073,,30378,,57636043,,,,,,,,,,,,,,,,,,,,,,,,,,,,,,,,,,,,,,,,,
75904839,859198e7-8daf-4baa-9cfd-63217b0ba58d,1694176194,120,1694175168,,0,0,16.67,5498,5778,351,313,390,358,0,3.6,0.63,0.95,1.05,569,1101,144,161,,157,21,51,37.26,52.48,1,59.26,2180,130,,3.4,0,98,99,,,,,,35,79,11.36,11.31,11.45,0.8,5.8,262,262,,1,266,266,,,,,,,,,"18,11,17,20,26,7,0,0,0","0,32,67,0,0","0,1,95,5,0",,,,,115,,,,,,,,,,,,,,,,,,,,,,,,,,,,,,,,,,,,6.4,27,10,177,48,,1018,6,,0,2,4,Balve,1,0,U1.000|5:42-U1.000|4:48-U1.000|5:22-U1.000|5:20-U1.000|5:24-U1.000|5:45-U1.000|6:27-U1.000|7:26-U1.000|6:20-U1.000|5:36-U1.000|4:56-U1.000|4:43-U1.000|4:31-U1.000|4:47-U1.000|5:31-U1.000|5:41-U0.670|3:18,,"Balve Running",,,3113,,250,3,11975090683,0,168070,250480,30378,,57650356,,,,,,,,,,,,,,,,,,,,,,,,,,,,,,,,,,,,,,,,4,
75962619,3e5b204e-57cd-444c-b026-a5cd7e999836,1694244588,120,1694242162,,0,0,13.24,4369,4418,347,349,364,369,0,3.9,0.81,0.95,1.08,446,875,141,160,,155,20,52.41,36.56,54.1,1,59.22,1609,105,,3.2,0,101,96,,,,,,12,80,11.55,11.65,11.67,-6.8,4.4,262,262,,1,266,266,,,,,,,,,"29,12,10,15,18,16,1,0,0","0,39,61,0,0","0,1,88,11,0",,,,,114,,,,,,,,,,,,,,,,,,,,,,,,,,,,,,,,,,,,2.3,13,6,164,89,,1017,0,,0,2,4,Balve,1,0,U1.000|5:11-U1.000|5:15-U1.000|6:32-U1.000|6:35-U1.000|6:19-U1.000|6:10-U1.000|6:29-U1.000|5:31-U1.000|4:40-U1.000|4:30-U1.000|4:25-U1.000|4:23-U1.000|5:32-U0.241|1:19,,"Balve Running",,,3113,,250,3,11980145176,0,168070,250480,30378,,57702915,,,,,,,,,,,,,,,,,,,,,,,,,,,,,,,,,,,,,,,,3,
76037375,242164f2-efa8-47dd-b2b4-c7e9f4d61360,1694330732,120,1694330514,,0,0,17.26,5619,6630,440,408,450,418,0,4.7,0.78,0.98,1.11,454,1135,140,161,,154,21,53.79,37.94,55.61,1,59.19,1474,129,,3.4,0,100,98,,,,,,31,79,11.76,11.77,12.16,-8.4,-9.6,271,271,,1,285,285,,,,,,,,,"22,15,11,14,15,18,5,0,0","0,49,50,0,0","0,4,77,17,1",,,,,117,,,,,,,,,,,,,,,,,,,,,,,,,,,,,,,,,,,,5.4,17,4,164,88,,1019,0,,0,2,4,Balve,1,0,U1.000|4:44-U1.000|5:13-U1.000|5:39-U1.000|6:19-U1.000|6:25-U1.000|7:03-U1.000|5:44-U1.000|7:23-U1.000|6:07-U1.000|4:59-U1.000|5:24-U1.000|4:57-U1.000|4:18-U1.000|4:24-U1.000|4:06-U1.000|4:06-U1.000|5:16-U0.263|1:33,,"Balve Running",,,3113,,250,3,11988134238,0,168070,250480,30378,,57767946,,,,,,,,,,,,,,,,,,,,,,,,,,,,,,,,,,,,,,,,"3,4",
76129846,817814b4-3972-4de1-a849-e03c349357ee,1694435855,120,1694433445,,0,0,13.63,4258,4418,310,289,326,307,0,3.4,0.73,0.93,1.03,447,916,151,164,,148,18,51.1,39.06,52.63,1,59.16,1601,144,,3.6,0,102,98,,,,,,17,79,12.04,12.12,12.19,-4,2.2,280,280,,1,286,286,,,,,,,,,"15,13,14,13,19,21,4,0,0","0,13,77,9,0","0,1,73,27,0",,,,,122,,,,,,,,,,,,,,,,,,,,,,,,,,,,,,,,,,,,3.7,28,8,214,53,,1014,5,,0,2,4,Balve,1,0,U1.000|4:54-U1.000|4:54-U1.000|6:20-U1.000|6:11-U1.000|5:55-U1.000|6:09-U1.000|4:58-U1.000|4:29-U1.000|4:19-U1.000|4:22-U1.000|4:17-U1.000|5:25-U1.000|5:39-U0.634|3:06,,"Balve Running",,,3113,,250,3,11997825158,0,168070,250480,30378,,57852810,,,,,,,,,,,,,,,,,,,,,,,,,,,,,,,,,,,,,,,,"4,5",
76300465,34d517c8-8cc3-46bd-998e-d25e0d6ad524,1694543700,120,1694613186,,0,0,5.7,1512,1876,28,25,33,30,0,0,0.08,1.08,,,366,156,169,,164,25,59.68,44.64,60.08,1,59.2,1222,125,,3.1,1.9,104,100,,,,,,11,81,13.59,14.34,14.83,4.1,-20.8,334,334,,1,383,383,,,,,,,,,"6,1,3,4,19,53,6,6,1","1,7,40,52,0","0,4,12,77,7",,,,,140,,,,,,,,,,,,,,,,,,,,,,,,,,,,,,,,,,,,5.8,21,5,90,80,,1012,0,,0,4,4,Frondenberg/Ruhr,1,0,U1.000|4:30-U1.000|4:18-U1.000|4:16-U1.000|4:11-U0.273|1:16-U0.407|1:58-U1.000|4:31-U0.019|0:12,,"Fröndenberg/Ruhr Running",,,3113,,250,3,12014118514,0,168070,250480,30378,,58004049,,,,,,,,,,,,,,,,,,,,,,,,,,,,,,,,,,,,,,,,,
76300466,b641da25-74d3-4d75-911b-f2910335a1ec,1694547908,120,1694613187,,0,0,2.25,660,660,15,8,17,10,0,0,0.09,1.01,,,154,155,164,,153,6,53.21,37.02,53.85,1,59.2,3460,43,,2.2,0,99,98,,,,,,4,81,12.46,12.36,12.54,3.8,4.1,300,300,,1,304,304,,,,,,,,,"6,2,5,18,43,24,2,0,0","0,3,81,16,0","0,0,41,58,0",,,,,126,,,,,,,,,,,,,,,,,,,,,,,,,,,,,,,,,,,,2.8,21,4,338,95,,1012,,,0,6,1,Frondenberg/Ruhr,1,0,U1.000|5:03-U1.000|4:39-U0.254|1:18,,"Fröndenberg/Ruhr Running",,,3113,,250,3,12014118702,0,168070,250480,30378,,58004050,,,,,,,,,,,,,,,,,,,,,,,,,,,,,,,,,,,,,,,,,
76300468,255a14f1-1e89-40fa-a47c-ddebbd949128,1694545733,120,1694613187,,0,0,6.29,1835,1835,0,0,0,0,0,0,0,,,,440,161,190,127,186,51,50.66,40.13,50.66,1,59.2,2880,239,,3.6,3,100,102,,,,,,36,80,12.33,14.64,14.64,13.3,4.6,308,308,,1,377,377,,,,,,,,,"31,3,4,2,2,2,22,34,0","0,21,25,26,28","22,8,11,5,54",,,,,129,,,,,,,,,,,,,,,,,,,,,,,,,,,,,,,,,,,,50.1,21,5,90,80,,1012,0,,0,4,4,Frondenberg/Ruhr,1,0,U1.200|4:10-U0.400|2:37-U1.210|4:11-U0.170|2:38-U1.000|3:36-U0.100|1:35-U0.120|1:58-U0.800|2:46-U0.460|4:13-U0.830|2:51,,"Fröndenberg/Ruhr Track Running",,,3113,,250,3,12014118638,0,168070,250480,30378,,58004052,,,,,,,,,,,,,,,,,,,,,,,,,,,,,,,,,,,,,,,,,
76315258,3fd43b7b-c426-4ef2-90c4-f772e087dc26,1694624474,120,1694623735,,0,0,15.45,4775,4920,390,379,415,403,0,4.4,0.67,0.98,1.11,502,1028,145,169,83,162,24,54.75,39.95,56.51,1,59.2,3170,161,,3.7,0,103,99,,,,,,104,81,12.26,12.14,12.46,-3.7,5.7,285,285,,1,292,292,,,,,,,,,"15,6,13,18,21,23,4,0,0","0,37,54,9,0","0,1,66,32,0",,,,,120,,,,,,,,,,,,,,,,,,,,,,,,,,,,,,,,,,,,36.8,16,12,15,78,,1019,1,,0,4,4,Balve,1,0,U1.000|5:01-U1.000|4:54-U1.000|5:18-U1.000|6:42-U1.000|6:03-U1.000|5:17-U1.000|5:38-U1.000|6:06-U1.000|5:30-U1.000|5:01-U1.000|4:55-U1.000|4:40-U1.000|4:12-U1.000|4:18-U1.000|4:06-U0.446|1:55,,"Balve Running",,,3113,,250,3,12015358417,0,168070,250480,30378,,58018113,,,,,,,,,,,,,,,,,,,,,,,,,,,,,,,,,,,,,,,,"4,4",
76414741,0f28dd07-6126-4cdc-bb29-fd59da34d3d8,1694714205,120,1694712947,,0,0,15.81,4329,4376,85,61,113,90,0,0,0.12,0.99,,640,951,142,157,,151,11,65.38,46.07,65.94,1,59.24,2592,150,,3.6,0,104,103,,,,,,78,81,13.29,13.28,13.34,0.6,1.4,323,323,,1,326,326,,,,,,,,,"3,2,1,6,39,45,4,0,0","0,36,64,0,0","0,0,15,85,0",,,,,135,,,,,,,,,,,,,,,,,,,,,,,,,,,,,,,,,,,,20.8,17,5,34,68,,1022,0,,0,3,4,Sundern,1,0,U1.000|4:12-U1.000|4:11-U1.000|4:17-U1.000|4:21-U1.000|4:29-U1.000|4:36-U1.000|4:33-U1.000|4:35-U1.000|4:30-U1.000|4:24-U1.000|4:30-U1.000|4:34-U1.000|4:52-U1.000|4:37-U1.000|4:41-U0.808|4:49,,"Sundern (Sauerland) Running",,,3113,,250,3,12023299620,0,168070,250480,30378,,58106501,,,,,,,,,,,,,,,,,,,,,,,,,,,,,,,,,,,,,,,,5,
76492683,4a8cef0c-d2f3-4c46-8e9f-f8d9b5f01bd6,1694788091,120,1694785627,,0,0,13,4269,4579,235,224,275,264,0,2.5,0.6,0.94,1.03,269,842,140,162,,155,18,53.22,36.71,54.47,1,59.22,1742,103,,3.1,0.1,98,99,,,,,,9,79,11.18,11.26,11.38,-3.9,-4.3,260,260,,1,267,267,,,,,,,,,"13,11,23,26,20,5,1,0,0","0,55,44,1,0","0,3,85,12,0",,,,,116,,,,,,,,,,,,,,,,,,,,,,,,,,,,,,,,,,,,2.3,21,8,172,56,,1018,4,,0,2,4,Balve,1,0,U1.000|5:45-U1.000|4:58-U1.000|5:37-U1.000|5:38-U1.000|5:40-U1.000|5:51-U1.000|5:41-U1.000|5:18-U1.000|5:22-U1.000|5:56-U1.000|4:41-U1.000|4:46-U1.000|5:55-U0.002|0:01,,"Balve Running",,,3113,,250,3,12028905223,0,168070,250480,30378,,58174698,,,,,,,,,,,,,,,,,,,,,,,,,,,,,,,,,,,,,,,,4,
76546723,9ccd3122-b1d3-4fc9-bd33-88e7fa7b7e7a,1694853161,120,1694851704,,0,0,16.32,5431,5600,423,407,445,435,0,4.2,0.81,0.94,1.08,497,1125,144,164,,155,19,50.44,36.81,52.12,1,59.18,1753,149,,3.6,0,103,96,,,,,,91,80,11.45,11.49,11.57,-4.9,2.8,261,261,,1,265,265,,,,,,,,,"25,15,10,18,18,12,1,0,0","0,37,62,1,0","0,3,87,9,0",,,,,113,,,,,,,,,,,,,,,,,,,,,,,,,,,,,,,,,,,,22.1,17,8,155,78,,1015,1,,0,2,4,Balve,1,0,U1.000|5:09-U1.000|5:17-U1.000|6:03-U1.000|6:30-U1.000|6:17-U1.000|6:07-U1.000|6:42-U1.000|4:55-U1.000|5:39-U1.000|6:53-U1.000|5:46-U1.000|4:49-U1.000|4:26-U1.000|4:38-U1.000|4:16-U1.000|5:15-U0.316|1:48,,"Balve Running",,,3113,,250,3,12033785831,0,168070,250480,30378,,58224290,,,,,,,,,,,,,,,,,,,,,,,,,,,,,,,,,,,,,,,,"3,4",
76663205,15a38a24-6bbf-40f8-8a04-b423d328dc5f,1694970458,120,1694969692,,0,0,13.49,3937,4104,180,217,203,239,0,2,0.52,0.94,1.02,340,850,147,170,112,147,25,57.68,42.25,58.43,1,59.19,1396,133,,3.4,0,100,100,,,,,,84,80,12.6,12.89,12.81,-4.3,-5.7,297,297,,1,307,307,,,,,,,,,"10,7,10,12,27,21,12,1,0","0,25,59,16,0","0,4,49,47,0",,,,,128,,,,,,,,,,,,,,,,,,,,,,,,,,,,,,,,,,,,45.6,23,9,198,67,,1013,1,,0,3,4,Balve,1,0,U1.000|5:04-U1.000|5:20-U1.000|4:44-U1.000|4:35-U1.000|4:38-U1.000|5:20-U1.000|6:07-U1.000|6:24-U1.000|4:32-U1.000|4:42-U1.000|4:12-U0.120|0:29-U1.000|3:51-U1.000|3:59-U0.367|1:40,,"Balve Running",,,3113,,250,3,12046123809,0,168070,250480,30378,,58333038,,,,,,,,,,,,,,,,,,,,,,,,,,,,,,,,,,,,,,,,"4,5",
76709245,4711c439-9247-475e-9cbd-81f15550bbf3,1695041792,120,1695039595,,0,0,13.49,4406,4660,317,299,348,330,0,3.8,0.8,0.91,1.04,492,887,142,160,,153,21,52.59,37.05,54.21,1,59.18,1345,110,,3.2,0,100,99,,,,,,23,79,11.62,11.77,11.85,-7.9,1,267,267,,1,275,275,,,,,,,,,"31,9,9,12,15,20,3,0,0","1,38,61,0,0","0,2,80,17,0",,,,,116,,,,,,,,,,,,,,,,,,,,,,,,,,,,,,,,,,,,4,20,18,208,74,,1007,3,,0,4,4,Balve,1,0,U1.000|5:11-U1.000|4:54-U1.000|6:46-U1.000|6:52-U1.000|6:51-U1.000|6:41-U1.000|5:00-U1.000|4:20-U1.000|4:20-U1.000|4:27-U1.000|4:17-U1.000|5:39-U1.000|5:43-U0.493|2:26,,"Balve Running",,,3113,,250,3,12050916015,0,168070,250480,30378,,58373831,,,,,,,,,,,,,,,,,,,,,,,,,,,,,,,,,,,,,,,,"4,5",
76844652,fef224d3-6f58-49e8-acb6-602d36afe0a9,1695148356,120,1695145749,,0,0,4.53,1216,1999,9,18,17,25,0,0,0.07,,,,283,148,163,,152,6,63.36,43.41,63.36,1,59.26,1048,91,,2.8,1.2,104,104,,,,,,26,81,13.33,13.91,14,0,-15.7,324,324,,1,352,352,,,,,,,,,"2,1,1,5,35,51,2,2,1","1,4,94,2,0","0,0,18,79,3",,,,,138,,,,,,,,,,,,,,,,,,,,,,,,,,,,,,,,,,,,23,17,21,225,62,,1010,0,,0,4,4,Westick,1,0,U1.000|4:48-U1.000|4:22-U1.000|4:21-U1.000|4:25-U0.271|1:19-U0.203|0:38-U0.052|0:23,,"Fröndenberg/Ruhr Running",,,3113,,250,3,12060703365,0,168070,250480,30378,,58490417,,,,,,,,,,,,,,,,,,,,,,,,,,,,,,,,,,,,,,,,,
76845005,e9cc89a6-b620-4520-b20f-df271c894256,1695150381,120,1695145835,,0,0,8.72,2417,2435,0,0,0,0,0,0,0,,,,579,153,179,,174,53,58.13,43.49,58.13,1,59.26,2880,223,,3.8,2.2,106,105,,,,,,77,81,12.98,14.7,14.7,0.4,-4.8,323,323,,1,377,377,,,,,,,,,"32,4,2,1,1,3,24,30,2","0,27,32,41,0","12,16,12,7,53",,,,,134,,,,,,,,,,,,,,,,,,,,,,,,,,,,,,,,,,,,70.7,17,20,224,64,,1010,0,,0,4,4,Westick,1,0,U0.200|0:38-U0.100|0:37-U0.200|0:39-U0.100|0:48-U0.190|0:39-U0.110|0:44-U0.210|0:38-U0.090|0:47-U0.200|0:39-U0.270|2:39-U1.600|5:35-U0.400|3:17-U0.800|2:50-U0.800|2:51-U0.400|3:26-U1.600|5:36-U0.410|3:41-U0.990|3:30-U0.050|0:44,,"Fröndenberg/Ruhr Track Running",,,3113,,250,3,12060712853,0,168070,250480,30378,,58490766,,,,,,,,,,,,,,,,,,,,,,,,,,,,,,,,,,,,,,,,,
76847481,03255721-ce9d-46ae-ab67-5175cb58c4fc,1695153093,120,1695146579,,0,0,1.99,613,613,24,13,39,28,0,0,0.18,1.19,,1262,132,136,155,,148,14,59.77,34.58,61.08,1,59.27,2860,30,,2,0,103,101,,,,,,13,81,11.99,11.65,13.03,6.6,21.5,289,289,,1,320,320,,,,,,,,,"3,2,14,38,39,4,0,0,0","0,81,19,0,0","0,0,87,7,6",,,,,120,,,,,,,,,,,,,,,,,,,,,,,,,,,,,,,,,,,,16.2,17,21,224,64,,1010,0,,1,4,4,Westick,1,0,U1.000|5:14-U0.993|4:59,,"Fröndenberg/Ruhr Running",,,3113,,250,3,12060841283,0,168070,250480,30378,,58492874,,,,,,,,,,,,,,,,,,,,,,,,,,,,,,,,,,,,,,,,5,
76910775,970ed7e5-d0f6-439e-85c8-fd2a974859d0,1695213226,120,1695210408,,0,0,13.17,4183,4343,347,342,370,369,0,4,0.78,0.92,1.03,456,850,142,159,,155,18,54.43,38.21,56.23,1,59.25,2026,110,,3.2,0,102,98,,,,,,104,80,12.04,12.11,12.27,-5.8,6.1,285,285,,1,293,293,,,,,,,,,"19,14,15,12,16,18,5,1,0","0,40,60,0,0","0,0,71,28,1",,,,,118,,,,,,,,,,,,,,,,,,,,,,,,,,,,,,,,,,,,35,19,23,202,68,,1009,3,,0,4,4,Balve,1,0,U1.000|5:06-U1.000|5:09-U1.000|6:03-U1.000|6:09-U1.000|6:05-U1.000|5:58-U1.000|6:40-U1.000|5:24-U1.000|4:29-U1.000|4:22-U1.000|4:18-U1.000|4:01-U1.000|5:06-U0.168|0:54,,"Balve Running",,,3113,,250,3,12065664412,0,168070,250480,30378,,58549226,,,,,,,,,,,,,,,,,,,,,,,,,,,,,,,,,,,,,,,,3,
76942908,09bbf6ef-2b16-4bb6-8f14-c8d62c196fcd,1695233564,120,1695230643,,0,0,3.93,1225,1477,57,51,65,56,0,1,0.48,1.15,1.22,352,264,139,154,,137,21,57.29,36.08,58.42,1,59.26,2304,52,,2.4,0,98,102,,,,,,29,79,11.76,12.24,12.23,1.2,-2.4,287,287,,1,300,300,,,,,,,,,"11,3,9,31,22,21,3,0,0","1,45,54,0,0","4,1,39,56,0",,,,,122,,,,,,,,,,,,,,,,,,,,,,,,,,,,,,,,,,,,27.6,20,16,190,64,,1006,0,,0,3,4,Balve,1,0,U1.000|5:21-U1.000|5:26-U1.000|4:15-U0.926|5:23,,"Balve Running",,,3113,,250,3,12068138040,0,168070,250480,30378,,58579680,,,,,,,,,,,,,,,,,,,,,,,,,,,,,,,,,,,,,,,,5,
76942931,c41f183b-9a57-4a7a-bff0-2942af415725,1695235227,120,1695230659,,0,0,2.92,1143,1143,8,0,12,4,0,0,0.07,,,,230,140,165,,154,40,42.85,26.96,43.14,1,59.26,2592,55,,2.2,1.1,,100,,,,,,28,72,9.23,11.13,11.54,27.3,24,228,228,,1,307,307,,,,,,,,,"56,9,7,2,2,2,2,5,15","0,53,46,1,0","32,19,20,13,16",,,,,106,,,,,,,,,,,,,,,,,,,,,,,,,,,,,,,,,,,,28.2,20,16,190,64,,1006,0,,0,3,4,Balve,1,0,U0.190|0:34-U0.220|1:44-U0.200|0:35-U0.200|1:33-U0.200|0:35-U0.200|1:37-U0.200|0:35-U0.200|1:41-U0.200|0:35-U0.160|2:33-U0.100|0:18-U0.070|0:59-U0.100|0:19-U0.070|0:57-U0.110|0:18-U0.040|0:47-U0.100|0:18-U0.060|1:01-U0.110|0:19-U0.190|1:43,,"Balve Track Running",,,3113,,250,3,12068141034,0,168070,250480,30378,,58579695,,,,,,,,,,,,,,,,,,,,,,,,,,,,,,,,,,,,,,,,,
76942940,14f86a2d-6f69-405a-b878-9bb4b6be9702,1695236734,120,1695230662,,0,0,1.61,518,552,11,8,20,17,0,0.5,0.39,1.08,,,111,137,143,,142,9,56.12,32.17,56.73,1,59.26,2578,22,,1.6,0,100,100,,,,,,11,78,11.26,11.24,11.29,2.8,5,272,272,,1,273,273,,,,,,,,,"4,3,16,68,8,0,0,0,0","0,81,19,0,0","0,0,95,5,0",,,,,120,,,,,,,,,,,,,,,,,,,,,,,,,,,,,,,,,,,,17.8,20,15,188,65,,1006,0,,0,2,4,,1,0,U1.000|5:28-U0.607|3:10,,"Balve Running",,,3113,,250,3,12068141715,0,168070,250480,30378,,58579701,,,,,,,,,,,,,,,,,,,,,,,,,,,,,,,,,,,,,,,,,
77033631,c4fdf670-6319-47d2-8b0d-687349170567,1695319658,120,1695318511,,0,0,14.29,4442,4775,264,271,281,298,0,3.4,0.71,0.98,1.06,442,915,137,161,91,161,22,58.56,39.44,59.86,1,59.26,1589,109,,3.2,0,101,100,,,,,,61,80,11.93,11.99,12.05,0.1,-2.8,286,286,,1,291,291,,,,,,,,,"13,9,11,21,29,15,2,0,0","1,66,32,0,0","0,1,68,30,0",,,,,121,,,,,,,,,,,,,,,,,,,,,,,,,,,,,,,,,,,,18.8,19,15,184,78,,997,0,,0,4,4,Balve,1,0,U1.000|5:55-U1.000|5:26-U1.000|4:46-U1.000|4:50-U1.000|4:53-U1.000|5:20-U1.000|5:06-U1.000|4:44-U1.000|5:34-U1.000|4:18-U1.000|4:28-U1.000|6:06-U1.000|5:40-U1.000|5:12-U0.289|1:46,,"Balve Running",,,3113,,250,3,12075613155,0,168070,250480,30378,,58661111,,,,,,,,,,,,,,,,,,,,,,,,,,,,,,,,,,,,,,,,"4,4,5",
77125095,8e472e76-08a5-4149-a3a8-9e41ebebafdb,1695407389,120,1695420087,,0,0,15.94,5177,5372,358,350,358,353,0,3.9,0.73,0.96,1.04,519,1040,136,162,,162,22,55.99,37.8,57.59,1,59.22,1360,114,,3.2,0,98,98,,,,,,99,80,11.64,11.76,11.86,-3.4,-3.6,275,275,,1,285,285,,,,,,,,,"24,15,10,11,25,11,4,1,0","1,75,24,0,0","0,1,81,17,1",,,,,115,,,,,,,,,,,,,,,,,,,,,,,,,,,,,,,,,,,,32.4,16,8,197,66,,1003,0,,0,4,4,Balve,1,0,U1.000|6:03-U1.000|6:41-U1.000|6:10-U1.000|6:42-U1.000|5:01-U1.000|4:51-U1.000|4:47-U1.000|5:48-U1.000|7:17-U1.000|6:11-U1.000|4:32-U1.000|4:40-U1.000|4:36-U1.000|4:31-U0.351|1:36-U1.000|3:47-U0.590|3:05,,"Balve Running",,,3113,,250,3,12083483002,0,168070,250480,30378,,58745158,,,,,,,,,,,,,,,,,,,,,,,,,,,,,,,,,,,,,,,,"4,4",
77147742,75298060-24a4-40ad-a799-4eb99196cb84,1695464801,120,1695463687,1695463991,0,0,12.09,4969,5749,387,388,351,331,4,3.8,0.75,1.05,0.86,348,890,135,169,,165,40,42.27,27.98,43.94,1,59.2,1310,130,,3,2.1,97,98,,,,,,82,76,9.02,10.22,11.88,31.6,-22.8,213,213,,1,308,307,,,,,,,,,"42,10,11,19,14,4,1,0,0","0,68,29,2,0","26,11,50,8,6",,,,,96,,,,,,,,,,,,,,,,,,,,,,,,,,,,,,,,,,,,19,12,17,239,81,,1014,2,,0,3,4,Balve,1,0,U1.000|5:27-U1.000|5:54-U1.000|5:19-U1.000|4:57-U1.000|5:24-U1.000|5:03-U1.000|5:11-U0.301|1:46-U0.143|0:37-U0.177|1:47-U0.148|0:41-U0.189|1:57-U0.138|0:39-U0.193|2:34-U0.131|0:36-U0.194|2:29-U0.136|0:38-U0.195|3:16-U0.140|0:39-U0.167|2:17-U0.137|0:40-U0.186|3:12-U0.139|0:40-U0.184|3:10-U0.142|0:45-U0.193|3:40-U0.141|0:44-U0.013|1:04-U1.000|6:27-U0.705|5:16,,"Balve Running",,,3113,,250,3,12086360498,0,168070,250480,30378,,58766044,,,,,,,,,,,,,,,,,,,,,,,,,,,,,,,,,,,,,,,,"4,4,4,5,5",
77201284,6a24aa91-71eb-4071-a6a6-2c96b911e512,1695539061,120,1695537061,,0,0,13.63,4787,4949,400,392,405,403,0,4.9,0.71,0.94,1.02,509,939,138,158,104,155,27,49.91,34.05,51.76,1,59.18,1296,99,,3.1,0,97,99,,,,,,88,80,11.15,11.04,11.43,-12.7,-5.7,257,257,,1,268,268,,,,,,,,,"35,8,16,12,12,16,2,0,0","0,54,46,0,0","2,11,67,21,0",,,,,107,,,,,,,,,,,,,,,,,,,,,,,,,,,,,,,,,,,,23.2,8,6,175,95,,1026,0,,0,3,4,Balve,1,0,U1.000|5:31-U1.000|5:53-U1.000|6:57-U1.000|10:00-U1.000|7:02-U1.000|6:24-U1.000|5:39-U1.000|5:02-U1.000|4:52-U1.000|5:10-U1.000|4:30-U1.000|4:14-U1.000|4:40-U0.632|3:55,,"Balve Running",,,3113,,250,3,12092247098,0,168070,250480,30378,,58814712,,,,,,,,,,,,,,,,,,,,,,,,,,,,,,,,,,,,,,,,"2,5",
77217384,07bf4218-8513-4130-ae61-c5c4c826fcea,1695547561,120,1695550704,,0,0,6.22,9075,9075,206,166,194,155,0,3,0.59,,,129,763,99,143,83,137,32,,,,1,59.21,1071,14,,1,0,,100,,,,,,45,59,,6.09,,37.7,,,,,,,,,,,,,,,,"88,11,0,0,0,0","56,44,0,0,0",,,,,,,,,,,,,,,,,,,,,,,,,,,,,,,,,,,,,,,,,,5.9,14,7,186,72,,1027,1,,0,2,4,Helle,1,0,,,"Balve Hiking",,,3113,,250,3,12093908841,0,168075,,30378,,58828615,,,,,,,,,,,,,,,,,,,,,,,,,,,,,,,,,,,,,,,,"4,4,5",
77299019,0efa1fda-f22e-4f9f-b5dc-198e1ee3b637,1695647802,120,1695644978,,0,0,13.68,4001,4013,312,312,331,332,0,3.5,0.76,0.97,1.05,523,912,150,169,,167,18,55.94,42.2,57.52,1,59.17,1589,149,,3.6,0,103,99,,,,,,106,80,12.82,12.9,12.96,-5.1,2.3,311,311,,1,317,317,,,,,,,,,"6,9,18,14,17,23,12,1,0","0,18,65,17,0","0,0,41,58,1",,,,,128,,,,,,,,,,,,,,,,,,,,,,,,,,,,,,,,,,,,53.9,19,13,177,53,,1023,3,,0,4,4,Balve,1,0,U1.000|5:03-U1.000|4:50-U1.000|5:54-U1.000|5:42-U1.000|5:38-U1.000|5:57-U1.000|4:46-U1.000|4:12-U1.000|4:14-U1.000|4:02-U1.000|3:53-U1.000|4:42-U1.000|4:45-U0.681|3:01,,"Balve Running",,,3113,,250,3,12102101585,0,168070,250480,30378,,58903663,,,,,,,,,,,,,,,,,,,,,,,,,,,,,,,,,,,,,,,,"4,5",
77408535,a4dc74b2-7cc9-4af7-9430-620ca3ec39bb,1695753191,120,1695754997,,0,0,6.35,1930,2304,22,22,36,35,0,0,0.03,1.19,,,403,140,159,,159,41,58.55,38.25,58.8,1,59.24,1211,107,,2.9,2,104,101,,,,,,39,78,11.88,13.79,14.21,12,-38.2,293,293,,1,381,381,,,,,,,,,"24,4,4,3,24,33,1,2,4","1,37,61,0,0","3,17,13,61,6",,,,,127,,,,,,,,,,,,,,,,,,,,,,,,,,,,,,,,,,,,28.3,19,5,183,68,,1020,0,,0,4,4,Westick,1,0,U1.000|4:46-U1.000|4:28-U1.000|4:24-U1.000|4:25-U0.273|1:18-U0.300|1:41-U0.318|1:42-U1.000|5:39-U0.463|3:48,,"Fröndenberg/Ruhr Running",,,3113,,250,3,12112777443,0,168070,250480,30378,,59001781,,,,,,,,,,,,,,,,,,,,,,,,,,,,,,,,,,,,,,,,,
77408536,939bdb74-1972-4d40-b9ef-be343a00357b,1695755569,120,1695754998,,0,0,7.43,2364,2364,0,0,0,0,0,0,0,,,,515,147,185,106,180,52,51.85,36.59,51.85,1,59.24,3936,186,,3.1,3,,100,,,,,,61,78,11.31,13.68,13.68,5.8,-1.4,285,285,,1,363,363,,,,,,,,,"49,3,5,2,1,2,3,26,9","0,40,34,25,1","22,23,12,9,34",,,,,121,,,,,,,,,,,,,,,,,,,,,,,,,,,,,,,,,,,,46.1,19,5,171,72,,1020,0,,1,4,4,Westick,1,0,U0.400|1:16-U0.200|1:38-U0.400|1:15-U0.210|1:33-U0.400|1:16-U0.200|1:47-U0.400|1:14-U0.400|4:05-U0.400|1:16-U0.200|1:45-U0.400|1:17-U0.200|1:51-U0.400|1:15-U0.200|1:49-U0.400|1:15-U0.400|3:55-U0.400|1:18-U0.190|1:40-U0.400|1:16-U0.200|1:50-U0.400|1:17-U0.190|1:46-U0.400|1:08-U0.040|0:40,,"Fröndenberg/Ruhr Track Running",,,3113,,250,3,12112777587,0,168070,250480,30378,,59001783,,,,,,,,,,,,,,,,,,,,,,,,,,,,,,,,,,,,,,,,,
77408539,6f18f8ae-0cf0-42c4-ad55-3e57e5c048ab,1695758229,120,1695754998,,0,0,1.93,628,653,22,12,16,6,0,0,0.21,1.05,,,134,140,146,110,143,7,53.83,32.37,54.93,1,59.24,3922,27,,1.9,0,98,97,,,,,,12,79,11.23,11.05,11.27,5.6,8.5,273,273,,1,275,275,,,,,,,,,"0,2,22,76,0,0,0,0,0","0,46,54,0,0","0,0,95,5,0",,,,,117,,,,,,,,,,,,,,,,,,,,,,,,,,,,,,,,,,,,16.1,18,6,163,72,,1020,0,,1,4,4,Westick,1,0,U1.000|5:25-U0.926|5:03,,"Fröndenberg/Ruhr Running",,,3113,,250,3,12112777653,0,168070,250480,30378,,59001785,,,,,,,,,,,,,,,,,,,,,,,,,,,,,,,,,,,,,,,,,
77470332,59fe6d67-a293-42a0-9807-c722e7db8b37,1695816444,120,1695825266,,0,0,13.65,4650,4819,333,304,362,336,0,3.8,0.7,0.96,1.04,456,921,137,157,,152,23,52.3,35.3,54.02,1,59.24,2886,95,,3.1,0,100,98,,,,,,94,79,11.1,11.13,11.26,-3.8,4.3,261,261,,1,267,267,,,,,,,,,"31,10,13,16,24,6,1,0,0","0,59,40,0,0","0,4,85,11,0",,,,,111,,,,,,,,,,,,,,,,,,,,,,,,,,,,,,,,,,,,26.3,22,9,158,61,,1020,3,,0,3,4,Balve,1,0,U1.000|5:19-U1.000|5:23-U1.000|7:05-U1.000|6:56-U1.000|6:29-U1.000|6:49-U1.000|5:30-U1.000|4:43-U1.000|4:46-U1.000|4:42-U1.000|4:43-U1.000|5:38-U1.000|6:00-U0.648|3:28,,"Balve Running",,,3113,,250,3,12118189236,0,168070,250480,30378,,59055147,,,,,,,,,,,,,,,,,,,,,,,,,,,,,,,,,,,,,,,,"3,5",
77522638,2ffe003d-13e8-4e8b-8f35-721bbb7ae0b8,1695887930,120,1695886750,,0,0,16.86,5654,5910,350,331,369,351,0,3.7,0.68,0.94,1.07,494,1142,139,163,,154,25,52.34,36.57,53.76,1,59.22,2172,121,,3.3,0,96,98,,,,,,12,80,11.16,11.18,11.25,-3.1,2.8,263,263,,1,267,267,,,,,,,,,"25,9,13,25,23,5,0,0,0","0,54,46,0,0","0,1,91,8,0",,,,,112,,,,,,,,,,,,,,,,,,,,,,,,,,,,,,,,,,,,1.7,16,7,208,78,,1018,0,,0,2,4,Balve,1,0,U1.000|5:48-U1.000|5:01-U1.000|5:27-U1.000|5:17-U1.000|5:30-U1.000|5:49-U1.000|6:33-U1.000|7:48-U1.000|6:38-U1.000|5:37-U1.000|4:51-U1.000|4:45-U1.000|4:30-U1.000|4:49-U1.000|5:12-U1.000|5:52-U0.862|4:49,,"Balve Running",,,3113,,250,3,12123242113,0,168070,250480,30378,,59101412,,,,,,,,,,,,,,,,,,,,,,,,,,,,,,,,,,,,,,,,"4,5",
77613155,4e4bd3f5-8b67-466a-81c6-be5052e7308f,1695994062,120,1695992122,,0,0,12.14,4617,5188,316,318,352,359,0,3.8,0.54,0.95,0.76,915,869,139,175,,175,43,44.82,30.71,46.25,1,59.2,1347,124,,3.1,1.4,99,99,,,,,,16,77,9.76,10.75,12.36,28.6,-22,233,233,,1,320,320,,,,,,,,,"33,8,15,20,16,7,2,0,0","0,55,37,8,0","19,11,51,14,6",,,,,102,,,,,,,,,,,,,,,,,,,,,,,,,,,,,,,,,,,,5.5,22,19,236,70,,1017,3,,0,4,4,Balve,1,0,U1.000|5:18-U1.000|5:38-U1.000|5:09-U1.000|4:39-U1.000|5:23-U1.000|4:53-U1.000|5:00-U0.266|1:26-U0.144|0:40-U0.188|1:33-U0.143|0:39-U0.191|1:29-U0.143|0:37-U0.189|1:33-U0.147|0:40-U0.196|1:43-U0.148|0:41-U0.186|2:29-U0.144|0:35-U0.183|2:02-U0.143|0:35-U0.185|3:01-U0.147|0:41-U0.197|3:32-U0.141|0:40-U0.203|4:24-U0.136|0:43-U1.000|6:29-U0.716|4:43,,"Balve Running",,,3113,,250,3,12132236723,0,168070,250480,30378,,59184096,,,,,,,,,,,,,,,,,,,,,,,,,,,,,,,,,,,,,,,,"4,4,5,5,5",
77661659,2aea5a56-6dd3-4918-ae19-6468abb3698a,1696061682,120,1696061132,,0,0,20.2,6248,6487,477,473,500,500,0,4.7,0.78,0.95,1.07,642,1381,146,163,,155,27,54.19,40.78,55.79,1,59.18,2029,178,,3.8,0,103,98,,,,,,38,81,12.27,12.38,12.5,-4.8,2.9,292,292,,1,301,301,,,,,,,,,"19,11,11,12,18,22,8,0,0","0,21,77,1,0","0,1,57,40,2",,,,,120,,,,,,,,,,,,,,,,,,,,,,,,,,,,,,,,,,,,5.8,10,6,200,94,,1027,0,,0,3,4,Balve,1,0,U1.000|4:38-U1.000|5:01-U1.000|5:31-U1.000|6:08-U1.000|6:36-U1.000|6:53-U1.000|5:15-U1.000|4:48-U1.000|4:52-U1.000|5:24-U1.000|6:55-U1.000|5:00-U1.000|4:58-U1.000|4:52-U1.000|4:05-U1.000|4:12-U1.000|4:08-U1.000|4:00-U1.000|4:12-U1.000|5:43-U0.203|0:59,,"Balve Running",,,3113,,250,3,12137235892,0,168070,250480,30378,,59229233,,,,,,,,,,,,,,,,,,,,,,,,,,,,,,,,,,,,,,,,"3,4,5",
77662209,,1696068900,120,1696061788,,0,0,,1,1,,,,,0,,,,,,0,,,,,,,,,1,,,,,,,,,,,,,,0,,,,,,,,,,,,,,,,,,,,,,,,,,,,,,,,,,,,,,,,,,,,,,,,,,,,,,,,,,,,,,,,,,,,,,,,,,1,,,0,0,,,test,,,connect,,,3,12137301477,0,168075,,30378,,59229746,,,,,,,,,,,,,,,,,,,,,,,,,,,,,,,,,,,,,,,,,
77731847,a3a66ba4-46ea-480e-bd55-7022734e172f,1696152473,120,1696149977,,0,0,15.3,4503,4588,84,78,108,100,0,0,0.16,,,,968,143,175,,172,47,59.25,42.26,59.68,1,59.21,1947,191,,3.4,2.6,104,100,,,,,,105,80,12.26,13.2,13.42,1.8,-22.5,304,304,,1,349,349,,,,,,,,,"7,4,6,21,40,15,2,5,0","0,33,62,5,0","2,3,41,48,5",,,,,127,,,,,,,,,,,,,,,,,,,,,,,,,,,,,,,,,,,,43.9,14,9,161,80,,1025,1,,0,2,4,Opladen,1,0,U1.000|4:57-U1.000|4:39-U1.000|4:55-U1.000|5:02-U1.000|4:57-U1.000|4:55-U1.000|4:53-U1.000|4:39-U1.000|4:40-U1.000|4:47-U1.000|4:50-U1.000|5:06-U0.660|3:02-U0.414|1:21-U0.214|1:28-U0.411|1:22-U0.208|1:46-U0.412|1:20-U0.983|6:23,,"Leverkusen Running",,,3113,,250,3,12144964233,0,168070,250480,30378,,59292354,,,,,,,,,,,,,,,,,,,,,,,,,,,,,,,,,,,,,,,,,
77800028,59fc79a3-605b-4da9-a29a-344eeb074072,1696237520,120,1696233888,,0,0,10.33,3316,3411,34,43,45,55,0,0,0.02,,,,655,135,147,,142,14,57.34,37.04,57.51,1,59.2,1172,71,,2.7,0,96,100,,,,,,64,79,11.2,11.26,11.24,-1.8,-4.6,270,270,,1,272,272,,,,,,,,,"5,5,21,50,15,2,1,0,0","1,92,7,0,0","0,0,92,7,0",,,,,118,,,,,,,,,,,,,,,,,,,,,,,,,,,,,,,,,,,,20.6,16,7,146,80,,1021,0,,0,4,4,Opladen,1,0,U1.000|5:28-U1.000|5:08-U1.000|5:12-U1.000|5:22-U1.000|5:33-U1.000|5:18-U1.000|5:24-U1.000|5:18-U1.000|5:30-U1.000|5:18-U0.331|1:45,,"Leverkusen Running",,,3113,,250,3,12151975337,0,168070,250480,30378,,59354613,,,,,,,,,,,,,,,,,,,,,,,,,,,,,,,,,,,,,,,,,
77900564,e1836a24-ca4c-4973-8901-667e677bffe6,1696324023,120,1696337840,,0,0,20.56,6441,6566,449,435,502,489,0,4.1,0.71,0.95,1.04,469,1388,145,169,,146,78,53.84,40.23,55.34,1,59.2,2019,186,,3.9,0,102,99,,,,,,150,81,11.99,11.87,12.11,1.1,6.4,287,287,,1,293,293,,,,,,,,,"11,10,14,21,26,14,3,0,0","0,31,62,6,0","0,6,48,45,0",,,,,118,,,,,,,,,,,,,,,,,,,,,,,,,,,,,,,,,,,,41.8,18,25,233,73,,1011,1,,0,11,4,Stockum,1,0,U1.000|5:29-U1.000|4:55-U1.000|5:04-U1.000|5:48-U1.000|5:19-U1.000|5:51-U1.000|4:42-U1.000|6:14-U1.000|5:46-U1.000|4:42-U1.000|4:51-U1.000|5:27-U1.000|5:01-U1.000|4:33-U1.000|4:52-U1.000|4:40-U1.000|5:09-U1.000|5:42-U1.000|4:21-U1.000|5:34-U0.561|3:19,,"Möhnesee Running",,,3113,,250,3,12161694963,0,168070,250480,30378,,59446006,,,,,,,,,,,,,,,,,,,,,,,,,,,,,,,,,,,,,,,,"4,4,5,5",
77975422,22492fdc-e5f0-45c8-a566-b9fc65876b81,1696428216,120,1696425445,,0,0,13.76,4129,4165,332,327,341,338,0,3.6,0.72,0.97,1.08,468,890,140,164,105,138,23,59.48,40.97,61.29,1,59.19,1397,116,,3.3,0,104,99,,,,,,78,81,12.56,12.78,12.71,-7.7,-0.5,302,302,,1,307,307,,,,,,,,,"12,11,16,13,16,17,14,1,0","1,53,46,1,0","0,0,51,49,0",,,,,123,,,,,,,,,,,,,,,,,,,,,,,,,,,,,,,,,,,,27.2,16,16,247,67,,1027,2,,0,4,4,Balve,1,0,U1.000|4:55-U1.000|5:01-U1.000|6:07-U1.000|6:09-U1.000|5:57-U1.000|6:14-U1.000|4:51-U1.000|4:13-U1.000|4:08-U1.000|3:59-U1.000|3:50-U1.000|4:47-U1.000|5:12-U0.755|3:27,,"Balve Running",,,3113,,250,3,12169547398,0,168070,250480,30378,,59515381,,,,,,,,,,,,,,,,,,,,,,,,,,,,,,,,,,,,,,,,"4,4",
78049902,42e3ca77-557b-4501-a6b8-ae424636d8ff,1696515966,120,1696514261,,0,0,12.41,4754,5457,321,278,350,305,0,3.7,0.6,1.04,0.82,386,882,135,164,,164,43,46.1,30.5,47.78,1,59.19,1223,107,,3.1,0.5,99,100,,,,,,13,77,9.71,10.7,11.93,27.8,-17.3,233,233,,1,307,307,,,,,,,,,"37,8,11,18,18,6,2,0,0","0,67,33,0,0","20,11,46,19,4",,,,,102,,,,,,,,,,,,,,,,,,,,,,,,,,,,,,,,,,,,2,15,15,262,69,,1025,2,,0,4,4,Balve,1,0,U1.000|5:12-U1.000|5:34-U1.000|5:04-U1.000|4:37-U1.000|5:21-U1.000|4:50-U1.000|5:03-U0.309|1:48-U0.140|0:40-U0.187|1:47-U0.133|0:39-U0.044|0:32-U0.138|0:39-U0.193|1:57-U0.137|0:39-U0.173|1:59-U0.145|0:38-U0.204|2:22-U0.137|0:40-U0.207|2:32-U0.141|0:40-U0.197|2:27-U0.143|0:40-U0.222|2:53-U0.140|0:35-U0.204|3:06-U0.150|0:40-U0.153|2:57-U1.000|6:24-U0.917|6:18,,"Balve Running",,,3113,,250,3,12184442098,0,168070,250480,30378,,59583002,,,,,,,,,,,,,,,,,,,,,,,,,,,,,,,,,,,,,,,,"4,5,5,5,5",
78123314,0599e1d9-3e19-4718-a818-63d856460d79,1696603323,120,1696599865,,0,0,10,3341,3597,247,229,257,239,0,3.6,0.75,0.95,0.99,411,676,141,167,,152,26,51.62,35.26,53.31,1,59.16,1186,84,,3,0,100,97,,,,,,9,79,11.39,11.31,11.73,-9.4,-5.8,270,270,,1,281,281,,,,,,,,,"23,11,17,15,25,8,2,0,0","0,54,43,3,0","1,1,78,18,1",,,,,114,,,,,,,,,,,,,,,,,,,,,,,,,,,,,,,,,,,,3.7,18,17,231,61,,1023,2,,0,4,4,Balve,1,0,U1.000|5:09-U1.000|5:23-U1.000|5:52-U1.000|6:26-U1.000|7:29-U1.000|5:08-U1.000|4:52-U1.000|4:39-U1.000|4:24-U1.000|6:17-U0.002|0:02,,"Balve Running",,,3113,,250,3,12198410989,0,168070,250480,30378,,59649448,,,,,,,,,,,,,,,,,,,,,,,,,,,,,,,,,,,,,,,,"4,5,5",
78195488,bef82125-ffde-4c21-b9ab-d44bfcdb211d,1696672895,120,1696684244,,0,0,4.76,1472,2563,26,28,30,32,0,0,0.13,0.82,,,336,156,172,,162,37,49.39,36.85,49.7,1,59.13,1178,79,,2.9,0,100,97,,,,,,42,79,11.76,12.58,12.84,12.9,-14.7,285,285,,1,329,329,,,,,,,,,"16,0,0,11,51,18,1,1,2","0,13,32,55,0","6,9,21,61,3",,,,,123,,,,,,,,,,,,,,,,,,,,,,,,,,,,,,,,,,,,52.6,15,20,231,86,,1022,1,,0,4,4,Westick,1,0,U1.000|4:55-U1.000|4:38-U1.000|4:37-U1.000|4:39-U0.755|5:42,,"Fröndenberg/Ruhr Running",,,3113,,250,3,12212355162,0,168070,250480,30378,,59715374,,,,,,,,,,,,,,,,,,,,,,,,,,,,,,,,,,,,,,,,,
78195489,89dcafe5-0def-4057-a704-2df1b123425a,1696675596,120,1696684245,,0,0,8.07,2657,2657,0,0,0,0,0,0,0,,,,587,151,198,114,193,49,47.89,35.33,47.89,1,59.13,2592,151,,3.5,0.5,93,107,,,,,,74,80,10.94,14.23,14.23,9.5,4.4,279,278,,1,379,378,,,,,,,,,"48,4,1,0,0,1,17,27,2","0,34,30,24,12","26,16,11,2,44",,,,,114,,,,,,,,,,,,,,,,,,,,,,,,,,,,,,,,,,,,93.5,16,21,234,83,,1022,2,,0,4,4,Westick,1,0,U1.990|6:45-U1.000|10:31-U1.010|3:23-U1.000|3:39-U1.000|11:10-U1.600|5:36-U0.400|1:21-U0.070|1:52,,"Fröndenberg/Ruhr Track Running",,,3113,,250,3,12212355537,0,168070,250480,30378,,59715373,,,,,,,,,,,,,,,,,,,,,,,,,,,,,,,,,,,,,,,,,
78195512,,1696680000,120,1696684268,,0,0,4,1200,1200,,,,,0,,,,,,288,,,,,,,37.79,,1,,,,,,,,,,,,,,22,,,,,,,,,,,,,,,,,,,,,,,,,,,,,,,,,,,,,,,,,,,,,,,,,,,,,,,,,,,,,,,,,,,,,,,,,,1,,,0,0,,,Auslaufen,,,connect,,,3,12212361848,0,168070,250480,30378,,59715387,,,,,,,,,,,,,,,,,,,,,,,,,,,,,,,,,,,,,,,,,
78245810,7805fd0a-8531-49e3-a1bb-79970d9ba3cc,1696753009,120,1696752737,,0,0,18.64,6024,6173,518,518,547,546,0,5.4,0.65,1,0.98,682,1347,155,179,107,163,28,47.21,38.5,48.84,1,59.12,3466,217,,4.2,0,102,97,,,,,,175,81,11.89,11.45,12.54,-5.9,-1.8,282,282,,1,304,304,,,,,,,,,"24,6,9,14,29,15,3,1,0","0,14,53,33,0","1,10,52,33,5",,,,,115,,,,,,,,,,,,,,,,,,,,,,,,,,,,,,,,,,,,68.4,14,7,303,86,,1025,0,,0,4,4,Hüsten,1,0,U1.000|4:56-U1.000|4:48-U1.000|6:16-U1.000|5:12-U1.000|5:13-U1.000|5:22-U1.000|5:25-U1.000|8:03-U1.000|5:33-U1.000|4:52-U1.000|4:31-U1.000|4:43-U1.000|5:11-U1.000|5:11-U1.000|6:34-U1.000|5:07-U1.000|5:37-U1.000|4:48-U0.637|3:04,,"Arnsberg Running",,,3113,,250,3,12222523419,0,168070,250480,30378,,59760355,,,,,,,,,,,,,,,,,,,,,,,,,,,,,,,,,,,,,,,,"3,4,4,5,5",
78333335,466f5994-f188-4adb-b180-f44f6c0e5f91,1696855611,120,1696854684,,0,0,16.57,5145,5879,348,285,376,317,0,3.9,0.65,0.97,1.08,650,1116,142,163,,159,19,55.98,39.96,57.69,1,59.11,2740,158,,3.6,0,98,100,,,,,,25,80,12.08,11.92,12.27,-7.8,-2.2,292,292,,1,299,299,,,,,,,,,"10,9,15,18,30,16,1,0,0","0,41,58,1,0","0,0,59,40,1",,,,,121,,,,,,,,,,,,,,,,,,,,,,,,,,,,,,,,,,,,6.9,18,16,261,69,,1020,2,,0,4,4,Balve,1,0,U1.000|5:29-U1.000|4:44-U1.000|4:59-U1.000|4:50-U1.000|5:05-U1.000|5:20-U1.000|5:50-U1.000|6:50-U1.000|5:53-U1.000|4:45-U1.000|4:35-U1.000|4:37-U1.000|4:26-U1.000|4:44-U1.000|5:27-U1.000|5:22-U0.570|2:48,,"Balve Running",,,3113,,250,3,12240761192,0,168070,250480,30378,,59841393,,,,,,,,,,,,,,,,,,,,,,,,,,,,,,,,,,,,,,,,"4,5",
78433058,506ffe8c-7f74-45e1-95b4-d80e9b48b910,1696963155,120,1696962335,,0,0,5.66,1592,2019,29,33,41,43,0,0,0.08,,,,363,145,162,,140,23,61.5,41.64,61.84,1,59.17,1338,86,,3,0,104,102,,,,,,10,79,12.77,14.06,14.43,8.5,-28.3,319,319,,1,386,386,,,,,,,,,"13,3,7,1,18,47,5,2,4","1,28,70,1,0","3,9,11,71,5",,,,,135,,,,,,,,,,,,,,,,,,,,,,,,,,,,,,,,,,,,5.5,19,12,213,64,,1017,0,,1,4,4,Westick,1,0,U1.000|4:39-U1.000|4:17-U1.000|4:16-U1.000|4:10-U0.638|3:27-U0.142|0:26-U0.269|1:56-U0.410|2:27-U0.195|0:54,,"Fröndenberg/Ruhr Running",,,3113,,250,3,12260600808,0,168070,250480,30378,,59928857,,,,,,,,,,,,,,,,,,,,,,,,,,,,,,,,,,,,,,,,,
78433114,0129eced-5c4b-4d78-9af8-78393ffe4b99,1696965396,120,1696962359,,0,0,4.7,1530,1530,0,0,0,0,0,0,0,,,,315,144,176,107,176,50,51.83,34.64,51.83,1,59.17,2371,100,,2.5,2.2,,100,,,,,,11,77,11.05,14.2,14.2,22.9,6.7,279,279,,1,381,381,,,,,,,,,"53,3,3,1,1,1,3,27,8","0,47,28,24,0","23,26,11,4,36",,,,,120,,,,,,,,,,,,,,,,,,,,,,,,,,,,,,,,,,,,9.7,19,13,211,64,,1017,0,,1,4,4,Westick,1,0,U1.000|3:15-U0.400|3:14-U0.800|2:33-U0.400|3:48-U0.600|1:53-U0.400|3:45-U0.400|1:08-U0.400|3:47-U0.200|0:32-U0.100|1:35,,"Fröndenberg/Ruhr Track Running",,,3113,,250,3,12260608259,0,168070,250480,30378,,59928910,,,,,,,,,,,,,,,,,,,,,,,,,,,,,,,,,,,,,,,,,
78433203,,1696969556,120,1696962434,,0,0,3.5,1080,1080,,,,,0,,,,,,238,,,,,,,36.23,,1,,,,,,,,,,,,,,25,,,,,,,,,,,,,,,,,,,,,,,,,,,,,,,,,,,,,,,,,,,,,,,,,,,,,,,,,,,,,,,,,,,,,,,,,,1,,,0,0,,,Running,,,connect,,,3,12260628673,0,168070,250480,30378,,59928995,,,,,,,,,,,,,,,,,,,,,,,,,,,,,,,,,,,,,,,,,
78477445,579de592-5077-4c18-9c2d-613ed4f7e12a,1697028633,120,1697027668,,0,0,17.23,5465,5864,440,412,492,465,0,4.8,0.78,0.98,1.1,488,1147,144,166,,160,23,53.52,39.11,55.32,1,59.16,2168,140,,3.5,0,100,99,,,,,,54,80,11.99,12.29,12.55,-3.2,-9.4,286,286,,1,303,303,,,,,,,,,"20,15,11,13,18,16,6,1,0","0,32,64,4,0","0,2,72,22,3",,,,,118,,,,,,,,,,,,,,,,,,,,,,,,,,,,,,,,,,,,12.6,21,21,229,60,,1015,2,,0,4,4,Balve,1,0,U1.000|5:14-U1.000|5:19-U1.000|6:46-U1.000|6:29-U1.000|6:47-U1.000|5:09-U1.000|4:30-U1.000|4:33-U1.000|5:37-U1.000|6:45-U1.000|5:23-U1.000|4:29-U1.000|4:20-U1.000|3:58-U1.000|3:33-U1.000|5:43-U1.000|5:19-U0.231|1:09,,"Balve Running",,,3113,,250,3,12270277711,0,168070,250480,30378,,59968916,,,,,,,,,,,,,,,,,,,,,,,,,,,,,,,,,,,,,,,,"3,4,5",
78565697,4cb0c122-f019-4a63-be56-2972dcfb8aba,1697133078,120,1697131916,,0,0,12.18,5188,5698,328,331,355,355,0,3.7,0.59,0.98,0.74,304,864,131,170,,168,49,41.98,26.82,43.37,1,59.17,1164,91,,2.9,0.7,102,100,,,,,,14,76,8.75,10.08,12.4,34.8,-33.7,206,206,,1,325,325,,,,,,,,,"48,7,12,19,10,3,1,0,0","1,79,19,1,0","26,14,48,8,4",,,,,93,,,,,,,,,,,,,,,,,,,,,,,,,,,,,,,,,,,,3.3,14,9,205,89,,1014,0,,0,4,4,Balve,1,0,U1.000|5:18-U1.000|5:47-U1.000|5:32-U1.000|5:00-U1.000|5:30-U1.000|5:08-U1.000|5:13-U0.282|1:56-U0.142|0:38-U0.176|2:06-U0.144|0:38-U0.185|2:17-U0.141|0:40-U0.191|2:17-U0.134|0:40-U0.176|2:22-U0.138|0:39-U0.171|1:54-U0.134|0:36-U0.165|4:17-U0.134|0:41-U0.175|3:21-U0.137|0:40-U0.194|2:53-U0.142|0:42-U0.186|2:51-U0.141|0:39-U1.000|9:41-U0.893|6:34,,"Balve Running",,,3113,,250,3,12288758743,0,168070,250480,30378,,60044574,,,,,,,,,,,,,,,,,,,,,,,,,,,,,,,,,,,,,,,,"4,4,5,5",
78611705,4e87b1eb-bb4a-4b50-9b23-69b2d43aaa61,1697204193,120,1697203180,,0,0,16.69,5342,5845,348,367,385,408,0,3.7,0.75,0.98,1.11,492,1095,143,161,,155,23,53.42,38.59,54.72,1,59.14,1414,125,,3.3,0,98,100,,,,,,11,81,11.67,12.35,12.06,-14.2,-11.2,276,276,,1,286,286,,,,,,,,,"21,12,21,18,8,9,11,1,0","0,33,67,0,0","0,0,76,24,0",,,,,116,,,,,,,,,,,,,,,,,,,,,,,,,,,,,,,,,,,,1.8,20,19,194,69,,1008,2,,0,3,4,Balve,1,0,U1.000|6:07-U1.000|5:12-U1.000|5:37-U1.000|5:32-U1.000|5:40-U1.000|5:55-U1.000|6:33-U1.000|7:19-U1.000|6:27-U1.000|4:40-U1.000|4:00-U1.000|3:58-U1.000|3:48-U1.000|4:06-U1.000|5:15-U1.000|5:26-U0.686|3:27,,"Balve Running",,,3113,,250,3,12298709045,0,168070,250480,30378,,60085243,,,,,,,,,,,,,,,,,,,,,,,,,,,,,,,,,,,,,,,,"4,5",
78653691,9a4273dd-4914-4850-a105-26c2a5ebf088,1697267383,120,1697265161,,0,0,12.51,4183,4919,178,172,213,207,0,2,0.49,0.93,0.95,319,848,139,190,,149,19,52.53,35.83,53.49,1,59.11,1298,97,,3.1,0,95,101,,,,,,76,80,10.94,11.2,11.47,-9.1,-16.7,261,261,,1,280,280,,,,,,,,,"17,14,28,21,8,9,2,0,0","0,62,32,4,2","0,6,74,20,1",,,,,112,,,,,,,,,,,,,,,,,,,,,,,,,,,,,,,,,,,,57.7,10,17,297,92,,1008,0,,1,4,4,Balve,1,0,U1.000|6:39-U1.000|5:44-U1.000|6:05-U1.000|5:54-U1.000|6:08-U1.000|6:00-U1.000|5:41-U1.000|5:12-U1.000|5:20-U1.000|4:30-U1.000|4:23-U1.000|4:58-U0.511|3:08,,"Balve Running",,,3113,,250,3,12307186505,0,168070,250480,30378,,60123557,,,,,,,,,,,,,,,,,,,,,,,,,,,,,,,,,,,,,,,,"4,5,5",
78714926,6d7f2c87-d01b-4ac8-bec1-a9363e653ed4,1697353127,120,1697348143,,0,0,6.06,1955,2033,19,27,27,34,0,0,0.1,,0.99,,391,134,154,,148,17,57.52,35.54,57.65,1,59.11,817,50,,2.4,0,100,100,,,,,,15,81,11.1,11.42,11.41,6.2,1.7,267,267,,1,279,279,,,,,,,,,"16,7,17,28,17,8,3,2,0","3,78,19,0,0","1,7,71,19,2",,,,,115,,,,,,,,,,,,,,,,,,,,,,,,,,,,,,,,,,,,6.6,6,18,261,91,,1012,0,,1,4,4,Bahrenfeld,1,0,U1.000|5:17-U1.000|5:26-U1.000|5:14-U1.000|5:35-U1.000|5:21-U1.000|5:24-U0.055|0:19,,"Hamburg Running",,,3113,,250,3,12320699786,0,168070,250480,30378,,60179836,,,,,,,,,,,,,,,,,,,,,,,,,,,,,,,,,,,,,,,,,
78790979,c82af437-e33e-47dc-9a52-50ffddbc7b1f,1697438439,120,1697437535,,0,0,14.44,4236,4571,95,85,124,113,0,0,0.17,,,,950,143,160,,145,28,59.49,42.23,60.02,1,59.13,1584,148,,3.6,0,103,101,,,,,,75,82,12.35,12.49,12.62,-2.1,-7,307,307,,1,317,317,,,,,,,,,"6,2,7,21,40,17,5,1,0","1,20,79,0,0","1,1,41,53,4",,,,,125,,,,,,,,,,,,,,,,,,,,,,,,,,,,,,,,,,,,21.6,6,8,258,95,,1019,0,,1,4,4,Bahrenfeld,1,0,U1.000|4:57-U1.000|4:50-U1.000|5:07-U1.000|5:15-U1.000|4:53-U1.000|4:45-U1.000|5:04-U1.000|4:46-U1.000|4:53-U1.000|5:14-U1.000|4:54-U1.000|4:53-U1.000|4:54-U1.000|4:20-U0.441|1:51,,"Hamburg Running",,,3113,,250,3,12335806283,0,168070,250480,30378,,60250053,,,,,,,,,,,,,,,,,,,,,,,,,,,,,,,,,,,,,,,,,
78873735,bc61a504-8099-4c85-8540-692ebd5734e4,1697528191,120,1697525489,,0,0,15.86,4081,4376,42,48,43,52,0,0,0.05,,0.89,,1017,158,183,,169,18,60.82,49.52,60.99,1,59.2,2880,237,,4.4,0,103,105,,,,,,116,83,14,14.22,14.22,-12,-17.4,356,356,,1,364,364,,,,,,,,,"1,0,1,1,15,67,10,4,1","0,1,67,31,1","0,0,4,86,10",,,,,140,,,,,,,,,,,,,,,,,,,,,,,,,,,,,,,,,,,,72,5,1,184,91,,1022,0,,0,4,4,Tempelhof,1,0,U1.000|4:22-U1.000|4:20-U1.000|4:23-U1.000|4:24-U1.000|4:26-U1.000|4:21-U1.000|4:27-U1.000|4:28-U1.000|4:25-U1.000|4:12-U1.000|4:19-U1.000|4:28-U1.000|4:05-U1.000|3:46-U1.000|3:54-U0.859|3:42,,"Berlin Running",,,3113,,250,3,12349697075,0,168070,250480,30378,,60325596,,,,,,,,,,,,,,,,,,,,,,,,,,,,,,,,,,,,,,,,,
78949265,c3ce750d-251a-473a-bfe6-6d974f9ce95c,1697614152,120,1697614016,,0,0,14.16,3688,4462,61,33,66,40,0,0,0.05,,,,881,143,160,,157,18,68.92,48.4,69.45,1,59.22,3456,189,,3.9,0,104,108,,,,,,85,83,13.91,14,14.29,-6.8,-12.3,354,354,,1,369,369,,,,,,,,,"2,1,2,3,18,54,18,2,0","0,27,72,0,0","1,1,5,83,10",,,,,139,,,,,,,,,,,,,,,,,,,,,,,,,,,,,,,,,,,,29.8,2,5,106,100,,1018,0,,0,3,4,Mitte,1,0,U1.000|4:42-U1.000|4:26-U1.000|4:22-U1.000|4:47-U1.000|4:24-U1.000|4:19-U1.000|4:12-U1.000|4:17-U1.000|4:24-U1.000|4:10-U1.000|4:13-U1.000|4:14-U1.000|4:03-U1.000|4:13-U0.164|0:42,,"Berlin Running",,,3113,,250,3,12364742194,0,168070,250480,30378,,60395685,,,,,,,,,,,,,,,,,,,,,,,,,,,,,,,,,,,,,,,,,
79058165,0108cbd0-3603-4deb-a463-ab164682c528,1697737564,120,1697735302,,0,0,14.01,4565,4899,325,310,332,322,0,3.6,0.75,0.94,1.04,440,954,143,161,,157,24,52.26,37.27,53.82,1,59.19,2029,118,,3.3,0,100,98,,,,,,98,79,11.59,11.52,11.67,-7.6,-2.4,274,274,,1,279,279,,,,,,,,,"21,13,13,15,25,12,0,0,0","0,33,67,0,0","0,1,76,24,0",,,,,117,,,,,,,,,,,,,,,,,,,,,,,,,,,,,,,,,,,,28.1,15,8,148,86,,991,0,,0,4,4,Balve,1,0,U1.000|5:13-U1.000|5:12-U1.000|6:35-U1.000|6:28-U1.000|6:21-U1.000|6:37-U1.000|5:04-U1.000|4:44-U1.000|4:39-U1.000|4:40-U1.000|4:28-U1.000|5:31-U1.000|5:00-U1.000|5:30-U0.012|0:04,,"Balve Running",,,3113,,250,3,12384932589,0,168070,250480,30378,,60494320,,,,,,,,,,,,,,,,,,,,,,,,,,,,,,,,,,,,,,,,"4,5",
79362628,dd08234e-23a6-407f-992e-21236f86ede0,1698153685,120,1698149993,,0,0,4.36,3480,3480,77,75,97,94,0,1.7,0.66,,,100,242,88,112,,100,22,,,,1,59.22,,3,,0.2,0,,100,,,,,,9,56,,4.62,,-6.2,,,,,,,,,,,,,,,,"75,25,0,0,0,0","98,2,0,0,0",,,,,,,,,,,,,,,,,,,,,,,,,,,,,,,,,,,,,,,,,,1.2,13,13,200,80,,1004,2,,0,4,4,Balve,1,0,,,"Balve Hiking",,,3113,,250,3,12448218174,0,168075,,30378,,60768340,,,,,,,,,,,,,,,,,,,,,,,,,,,,,,,,,,,,,,,,5,
79426395,2d9127f1-3c22-4aef-8bbe-5dc97bdd7948,1698226066,120,1698223854,,0,0,4.34,3115,3115,67,65,81,82,0,1.4,0.53,,,226,272,98,127,99,127,23,,,,1,59.22,,9,,0.6,0,,100,,,,,,12,60,,5.2,,2.2,,,,,,,,,,,,,,,,"24,76,0,0,0,0","64,36,0,0,0",,,,,,,,,,,,,,,,,,,,,,,,,,,,,,,,,,,,,,,,,,2.5,9,11,156,87,,1001,1,,0,4,4,Balve,1,0,,,"Balve Hiking",,,3113,,250,3,12459808023,0,168075,,30378,,60827460,,,,,,,,,,,,,,,,,,,,,,,,,,,,,,,,,,,,,,,,5,
79505482,e9e5e734-925d-445d-8679-c92d121af9d1,1698308493,120,1698304623,,0,0,4.08,3076,3076,70,75,90,91,0,1.5,0.5,,,217,254,95,124,82,118,25,,,,1,59.22,,7,,0.4,0,,100,,,,,,18,58,,4.98,,5.3,,,,,,,,,,,,,,,,"56,44,0,0,0,0","78,22,0,0,0",,,,,,,,,,,,,,,,,,,,,,,,,,,,,,,,,,,,,,,,,,4.6,8,9,258,94,,996,0,,0,4,4,Balve,1,0,,,"Balve Hiking",,,3113,,250,3,12472543818,0,168075,,30378,,60900003,,,,,,,,,,,,,,,,,,,,,,,,,,,,,,,,,,,,,,,,5,
79550089,,1698346699,120,1698339534,,0,0,4,3600,3600,,,,,0,,,,,,207,,,,,,,,,1,,,,,,,,,,,,,,41,,,,,,,,,,,,,,,,,,,,,,,,,,,,,,,,,,,,,,,,,,,,,,,,,,,,,,,,,,,,,,,,,,,,,,,,,,1,,,0,0,,,"Ums Kreuz",,,connect,,,3,12478936690,0,168075,,30378,,60940946,,,,,,,,,,,,,,,,,,,,,,,,,,,,,,,,,,,,,,,,,
79661332,1a657457-b5ec-4ae3-a663-934b83ec8a34,1698484352,120,1698478882,,0,0,4.14,1501,1501,92,91,100,99,0,2.4,0.9,1.06,1.08,384,310,146,170,,169,18,44.54,30.22,45.78,1,59.12,1064,46,,2.4,0,95,95,,,,,,35,80,10.25,10.21,10.63,-10.2,-15.4,239,239,,1,253,253,,,,,,,,,"27,28,20,18,5,1,0,0,0","0,27,68,5,0","0,12,81,7,0",,,,,103,,,,,,,,,,,,,,,,,,,,,,,,,,,,,,,,,,,,31.7,9,13,190,91,,998,0,,0,4,4,Balve,1,0,U1.000|5:53-U1.000|6:35-U1.000|5:24-U1.000|6:15-U0.142|0:53,,"Balve Running",,,3113,,250,3,12497153110,0,168070,250480,30378,,61036514,,,,,,,,,,,,,,,,,,,,,,,,,,,,,,,,,,,,,,,,"5,5",
79906877,f9a2b5cf-f01d-4b68-9c4e-d497d3f347ea,1698768006,60,1698770412,,0,0,31.88,5992,5992,256,267,387,365,0,0.7,0.31,,,331,923,,,,,,,,,1,,,,,,,,,150,,,,,86,90,,28.34,,,,220,154,,0,220,201,,,,,,,,,"17,7,11,24,22,7,12",,"30,0,70,0,0",,,,,,,,,,,,,,,,,,,,,,,,,,,,,,,,,,,,,,,,,,,,,,,,,,0,1,,,1,1,U0.000|0:02-U17.662|38:53-U14.212|1:00:57,,,,,315-0,,,7,,0,168072,,30378,,61253699,,,,,,,,,,,,,,,,,,,,,,,,,,,,,,,,,,,,,,,,"5,5",
79957900,54647be1-00e7-43bf-822d-ccbe070d48e0,1698777354,60,1698830047,,0,0,13.58,3926,4285,37,56,75,92,0,0,0.1,,0.62,,925,163,191,,189,53,50.29,42.74,50.37,1,59.09,3295,319,,4.4,3.2,100,97,,,,,,165,80,12.37,14.37,14.48,12.7,1.5,316,316,,1,385,385,,,,,,,,,"18,2,4,5,10,34,15,11,0","0,15,14,53,17","12,6,12,48,22",,,,,130,,,,,,,,,,,,,,,,,,,,,,,,,,,,,,,,,,,,123.1,9,10,212,91,,1006,0,,1,6,4,Westick,1,0,U1.000|4:27-U1.000|4:16-U1.000|4:31-U1.000|4:25-U0.246|1:09-U2.500|11:19-U2.049|10:55-U2.112|10:56-U2.672|13:29,,"Fröndenberg/Ruhr Running",,,3113,,250,3,12552771302,0,168070,250480,30378,,61300305,,,,,,,,,,,,,,,,,,,,,,,,,,,,,,,,,,,,,,,,,
79970422,0a005ddb-221f-4dbc-b47f-58e52ed52dbc,1698841153,60,1698840055,,0,0,6.36,2242,2290,97,120,119,142,0,1.8,0.64,0.99,1.01,246,473,147,168,,156,17,45.69,32.07,46.35,1,59.05,2268,66,,2.8,0,97,93,,,,,,59,79,10.31,10.41,10.43,-2.1,0.7,244,244,,1,249,249,,,,,,,,,"19,18,32,25,5,1,0,0,0","0,20,74,6,0","0,11,83,5,0",,,,,108,,,,,,,,,,,,,,,,,,,,,,,,,,,,,,,,,,,,40.6,13,20,194,82,,1002,1,,0,4,4,Balve,1,0,,,"Balve Running",,,3113,,250,3,12555410219,0,168070,250480,30378,,61311530,,,,,,,,,,,,,,,,,,,,,,,,,,,,,,,,,,,,,,,,5,
80053378,dd779aa5-8653-4de7-97f5-99d38ca7200e,1698926546,60,1698927292,,0,0,11.79,3992,4170,373,356,377,362,0,4.1,0.84,0.94,1.06,488,859,149,172,,165,20,47.13,35.15,49.06,1,58.94,1794,121,,3.4,0,98,95,,,,,,101,81,11.46,11.3,11.61,-6.2,5.8,271,271,,1,277,277,,,,,,,,,"32,14,11,12,22,8,1,0,0","0,24,59,17,0","0,5,70,25,0",,,,,109,,,,,,,,,,,,,,,,,,,,,,,,,,,,,,,,,,,,46.7,11,30,181,80,,981,1,,0,11,4,Balve,1,0,,,"Balve Running",,,3113,,250,3,12568543452,0,168070,250480,30378,,61385405,,,,,,,,,,,,,,,,,,,,,,,,,,,,,,,,,,,,,,,,"3,5",
80115323,23c7cfc3-398e-4082-822b-9a546296c45f,1699000326,60,1699000309,,0,0,11.01,3374,3386,69,78,89,97,0,0,0.15,,,,768,151,165,,160,9,52.32,39.3,52.67,1,58.84,1643,124,,3.5,0,98,96,,,,,,96,81,11.73,11.79,11.81,4,1.9,290,290,,1,293,293,,,,,,,,,"1,1,15,40,39,3,0,0,0","0,2,96,1,0","0,0,69,31,0",,,,,121,,,,,,,,,,,,,,,,,,,,,,,,,,,,,,,,,,,,42.4,9,18,205,76,,985,0,,0,4,4,Hitdorf,1,0,U4.238|21:04-U1.000|4:58-U1.000|5:00-U1.000|5:13-U1.000|5:20-U1.000|5:08-U1.000|5:22-U0.768|4:08,,"Leverkusen Running",,,3113,,250,3,12578758441,0,168070,250480,30378,,61442256,,,,,,,,,,,,,,,,,,,,,,,,,,,,,,,,,,,,,,,,,
80194830,bec73224-bffb-4d84-8501-4d9b9f917810,1699088555,60,1699087044,,0,0,6.57,1962,1990,33,43,39,49,0,0,0.22,,,,449,147,163,,158,13,56.06,39.14,56.31,1,58.79,1308,88,,3.1,0,100,98,,,,,,42,81,11.99,12.2,12.13,4.7,1.7,297,297,,1,303,303,,,,,,,,,"0,2,7,42,41,7,1,0,0","1,14,83,2,0","0,0,69,30,1",,,,,124,,,,,,,,,,,,,,,,,,,,,,,,,,,,,,,,,,,,28,9,22,170,80,,985,0,,0,4,4,"Monheim am Rhein",1,0,U1.000|5:12-U1.000|4:52-U1.000|4:55-U1.000|5:05-U1.000|5:12-U1.000|5:02-U0.565|2:24,,"Monheim am Rhein Running",,,3113,,250,3,12590663970,0,168070,250480,30378,,61513496,,,,,,,,,,,,,,,,,,,,,,,,,,,,,,,,,,,,,,,,,
80299004,6c68f7ec-168c-4d93-b8a4-f3069367f1e0,1699176313,60,1699202138,,0,0,6.13,1971,2060,24,42,38,54,0,0,0.21,1.09,0.98,,429,147,166,,163,22,51.18,35.71,51.24,1,58.69,1183,72,,2.9,0,98,95,,,,,,52,80,11.14,11.39,11.33,6.1,4.8,277,277,,1,284,284,,,,,,,,,"7,8,19,36,27,2,0,0,0","1,15,81,3,0","0,1,68,31,0",,,,,117,,,,,,,,,,,,,,,,,,,,,,,,,,,,,,,,,,,,38.6,10,15,213,89,,974,,,0,4,1,"Monheim am Rhein",1,0,U1.000|4:57-U1.000|4:40-U1.000|5:21-U1.000|5:33-U1.000|5:37-U1.000|5:58-U0.131|0:44,,"Monheim am Rhein Running",,,3113,,250,3,12611508301,0,168070,250480,30378,,61607369,,,,,,,,,,,,,,,,,,,,,,,,,,,,,,,,,,,,,,,,,
80346268,d4336bb1-73a9-43d1-80fa-e8271b058421,1699258316,60,1699258325,,0,0,4.21,3542,3542,71,75,86,90,0,1.3,0.44,,,197,277,85,112,,105,29,,,,1,58.69,4,5,,0.3,0,,94,,,,,,13,58,,4.58,,-12.2,,,,,,,,,,,,,,,,"80,20,0,0,0,0","90,10,0,0,0",,,,,,,,,,,,,,,,,,,,,,,,,,,,,,,,,,,,,,,,,,2.6,8,20,223,90,,1001,0,,0,4,4,Balve,1,0,U1.000|13:58-U1.000|13:19-U1.000|12:56-U1.000|13:09-U0.207|5:40,,"Balve Walking",,,3113,,250,3,12618183705,0,168075,,30378,,61647578,,,,,,,,,,,,,,,,,,,,,,,,,,,,,,,,,,,,,,,,5,
80369327,1c578164-f075-4949-8701-f77faf723b19,1699276591,60,1699278260,,0,0,13.02,4174,4268,373,377,382,385,0,4.1,0.95,1.01,1.12,457,918,149,167,,165,24,50.42,37.77,52.19,1,58.6,1790,130,,3.5,0,97,96,,,,,,114,80,11.93,12.09,12.15,-7,8.4,290,290,,1,297,297,,,,,,,,,"24,13,17,7,12,23,4,0,0","1,8,85,6,0","0,3,53,43,0",,,,,117,,,,,,,,,,,,,,,,,,,,,,,,,,,,,,,,,,,,45.3,11,23,215,75,,1003,1,,0,3,4,,1,0,U1.000|6:11-U1.000|6:28-U1.000|5:56-U1.000|6:24-U1.000|6:25-U1.000|5:34-U1.000|5:15-U1.000|5:18-U1.000|4:45-U1.000|4:32-U1.000|4:17-U1.000|4:14-U1.000|4:07-U0.022|0:06,,"Balve Running",,,3113,,250,3,12621561916,0,168070,250480,30378,,61668178,,,,,,,,,,,,,,,,,,,,,,,,,,,,,,,,,,,,,,,,3,
80483815,7a46d031-08df-4e51-9a7c-b0967da2999c,1699381927,60,1699380808,,0,0,6.16,2251,2429,28,19,49,42,0,0,0.13,1.02,,,421,135,163,,144,28,48.87,30.66,49.23,1,58.63,1164,102,,3,1.9,102,100,,,,,,43,77,9.94,12.03,12.26,24.4,-24.5,244,244,,1,329,329,,,,,,,,,"36,5,6,11,26,10,1,2,2","5,43,52,0,0","12,26,20,39,4",,,,,107,,,,,,,,,,,,,,,,,,,,,,,,,,,,,,,,,,,,32.2,8,18,222,83,,1011,0,,1,4,4,Westick,1,0,U1.000|4:57-U1.000|4:49-U1.000|4:38-U1.000|6:04-U0.611|7:40-U0.409|2:25-U0.417|2:18-U0.725|4:39,,"Fröndenberg/Ruhr Running",,,3113,,250,3,12639034859,0,168070,250480,30378,,61771064,,,,,,,,,,,,,,,,,,,,,,,,,,,,,,,,,,,,,,,,,
80489633,43dd3404-67cf-4b4b-9d4f-29c56a792122,1699384616,60,1699383239,,0,0,5.93,2001,2001,0,0,0,0,0,0,0,,,,431,153,186,,176,50,45.6,33.65,45.6,1,58.63,4128,199,,3.3,3.1,,100,,,,,,35,79,10.67,13.06,13.06,23.2,5.9,275,274,,1,353,353,,,,,,,,,"56,5,1,1,1,2,4,18,13","2,32,16,46,4","19,29,13,8,31",,,,,113,,,,,,,,,,,,,,,,,,,,,,,,,,,,,,,,,,,,33.8,8,19,219,83,,1011,0,,1,4,4,Westick,1,0,U0.400|1:17-U0.100|0:50-U0.400|1:15-U0.100|0:47-U0.400|1:15-U0.100|0:55-U0.400|1:17-U0.600|4:54-U0.300|0:53-U0.100|0:57-U0.300|0:53-U0.100|0:57-U0.300|0:54-U0.100|1:05-U0.300|0:57-U0.100|1:01-U0.270|0:57-U0.630|5:13-U0.200|0:35-U0.100|1:01-U0.200|0:34-U0.100|0:53-U0.210|0:37-U0.120|3:25,,"Fröndenberg/Ruhr Track Running",,,3113,,250,3,12639635452,0,168070,250480,30378,,61775441,,,,,,,,,,,,,,,,,,,,,,,,,,,,,,,,,,,,,,,,,
80491678,b10a6c35-d7eb-4147-95e9-b071be008e5e,1699386959,60,1699384407,,0,0,2.93,1011,1011,25,20,20,15,0,0,0,,,,211,143,151,,151,7,48.69,31.36,49.31,1,58.62,4330,36,,2.2,0,96,95,,,,,,6,80,10.51,10.52,10.55,0.2,0.7,257,257,,1,259,259,,,,,,,,,"7,12,52,28,1,0,0,0,0","0,26,74,0,0","0,1,99,0,0",,,,,109,,,,,,,,,,,,,,,,,,,,,,,,,,,,,,,,,,,,3.2,8,20,221,82,,1011,0,,1,4,4,Westick,1,0,U1.000|6:03-U1.000|5:35-U0.934|5:13,,"Fröndenberg/Ruhr Running",,,3113,,250,3,12639983627,0,168070,250480,30378,,61776795,,,,,,,,,,,,,,,,,,,,,,,,,,,,,,,,,,,,,,,,,
80549678,833d901e-ede1-4aa6-9106-77346476b46e,1699446329,60,1699447806,,0,0,14.23,4507,4688,346,323,359,335,0,3.8,0.81,0.96,1.02,506,975,147,164,,164,21,52.14,38.57,53.81,1,58.62,3462,135,,3.6,0,100,97,,,,,,109,81,11.9,11.91,12.08,-6.2,1.6,287,287,,1,294,294,,,,,,,,,"16,17,11,13,22,19,1,0,0","0,19,79,1,0","0,0,65,35,0",,,,,117,,,,,,,,,,,,,,,,,,,,,,,,,,,,,,,,,,,,33.4,9,20,212,77,,1014,1,,0,4,4,Balve,1,0,U1.000|5:00-U1.000|5:01-U1.000|6:11-U1.000|6:23-U1.000|6:08-U1.000|6:24-U1.000|5:04-U1.000|4:36-U1.000|4:27-U1.000|4:28-U1.000|4:18-U1.000|5:26-U1.000|5:55-U1.000|4:39-U0.232|1:07,,"Balve Running",,,3113,,250,3,12648962308,0,168070,250480,30378,,61828206,,,,,,,,,,,,,,,,,,,,,,,,,,,,,,,,,,,,,,,,"4,4",
80628687,2cf24c2b-eb75-43cb-a3c0-2d98e68e352f,1699536779,60,1699539938,,0,0,16.71,5273,5438,328,306,343,325,0,3.3,0.68,0.96,1.05,414,1138,146,165,,160,21,52.87,39.24,54.24,1,58.6,3181,152,,3.7,0,98,98,,,,,,141,81,11.81,11.84,11.91,-6.6,-2.2,288,288,,1,292,292,,,,,,,,,"13,9,13,29,21,14,2,0,0","0,24,73,3,0","0,0,62,38,0",,,,,117,,,,,,,,,,,,,,,,,,,,,,,,,,,,,,,,,,,,48.1,9,15,211,87,,1002,1,,0,4,4,Balve,1,0,U1.000|5:51-U1.000|4:55-U1.000|5:27-U1.000|5:15-U1.000|5:18-U1.000|5:35-U1.000|6:03-U1.000|7:04-U1.000|6:00-U1.000|5:07-U1.000|4:32-U1.000|4:23-U1.000|4:11-U1.000|4:31-U1.000|5:09-U1.000|5:14-U0.711|3:19,,"Balve Running",,,3113,,250,3,12663394368,0,168070,250480,30378,,61896315,,,,,,,,,,,,,,,,,,,,,,,,,,,,,,,,,,,,,,,,"4,5",
80688286,0503c3f2-a8b8-46f8-b048-a4325f4d92e5,1699620495,60,1699622378,,0,0,16.78,5136,5450,355,353,372,367,0,3.6,0.69,0.97,1.04,536,1137,149,168,,165,19,53.38,40.68,54.79,1,58.58,3468,170,,3.9,0,99,98,,,,,,138,81,12.2,12.23,12.34,-7.2,-0.3,301,301,,1,305,305,,,,,,,,,"10,9,10,26,22,21,2,0,0","0,17,76,7,0","0,0,43,57,0",,,,,121,,,,,,,,,,,,,,,,,,,,,,,,,,,,,,,,,,,,49.2,8,22,206,78,,998,1,,0,4,4,Balve,1,0,U1.000|5:37-U1.000|4:50-U1.000|5:09-U1.000|5:16-U1.000|5:07-U1.000|5:26-U1.000|5:54-U1.000|6:42-U1.000|6:00-U1.000|5:03-U1.000|4:24-U1.000|4:14-U1.000|4:15-U1.000|4:24-U1.000|4:55-U1.000|4:51-U0.778|3:28,,"Balve Running",,,3113,,250,3,12674977230,0,168070,250480,30378,,61950087,,,,,,,,,,,,,,,,,,,,,,,,,,,,,,,,,,,,,,,,"4,5,5",
80739800,b1f5ad05-41e6-4bc3-987d-e0432f054772,1699696096,60,1699698448,,0,0,16,5447,5618,482,438,501,458,0,4.9,0.81,1,1.15,519,1152,149,173,,157,22,46.82,35.78,48.72,1,58.54,2905,143,,3.6,0,95,96,,,,,,161,81,11.41,11.58,11.66,-9.4,-1.5,271,271,,1,276,276,,,,,,,,,"32,13,15,11,12,14,3,0,0","1,21,67,11,0","0,3,77,21,0",,,,,109,,,,,,,,,,,,,,,,,,,,,,,,,,,,,,,,,,,,55.7,5,19,256,94,,1004,0,,0,4,4,Helle,1,0,U1.000|5:54-U1.000|7:15-U1.000|6:57-U1.000|6:11-U1.000|6:24-U1.000|5:05-U1.000|5:32-U1.000|5:17-U1.000|7:10-U1.000|6:13-U1.000|5:55-U1.000|4:18-U1.000|4:15-U1.000|4:11-U1.000|4:13-U1.000|5:56-U0.003|0:02,,"Balve Running",,,3113,,250,3,12685400232,0,168070,250480,30378,,61996376,,,,,,,,,,,,,,,,,,,,,,,,,,,,,,,,,,,,,,,,"3,4,5",
80825730,3807f0a7-c89e-4e94-a2c7-590926dd6d62,1699799184,60,1699801279,,0,0,15.21,3909,4260,78,75,101,101,0,0,0.15,,,,968,155,183,96,179,20,62.64,49.43,63.05,1,58.62,4032,253,,4.5,2,102,103,,,,,,135,82,14.03,14.65,14.6,6,8.4,365,365,,1,386,386,,,,,,,,,"1,2,2,9,21,38,18,8,0","1,11,57,30,1","0,0,14,63,23",,,,,142,,,,,,,,,,,,,,,,,,,,,,,,,,,,,,,,,,,,81.5,6,8,202,79,,1008,0,,0,4,4,Amecke,1,0,U1.000|4:45-U1.000|4:24-U1.000|4:15-U1.000|4:24-U1.000|3:27-U1.000|4:32-U0.449|1:55-U1.000|3:16-U1.000|5:05-U1.000|4:30-U1.000|4:22-U1.000|4:36-U0.204|1:02-U1.000|3:58-U1.000|3:59-U1.000|3:44-U0.560|2:58,,"Sundern (Sauerland) Running",,,3113,,250,3,12703452137,0,168070,250480,30378,,62072783,,,,,,,,,,,,,,,,,,,,,,,,,,,,,,,,,,,,,,,,,
80885103,1a615a6e-55f6-4cf2-a554-305efd2b4e8c,1699882690,60,1699884106,,0,0,11.76,3810,4630,251,201,273,219,0,3.1,0.72,1.01,1.06,442,794,142,163,,163,20,53.12,37.01,54.8,1,58.6,2604,109,,3.3,0,99,97,,,,,,96,81,11.61,11.56,11.84,-2.3,-5.4,287,287,,1,295,295,,,,,,,,,"13,11,21,23,19,10,2,0,0","1,34,65,0,0","1,3,52,42,1",,,,,114,,,,,,,,,,,,,,,,,,,,,,,,,,,,,,,,,,,,34.6,11,21,202,90,,1000,1,,0,6,4,Balve,1,0,U1.000|5:17-U1.000|5:45-U1.000|5:16-U1.000|4:44-U1.000|5:57-U1.000|5:58-U1.000|5:27-U1.000|4:30-U1.000|5:53-U1.000|6:03-U1.000|4:14-U0.757|4:26,,"Balve Running",,,3113,,250,3,12714508278,0,168070,250480,30378,,62122635,,,,,,,,,,,,,,,,,,,,,,,,,,,,,,,,,,,,,,,,"4,5,5",
80896762,,1699883820,60,1699898302,,0,0,,600,600,,,,,0,,,,,,95,,,,,,,,,1,,,,,,,,,,,,,,15,,,,,,,,,,,,,,,,,,,,,,,,,,,,,,,,,,,,,,,,,,,,,,,,,,,,,,,,,,,,,,,,,,,,,,,,,,1,,,0,0,,,"Uhr war gestoppt ",,,connect,,,3,12717262578,0,168070,250480,30378,,62132684,,,,,,,,,,,,,,,,,,,,,,,,,,,,,,,,,,,,,,,,,
80984031,311b7aa6-8b6f-468e-8b7e-33ad7b6d89ba,1699988320,60,1699991358,,0,0,0.86,334,334,0,0,4,3,0,0,0.02,,,,70,142,162,,157,21,42.47,24.15,42.47,1,58.61,1289,15,,1.1,0,,100,,,,,,8,74,9.23,11.57,11.56,-5.5,8.2,222,222,,1,305,305,,,,,,,,,"69,9,4,1,1,2,1,4,9","0,45,54,1,0","2,58,21,10,9",,,,,104,,,,,,,,,,,,,,,,,,,,,,,,,,,,,,,,,,,,15.2,9,13,236,90,,1001,0,,1,6,4,Westick,1,0,,,"Fröndenberg/Ruhr Running",,,3113,,250,3,12732304750,0,168070,250480,30378,,62209023,,,,,,,,,,,,,,,,,,,,,,,,,,,,,,,,,,,,,,,,,
80984032,24792e53-94a7-4050-b235-fc514cc016ef,1699986593,60,1699991358,,0,0,4.22,1178,1178,4,22,10,27,0,0,0.05,,0.92,,287,151,162,,162,17,58.71,41.27,58.47,1,58.61,1303,73,,2.9,0,102,100,,,,,,34,81,12.76,12.91,12.78,1.7,0.2,324,324,,1,325,325,,,,,,,,,"1,1,1,4,66,26,0,0,0","1,7,92,1,0","0,0,10,90,0",,,,,133,,,,,,,,,,,,,,,,,,,,,,,,,,,,,,,,,,,,39.4,9,14,230,90,,1001,0,,1,6,4,Westick,1,0,U1.000|4:47-U1.000|4:33-U1.000|4:36-U1.000|4:38-U0.219|1:05,,"Fröndenberg/Ruhr Running",,,3113,,250,3,12732304638,0,168070,250480,30378,,62209024,,,,,,,,,,,,,,,,,,,,,,,,,,,,,,,,,,,,,,,,,
80984033,fd2a1e10-f9c9-47ed-86cc-ce55c2858413,1699988835,60,1699991359,,0,0,5.45,1655,1655,0,0,0,0,0,0,0,,,,416,161,187,,177,51,48.21,37.95,48.21,1,58.62,5280,254,,3.4,3.6,102,103,,,,,,63,79,11.86,13.75,13.75,-4.3,-10.1,310,310,,1,373,373,,,,,,,,,"43,4,3,3,1,2,11,25,8","0,19,25,46,10","17,20,14,10,40",,,,,125,,,,,,,,,,,,,,,,,,,,,,,,,,,,,,,,,,,,73.6,9,13,236,90,,1001,0,,1,6,4,Westick,1,0,U0.200|1:42-U0.600|2:01-U0.200|1:46-U0.410|1:18-U0.200|1:35-U0.400|1:18-U0.200|1:45-U0.210|0:36-U0.190|1:52-U0.210|0:37-U0.200|1:50-U0.330|1:04-U0.170|1:28-U0.300|0:55-U0.200|1:49-U0.600|2:01-U0.200|1:43-U0.610|2:01-U0.020|0:14,,"Fröndenberg/Ruhr Track Running",,,3113,,250,3,12732305016,0,168070,250480,30378,,62209028,,,,,,,,,,,,,,,,,,,,,,,,,,,,,,,,,,,,,,,,,
80984039,6b76a517-d06b-4e40-9a5e-98c316d0cb36,1699990832,60,1699991359,,0,0,2.25,721,721,4,6,4,6,0,0,0,,,,160,143,150,,150,3,53.34,33.45,53.4,1,58.61,5263,33,,2.1,0,100,97,,,,,,17,81,11.22,11.25,11.23,0.4,-1,279,279,,1,280,280,,,,,,,,,"2,3,16,64,14,0,0,0,0","1,12,87,0,0","0,1,95,4,0",,,,,116,,,,,,,,,,,,,,,,,,,,,,,,,,,,,,,,,,,,24.2,9,13,236,90,,1001,0,,1,6,4,Westick,1,0,U1.000|5:24-U1.000|5:17-U0.248|1:19,,"Fröndenberg/Ruhr Running",,,3113,,250,3,12732305097,0,168070,250480,30378,,62209025,,,,,,,,,,,,,,,,,,,,,,,,,,,,,,,,,,,,,,,,,
80984974,,1699995435,60,1699991872,,0,0,0.6,120,120,,,,,0,,,,,,43,,,,,,,50.04,,1,,,,,,,,,,,,,,3,,,,,,,,,,,,,,,,,,,,,,,,,,,,,,,,,,,,,,,,,,,,,,,,,,,,,,,,,,,,,,,,,,,,,,,,,,1,,,0,0,,,Running,,,connect,,,3,12732424741,0,168070,250480,30378,,62209794,,,,,,,,,,,,,,,,,,,,,,,,,,,,,,,,,,,,,,,,,
81033266,94311006-166b-4004-95f3-ed5059d36393,1700050146,60,1700055986,,0,0,16.65,5222,5498,368,369,389,393,0,4.2,0.71,1.02,1.1,574,1137,145,161,,160,18,53.77,39.51,55.23,1,58.61,4325,143,,3.6,0,99,97,,,,,,130,81,11.92,12.18,12.26,-6.4,3.4,291,291,,1,301,301,,,,,,,,,"15,12,13,26,12,17,5,1,0","1,27,73,0,0","0,1,61,38,1",,,,,118,,,,,,,,,,,,,,,,,,,,,,,,,,,,,,,,,,,,40.2,9,20,263,86,,1015,1,,0,4,4,Balve,1,0,U1.000|6:02-U1.000|5:06-U1.000|5:28-U1.000|5:23-U1.000|5:30-U1.000|5:40-U1.000|6:14-U1.000|6:55-U1.000|5:49-U1.000|4:49-U1.000|4:28-U1.000|4:08-U1.000|3:59-U1.000|4:18-U1.000|5:05-U1.000|5:06-U0.652|3:02,,"Balve Running",,,3113,,250,3,12741315196,0,168070,250480,30378,,62253155,,,,,,,,,,,,,,,,,,,,,,,,,,,,,,,,,,,,,,,,"4,4",
81129471,b61a8f4c-d300-4e56-8d6e-8c90e2f9c8ba,1700141593,60,1700157835,,0,0,15.31,4792,5238,383,368,386,368,0,4,0.88,0.94,1.06,517,1058,144,166,,166,19,54.4,39.34,56.15,1,58.6,3173,140,,3.5,0,95,102,,,,,,127,81,12.14,12.28,12.29,-1.2,2.1,292,292,,1,297,297,,,,,,,,,"16,14,18,9,11,26,5,0,0","0,30,68,2,0","0,1,52,47,0",,,,,118,,,,,,,,,,,,,,,,,,,,,,,,,,,,,,,,,,,,42.7,7,3,85,87,,1012,0,,0,4,4,Balve,1,0,U1.000|6:08-U1.000|6:21-U1.000|5:50-U1.000|6:15-U1.000|4:42-U1.000|4:24-U1.000|4:25-U1.000|5:12-U1.000|6:47-U1.000|5:39-U1.000|5:24-U1.000|4:27-U1.000|4:02-U1.000|4:20-U1.000|4:12-U0.307|1:44,,"Balve Running",,,3113,,250,3,12757392356,0,168070,250480,30378,,62340488,,,,,,,,,,,,,,,,,,,,,,,,,,,,,,,,,,,,,,,,"4,4",
81180555,90ef3fa7-1eee-42b3-a425-2cfbe53702ff,1700227627,60,1700229046,,0,0,14.38,4684,4901,333,311,348,329,0,3.6,0.54,1,0.97,276,950,140,158,,143,26,53.76,37.36,55.4,1,58.61,2304,139,,3.4,1.1,101,100,,,,,,107,81,11.4,11.78,13.05,10,-22.3,279,279,,1,335,335,,,,,,,,,"18,7,9,28,26,9,3,0,0","0,44,56,0,0","6,5,50,36,4",,,,,114,,,,,,,,,,,,,,,,,,,,,,,,,,,,,,,,,,,,30.9,6,6,295,76,,1020,1,,0,3,4,Balve,1,0,U1.000|4:53-U1.000|5:23-U1.000|4:48-U1.000|4:31-U1.000|5:10-U1.000|4:47-U1.000|5:01-U1.000|5:04-U0.241|1:24-U0.144|0:41-U0.175|1:43-U0.146|0:42-U0.190|1:45-U0.140|0:41-U0.171|1:48-U0.144|0:41-U0.181|2:09-U0.141|0:46-U0.009|0:18-U1.000|6:18-U1.000|5:23-U1.000|6:10-U0.376|1:54-U1.000|4:10-U0.326|1:53,,"Balve Running",,,3113,,250,3,12766860725,0,168070,250480,30378,,62385142,,,,,,,,,,,,,,,,,,,,,,,,,,,,,,,,,,,,,,,,"4,5",
81261291,3b8b5760-fa4d-4f35-b8b7-e757aab282ad,1700308967,60,1700323003,,0,0,10.01,2883,3175,157,172,182,201,0,2.4,0.7,0.89,1,366,670,148,164,,159,20,58.08,41.97,59.1,1,58.59,1735,122,,3.4,0,98,100,,,,,,80,82,12.72,13.57,13.43,-3.4,-17.2,320,320,,1,350,350,,,,,,,,,"7,10,9,16,23,26,2,5,1","1,12,82,5,0","0,0,40,54,7",,,,,127,,,,,,,,,,,,,,,,,,,,,,,,,,,,,,,,,,,,43.4,6,16,180,85,,1023,1,,0,4,4,Balve,1,0,U1.000|5:36-U1.000|4:23-U1.000|4:53-U1.000|4:53-U1.000|4:32-U1.000|5:06-U1.000|4:57-U1.000|3:07-U1.000|4:42-U1.000|5:52-U0.006|0:03,,"Balve Running",,,3113,,250,3,12781327359,0,168070,250480,30378,,62457517,,,,,,,,,,,,,,,,,,,,,,,,,,,,,,,,,,,,,,,,5,
81330489,9dc19c8a-cd13-45ad-b02b-c5acf75004b6,1700402058,60,1700406151,,0,0,21.74,7203,7353,677,626,692,641,0,5.8,0.82,0.97,1.1,625,1531,142,164,,153,21,51.67,37.84,53.81,1,58.57,2133,174,,3.9,0,97,100,,,,,,182,80,11.85,11.79,12.01,-6,5,281,281,,1,289,289,,,,,,,,,"25,13,12,10,16,21,2,0,0","0,44,55,1,0","0,3,61,35,0",,,,,113,,,,,,,,,,,,,,,,,,,,,,,,,,,,,,,,,,,,44.1,11,23,246,84,,1009,0,,0,4,4,Helle,1,0,U1.000|5:48-U1.000|6:05-U1.000|6:50-U1.000|6:26-U1.000|4:42-U1.000|5:08-U1.000|5:04-U1.000|5:51-U1.000|6:54-U1.000|5:11-U1.000|4:55-U1.000|4:29-U1.000|4:24-U1.000|4:23-U1.000|8:27-U1.000|7:13-U1.000|5:50-U1.000|4:27-U1.000|4:18-U1.000|4:13-U1.000|4:32-U0.741|4:53,,"Balve Running",,,3113,,250,3,12794315473,0,168070,250480,30378,,62518682,,,,,,,,,,,,,,,,,,,,,,,,,,,,,,,,,,,,,,,,"3,4,4,5",
81383200,82354203-9c77-4a23-8c79-4b22209f01a4,1700476802,60,1700475529,,0,0,,893,893,,,,,0,,,,,,127,114,130,,129,7,,,,1,58.58,996,9,,0.7,0,,100,,,,,,8,,,,,,,,,,,,,,,,,,,,,,"4,96,0,0,0",,,,,,,,,,,,,,,,,,,,,,,,,,,,,,,,,,,,,,,,,,5,,,,,,,,,,1,,,1,0,,,Strength,,,3113,,250,3,12802928592,0,168074,,30378,,62566317,,,,,,,,,,,,,,,,,,,,,,,,,,,,,,,,,,,,,,,,,
81390017,fc0c9781-4457-41cf-b46b-ab11d802734c,1700479768,60,1700480860,,0,0,14.76,4526,4563,232,242,271,280,0,3.1,0.58,0.99,1.02,505,981,149,168,,161,21,53.26,40.18,54.25,1,58.55,2312,138,,3.5,0,100,98,,,,,,125,81,11.96,12.05,12.14,-0.1,4.1,292,292,,1,300,300,,,,,,,,,"9,7,12,22,31,17,2,0,0","0,9,87,4,0","0,2,57,41,0",,,,,121,,,,,,,,,,,,,,,,,,,,,,,,,,,,,,,,,,,,43.2,10,19,248,83,,1009,1,,0,3,4,Helle,1,0,U1.000|4:54-U1.000|5:06-U1.000|5:08-U1.000|5:24-U1.000|5:32-U1.000|5:54-U1.000|4:58-U1.000|6:15-U1.000|4:56-U1.000|4:21-U1.000|4:39-U1.000|4:58-U1.000|4:45-U1.000|4:43-U0.755|3:54,,"Balve Running",,,3113,,250,3,12803793939,0,168070,250480,30378,,62572618,,,,,,,,,,,,,,,,,,,,,,,,,,,,,,,,,,,,,,,,"4,4,5,5",
81414708,e94a4cfa-6b36-4a21-974f-3eb026480790,1700505022,60,1700506456,,0,0,,4478,4478,,,,,0,,,,,,248,84,115,,88,23,,,,1,58.57,1893,5,,0.3,0,,100,,,,,,18,51,,,,,,,,,,,,,,,,,,,,,"80,20,0,0,0",,,,,,,,,,,,,,,,,,,,,,,,,,,,,,,,,,,,,,,,,,5,,,,,,,,,,1,,,1,0,U0.000|24:47-U0.000|3:38-U0.000|46:13,,Gym,,,3113,,250,3,12808958167,0,168075,,30378,,62594727,,,,,,,,,,,,,,,,,,,,,,,,,,,,,,,,,,,,,,,,,
81486264,d2cf317c-77c5-48a4-b2b5-98c0408a6071,1700591573,60,1700594058,,0,0,6.42,2200,2549,22,41,29,49,0,0,0.13,,1.07,,414,135,159,101,159,30,52.9,33.19,52.93,1,58.62,1164,101,,2.9,1.4,102,103,,,,,,50,78,10.5,12.42,12.3,21.4,-13.6,257,257,,1,319,319,,,,,,,,,"35,5,2,3,20,29,1,2,2","4,47,49,0,0","12,20,17,46,4",,,,,112,,,,,,,,,,,,,,,,,,,,,,,,,,,,,,,,,,,,41.1,5,13,43,93,,1022,0,,1,4,4,Westick,1,0,U1.000|4:47-U1.000|4:30-U1.000|4:17-U1.000|4:21-U1.000|10:13-U0.183|1:13-U0.821|4:56-U0.410|2:23,,"Fröndenberg/Ruhr Running",,,3113,,250,3,12822421448,0,168070,250480,30378,,62657265,,,,,,,,,,,,,,,,,,,,,,,,,,,,,,,,,,,,,,,,,
81486285,7594fdad-9ce3-4a6c-ade2-e14c6a33bea8,1700594323,60,1700594084,,0,0,5.28,1541,1541,0,0,0,0,0,0,0,,,,359,155,182,,177,58,53.54,39.7,53.54,1,58.63,2312,179,,3.1,2.8,106,104,,,,,,57,81,12.33,14.66,14.66,8.2,7.9,324,324,,1,397,397,,,,,,,,,"33,4,2,1,1,2,25,29,1","2,26,13,58,1","21,8,11,7,53",,,,,127,,,,,,,,,,,,,,,,,,,,,,,,,,,,,,,,,,,,74.3,5,13,43,94,,1023,0,,1,4,4,Westick,1,0,U0.390|1:18-U0.110|0:34-U0.400|1:19-U0.100|0:36-U0.400|1:22-U0.410|4:43-U1.000|3:29-U0.200|1:59-U1.000|3:31-U0.200|2:01-U0.600|2:12-U0.410|1:23-U0.060|1:16,,"Fröndenberg/Ruhr Track Running",,,3113,,250,3,12822428874,0,168070,250480,30378,,62657283,,,,,,,,,,,,,,,,,,,,,,,,,,,,,,,,,,,,,,,,,
81486301,444ca24b-7067-48b5-8c03-d98fa3e67864,1700596265,60,1700594098,,0,0,3.38,1153,1308,1,8,2,8,0,0,0.06,,,,223,129,145,,145,12,56.25,32.1,56.13,1,58.63,2285,31,,2,0,102,100,,,,,,21,80,10.47,10.71,10.64,-4.1,-4.4,255,255,,1,261,261,,,,,,,,,"9,21,27,30,11,1,0,0,0","2,95,2,0,0","0,4,96,1,0",,,,,110,,,,,,,,,,,,,,,,,,,,,,,,,,,,,,,,,,,,18.8,5,13,41,94,,1023,0,,1,4,4,Westick,1,0,U1.000|6:15-U1.000|5:33-U1.000|5:19-U0.375|2:05,,"Fröndenberg/Ruhr Running",,,3113,,250,3,12822431849,0,168070,250480,30378,,62657297,,,,,,,,,,,,,,,,,,,,,,,,,,,,,,,,,,,,,,,,,
81544199,8f2fbf3d-d9e1-47d5-9ac2-1eeb0b93d7f3,1700656656,60,1700671497,,0,0,13.45,3662,3911,158,122,171,135,0,1.1,0.37,0.92,0.95,486,863,151,180,,175,25,60.54,45.8,61.63,1,58.69,2736,189,,3.9,0.2,100,104,,,,,,115,82,13.49,14.2,14.23,-1,-3.8,345,345,,1,373,373,,,,,,,,,"4,5,8,18,26,9,26,5,0","0,19,49,31,0","0,0,24,50,26",,,,,134,,,,,,,,,,,,,,,,,,,,,,,,,,,,,,,,,,,,87.8,3,3,320,73,,1030,1,,0,4,4,Balve,1,0,U1.000|5:35-U1.000|4:27-U1.000|5:04-U1.000|4:58-U1.000|5:04-U0.686|3:24-U1.000|3:41-U1.000|4:32-U0.769|3:47-U1.000|3:43-U1.000|3:43-U1.000|3:39-U1.000|3:32-U0.992|5:52,,"Balve Running",,,3113,,250,3,12833429572,0,168070,250480,30378,,62708840,,,,,,,,,,,,,,,,,,,,,,,,,,,,,,,,,,,,,,,,"5,5",
81623477,cc0f02b1-2c9f-4885-b0cb-3d673e776788,1700766585,60,1700765388,,0,0,,1102,1102,,,,,0,,,,,,92,93,110,,94,29,,,,1,58.7,1427,3,,0.2,0,,100,,,,,,6,52,,,,,,,,,,,,,,,,,,,,,"78,22,0,0,0",,,,,,,,,,,,,,,,,,,,,,,,,,,,,,,,,,,,,,,,,,2.6,,,,,,,,,,1,,,1,0,,,Gym,,,3113,,250,3,12848474068,0,168075,,30378,,62779640,,,,,,,,,,,,,,,,,,,,,,,,,,,,,,,,,,,,,,,,,
81623480,ba9a5a8f-ec73-4628-a729-709b8ea6ef1c,1700763408,60,1700765391,,0,0,10.01,2539,2601,,,,,0,,,,,,566,150,173,,170,15,66.71,48.69,66.71,1,58.7,1454,122,,3.2,0.9,,100,,,,,,74,80,,15.15,,-2.3,-13.5,369,369,,1,406,406,,,,,,,,,"2,0,2,12,22,28,22,8,3","0,18,65,17,0","0,1,15,56,27",,,,,148,,,,,,,,,,,,,,,,,,,,,,,,,,,,,,,,,,,,55.5,,,,,,,,,,1,,,1,1,U1.000|4:02-U1.000|4:00-U1.000|4:08-U1.000|4:26-U1.359|6:42-U0.459|1:14-U1.000|3:27-U1.000|4:31-U1.000|4:07-U1.000|4:43-U0.195|0:59,,"Treadmill Running",,,3113,,250,3,12848473858,0,168070,250480,30378,,62779643,,,,,,,,,,,,,,,,,,,,,,,,,,,,,,,,,,,,,,,,,
81674288,6ece44ab-8a0a-4fcf-8135-d3c1703f36dd,1700832372,60,1700840610,,0,0,16.77,5174,5414,370,361,381,370,0,3.9,0.76,0.99,1.04,441,1131,141,158,,155,18,56.95,40.3,58.54,1,58.68,1586,148,,3.5,0,100,100,,,,,,90,81,12.16,12.07,12.25,-4.2,2.5,297,297,,1,301,301,,,,,,,,,"12,8,11,19,29,20,1,0,0","1,42,58,0,0","0,0,51,49,0",,,,,120,,,,,,,,,,,,,,,,,,,,,,,,,,,,,,,,,,,,23,3,22,295,85,,1008,0,,0,6,4,Balve,1,0,U1.000|5:33-U1.000|4:50-U1.000|4:58-U1.000|4:56-U1.000|5:05-U1.000|5:32-U1.000|6:05-U1.000|7:01-U1.000|5:54-U1.000|5:13-U1.000|4:25-U1.000|4:23-U1.000|4:16-U1.000|4:28-U1.000|5:06-U1.000|4:57-U0.773|3:32,,"Balve Running",,,3113,,250,3,12857649990,0,168070,250480,30378,,62825505,,,,,,,,,,,,,,,,,,,,,,,,,,,,,,,,,,,,,,,,"4,5,5",
81682444,8914fdb4-6daf-409d-84da-d68bd2da6029,1700845843,60,1700848768,,0,0,,5215,5215,,,,,0,,,,,,376,91,123,,116,47,,,,1,58.7,1367,9,,0.6,0,,100,,,,,,30,,,,,,,,,,,,,,,,,,,,,,"70,30,0,0,0",,,,,,,,,,,,,,,,,,,,,,,,,,,,,,,,,,,,,,,,,,6.9,,,,,,,,,,1,,,1,0,,,Strength,,,3113,,250,3,12859179791,0,168074,,30378,,62833112,,,,,,,,,,,,,,,,,,,,,,,,,,,,,,,,,,,,,,,,,
81736658,bdc4e613-b7de-412a-9a77-43b56fa9d9f0,1700914734,60,1700919389,,0,0,20.61,7219,7940,546,511,581,556,0,5,0.8,1,1.11,553,1447,139,165,,150,22,49.61,35.29,51.34,1,58.62,1624,150,,3.5,0.1,97,96,,,,,,142,81,10.89,10.81,11.01,-9.2,-2.5,262,262,,1,266,266,,,,,,,,,"33,13,14,16,18,5,0,0,0","1,49,49,1,0","0,4,81,15,0",,,,,106,,,,,,,,,,,,,,,,,,,,,,,,,,,,,,,,,,,,34.7,4,19,293,88,,1009,1,,0,6,4,Helle,1,0,U1.000|5:50-U1.000|5:43-U1.000|6:32-U1.000|6:43-U1.000|7:36-U1.000|6:51-U1.000|5:17-U1.000|5:56-U1.000|6:10-U1.000|5:06-U1.000|5:41-U1.000|6:21-U1.000|5:30-U1.000|6:03-U1.000|6:45-U1.000|5:13-U1.000|4:41-U1.000|4:48-U1.000|4:40-U1.000|4:49-U0.613|4:01,,"Balve Running",,,3113,,250,3,12868500200,0,168070,250480,30378,,62880769,,,,,,,,,,,,,,,,,,,,,,,,,,,,,,,,,,,,,,,,"3,4,5,5,5,5",
81768865,c2068537-9ccd-4d41-9249-472d59eb2ac3,1700972921,60,1700972723,,0,0,10.01,3226,3244,174,187,186,199,0,2.6,0.77,0.95,1.05,368,679,138,154,,154,22,55.49,36.79,56.59,1,58.58,1243,82,,2.9,0,98,99,,,,,,67,81,11.35,11.48,11.44,-3.1,-4.2,278,278,,1,282,282,,,,,,,,,"14,10,14,27,29,5,1,0,0","0,63,37,0,0","0,0,81,19,0",,,,,115,,,,,,,,,,,,,,,,,,,,,,,,,,,,,,,,,,,,27.1,0,7,245,98,,1016,0,,1,4,4,Balve,1,0,U1.000|6:14-U1.000|5:01-U1.000|5:24-U1.000|5:27-U1.000|5:08-U1.000|5:37-U1.000|5:38-U1.000|4:32-U1.000|4:43-U1.000|5:58-U0.006|0:03,,"Balve Running",,,3113,,250,3,12875706664,0,168070,250480,30378,,62909316,,,,,,,,,,,,,,,,,,,,,,,,,,,,,,,,,,,,,,,,"5,5",
81863641,875f904f-3184-40dc-88b3-75c9203503bf,1701068676,-300,1701089855,,0,0,10.27,3090,3090,175,190,200,215,0,2.2,0.57,1,1.03,384,685,150,171,,168,30,54.02,39.95,55.06,1,58.57,1347,124,,3.3,0,97,100,,,,,,72,81,12.19,12.17,12.33,-0.3,-1.6,297,297,,1,304,304,,,,,,,,,"7,5,10,23,34,17,4,0,0","0,12,74,14,0","0,4,49,46,1",,,,,123,,,,,,,,,,,,,,,,,,,,,,,,,,,,,,,,,,,,38.5,4,18,316,77,,1020,0,,1,3,4,Atlanta,1,0,U1.000|5:24-U1.000|5:19-U1.000|4:49-U1.000|5:04-U1.000|4:47-U1.000|5:09-U1.000|4:45-U1.000|4:55-U1.000|5:19-U1.000|4:46-U0.267|1:11,,"Atlanta Running",,,3113,,250,3,12892614587,0,168070,250480,30378,,62996732,,,,,,,,,,,,,,,,,,,,,,,,,,,,,,,,,,,,,,,,5,
82001274,83a17761-4c3b-4dc1-9eba-f09d03b670b8,1701105587,-300,1701258879,,0,0,4.75,1728,1738,80,86,86,96,0,1.8,0.64,1.03,0.92,,316,126,143,,141,23,53.43,30.34,54.46,1,58.57,1106,36,,2.1,0,,100,,,,,,18,79,9.98,10.01,10.18,-0.3,-0.3,234,234,,1,242,242,,,,,,,,,"19,35,30,13,2,0,0,0,0","0,95,5,0,0","1,10,87,3,0",,,,,104,,,,,,,,,,,,,,,,,,,,,,,,,,,,,,,,,,,,7.4,8,10,306,46,,1020,0,,0,2,4,Atlanta,1,0,U1.000|5:47-U1.000|6:10-U1.000|5:56-U1.000|6:12-U0.751|4:44,,"Atlanta Running",,,3113,,250,3,12917180115,0,168070,250480,30378,,63119301,,,,,,,,,,,,,,,,,,,,,,,,,,,,,,,,,,,,,,,,,
82001285,8e09a866-8666-40fd-ad53-957f57139379,1701152088,-300,1701258895,,0,0,8.29,2663,2663,0,40,4,44,0,0,0.05,,0.89,,552,142,154,,154,10,53.68,36.44,53.36,1,58.53,1185,74,,2.8,0,97,99,,,,,,48,80,11.06,11.28,11.15,-6.2,-9.4,265,265,,1,269,269,,,,,,,,,"2,6,26,44,19,2,0,0,0","0,27,73,0,0","0,1,93,6,0",,,,,117,,,,,,,,,,,,,,,,,,,,,,,,,,,,,,,,,,,,18.3,0,11,295,69,,1024,0,,1,4,4,,1,0,U1.000|5:43-U1.000|5:35-U1.000|5:32-U1.000|5:23-U1.000|5:13-U1.000|5:09-U1.000|5:10-U1.000|5:10-U0.291|1:28,,"Cobb County Running",,,3113,,250,3,12917183672,0,168070,250480,30378,,63119313,,,,,,,,,,,,,,,,,,,,,,,,,,,,,,,,,,,,,,,,,
82001286,1ee26849-2b1e-461c-a617-2cf3d9ac5181,1701177649,60,1701258896,,0,0,1.48,415,415,,,,,0,,,,,,71,123,145,,137,26,75.82,37.23,75.82,1,58.55,1156,12,,0.8,0,,100,,,,,,4,81,,16.23,,36.5,-3.2,337,334,,1,444,441,,,,,,,,,"19,2,0,0,1,31,32,1,14","8,82,10,0,0","16,6,11,35,33",,,,,132,,,,,,,,,,,,,,,,,,,,,,,,,,,,,,,,,,,,5.6,,,,,,,,,,1,,,1,1,U1.000|5:06-U0.484|1:49,,"Treadmill Running",,,3113,,250,3,12917184195,0,168070,250480,30378,,63119312,,,,,,,,,,,,,,,,,,,,,,,,,,,,,,,,,,,,,,,,,
82001292,2a69c1af-6109-496f-9db8-d17272238fbe,1701237673,-300,1701258906,,0,0,2.59,867,884,20,1,25,7,0,0,0.16,1.12,,,183,133,144,,140,9,55.47,32.19,56.5,1,58.53,642,36,,2.1,0,,100,,,,,,12,80,11.03,10.79,11.11,6.4,8.8,269,269,,1,272,272,,,,,,,,,"4,3,41,51,1,0,0,0,0","2,82,16,0,0","0,2,98,0,0",,,,,112,,,,,,,,,,,,,,,,,,,,,,,,,,,,,,,,,,,,11,-3,8,314,71,,1025,0,,1,2,4,"Sandy Springs",1,0,U1.000|5:49-U1.000|5:25-U0.591|3:13,,"Sandy Springs Running",,,3113,,250,3,12917185699,0,168070,250480,30378,,63119320,,,,,,,,,,,,,,,,,,,,,,,,,,,,,,,,,,,,,,,,,
82001317,b5a37c0a-c942-4952-b3fe-a279606affe3,1701238717,-300,1701258934,,0,0,7.5,2082,2082,21,0,20,0,0,0,0.05,,,,522,147,163,,162,22,61.35,43.01,61.78,1,58.55,1728,168,,3.7,0,107,103,,,,,,44,82,13.07,13.61,13.82,14,17.3,332,332,,1,359,359,,,,,,,,,"7,7,16,13,2,20,30,4,0","1,15,82,2,0","0,4,40,32,24",,,,,132,,,,,,,,,,,,,,,,,,,,,,,,,,,,,,,,,,,,24.4,-2,8,314,71,,1025,0,,1,2,4,"Sandy Springs",1,0,U0.400|1:41-U0.410|1:34-U0.400|1:35-U0.410|1:25-U0.400|2:29-U0.400|1:36-U0.400|1:36-U0.400|1:35-U0.400|1:25-U0.400|2:39-U0.810|3:14-U0.800|3:14-U1.870|10:38,,"Sandy Springs Track Running",,,3113,,250,3,12917191451,0,168070,250480,30378,,63119341,,,,,,,,,,,,,,,,,,,,,,,,,,,,,,,,,,,,,,,,,
82041025,07efecb5-8d50-4ad0-996a-70d23cc273d4,1701242013,-300,1701310044,,0,0,4.7,1325,1352,75,72,82,81,0,1.6,0.69,1.05,1.05,,317,156,171,114,168,16,55.36,41.07,56.5,1,58.55,2737,87,,3,0,101,100,,,,,,31,82,12.97,13.19,13.28,3.3,6.1,323,323,,1,334,334,,,,,,,,,"2,2,9,20,34,23,11,1,0","0,8,54,38,0","0,0,23,74,4",,,,,130,,,,,,,,,,,,,,,,,,,,,,,,,,,,,,,,,,,,34.1,-2,5,315,68,,1026,0,,1,2,4,Atlanta,1,0,U1.000|4:57-U1.000|5:02-U1.000|4:10-U1.000|4:51-U0.704|3:05,,"Atlanta Running",,,3113,,250,3,12925818837,0,168070,250480,30378,,63153489,,,,,,,,,,,,,,,,,,,,,,,,,,,,,,,,,,,,,,,,,
82155580,b1053f09-a7e8-498c-988b-555727441d39,1701359409,-300,1701475495,,0,0,17.01,4550,4623,267,262,308,302,0,2.6,0.58,0.96,1.04,,1097,156,175,,170,23,59.07,47.61,60.24,1,58.58,2736,221,,4.2,0,103,100,,,,,,131,83,13.63,13.67,13.73,3,3.8,344,344,,1,348,348,,,,,,,,,"2,2,3,9,23,45,15,1,0","0,2,65,33,0","0,0,13,80,7",,,,,135,,,,,,,,,,,,,,,,,,,,,,,,,,,,,,,,,,,,48,13,10,162,43,,1020,1,,0,3,4,Atlanta,1,0,U1.000|4:45-U1.000|4:35-U1.000|4:00-U1.000|4:23-U1.000|4:08-U1.000|4:29-U1.000|4:16-U1.000|4:25-U1.000|4:15-U1.000|4:35-U1.000|4:31-U1.000|4:38-U1.000|4:23-U1.000|4:30-U1.000|4:47-U1.000|4:36-U1.000|4:30-U0.008|0:02,,"Atlanta Running",,,3113,,250,3,12947621033,0,168070,250480,30378,,63255101,,,,,,,,,,,,,,,,,,,,,,,,,,,,,,,,,,,,,,,,,
82157047,e80a3a06-0254-48d0-80e4-3c065febbbca,1701451301,-420,1701480342,,0,0,11.22,3202,3787,174,135,190,152,0,2.6,0.45,1.1,0.94,368,716,148,170,,169,21,58.75,42.77,60.13,1,57.95,2016,145,,3.5,0,103,104,,,,,,16,82,12.9,12.7,13.38,-3.5,-5.9,324,324,,1,344,344,,,,,,,,,"2,3,5,16,44,26,3,0,0","0,22,70,8,0","0,3,24,65,8",,,,,128,,,,,,,,,,,,,,,,,,,,,,,,,,,,,,,,,,,,5.1,0,5,216,68,,1010,0,,0,4,4,Boulder,1,0,U1.000|4:50-U1.000|4:33-U1.000|4:46-U1.000|4:48-U1.000|4:54-U1.000|5:18-U1.000|4:58-U1.000|4:24-U1.000|4:21-U1.000|4:28-U1.000|4:50-U0.217|1:14,,"Boulder Running",,,3113,,250,3,12948099007,0,168070,250480,30378,,63256427,,,,,,,,,,,,,,,,,,,,,,,,,,,,,,,,,,,,,,,,"4,4,5",
82187782,cf20962e-0293-4d33-8080-1c66400194a2,1701497052,-420,1701527037,,0,0,11.5,3791,4695,300,231,322,257,0,4.3,0.58,0.99,1,410,827,157,173,,161,20,45.22,36.2,47.02,1,57.09,2160,148,,3.5,0,100,100,,,,,,37,80,11.73,11.84,12.86,-2,13.6,282,282,,1,318,318,,,,,,,,,"25,3,6,14,26,24,2,0,0","0,11,38,52,0","3,9,52,33,4",,,,,114,,,,,,,,,,,,,,,,,,,,,,,,,,,,,,,,,,,,10.8,-3,8,262,57,,1014,0,,1,3,4,Boulder,1,0,U1.000|4:51-U1.000|4:39-U1.000|5:15-U1.000|5:10-U1.000|7:13-U1.000|10:32-U1.000|4:22-U1.000|4:22-U1.000|4:24-U1.000|5:17-U1.000|4:39-U0.500|2:26,,"Boulder Running",,,3113,,250,3,12954386315,0,168070,250480,30378,,63282302,,,,,,,,,,,,,,,,,,,,,,,,,,,,,,,,,,,,,,,,"3,4",
82195721,b27e5649-b40d-4048-8cca-ec00c79e52b8,1701507805,-420,1701534709,,0,0,4.97,1278,1278,59,75,72,87,0,1.5,0.46,1.01,0.89,1029,332,170,187,,166,10,54.44,45.92,55.02,1,55.61,4325,149,,3.4,1.1,100,99,,,,,,47,84,13.93,14.11,14.1,8.6,10.2,352,352,,1,360,360,,,,,,,,,"0,0,0,1,19,66,14,1,0","0,2,15,79,4","0,0,8,82,10",,,,,139,,,,,,,,,,,,,,,,,,,,,,,,,,,,,,,,,,,,74.2,2,23,277,38,,1014,1,,1,2,4,,1,0,U1.000|4:02-U1.000|4:23-U1.000|4:31-U1.000|4:17-U0.966|4:03,,"Boulder County Running",,,3113,,250,3,12956128526,0,168070,250484,30378,,63289465,,,,,,,,,,,,,,,,,,,,,,5,1278,,,0,"South Boulder Creek parkrun #235",,,,,,,0,0,30378,82195721,469794,,"5,5",
82198818,5cbcc009-95b8-47a7-a1dc-eb048d645d5a,1701509173,-420,1701536449,,0,0,0.64,210,210,16,11,17,12,0,1.1,0.66,1.31,,,47,151,162,129,162,8,48.09,28.42,50.05,1,57.09,4291,23,,1.6,0,,100,,,,,,4,82,11.23,11.08,11.75,-25.8,-37.1,277,277,,1,296,296,,,,,,,,,"3,8,49,24,14,2,0,0,0","0,11,83,6,0","0,0,56,44,0",,,,,111,,,,,,,,,,,,,,,,,,,,,,,,,,,,,,,,,,,,7.6,2,23,277,38,,1014,1,,1,2,4,,1,0,,,"Boulder County Running",,,3113,,250,3,12956474792,0,168070,250480,30378,,63292412,,,,,,,,,,,,,,,,,,,,,,,,,,,,,,,,,,,,,,,,,
82290401,43519fc3-d550-488e-919f-64020916bc4f,1701597253,-420,1701637606,,0,0,20.75,13538,14919,1229,1207,1229,1222,0,8.9,0.89,0.96,0.97,505,1694,121,166,,134,26,27.08,16.09,29.16,1,56.46,2609,110,,3.2,0,97,95,,,,,,136,71,7.65,7.76,8.7,-9.7,7.7,151,151,,1,195,195,,,,,,,,,"81,4,4,5,6,1,0,0,0","20,54,25,1,0","30,39,28,2,0",,,,,65,,,,,,,,,,,,,,,,,,,,,,,,,,,,,,,,,,,,29.6,4,16,330,50,,1015,2,,1,3,4,Boulder,1,0,U1.000|8:14-U1.000|6:20-U1.000|9:13-U1.000|9:28-U1.000|9:45-U1.000|14:32-U1.000|22:34-U1.000|19:07-U1.000|18:02-U1.000|24:31-U1.000|18:40-U1.000|8:29-U1.000|6:44-U1.000|8:56-U1.000|4:49-U1.000|6:33-U1.000|6:57-U1.000|8:43-U1.000|4:58-U1.000|5:09-U0.752|3:52,,"Boulder Running",,,3113,,250,3,12971563151,0,168070,250480,30378,,63373744,,,,,,,,,,,,,,,,,,,,,,,,,,,,,,,,,,,,,,,,"0,2,4,4",
82356555,acc7114a-ee64-4255-bd0d-f048572aa057,1701703499,-420,1701735063,,0,0,16.62,5838,6015,528,550,566,596,0,6.5,0.79,0.94,1.03,603,1202,149,172,,168,29,45.04,34.59,46.74,1,56.53,2736,213,,4.1,0.7,103,101,,,,,,166,79,11.55,11.95,12.14,-17.2,1.3,262,262,,1,292,292,,,,,,,,,"35,5,5,11,19,17,9,0,0","0,12,80,8,0","4,17,41,34,3",,,,,108,,,,,,,,,,,,,,,,,,,,,,,,,,,,,,,,,,,,54,10,9,282,35,,1017,0,,0,2,4,Boulder,1,0,U1.000|5:00-U1.000|4:53-U1.000|5:05-U1.000|5:43-U1.000|6:51-U1.000|9:38-U1.000|16:07-U1.000|5:13-U1.000|4:56-U1.000|4:33-U1.000|4:44-U1.000|3:55-U1.000|4:00-U1.000|4:31-U1.000|4:29-U1.000|4:32-U0.621|3:09,,"Boulder Running",,,3113,,250,3,12984138089,0,168070,250480,30378,,63431623,,,,,,,,,,,,,,,,,,,,,,,,,,,,,,,,,,,,,,,,"1,3,4",
82426092,02d7b60f-6688-4201-b5ae-3b46c592d206,1701797362,-420,1701825020,,0,0,5.89,1879,2264,96,46,102,55,0,1.1,0.47,1.16,0.88,378,367,134,149,,149,11,58.32,35.96,60.11,1,57.92,1584,57,,2.5,0,101,103,,,,,,35,81,11.68,11.32,11.93,-0.8,-5.5,289,289,,1,299,299,,,,,,,,,"5,4,16,48,26,1,0,0,0","1,81,18,0,0","0,2,70,28,0",,,,,116,,,,,,,,,,,,,,,,,,,,,,,,,,,,,,,,,,,,20.1,9,10,275,45,,1021,0,,0,2,4,Boulder,1,0,U1.000|5:15-U1.000|4:57-U1.000|5:10-U1.000|5:46-U1.000|5:30-U0.891|4:42,,"Boulder Running",,,3113,,250,3,12997040083,0,168070,250480,30378,,63495014,,,,,,,,,,,,,,,,,,,,,,,,,,,,,,,,,,,,,,,,5,
82459197,07c4eda4-b309-4db3-b64e-c260f4d5e833,1701845917,-420,1701879667,,0,0,16.53,5563,5808,483,457,504,482,0,6.4,0.73,0.83,0.96,631,1266,158,176,,164,20,43.67,36.36,45.34,1,56.97,2736,236,,4.2,0.9,101,101,,,,,,196,80,12.16,12.66,12.58,-14.4,-2.5,277,277,,1,305,305,,,,,,,,,"33,5,5,8,14,20,11,4,0","0,4,51,45,0","2,20,30,45,2",,,,,111,,,,,,,,,,,,,,,,,,,,,,,,,,,,,,,,,,,,70.6,6,11,259,35,,1019,0,,1,2,4,Boulder,1,0,U1.000|4:44-U1.000|4:43-U1.000|5:12-U1.000|5:44-U1.000|6:49-U1.000|10:26-U1.000|13:53-U1.000|4:57-U1.000|4:55-U1.000|4:30-U1.000|4:51-U1.000|3:31-U1.000|3:38-U1.000|4:02-U1.000|4:09-U1.000|4:14-U0.533|2:23,,"Boulder Running",,,3113,,250,3,13004388085,0,168070,250480,30378,,63523464,,,,,,,,,,,,,,,,,,,,,,,,,,,,,,,,,,,,,,,,"1,4,4,5",
82530749,db9217e5-74b0-4bbd-8171-732ea4f86248,1701951596,-420,1701981970,,0,0,13.59,4582,4868,437,431,485,481,0,5.5,0.59,0.84,0.9,560,989,156,176,,165,26,44.39,35.72,46.19,1,56.74,2448,187,,3.9,0.4,102,100,,,,,,135,80,11.7,11.81,12.09,-1,1.9,273,273,,1,293,293,,,,,,,,,"34,5,4,10,18,24,5,1,0","0,9,51,39,0","5,14,31,49,1",,,,,111,,,,,,,,,,,,,,,,,,,,,,,,,,,,,,,,,,,,52.5,14,24,257,26,,1002,2,,1,2,4,Boulder,1,0,U1.000|4:36-U1.000|4:47-U1.000|4:59-U1.000|7:43-U1.000|7:47-U1.000|7:16-U1.000|6:39-U0.079|0:47-U1.000|7:37-U1.000|4:24-U1.000|3:57-U1.000|4:23-U1.000|4:26-U1.000|4:37-U0.515|2:25,,"Boulder Running",,,3113,,250,3,13019144734,0,168070,250480,30378,,63585420,,,,,,,,,,,,,,,,,,,,,,,,,,,,,,,,,,,,,,,,"3,3,4,5",
82608130,4fba3c2e-810f-4942-a59e-d63c99b87590,1702022933,-420,1702117766,,0,0,16.39,6762,6830,559,559,590,588,0,6.9,0.69,0.81,0.87,659,1295,151,171,,141,39,36.23,28.53,37.77,1,55.03,2902,193,,4,0.1,96,99,,,,,,147,75,10.22,10.66,10.89,-4.9,-3.5,221,221,,1,257,257,,,,,,,,,"43,4,8,13,20,10,1,0,0","2,13,63,23,0","8,34,40,17,1",,,,,97,,,,,,,,,,,,,,,,,,,,,,,,,,,,,,,,,,,,41.7,1,6,242,48,,1012,1,,1,4,4,Boulder,1,0,U1.000|4:56-U1.000|5:13-U1.000|5:42-U1.000|6:59-U1.000|15:48-U1.000|14:53-U1.000|5:28-U1.000|4:58-U1.000|4:47-U1.000|5:06-U1.000|5:44-U1.000|4:53-U1.000|12:16-U1.000|4:30-U1.000|4:56-U1.000|4:42-U0.393|1:53,,"Boulder Running",,,3113,,250,3,13035542707,0,168070,250480,30378,,63655547,,,,,,,,,,,,,,,,,,,,,,,,,,,,,,,,,,,,,,,,"0,4,4",
82702908,6216b627-1909-4fc3-9d1a-95bac53dfdb1,1702223208,60,1702225040,,0,0,15.28,3536,3561,45,37,72,64,0,0,0.07,,,,920,166,179,,175,11,64.36,55.83,64.64,1,57.62,4499,358,,5,0.8,105,101,,,,,,142,84,15.59,15.69,15.74,2.4,1.9,412,412,,1,418,418,,,,,,,,,"0,0,0,0,3,24,62,10,0","0,1,12,86,0","0,0,1,33,66",,,,,154,,,,,,,,,,,,,,,,,,,,,,,,,,,,,,,,,,,,89.7,7,19,221,87,,1007,0,,0,4,4,"Sundern (Sauerland)",1,0,U1.000|4:15-U1.000|4:00-U1.000|4:00-U1.000|3:54-U1.000|3:51-U1.000|3:49-U1.000|3:41-U1.000|3:43-U1.000|3:43-U1.000|3:39-U1.000|3:55-U1.000|3:50-U1.000|3:53-U1.000|3:52-U1.000|3:48-U0.275|1:04,,"Sundern (Sauerland) Running",,,3113,,250,3,13052564273,0,168070,250480,30378,,63733848,,,,,,,,,,,,,,,,,,,,,,,,,,,,,,,,,,,,,,,,,
82752610,807697ea-b348-4a8d-936c-f5a371e867c7,1702299073,60,1702299450,,0,0,11.42,3520,3577,206,193,234,221,0,2.7,0.47,1.03,1.02,409,760,147,165,109,165,22,53.92,39.14,55.2,1,58.44,3231,117,,3.3,0,98,99,,,,,,89,81,11.93,11.9,12.14,-3.4,-2.6,291,291,,1,299,299,,,,,,,,,"5,8,16,25,33,11,1,0,0","0,15,83,2,0","0,1,61,36,2",,,,,120,,,,,,,,,,,,,,,,,,,,,,,,,,,,,,,,,,,,35,8,25,265,87,,1001,0,,0,11,4,Balve,1,0,U1.000|5:31-U1.000|4:46-U1.000|5:22-U1.000|5:11-U1.000|5:29-U1.000|5:25-U1.000|5:09-U1.000|4:42-U1.000|4:42-U1.000|4:34-U1.000|5:33-U0.422|2:15,,"Balve Running",,,3113,,250,3,13060976248,0,168070,250480,30378,,63775113,,,,,,,,,,,,,,,,,,,,,,,,,,,,,,,,,,,,,,,,"4,5",
82778699,75300bb8-de8e-4f47-9656-73919426ffbb,1702321734,60,1702321910,,0,0,,3688,3688,,,,,0,,,,,,286,95,131,,104,26,,,,1,58.44,2857,11,,0.7,0,,100,,,,,,19,55,,,,,,,,,,,,,,,,,,,,,"60,40,0,0,0",,,,,,,,,,,,,,,,,,,,,,,,,,,,,,,,,,,,,,,,,,4.7,,,,,,,,,,1,,,1,0,,,Gym,,,3113,,250,3,13065109727,0,168075,,30378,,63798327,,,,,,,,,,,,,,,,,,,,,,,,,,,,,,,,,,,,,,,,,
82851433,8fbb1700-bfc1-4e85-a8a0-d015f49e0aa6,1702405782,60,1702406136,,0,0,4.22,1231,1231,0,26,2,28,0,0,0.1,,0.94,,276,142,156,111,144,7,60.46,39.19,60,1,58.74,1463,64,,2.6,0,101,101,,,,,,31,80,12.12,12.41,12.23,-0.8,-5.7,301,301,,1,305,305,,,,,,,,,"0,1,1,35,46,17,0,0,0","2,37,61,0,0","0,0,56,44,0",,,,,129,,,,,,,,,,,,,,,,,,,,,,,,,,,,,,,,,,,,35.8,9,12,178,91,,1000,0,,1,4,4,Westick,1,0,U1.000|5:06-U1.000|5:01-U1.000|4:54-U1.000|4:29-U0.219|1:01,,"Fröndenberg/Ruhr Running",,,3113,,250,3,13076961264,0,168070,250480,30378,,63860079,,,,,,,,,,,,,,,,,,,,,,,,,,,,,,,,,,,,,,,,,
82851747,d543b04c-3729-44fa-98b2-ab9c9218b69e,1702407350,60,1702406435,,0,0,8.49,2359,2359,12,18,12,0,0,0,0.02,,,,584,162,183,100,171,47,53.3,43.29,53.35,1,58.88,4320,237,,3.8,2.6,105,100,,,,,,96,82,12.94,14.34,14.32,16.2,8.7,334,334,,1,381,381,,,,,,,,,"24,5,6,6,3,9,28,16,2","0,17,26,49,8","6,13,24,10,47",,,,,132,,,,,,,,,,,,,,,,,,,,,,,,,,,,,,,,,,,,97.3,9,12,183,91,,1000,0,,1,4,4,Westick,1,0,U0.980|3:42-U2.000|7:17-U0.400|2:59-U1.010|3:34-U0.400|2:44-U1.010|3:47-U0.400|2:22-U1.000|3:34-U1.290|9:20,,"Fröndenberg/Ruhr Track Running",,,3113,,250,3,13077029106,0,168070,250480,30378,,63860347,,,,,,,,,,,,,,,,,,,,,,,,,,,,,,,,,,,,,,,,,
82852297,3f87a119-17cd-49f5-b388-9dda1b003ca5,1702410045,60,1702407020,,0,0,1.47,457,457,6,0,7,2,0,0,0.17,,,,99,138,146,,144,5,58.01,33.11,58.6,1,58.91,4302,22,,1.5,0,101,102,,,,,,10,81,11.72,11.62,11.76,3.5,4.5,293,293,,1,295,295,,,,,,,,,"2,4,10,59,23,2,0,0,0","0,71,29,0,0","0,0,68,32,0",,,,,119,,,,,,,,,,,,,,,,,,,,,,,,,,,,,,,,,,,,17.1,8,12,183,91,,1000,0,,1,4,4,Westick,1,0,U1.000|5:12-U0.465|2:25,,"Fröndenberg/Ruhr Running",,,3113,,250,3,13077163730,0,168070,250480,30378,,63860843,,,,,,,,,,,,,,,,,,,,,,,,,,,,,,,,,,,,,,,,,
82902987,0a128bc2-b4be-4734-ab07-553a56397681,1702477976,60,1702483257,,0,0,14.52,4398,4554,229,189,253,210,0,1.9,0.49,0.94,1.07,318,960,146,164,,158,23,55.61,40.7,56.88,1,58.91,3458,141,,3.5,0,100,99,,,,,,122,81,12.19,12.17,12.35,0.1,2.2,301,301,,1,307,307,,,,,,,,,"8,7,10,21,35,17,2,0,0","0,22,76,1,0","0,0,45,54,1",,,,,122,,,,,,,,,,,,,,,,,,,,,,,,,,,,,,,,,,,,42.9,8,4,238,88,,999,0,,0,4,4,Helle,1,0,U1.000|4:47-U1.000|4:53-U1.000|4:59-U1.000|5:10-U1.000|5:24-U1.000|4:49-U1.000|4:59-U1.000|4:52-U1.000|4:32-U1.000|6:15-U1.000|5:06-U1.000|4:29-U1.000|5:27-U1.000|4:31-U0.520|3:06,,"Balve Running",,,3113,,250,3,13087381090,0,168070,250480,30378,,63905865,,,,,,,,,,,,,,,,,,,,,,,,,,,,,,,,,,,,,,,,"5,5,5",
82983724,d030b536-8740-4c58-9baa-debcafa3aaa3,1702564577,60,1702565681,,0,0,13.15,3931,4647,145,144,148,154,0,1.3,0.43,0.91,1.03,,853,147,167,,147,21,55.99,41.01,56.76,1,58.92,2736,157,,3.6,0.1,100,100,,,,,,99,81,12.21,12.57,12.53,3,-0.8,301,301,,1,312,312,,,,,,,,,"8,5,10,13,33,28,3,0,0","0,23,73,4,0","1,5,33,61,0",,,,,124,,,,,,,,,,,,,,,,,,,,,,,,,,,,,,,,,,,,42.7,3,8,326,94,,1020,0,,0,4,4,Balve,1,0,U1.000|5:14-U1.000|4:25-U1.000|4:41-U1.000|4:45-U1.000|4:55-U1.000|5:04-U1.000|4:35-U1.000|4:48-U1.000|4:25-U1.000|4:47-U1.000|5:11-U1.000|6:48-U1.000|4:27-U0.147|1:26,,"Balve Running",,,3113,,250,3,13098439844,0,168070,250480,30378,,63978765,,,,,,,,,,,,,,,,,,,,,,,,,,,,,,,,,,,,,,,,,
83045127,51bba335-086d-4068-a6f7-0094f4002725,1702644766,60,1702647867,,0,0,16.75,5051,5306,347,336,351,343,0,3.4,0.71,0.97,1.1,425,1146,150,165,,163,19,53.87,41.38,55.29,1,58.9,2605,166,,3.7,0,99,98,,,,,,130,82,12.42,12.8,12.63,-10.5,-5.5,299,299,,1,304,304,,,,,,,,,"13,10,10,21,17,17,11,1,0","0,7,89,4,0","0,0,49,50,0",,,,,121,,,,,,,,,,,,,,,,,,,,,,,,,,,,,,,,,,,,41.7,6,11,266,94,,1035,0,,0,4,4,Balve,1,0,U1.000|5:30-U1.000|4:39-U1.000|5:08-U1.000|5:04-U1.000|5:16-U1.000|5:28-U1.000|6:12-U1.000|7:02-U1.000|5:50-U1.000|4:58-U1.000|4:04-U1.000|4:02-U1.000|3:49-U1.000|4:04-U1.000|4:54-U1.000|4:59-U0.746|3:13,,"Balve Running",,,3113,,250,3,13109100853,0,168070,250480,30378,,64033398,,,,,,,,,,,,,,,,,,,,,,,,,,,,,,,,,,,,,,,,"4,5,5",
83179421,e45a77d8-2eb7-44f6-8cef-1e9fb3ec2d14,1702815086,60,1702820671,,0,0,25.02,6047,6227,124,105,177,162,0,0,0.15,1.06,,,1536,161,179,,175,11,63.91,55.21,64.36,1,58.99,4320,343,,5,0.7,103,101,,,,,,215,83,14.94,15.02,15.17,0.2,-3.6,390,390,,1,399,399,,,,,,,,,"0,0,0,1,5,46,45,2,0","0,1,56,43,0","0,0,0,68,32",,,,,150,,,,,,,,,,,,,,,,,,,,,,,,,,,,,,,,,,,,82.8,8,14,217,83,,1036,1,,0,3,4,"Sundern (Sauerland)",1,0,U1.000|4:11-U1.000|4:05-U1.000|4:13-U1.000|4:09-U1.000|4:05-U1.000|4:08-U1.000|4:04-U1.000|4:08-U1.000|4:05-U1.000|4:00-U1.000|4:19-U1.000|4:07-U1.000|4:07-U1.000|4:04-U1.000|4:09-U1.000|3:58-U1.000|3:54-U1.000|3:43-U1.000|3:49-U1.000|3:45-U1.000|4:08-U1.000|3:45-U1.000|3:58-U1.000|3:54-U1.000|3:56-U0.015|0:04,,"Sundern (Sauerland) Running",,,3113,,250,3,13133606761,0,168070,250480,30378,,64154919,,,,,,,,,,,,,,,,,,,,,,,,,,,,,,,,,,,,,,,,,
83243102,8af62a84-b468-46e2-ae99-4ccf253c2bb1,1702903301,60,1702904449,,0,0,13,4025,4081,271,262,286,279,0,3.3,0.79,1.01,1.03,393,874,143,159,105,159,20,55.65,39.33,57.14,1,58.99,2877,116,,3.3,0,100,99,,,,,,95,81,11.9,11.94,12.08,-1.3,0.4,291,291,,1,298,298,,,,,,,,,"8,10,11,25,31,14,1,0,0","0,36,63,0,0","0,1,62,37,0",,,,,120,,,,,,,,,,,,,,,,,,,,,,,,,,,,,,,,,,,,31.4,7,14,223,71,,1031,1,,0,2,4,Balve,1,0,U1.000|5:36-U1.000|4:42-U1.000|5:07-U1.000|5:09-U1.000|5:13-U1.000|5:21-U1.000|5:08-U1.000|4:53-U1.000|5:33-U1.000|5:40-U1.000|4:27-U1.000|4:28-U1.000|5:48-U0.001|0:01,,"Balve Running",,,3113,,250,3,13144243433,0,168070,250480,30378,,64210534,,,,,,,,,,,,,,,,,,,,,,,,,,,,,,,,,,,,,,,,"4,5,5",
83335035,21b2f9f8-ebeb-4d44-91bb-be27ba2a31fa,1703010633,60,1703013881,,0,0,4.2,1175,1175,1,16,5,19,0,0,0,,,,274,142,152,101,148,12,63.67,41.15,63.41,1,59.08,1164,62,,2.6,0,104,101,,,,,,30,81,12.74,12.9,12.78,2.2,2,322,322,,1,324,324,,,,,,,,,"0,1,2,12,49,36,1,0,0","1,26,73,0,0","0,0,11,89,0",,,,,132,,,,,,,,,,,,,,,,,,,,,,,,,,,,,,,,,,,,29.6,6,17,227,93,,1015,0,,1,6,4,Westick,1,0,U1.000|4:46-U1.000|4:33-U1.000|4:38-U1.000|4:42-U0.201|0:58,,"Fröndenberg/Ruhr Running",,,3113,,250,3,13160374360,0,168070,250480,30378,,64295278,,,,,,,,,,,,,,,,,,,,,,,,,,,,,,,,,,,,,,,,,
83335060,411dd49a-4ae7-4714-b67f-ba844d90ef83,1703012185,60,1703013915,,0,0,9.45,2450,2499,0,9,0,8,0,0,0.02,,,,627,163,183,,169,51,57.52,47.28,57.45,1,59.11,3456,293,,4,3.1,100,108,,,,,,102,85,13.87,15.08,15.06,13,1,365,365,,1,405,405,,,,,,,,,"20,7,5,4,3,7,18,30,6","0,11,24,64,2","4,8,22,12,54",,,,,136,,,,,,,,,,,,,,,,,,,,,,,,,,,,,,,,,,,,91.4,6,16,235,94,,1015,0,,1,6,4,Westick,1,0,U1.710|7:21-U0.990|3:30-U0.400|2:29-U1.010|3:31-U1.000|3:31-U0.390|2:38-U1.010|3:22-U0.400|3:03-U0.400|1:22-U0.100|0:40-U0.400|1:19-U0.100|0:35-U0.400|1:21-U0.100|0:28-U0.400|1:23-U0.100|0:38-U0.410|1:20-U0.130|2:18,,"Fröndenberg/Ruhr Track Running",,,3113,,250,3,13160381074,0,168070,250480,30378,,64295301,,,,,,,,,,,,,,,,,,,,,,,,,,,,,,,,,,,,,,,,,
83335064,8a8cc171-d495-4e60-a068-f2344e583d90,1703014821,60,1703013919,,0,0,2.26,702,702,3,4,13,4,0,0,0,,,,153,137,147,,145,7,58.61,34.68,58.68,1,59.11,3434,31,,2,0,102,101,,,,,,16,81,11.61,11.65,11.63,1.5,1.9,289,289,,1,290,290,,,,,,,,,"2,1,12,47,36,2,0,0,0","1,69,29,0,0","0,0,80,20,0",,,,,119,,,,,,,,,,,,,,,,,,,,,,,,,,,,,,,,,,,,20.4,6,16,235,94,,1015,0,,1,6,4,Westick,1,0,U1.000|5:04-U1.000|5:13-U0.264|1:26,,"Fröndenberg/Ruhr Running",,,3113,,250,3,13160382308,0,168070,250480,30378,,64295306,,,,,,,,,,,,,,,,,,,,,,,,,,,,,,,,,,,,,,,,,
83379481,e98e49bc-0944-4ada-b243-115d5f938575,1703076969,60,1703078185,,0,0,12.9,4322,4470,221,227,241,249,0,1.7,0.64,0.96,1.04,269,884,138,158,107,155,25,52.89,35.84,53.98,1,59.08,2332,87,,3,0,98,96,,,,,,101,81,10.93,11.02,11.04,-4.1,-2.7,266,266,,1,271,271,,,,,,,,,"15,14,25,28,17,2,0,0,0","0,62,37,0,0","0,1,88,11,0",,,,,111,,,,,,,,,,,,,,,,,,,,,,,,,,,,,,,,,,,,33.7,5,21,248,92,,1014,0,,0,4,4,Balve,1,0,U1.000|6:00-U1.000|5:17-U1.000|5:57-U1.000|5:42-U1.000|5:57-U1.000|5:52-U1.000|5:34-U1.000|5:18-U1.000|5:56-U1.000|5:40-U1.000|4:47-U1.000|4:43-U0.897|5:20,,"Balve Running",,,3113,,250,3,13168114362,0,168070,250480,30378,,64335476,,,,,,,,,,,,,,,,,,,,,,,,,,,,,,,,,,,,,,,,"4,5",
83397110,c23fc69c-b807-47c6-9748-1f010398e005,1703099156,60,1703098606,,0,0,,3024,3024,,,,,0,,,,,,200,86,114,,90,29,,,,1,59.08,1992,5,,0.3,0,,100,,,,,,12,54,,,,,,,,,,,,,,,,,,,,,"79,21,0,0,0",,,,,,,,,,,,,,,,,,,,,,,,,,,,,,,,,,,,,,,,,,4,,,,,,,,,,1,,,1,0,,,Gym,,,3113,,250,3,13171828059,0,168075,,30378,,64349982,,,,,,,,,,,,,,,,,,,,,,,,,,,,,,,,,,,,,,,,,
83455632,f7c1c438-1930-4727-9667-2c58b8ede7fd,1703180780,60,1703182734,,0,0,13.29,4823,4865,364,373,403,410,0,3.9,0.86,1.11,0.94,431,1044,161,182,,176,16,38.68,32.7,39.97,1,59.08,2016,165,,3.7,0,,100,,,,,,138,81,10.38,10.21,10.67,14.8,27.6,242,242,,1,255,255,,,,,,,,,"35,15,20,21,7,1,0,0,0","1,1,43,54,0","0,20,68,11,0",,,,,102,,,,,,,,,,,,,,,,,,,,,,,,,,,,,,,,,,,,81.7,6,31,290,89,,996,0,,1,6,4,,1,0,U1.000|6:23-U1.000|6:48-U1.000|6:03-U1.000|6:57-U1.000|6:55-U1.000|5:59-U1.000|5:56-U1.000|5:37-U1.000|6:26-U1.000|6:00-U1.000|5:15-U1.000|5:27-U1.000|5:09-U0.285|1:26,,"Balve Running",,,3113,,250,3,13182395314,0,168070,250480,30378,,64403891,,,,,,,,,,,,,,,,,,,,,,,,,,,,,,,,,,,,,,,,"4,4",
83496457,55fc032c-d6cc-45d4-b212-aadac952c13a,1703247694,60,1703250093,,0,0,16.46,5657,5710,474,433,503,463,0,4.7,0.81,0.98,1.11,560,1169,147,171,,167,21,47.14,35.47,48.97,1,59,1503,115,,3.2,0,90,103,,,,,,91,82,11.21,11.18,11.39,-6.3,3,261,261,,1,266,266,,,,,,,,,"30,15,13,14,16,10,0,0,0","1,30,57,13,0","0,4,81,15,0",,,,,106,,,,,,,,,,,,,,,,,,,,,,,,,,,,,,,,,,,,36.1,6,23,284,92,,1001,1,,0,10,4,Helle,1,0,U1.000|5:37-U1.000|6:12-U1.000|6:38-U1.000|7:16-U1.000|6:36-U1.000|4:58-U1.000|5:37-U1.000|5:35-U1.000|6:56-U1.000|6:35-U1.000|5:09-U1.000|5:26-U1.000|4:31-U1.000|4:36-U1.000|4:27-U1.000|5:07-U0.457|2:59,,"Balve Running",,,3113,,250,3,13189939663,0,168070,250480,30378,,64439649,,,,,,,,,,,,,,,,,,,,,,,,,,,,,,,,,,,,,,,,"4,4,5",
83580830,de64a3e5-3682-40cc-9d52-9f9677eb1881,1703358216,60,1703357615,,0,0,7.53,2572,2654,148,139,165,157,0,2.4,0.58,0.99,0.94,484,504,132,151,,145,20,54.61,33.67,56.02,1,58.94,910,59,,2.5,0,98,97,,,,,,45,80,10.79,10.77,11.09,-1.7,-0.5,262,262,,1,274,274,,,,,,,,,"16,11,32,27,14,1,0,0,0","1,88,12,0,0","0,3,81,15,0",,,,,110,,,,,,,,,,,,,,,,,,,,,,,,,,,,,,,,,,,,17.7,8,24,260,92,,1009,0,,1,6,4,Balve,1,0,U1.000|5:41-U1.000|5:03-U1.000|5:49-U1.000|5:31-U1.000|5:35-U1.000|6:24-U1.000|5:26-U0.534|3:22,,"Balve Running",,,3113,,250,3,13205325309,0,168070,250480,30378,,64515092,,,,,,,,,,,,,,,,,,,,,,,,,,,,,,,,,,,,,,,,"4,5,5",
83615310,6ef03c6b-d09c-4d67-8757-2da702979bc5,1703410328,60,1703413980,,0,0,23.54,6908,7051,435,417,493,474,0,3.6,0.59,1.01,1.04,439,1592,156,175,,163,95,52.69,43.88,53.94,1,58.91,3190,253,,4.5,0,100,98,,,,,,223,82,12.62,12.51,12.87,-0.3,3.7,313,313,,1,323,323,,,,,,,,,"1,3,11,25,37,19,3,0,0","1,4,58,38,0","0,0,37,61,3",,,,,125,,,,,,,,,,,,,,,,,,,,,,,,,,,,,,,,,,,,63.2,8,26,237,93,,1006,0,,0,6,4,Neheim-Hüsten,1,0,U1.000|5:13-U1.000|5:07-U1.000|5:08-U1.000|5:28-U1.000|4:33-U1.000|4:51-U1.000|4:31-U1.000|5:17-U1.000|5:25-U1.000|4:34-U1.000|5:05-U1.000|5:32-U1.000|5:17-U1.000|5:08-U1.000|4:51-U1.000|4:19-U1.000|4:24-U1.000|4:18-U1.000|4:13-U1.000|4:49-U1.000|4:45-U1.000|4:50-U1.000|4:48-U0.539|2:41,,"Arnsberg Running",,,3113,,250,3,13211121025,0,168070,250480,30378,,64546282,,,,,,,,,,,,,,,,,,,,,,,,,,,,,,,,,,,,,,,,"4,4,4",
83672639,71450b50-f8dc-4223-8aa8-68453ee1c5bc,1703500938,60,1703500288,,0,0,8.4,2716,2855,111,120,119,129,0,1.7,0.49,1.02,0.96,511,564,137,155,,150,21,55.78,36.19,56.62,1,58.89,1721,74,,2.8,0,98,98,,,,,,46,81,11.28,11.29,11.41,-4.8,-6.6,272,272,,1,279,279,,,,,,,,,"10,8,15,43,22,2,0,0,0","1,66,34,0,0","0,0,82,17,0",,,,,115,,,,,,,,,,,,,,,,,,,,,,,,,,,,,,,,,,,,16.7,9,21,248,96,,1008,0,,0,6,4,Balve,1,0,U1.000|5:53-U1.000|5:12-U1.000|5:35-U1.000|5:24-U1.000|5:08-U1.000|5:05-U1.000|5:03-U1.000|5:33-U0.395|2:23,,"Balve Running",,,3113,,250,3,13221619130,0,168070,250480,30378,,64596575,,,,,,,,,,,,,,,,,,,,,,,,,,,,,,,,,,,,,,,,"5,5",
83746629,82976928-c937-4247-8f6c-4ca16f3df4cb,1703584997,60,1703585955,,0,0,15.25,3632,3632,60,57,112,109,0,0,0.14,,,,963,163,182,,159,11,63.88,53.99,64.2,1,58.97,4320,337,,5,0.5,104,102,,,,,,123,83,15.14,15.45,15.51,-4.8,-8.9,396,396,,1,410,410,,,,,,,,,"0,0,0,0,6,46,36,11,0","0,1,48,50,1","0,0,0,54,46",,,,,152,,,,,,,,,,,,,,,,,,,,,,,,,,,,,,,,,,,,93.7,7,21,261,89,,1013,0,,0,4,4,Langscheid,1,0,U1.000|4:32-U1.000|4:20-U1.000|4:20-U1.000|4:15-U1.000|4:12-U1.000|4:08-U1.000|4:11-U1.000|4:01-U1.000|3:46-U1.000|3:43-U1.000|3:48-U1.000|3:45-U1.000|3:37-U1.000|3:29-U1.000|3:27-U0.250|0:57,,"Sundern (Sauerland) Running",,,3113,,250,3,13231579127,0,168070,250480,30378,,64663611,,,,,,,,,,,,,,,,,,,,,,,,,,,,,,,,,,,,,,,,,
83763045,,1703582220,60,1703596732,,0,0,3,900,900,,,,,0,,,,,,218,,,,,,,37.02,,1,,,,,,,,,,,,,,16,,,,,,,,,,,,,,,,,,,,,,,,,,,,,,,,,,,,,,,,,,,,,,,,,,,,,,,,,,,,,,,,,,,,,,,,,,1,,,0,0,,,"Ein und auslaufen",,,connect,,,3,13234546973,0,168070,250480,30378,,64679204,,,,,,,,,,,,,,,,,,,,,,,,,,,,,,,,,,,,,,,,,
83763291,,1703582460,60,1703596971,,0,0,2,600,600,,,,,0,,,,,,145,,,,,,,35.65,,1,,,,,,,,,,,,,,11,,,,,,,,,,,,,,,,,,,,,,,,,,,,,,,,,,,,,,,,,,,,,,,,,,,,,,,,,,,,,,,,,,,,,,,,,,1,,,0,0,,,"mehr ein und auslaufen",,,connect,,,3,13234605531,0,168070,250480,30378,,64679431,,,,,,,,,,,,,,,,,,,,,,,,,,,,,,,,,,,,,,,,,
83822640,7bb61298-6edd-4799-8379-2612a04c39a1,1703669793,60,1703671292,,0,0,13.94,4433,4980,328,327,334,335,0,3.6,0.75,0.93,1.04,435,944,142,158,,157,20,54.35,38.33,55.94,1,58.97,2886,108,,3.2,0,101,98,,,,,,36,81,11.8,11.95,12.01,-11.4,-3.4,285,285,,1,292,292,,,,,,,,,"19,15,9,15,20,20,2,0,0","1,35,65,0,0","0,0,72,27,0",,,,,116,,,,,,,,,,,,,,,,,,,,,,,,,,,,,,,,,,,,6.7,6,12,168,87,,1019,0,,0,4,4,Balve,1,0,U1.000|5:03-U1.000|5:21-U1.000|6:37-U1.000|6:23-U1.000|6:33-U1.000|6:02-U1.000|5:10-U1.000|4:28-U1.000|4:24-U1.000|4:21-U1.000|4:21-U1.000|5:26-U1.000|4:55-U0.938|4:49,,"Balve Running",,,3113,,250,3,13244664468,0,168070,250480,30378,,64730758,,,,,,,,,,,,,,,,,,,,,,,,,,,,,,,,,,,,,,,,"4,5",
83996063,c606158e-01ff-4b3a-a685-9236d9f03ca8,1703841047,60,1703852145,,0,0,19.91,5435,5794,287,272,318,306,0,2.6,0.65,1.01,1,357,1326,162,180,131,172,23,54.48,47.1,55.5,1,58.92,4347,313,,4.9,0.9,100,98,,,,,,188,82,13.4,13.35,13.58,0.2,2,338,338,,1,346,346,,,,,,,,,"2,1,3,10,38,36,9,1,0","0,5,34,61,0","0,1,18,75,7",,,,,134,,,,,,,,,,,,,,,,,,,,,,,,,,,,,,,,,,,,79.6,8,31,223,87,,1010,0,,0,6,4,Aachen-Mitte,1,0,U1.000|5:06-U1.000|4:48-U1.000|5:02-U1.000|4:40-U1.000|4:53-U1.000|4:42-U1.000|4:25-U1.000|4:31-U1.000|4:11-U1.000|4:16-U1.000|4:18-U1.000|4:17-U1.000|4:41-U1.000|4:15-U1.000|4:14-U1.000|4:07-U1.000|4:37-U1.000|4:22-U1.000|4:50-U0.910|4:20,,"Aachen Running",,,3113,,250,3,13272967084,0,168070,250480,30378,,64886625,,,,,,,,,,,,,,,,,,,,,,,,,,,,,,,,,,,,,,,,"5,5",
84169153,4c37b04a-32b8-4513-bad6-975e6b405208,1703936276,60,1703934990,,0,0,7.02,1906,2273,114,102,117,108,0,2.1,0.53,0.97,0.96,644,461,151,165,,165,21,60.75,43.97,62.1,1,58.94,2788,103,,3.1,0,101,103,,,,,,53,82,13.62,13.58,14.63,-4.3,-21.9,348,348,,1,383,383,,,,,,,,,"3,6,9,6,18,45,12,2,0","1,4,87,8,0","0,0,12,75,13",,,,,135,,,,,,,,,,,,,,,,,,,,,,,,,,,,,,,,,,,,40,7,18,241,92,,1014,,,0,4,1,Balve,1,0,U1.000|5:12-U1.000|4:15-U1.000|4:13-U1.000|4:14-U1.000|4:14-U1.000|4:00-U1.000|5:31-U0.017|0:06,,"Balve Running",,,3113,,250,3,13285341499,0,168070,250480,30378,,65036842,,,,,,,,,,,,,,,,,,,,,,,,,,,,,,,,,,,,,,,,"4,5",
84352346,3b93f5d0-fe7f-45ad-a47b-b3aed746e5af,1704029134,60,1704032630,,0,0,3.68,1092,1172,28,35,29,37,0,0,0.17,1.13,0.96,,250,143,153,93,152,12,58.65,38.06,59.06,1,58.96,1280,56,,2.5,0,100,102,,,,,,23,81,12.1,12.19,12.2,-4.7,-8.3,298,298,,1,302,302,,,,,,,,,"0,2,5,28,60,5,0,0,0","1,17,82,0,0","0,0,51,49,0",,,,,125,,,,,,,,,,,,,,,,,,,,,,,,,,,,,,,,,,,,21.2,8,25,198,82,,999,0,,0,11,4,Amecke,1,0,U1.000|5:07-U1.000|4:53-U1.000|4:54-U0.679|3:19,,"Sundern (Sauerland) Running",,,3113,,250,3,13302467387,0,168070,250480,30378,,65194681,,,,,,,,,,,,,,,,,,,,,,,,,,,,,,,,,,,,,,,,,
84352430,47874a06-2eb8-4628-99a2-b24064740642,1704030617,60,1704032645,,0,0,8.16,1822,1822,42,33,58,51,0,0,0.1,1.05,,,513,173,178,,177,6,63.02,55.83,63.51,1,59.02,4032,210,,4.1,0.4,105,100,,,,,,82,85,16.21,16.18,16.26,2.6,2.7,429,429,,1,431,431,,,,,,,,,"0,0,0,0,0,7,81,12,0","0,0,2,98,0","0,0,0,11,89",,,,,158,,,,,,,,,,,,,,,,,,,,,,,,,,,,,,,,,,,,89.9,8,24,201,82,,999,0,,0,4,4,Amecke,1,0,U1.000|3:42-U1.000|3:44-U1.000|3:45-U1.000|3:39-U1.000|3:43-U1.000|3:43-U1.000|3:42-U1.000|3:46-U0.155|0:39,,"Sundern (Sauerland) Running",,,3113,,250,3,13302467575,0,168070,250480,30378,,65194764,,,,,,,,,,,,,,,,,,,,,,,,,,,,,,,,,,,,,,,,,
84352886,58fc9439-d96c-4381-926f-ad281a6e99f0,1704032567,60,1704032719,,0,0,7.27,2162,2181,56,56,76,73,0,0.4,0.29,,0.96,794,464,140,149,107,147,8,60.15,39.58,60.72,1,59.02,4320,69,,2.7,0,102,101,,,,,,41,81,12.18,12.19,12.34,0.4,3,302,302,,1,308,308,,,,,,,,,"3,2,8,31,41,12,3,0,0","0,45,55,0,0","0,0,53,46,1",,,,,125,,,,,,,,,,,,,,,,,,,,,,,,,,,,,,,,,,,,19.1,8,22,207,81,,999,0,,0,4,4,Langscheid,1,0,U1.000|5:06-U1.000|4:48-U1.000|4:47-U1.000|4:56-U1.000|4:59-U1.000|4:55-U1.000|5:09-U0.269|1:23,,"Sundern (Sauerland) Running",,,3113,,250,3,13302467753,0,168070,250480,30378,,65195215,,,,,,,,,,,,,,,,,,,,,,,,,,,,,,,,,,,,,,,,5,
84460824,26db5e05-d4ec-4b47-b794-3cdbeefd5a95,1704110960,60,1704114825,,0,0,,1742,1742,,,,,0,,,,,,133,91,112,87,93,29,,,,1,59.02,3041,5,,0.3,0,,100,,,,,,4,52,,,,,,,,,,,,,,,,,,,,,"75,25,0,0,0",,,,,,,,,,,,,,,,,,,,,,,,,,,,,,,,,,,,,,,,,,1.3,,,,,,,,,,1,,,1,0,,,Gym,,,3113,,250,3,13313386129,0,168075,,30378,,65290672,,,,,,,,,,,,,,,,,,,,,,,,,,,,,,,,,,,,,,,,,
84460862,e5dfa2ea-03dc-49d2-85c0-a60456a9649b,1704113318,60,1704114883,,0,0,15.93,4825,4979,474,430,493,450,0,5.1,0.84,1,1.09,662,1093,150,167,,160,20,53.58,41.01,55.74,1,59.02,4321,176,,3.8,0,98,99,,,,,,117,83,12.79,12.86,13.17,-3.7,7.9,310,310,,1,321,321,,,,,,,,,"16,9,16,14,12,19,13,1,0","0,13,73,14,0","0,0,47,49,4",,,,,119,,,,,,,,,,,,,,,,,,,,,,,,,,,,,,,,,,,,40.5,6,21,238,87,,1006,0,,0,4,4,Helle,1,0,U1.000|4:57-U1.000|5:27-U1.000|5:41-U1.000|6:25-U1.000|5:56-U1.000|4:18-U1.000|4:52-U1.000|4:45-U1.000|5:52-U1.000|6:26-U1.000|4:02-U1.000|4:06-U1.000|3:57-U1.000|3:57-U1.000|4:01-U0.931|5:42,,"Balve Running",,,3113,,250,3,13313399322,0,168070,250480,30378,,65290708,,,,,,,,,,,,,,,,,,,,,,,,,,,,,,,,,,,,,,,,"3,4,5",
84619943,b3c7ed28-231f-4a05-97b7-266722799832,1704225011,60,1704225367,,0,0,13.21,3821,3899,133,122,154,146,0,1,0.34,0.93,0.96,666,852,150,175,,167,26,56.71,42.63,57.48,1,59.03,3168,168,,3.6,1,98,102,,,,,,99,81,12.63,13.49,13.4,-1.6,0,311,311,,1,338,338,,,,,,,,,"7,10,11,24,20,5,20,4,0","0,15,60,25,0","0,0,55,31,14",,,,,128,,,,,,,,,,,,,,,,,,,,,,,,,,,,,,,,,,,,58.2,9,29,217,86,,988,0,,1,6,4,Balve,1,0,U1.000|5:58-U1.000|5:15-U1.000|5:00-U1.000|5:03-U1.000|4:50-U0.431|2:03-U1.000|3:35-U1.000|3:47-U1.000|5:12-U1.000|5:23-U0.499|2:47-U1.000|3:41-U1.000|3:43-U1.000|5:48-U0.276|1:35,,"Balve Running",,,3113,,250,3,13332213415,0,168070,250480,30378,,65423519,,,,,,,,,,,,,,,,,,,,,,,,,,,,,,,,,,,,,,,,5,
84683365,4f608c12-00b9-4cf8-85f3-77fd38772dfe,1704290222,60,1704290925,,0,0,15.27,3850,3850,74,88,90,105,0,0,0.15,,0.99,,972,161,175,,168,9,60.65,50.55,60.95,1,59.05,4320,241,,4.4,0,103,100,,,,,,130,82,14.26,14.36,14.35,5.2,5.8,364,364,,1,368,368,,,,,,,,,"0,0,0,3,16,57,23,2,0","0,1,32,67,0","0,0,0,88,12",,,,,145,,,,,,,,,,,,,,,,,,,,,,,,,,,,,,,,,,,,61.1,8,24,237,86,97,992,0,,0,6,4,"Sundern (Sauerland)",1,0,U1.000|4:21-U1.000|4:11-U1.000|4:08-U1.000|4:15-U1.000|4:08-U1.000|4:09-U1.000|4:07-U1.000|4:03-U1.000|4:03-U1.000|4:00-U1.000|4:22-U1.000|4:19-U1.000|4:23-U1.000|4:14-U1.000|4:20-U0.269|1:08,,"Sundern (Sauerland) Running",,,3113,,250,3,13341953827,0,168070,250480,30378,,65476492,,,,,,,,,,,,,,,,,,,,,,,,,,,,,,,,,,,,,,,,,
84784734,d3abd3f4-f47d-4fbd-867e-cac77fc04412,1704372666,60,1704374273,,0,0,16.69,4945,5133,343,341,353,354,0,3.7,0.67,1.03,1.12,449,1106,147,169,,157,17,56.61,42.23,58.06,1,59.04,3746,161,,3.7,0,97,100,,,,,,101,82,12.58,12.8,12.81,-8.8,-0.9,306,306,,1,313,313,,,,,,,,,"10,9,9,20,20,23,9,1,0","0,14,85,1,0","0,0,44,55,1",,,,,123,,,,,,,,,,,,,,,,,,,,,,,,,,,,,,,,,,,,29.5,7,18,266,91,95,1004,0,,0,6,4,Balve,1,0,U1.000|5:23-U1.000|4:30-U1.000|5:03-U1.000|5:02-U1.000|5:01-U1.000|5:28-U1.000|5:53-U1.000|6:39-U1.000|5:53-U1.000|4:54-U1.000|4:08-U1.000|4:04-U1.000|3:52-U1.000|4:07-U1.000|4:47-U1.000|4:47-U0.690|2:55,,"Balve Running",,,3113,,250,3,13356175646,0,168070,250480,30378,,65563924,,,,,,,,,,,,,,,,,,,,,,,,,,,,,,,,,,,,,,,,"4,4",
84860906,2dde7c35-49d7-4469-8a70-7a8d985701a9,1704440845,60,1704441421,,0,0,12.17,3947,3958,184,189,205,210,0,2.3,0.66,0.95,1.04,247,819,140,161,,160,23,54.04,37.06,55.03,1,59.03,2630,88,,3,0,96,98,,,,,,25,81,11.24,11.42,11.44,-5.9,-9.6,272,272,,1,280,280,,,,,,,,,"15,9,17,31,21,7,0,0,0","0,50,50,0,0","0,1,80,19,0",,,,,114,,,,,,,,,,,,,,,,,,,,,,,,,,,,,,,,,,,,5.6,5,18,186,92,83,1000,0,,1,4,4,Balve,1,0,U1.000|6:07-U1.000|5:21-U1.000|5:28-U1.000|5:26-U1.000|5:57-U1.000|5:27-U1.000|4:39-U1.000|5:16-U1.000|4:54-U1.000|5:27-U1.000|5:02-U1.000|5:44-U0.167|0:59,,"Balve Running",,,3113,,250,3,13367037703,0,168070,250480,30378,,65631959,,,,,,,,,,,,,,,,,,,,,,,,,,,,,,,,,,,,,,,,"5,5",
85010326,80256ca5-aae3-4b60-8a98-fe473c1abf45,1704564030,60,1704565465,,0,0,13.09,4641,4925,361,360,368,369,0,3.9,0.89,1.1,1.03,416,918,141,155,,152,20,47.97,33.57,49.61,1,58.93,1337,96,,3.1,0,94,100,,,,,,114,81,10.68,10.5,10.86,7.2,21.1,253,253,,1,262,262,,,,,,,,,"32,19,16,15,16,2,0,0,0","1,37,62,0,0","0,9,79,13,0",,,,,104,,,,,,,,,,,,,,,,,,,,,,,,,,,,,,,,,,,,35.2,1,6,337,94,98,1013,0,,1,9,4,,1,0,U1.000|6:11-U1.000|6:46-U1.000|6:19-U1.000|6:55-U1.000|6:49-U1.000|6:14-U1.000|5:47-U1.000|5:51-U1.000|6:01-U1.000|5:23-U1.000|4:50-U1.000|4:59-U1.000|4:46-U0.091|0:29,,"Balve Running",,,3113,,250,3,13389250681,0,168070,250480,30378,,65762916,,,,,,,,,,,,,,,,,,,,,,,,,,,,,,,,,,,,,,,,3,
85089956,cf0efc17-aa75-4fa5-86ef-46e5215a4adc,1704640675,60,1704646131,,0,0,30.5,7645,7986,99,107,128,135,0,0,0.07,,,,1928,155,167,,155,10,64.61,53.73,64.85,1,59.03,4320,331,,5,0,104,102,,,,,,255,82,14.37,14.42,14.45,1.1,0.6,375,375,,1,379,379,,,,,,,,,"0,0,0,1,10,65,23,1,0","0,2,91,7,0","0,0,1,82,17",,,,,146,,,,,,,,,,,,,,,,,,,,,,,,,,,,,,,,,,,,58.6,-2,17,45,82,90,1025,0,,0,4,4,"Sundern (Sauerland)",1,0,U1.000|4:12-U1.000|4:11-U1.000|4:16-U1.000|4:18-U1.000|4:14-U1.000|4:14-U1.000|4:13-U1.000|4:12-U1.000|4:11-U1.000|4:00-U1.000|4:14-U1.000|4:07-U1.000|4:04-U1.000|4:04-U1.000|4:08-U1.000|4:13-U1.000|4:08-U1.000|4:09-U1.000|4:16-U1.000|4:05-U1.000|4:03-U1.000|4:16-U1.000|4:09-U1.000|4:18-U1.000|4:18-U1.000|4:01-U1.000|4:10-U1.000|4:04-U1.000|4:06-U1.000|4:25-U0.498|2:05,,"Sundern (Sauerland) Running",,,3113,,250,3,13402982070,0,168070,250480,30378,,65834811,,,,,,,,,,,,,,,,,,,,,,,,,,,,,,,,,,,,,,,,,
85155183,d08e9836-3c19-4e76-b756-c65e933db196,1704718846,60,1704720171,,0,0,12.01,4233,4408,228,233,241,248,0,2.5,0.58,0.99,0.98,452,829,135,152,96,147,16,51.09,33.57,52.27,1,59.01,3070,80,,2.9,0,97,97,,,,,,92,81,10.54,10.48,10.64,2.5,1.4,254,254,,1,258,258,,,,,,,,,"25,15,26,26,6,0,0,0,0","0,79,21,0,0","0,10,82,8,0",,,,,105,,,,,,,,,,,,,,,,,,,,,,,,,,,,,,,,,,,,27.3,-4,17,54,69,31,1030,0,,0,2,4,Balve,1,0,U1.000|5:27-U1.000|6:12-U1.000|5:34-U1.000|5:23-U1.000|5:42-U1.000|6:07-U1.000|6:09-U1.000|6:18-U1.000|5:12-U1.000|6:09-U1.000|6:50-U1.000|5:24-U0.013|0:05,,"Balve Running",,,3113,,250,3,13413286694,0,168070,250480,30378,,65890437,,,,,,,,,,,,,,,,,,,,,,,,,,,,,,,,,,,,,,,,"4,5",
85184036,8fee548a-340b-42e5-b108-002c50f21d36,1704739824,60,1704738719,,0,0,,2387,2387,,,,,0,,,,,,96,71,100,,90,27,,,,1,59.01,2763,2,,0.1,0,,100,,,,,,7,53,,,,,,,,,,,,,,,,,,,,,"100,0,0,0,0",,,,,,,,,,,,,,,,,,,,,,,,,,,,,,,,,,,,,,,,,,2.1,,,,,,,,,,1,,,1,0,,,Gym,,,3113,,250,3,13417441154,0,168075,,30378,,65913083,,,,,,,,,,,,,,,,,,,,,,,,,,,,,,,,,,,,,,,,,
85281744,e6f319a5-8e86-4099-9776-9f94395ffefd,1704825056,60,1704843387,,0,0,4.26,1194,1194,4,27,8,29,0,0,0.05,,,,327,,,,,,,41.1,,1,59.01,1175,9,,0.6,0,,100,,,,,,30,82,12.64,12.87,12.68,,,320,320,,1,322,322,,,,,,,,,"0,2,1,7,63,27,0,0,0",,"0,0,13,87,0",,,,,131,,,,,,,,,,,,,,,,,,,,,,,,,,,,,,,,,,,,,-3,12,63,61,0,1032,0,,1,2,4,Westick,1,0,U1.000|4:47-U1.000|4:48-U1.000|4:36-U1.000|4:29-U0.256|1:14,,"Fröndenberg/Ruhr Running",,,3113,,250,3,13436079425,0,168070,250480,30378,,65997325,,,,,,,,,,,,,,,,,,,,,,,,,,,,,,,,,,,,,,,,,
85281780,14dc0e12-4a25-42a6-a250-bcda27d9b829,1704826656,60,1704843425,,0,0,10.15,2822,2822,0,0,0,0,0,0,0,,,,715,155,183,,175,51,56.84,43.78,56.84,1,59.03,3168,212,,3.6,2.5,106,106,,,,,,90,84,12.94,14.31,14.31,15.8,1,340,340,,1,387,387,,,,,,,,,"33,6,4,2,2,4,14,32,3","2,25,17,56,0","7,15,20,13,45",,,,,128,,,,,,,,,,,,,,,,,,,,,,,,,,,,,,,,,,,,75.1,-3,13,61,60,0,1032,0,,1,2,4,Westick,1,0,U0.400|1:21-U0.100|0:33-U0.400|1:23-U0.100|0:35-U0.400|1:22-U0.100|0:37-U0.400|1:24-U0.100|0:35-U0.400|1:22-U0.390|2:50-U0.400|1:22-U0.090|0:43-U0.400|1:21-U0.100|0:42-U0.400|1:21-U0.110|0:43-U0.400|1:21-U0.100|0:38-U0.400|1:21-U0.400|2:56-U0.400|1:24-U0.090|0:41-U0.400|1:21-U0.100|0:41-U0.400|1:21-U0.110|0:48-U0.400|1:22-U0.100|0:46-U0.400|1:24-U0.240|2:51-U0.400|1:15-U0.330|2:41-U0.400|1:15-U0.350|2:42-U0.400|1:16-U0.040|0:46,,"Fröndenberg/Ruhr Track Running",,,3113,,250,3,13436084866,0,168070,250480,30378,,65997340,,,,,,,,,,,,,,,,,,,,,,,,,,,,,,,,,,,,,,,,,
85281785,b2ee1f12-a5d4-4af6-8d71-24868df7eea9,1704829665,60,1704843429,,0,0,1.74,631,631,2,0,1,0,0,0,0,,,,122,125,131,,131,7,54.14,28.27,54.29,1,59.03,3155,17,,1.2,0,,100,,,,,,11,81,9.96,10.01,10.04,-0.8,0.7,242,242,,1,245,245,,,,,,,,,"15,22,51,11,1,0,0,0,0","0,100,0,0,0","0,7,93,0,0",,,,,102,,,,,,,,,,,,,,,,,,,,,,,,,,,,,,,,,,,,11.8,-4,11,67,66,0,1032,0,,1,2,4,Westick,1,0,U1.000|6:03-U0.738|4:28,,"Fröndenberg/Ruhr Running",,,3113,,250,3,13436085592,0,168070,250480,30378,,65997346,,,,,,,,,,,,,,,,,,,,,,,,,,,,,,,,,,,,,,,,,
85325189,9368712b-8995-4768-bcaf-1596ff1fd048,1704895684,60,1704897345,,0,0,16.73,4875,5156,365,332,382,350,0,3.8,0.68,0.94,1.06,594,1104,147,161,,158,17,57.79,43.06,59.49,1,59.03,2880,161,,3.7,0,100,100,,,,,,137,82,12.93,13.06,13.03,-6.2,-0.7,319,319,,1,322,322,,,,,,,,,"10,9,10,13,21,21,15,0,0","1,15,84,1,0","0,0,23,77,0",,,,,126,,,,,,,,,,,,,,,,,,,,,,,,,,,,,,,,,,,,47,1,4,74,55,6,1028,0,,0,2,4,Balve,1,0,U1.000|5:21-U1.000|4:24-U1.000|4:55-U1.000|4:46-U1.000|4:48-U1.000|5:12-U1.000|5:45-U1.000|6:46-U1.000|5:44-U1.000|4:43-U1.000|3:56-U1.000|4:00-U1.000|3:46-U1.000|4:00-U1.000|4:51-U1.000|5:02-U0.733|3:16,,"Balve Running",,,3113,,250,3,13443709891,0,168070,250480,30378,,66035188,,,,,,,,,,,,,,,,,,,,,,,,,,,,,,,,,,,,,,,,"4,5",
85458138,13570694-57c3-479e-9ec5-1671cdbe0131,1704997882,60,1705001368,,0,0,14.95,5080,5409,424,383,436,399,0,4.5,0.83,1.09,1.09,544,807,91,156,,138,40,80.61,35.67,83.75,1,59.03,1224,51,,2.4,0,98,98,,,,,,15,81,11.3,11.08,11.56,-15.3,-2.3,272,272,,1,282,282,,,,,,,,,"23,16,19,15,20,6,0,0,0","68,30,2,0,0","0,4,68,28,0",,,,,109,,,,,,,,,,,,,,,25,,,,,,,,,,,,,,,,,,,,,5.9,-3,3,43,79,82,1033,0,,1,4,4,Helle,1,0,U1.000|6:00-U1.000|6:09-U1.000|7:07-U1.000|6:35-U1.000|5:16-U1.000|5:32-U1.000|5:46-U1.000|6:08-U1.000|6:39-U1.000|4:45-U1.000|4:49-U1.000|4:35-U1.000|4:48-U1.000|4:46-U0.949|5:45,,"Balve Running",,,3113,,250,3,13462619586,0,168070,250480,30378,9214746,66152902,542,200,135,250,26,74.53,88.79,38.53,,,,,,,,,0,,0,,0,,,,,,,,,,,,,,,,,,,"4,4,5",
85534336,0b4d483a-2428-41e7-859c-0bb600d213b5,1705062878,60,1705062916,,0,0,11.81,3423,3547,162,180,168,190,0,1.7,0.46,,,561,892,,,,,,,42.16,,1,59.03,468,25,,1.8,0,,100,,,,,,83,82,12.58,12.81,12.9,,,315,315,,1,329,329,,,,,,,,,"6,5,9,22,23,24,10,1,0",,"0,2,37,54,6",,,,,126,,,,,,,,,,,,,,,,,,,,,,,,,,,,,,,,,,,,,0,8,297,91,96,1032,1,,0,4,4,Balve,1,0,U1.000|5:27-U1.000|4:25-U1.000|5:08-U1.000|4:55-U1.000|5:04-U1.000|5:14-U1.000|5:26-U1.000|4:32-U0.534|2:19-U1.000|3:50-U1.000|4:01-U1.000|5:15-U0.277|1:26,,"Balve Running",,,3113,,250,3,13471025768,0,168070,250480,30378,,66216878,,,,,,,,,,,,,,,,,,,,,,,,,,,,,,,,,,,,,,,,"5,5",
85644975,ee69d3d9-1ac9-4a44-9d79-7644cffb89ad,1705173627,60,1705174536,,0,0,6.37,2092,3940,52,101,57,107,0,0.9,0.41,,,,480,,,,,,,34.9,,1,59.03,178,19,,1.3,0,,100,,,,,,51,80,10.84,11.04,10.99,,,262,262,,1,270,270,,,,,,,,,"9,9,22,44,12,4,0,0,0",,"0,5,83,11,1",,,,,114,,,,,,,,,,,,,,,,,,,,,,,,,,,,,,,,,,,,,1,16,254,92,98,1019,0,,1,9,4,Balve,1,0,U1.000|6:17-U1.000|5:37-U1.000|5:27-U1.000|5:20-U1.000|4:58-U1.000|5:08-U0.367|2:06,,"Balve Running",,,3113,,250,3,13491528253,0,168070,250480,30378,,66314260,,,,,,,,,,,,,,,,,,,,,,,,,,,,,,,,,,,,,,,,,
85705825,648c45d9-1cbf-415e-b140-94ea6f108fe1,1705236835,60,1705242185,,0,0,26.63,7686,8836,151,147,165,160,0,0,0.15,,,701,1750,150,176,,140,36,56.86,45.15,57.27,1,59.06,3168,270,,4.6,0.3,97,101,,,,,,226,83,12.49,13.1,13.27,1.9,3.8,316,316,,1,344,344,,,,,,,,,"3,3,10,27,24,18,13,2,0","0,17,58,25,0","2,0,44,42,11",,,,,125,,,,,,,,,,,,,,,,,,,,,,,,,,,,,,,,,,,,79,1,16,242,89,98,1009,0,,0,4,4,Amecke,1,0,U1.000|5:20-U1.000|5:11-U1.000|5:17-U1.000|5:21-U1.000|5:04-U1.000|5:16-U1.000|5:10-U1.000|4:28-U1.000|4:00-U1.000|4:09-U1.000|4:03-U1.000|4:01-U1.000|4:01-U1.000|3:58-U1.000|3:39-U1.000|4:18-U1.000|4:26-U1.000|4:36-U1.000|4:46-U1.000|4:44-U1.000|4:46-U1.000|4:52-U1.000|4:45-U1.000|7:27-U1.000|5:26-U1.000|5:39-U0.633|3:20,,"Sundern (Sauerland) Running",,,3113,,250,3,13502534297,0,168070,250480,30378,,66369470,,,,,,,,,,,,,,,,,,,,,,,,,,,,,,,,,,,,,,,,5,
85779869,e9de2223-7f51-4f03-bad9-f272c5d367a8,1705322329,60,1705325021,,0,0,15.4,5121,5175,390,390,400,400,0,4.1,0.93,0.99,1.08,510,1052,145,164,92,164,17,50.02,36.67,51.59,1,59,2335,119,,3.3,0,95,98,,,,,,127,82,11.42,11.56,11.57,2.8,6,269,269,,1,273,273,,,,,,,,,"27,15,13,11,18,14,2,0,0","0,20,79,1,0","0,1,85,14,0",,,,,110,,,,,,,,,,,,,,,,,,,,,,,,,,,,,,,,,,,,37,1,23,268,89,97,1001,0,,0,4,4,Balve,1,0,U1.000|6:10-U1.000|6:35-U1.000|6:17-U1.000|6:48-U1.000|5:08-U1.000|4:41-U1.000|4:22-U1.000|5:27-U1.000|7:13-U1.000|6:03-U1.000|6:08-U1.000|4:50-U1.000|4:29-U1.000|4:32-U1.000|4:39-U0.396|1:58,,"Balve Running",,,3113,,250,3,13514933375,0,168070,250480,30378,,66435546,,,,,,,,,,,,,,,,,,,,,,,,,,,,,,,,,,,,,,,,"4,4",
85904880,5df6e166-53a6-4c3a-a2b9-311159eb72eb,1705431392,60,1705431051,,0,0,7.52,2125,2125,0,0,0,0,0,0,0,,,,524,159,185,110,180,43,53.68,42.12,53.68,1,59.02,3301,260,,3.5,3.3,97,110,,,,,,82,84,12.75,14.25,14.25,8.1,-0.6,330,330,,1,382,382,,,,,,,,,"37,5,6,2,2,4,10,24,10","0,23,24,47,6","5,24,21,9,42",,,,,126,,,,,,,,,,,,,,,,,,,,,,,,,,,,,,,,,,,,78,-2,13,208,79,48,1008,0,,1,3,4,Westick,1,0,U0.210|0:37-U0.090|0:37-U0.310|0:57-U0.090|0:41-U0.200|0:38-U0.390|2:30-U0.600|1:58-U0.200|1:20-U0.590|1:59-U0.220|1:25-U0.600|1:58-U0.310|2:24-U0.590|2:00-U0.300|2:30-U0.600|1:58-U0.310|2:27-U0.610|2:01-U0.390|3:12-U0.200|0:37-U0.100|0:55-U0.300|0:55-U0.100|1:02-U0.200|0:37-U0.010|0:06,,"Fröndenberg/Ruhr Track Running",,,3113,,250,3,13534174117,0,168070,250480,30378,,66541624,,,,,,,,,,,,,,,,,,,,,,,,,,,,,,,,,,,,,,,,,
85905237,7c414dfb-439f-4399-a15e-3dd8fd248141,1705433790,60,1705431188,,0,0,2.24,755,755,0,6,0,5,0,0,0,,,,153,135,140,95,140,5,53.99,31.53,53.81,1,59.02,3284,25,,1.7,0,101,99,,,,,,16,81,10.58,10.85,10.75,-0.4,-0.2,256,256,,1,262,262,,,,,,,,,"14,11,29,28,11,6,1,0,0","0,100,0,0,0","0,8,82,9,0",,,,,110,,,,,,,,,,,,,,,,,,,,,,,,,,,,,,,,,,,,19,-1,13,208,79,48,1008,0,,1,3,4,Westick,1,0,U1.000|5:38-U1.000|5:38-U0.240|1:19,,"Fröndenberg/Ruhr Running",,,3113,,250,3,13534214797,0,168070,250480,30378,,66541831,,,,,,,,,,,,,,,,,,,,,,,,,,,,,,,,,,,,,,,,,
85909453,,1705429500,60,1705433180,,0,0,,0,0,,,,,0,,,,,,,,,,,,,,,1,,,,,,,,,,,,,,0,,,,,,,,,,,,,,,,,,,,,,,,,,,,,,,,,,,,,,,,,,,,,,,,,,,,,,,,,,,,,,,,,,,,,,,,,,1,,,0,0,,,"Einlaufen ",,,connect,,,3,13534802163,0,168070,250480,30378,,66545575,,,,,,,,,,,,,,,,,,,,,,,,,,,,,,,,,,,,,,,,,
85967135,e314c34a-9464-46da-a180-b5dea5d25d76,1705494510,60,1705496441,,0,0,12.39,4317,4569,382,338,383,339,0,4.6,0.85,0.99,1.06,507,904,143,169,95,152,19,48.11,34.11,50.16,1,59,2192,105,,3.2,0,96,97,,,,,,108,81,11.33,11.33,11.51,-8.8,-2.3,265,265,,1,275,275,,,,,,,,,"33,7,12,18,14,14,2,0,0","0,32,66,1,0","0,10,66,25,0",,,,,106,,,,,,,,,,,,,,,,,,,,,,,,,,,,,,,,,,,,39.1,0,6,164,89,98,991,1,,0,7,4,Helle,1,0,U1.000|5:16-U1.000|7:53-U1.000|9:16-U1.000|6:07-U1.000|6:04-U1.000|5:59-U1.000|5:04-U1.000|4:15-U1.000|4:15-U1.000|4:36-U1.000|5:20-U1.000|5:25-U0.392|2:26,,"Balve Running",,,3113,,250,3,13543867467,0,168070,250480,30378,,66597596,,,,,,,,,,,,,,,,,,,,,,,,,,,,,,,,,,,,,,,,3,
86008270,98018b9b-fe5a-42b2-81d9-26434fc6aee2,1705517467,60,1705517952,,0,0,3.68,4056,4056,63,62,80,81,0,1.3,0.5,,,155,266,86,109,,108,28,,,,1,58.99,1834,4,,0.2,0,,100,,,,,,20,54,,3.73,,-9.5,,,,,,,,,,,,,,,,"94,6,0,0,0,0","91,9,0,0,0",,,,,,,,,,,,,,,,,,,,,,,,,,,,,,,,,,,,,,,,,,3.2,-1,7,15,92,99,988,0,,1,7,4,Balve,1,0,,,"Balve Hiking",,,3113,,250,3,13548640341,0,168075,,30378,,66636377,,,,,,,,,,,,,,,,,,,,,,,,,,,,,,,,,,,,,,,,5,
86049203,425eea90-6a75-42e5-9249-94e3d388f756,1705564232,60,1705566667,,0,0,15.41,5886,5960,383,383,389,394,0,4.1,0.88,0.97,1.12,432,1115,141,159,,149,18,43.76,31.14,45.1,1,58.97,1413,96,,3.1,0,96,90,,,,,,146,81,9.96,10.24,10.14,-1.9,3.6,234,234,,1,238,238,,,,,,,,,"52,8,11,14,12,2,0,0,0","0,38,61,0,0","0,5,92,3,0",,,,,97,,,,,,,,,,,,,,,,,,,,,,,,,,,,,,,,,,,,37.2,-4,3,320,93,98,997,0,,0,4,4,Balve,1,0,U1.000|6:33-U1.000|7:41-U1.000|7:19-U1.000|8:01-U1.000|5:54-U1.000|5:42-U1.000|5:09-U1.000|6:15-U1.000|8:44-U1.000|7:06-U1.000|6:54-U1.000|6:00-U1.000|4:58-U1.000|5:12-U1.000|4:39-U0.411|2:00,,"Balve Running",,,3113,,250,3,13554997627,0,168070,250480,30378,,66673729,,,,,,,,,,,,,,,,,,,,,,,,,,,,,,,,,,,,,,,,"4,4",
86166713,2af5fce9-9ef6-4e98-ab94-3307fa9d04ce,1705691395,60,1705691557,,0,0,7.96,1857,1857,,,,,0,,,,,,453,156,178,,178,26,69.96,52.95,69.96,1,58.97,1280,128,,3.2,1.4,,100,,,,,,65,81,,17.37,,-4.7,-27.1,412,412,,1,486,486,,,,,,,,,"1,0,3,12,25,12,22,10,16","1,4,61,33,0","1,0,12,38,49",,,,,159,,,,,,,,,,,,,,,,,,,,,,,,,,,,,,,,,,,,71.8,,,,,,,,,,1,,,1,1,U1.000|3:56-U1.000|3:50-U1.000|3:50-U1.000|4:42-U1.000|3:40-U1.000|2:49-U1.000|4:47-U0.957|3:24,,"Treadmill Running",,,3113,,250,3,13576323926,0,168070,250480,30378,,66777797,,,,,,,,,,,,,,,,,,,,,,,,,,,,,,,,,,,,,,,,,
86213005,93fd0d14-0455-42fc-8355-09638c5f2546,1705747915,60,1705750708,,0,0,16.38,5700,5936,525,515,540,523,0,5.3,0.83,1.01,1.03,623,1181,149,167,114,144,27,45.57,34.94,47.41,1,58.88,1780,153,,3.6,0,98,96,,,,,,162,83,11.24,11.15,11.55,1.3,8.6,263,263,,1,276,276,,,,,,,,,"31,14,13,14,16,10,1,0,0","0,10,82,7,0","2,10,61,26,1",,,,,104,,,,,,,,,,,,,,,,,,,,,,,,,,,,,,,,,,,,50.3,-2,10,202,81,18,1030,1,,0,2,4,Helle,1,0,U1.000|5:53-U1.000|5:58-U1.000|6:55-U1.000|6:32-U1.000|4:47-U1.000|5:20-U1.000|5:28-U1.000|6:44-U1.000|8:04-U1.000|7:13-U1.000|5:48-U1.000|5:22-U1.000|4:26-U1.000|4:40-U1.000|4:24-U1.000|5:13-U0.375|2:14,,"Balve Running",,,3113,,250,3,13584247210,0,168070,250480,30378,,66819616,,,,,,,,,,,,,,,,,,,,,,,,,,,,,,,,,,,,,,,,"3,4,4,5",
86302592,0121ad22-39b7-45cb-9ef1-1d97a373be2c,1705848800,60,1705852525,,0,0,18.53,6586,6682,534,540,568,574,0,5.2,0.84,1,1.12,502,1337,144,168,,158,22,46.51,34.41,48.15,1,58.8,1778,155,,3.6,0,93,102,,,,,,168,83,10.77,10.69,11.01,-3.9,5,253,253,,1,263,263,,,,,,,,,"35,10,12,20,16,6,0,0,0","0,36,60,3,0","0,14,71,15,0",,,,,102,,,,,,,,,,,,,,,,,,,,,,,,,,,,,,,,,,,,44.2,3,24,203,78,90,1021,0,,0,11,4,Helle,1,0,U1.000|6:22-U1.000|7:08-U1.000|5:52-U1.000|6:32-U1.000|5:12-U1.000|5:33-U1.000|5:19-U1.000|6:32-U1.000|8:07-U1.000|4:58-U1.000|5:53-U1.000|6:15-U1.000|5:50-U1.000|6:45-U1.000|5:32-U1.000|4:56-U1.000|5:18-U1.000|5:04-U0.527|2:39,,"Balve Running",,,3113,,250,3,13603624827,0,168070,250480,30378,,66899126,,,,,,,,,,,,,,,,,,,,,,,,,,,,,,,,,,,,,,,,"3,4,4,5",
86399062,66dc52fd-3757-4c32-9eab-79849265fa26,1705950773,60,1705952359,,0,0,13.29,4845,5032,354,354,374,371,0,4.3,0.76,0.98,1.14,394,935,129,153,,145,18,51.82,32.52,53.53,1,58.69,1231,93,,3,0,100,95,,,,,,91,81,10.5,10.37,10.73,-13.3,4.4,245,245,,1,254,254,,,,,,,,,"35,14,15,20,13,2,0,0,0","1,74,25,0,0","0,16,74,10,0",,,,,102,,,,,,,,,,,,,,,,,,,,,,,,,,,,,,,,,,,,30.5,6,22,242,87,82,1014,0,,1,4,4,Helle,1,0,U1.000|5:54-U1.000|6:17-U1.000|6:28-U1.000|7:32-U1.000|7:05-U1.000|6:16-U1.000|7:38-U1.000|6:15-U1.000|5:10-U1.000|4:57-U1.000|5:21-U1.000|5:01-U1.000|5:14-U0.290|1:36,,"Balve Running",,,3113,,250,3,13619420308,0,168070,250480,30378,,66983674,,,,,,,,,,,,,,,,,,,,,,,,,,,,,,,,,,,,,,,,3,
86482676,2502d0db-9a30-4d15-8c2d-507175dc5d7c,1706034530,60,1706036192,,0,0,5.49,1752,2035,41,35,57,50,0,0.3,0.27,0.94,0.86,269,348,131,147,,122,14,59.95,35.79,60.58,1,58.77,874,58,,2.5,0,102,103,,,,,,25,79,11.4,12.13,12.48,7.8,-21.2,283,283,,1,327,327,,,,,,,,,"19,2,4,15,50,4,1,2,3","3,78,19,0,0","7,8,37,43,6",,,,,119,,,,,,,,,,,,,,,,,,,,,,,,,,,,,,,,,,,,15.1,7,27,204,81,99,1021,0,,1,11,4,Westick,1,0,U1.000|4:50-U1.000|4:50-U1.000|4:50-U1.000|4:55-U1.000|5:51-U0.489|3:56,,"Fröndenberg/Ruhr Running",,,3113,,250,3,13633635656,0,168070,250480,30378,,67058506,,,,,,,,,,,,,,,,,,,,,,,,,,,,,,,,,,,,,,,,5,
86482691,e64d53a0-e642-47ba-8fbd-99a78cb0eefe,1706036581,60,1706036208,,0,0,4.69,1405,1405,0,16,0,16,0,0,0.04,,,,309,146,181,,181,48,56.37,38.23,56.13,1,58.77,1752,134,,3.1,2.1,,100,,,,,,34,81,11.99,14.58,14.56,19,-5.1,311,311,,1,391,391,,,,,,,,,"36,1,1,1,2,6,21,32,0","0,28,43,28,0","25,10,7,8,51",,,,,124,,,,,,,,,,,,,,,,,,,,,,,,,,,,,,,,,,,,45.1,7,27,204,81,99,1021,0,,1,11,4,Westick,1,0,U0.860|3:26-U0.190|1:23-U1.010|3:28-U0.190|1:39-U1.010|3:30-U0.190|1:37-U1.010|3:25-U0.230|4:57,,"Fröndenberg/Ruhr Track Running",,,3113,,250,3,13633641509,0,168070,250480,30378,,67058520,,,,,,,,,,,,,,,,,,,,,,,,,,,,,,,,,,,,,,,,,
86519811,,1706040000,60,1706089438,,0,0,4,1200,1200,,,,,0,,,,,,266,,,,,,,37.79,,1,,,,,,,,,,,,,,29,,,,,,,,,,,,,,,,,,,,,,,,,,,,,,,,,,,,,,,,,,,,,,,,,,,,,,,,,,,,,,,,,,,,,,,,,,1,,,0,0,,,Cooldown,,,connect,,,3,13641155595,0,168070,250480,30378,,67091169,,,,,,,,,,,,,,,,,,,,,,,,,,,,,,,,,,,,,,,,,
86535217,36cb614a-f9c1-467d-8a4d-4d7c15f30764,1706102140,60,1706101049,,0,0,7.54,2418,2460,139,162,155,178,0,2.3,0.67,0.97,0.98,,500,141,156,,151,23,54.29,36.28,55.33,1,58.73,1244,69,,2.7,0,98,99,,,,,,50,81,11.34,11.49,11.52,-3.3,-5.9,272,272,,1,280,280,,,,,,,,,"11,11,16,28,30,4,0,0,0","1,45,54,0,0","0,1,83,15,1",,,,,115,,,,,,,,,,,,,,,,,,,,,,,,,,,,,,,,,,,,23.2,9,30,266,78,92,1021,1,,0,11,4,Balve,1,0,U1.000|5:38-U1.000|4:46-U1.000|5:20-U1.000|5:23-U1.000|5:06-U1.000|5:49-U1.000|4:56-U0.541|3:20,,"Balve Running",,,3113,,250,3,13643508003,0,168070,250480,30378,,67104249,,,,,,,,,,,,,,,,,,,,,,,,,,,,,,,,,,,,,,,,,
86616814,ca5789ba-72f9-4e23-96be-cca865fd8330,1706193156,60,1706193404,,0,0,11.65,3739,3775,309,301,321,312,0,3.6,0.72,0.92,1,476,814,148,165,,165,15,50.82,37.39,52.53,1,58.7,1358,121,,3.3,0,103,97,,,,,,75,81,11.94,11.76,12.13,-6.4,5,286,286,,1,295,295,,,,,,,,,"17,18,12,10,26,14,2,0,0","0,18,80,3,0","0,5,59,35,1",,,,,115,,,,,,,,,,,,,,,,,,,,,,,,,,,,,,,,,,,,26.7,6,9,218,81,94,1028,0,,0,4,4,Balve,1,0,U1.000|4:56-U1.000|5:05-U1.000|6:19-U1.000|6:18-U1.000|6:13-U1.000|6:24-U1.000|4:38-U1.000|4:31-U1.000|4:39-U1.000|4:37-U1.000|4:38-U0.648|4:01,,"Balve Running",,,3113,,250,3,13659356446,0,168070,250480,30378,,67177022,,,,,,,,,,,,,,,,,,,,,,,,,,,,,,,,,,,,,,,,"4,5",
86713659,38dcbe66-93d2-4b07-9f59-66e232c19576,1706295761,60,1706294448,,0,0,7.02,2052,2052,109,124,119,136,0,1.9,0.64,0.98,0.98,507,449,145,176,106,173,31,58.65,40.3,59.62,1,58.72,1222,106,,3.1,0.7,97,101,,,,,,54,81,12.46,13.56,13.69,-7.9,-29.2,317,317,,1,366,366,,,,,,,,,"10,10,10,25,20,5,11,9,0","1,50,26,22,0","0,2,57,21,21",,,,,127,,,,,,,,,,,,,,,,,,,,,,,,,,,,,,,,,,,,65.9,4,17,289,79,78,1031,0,,1,4,4,Balve,1,0,U1.000|5:56-U1.000|4:50-U1.000|5:06-U0.791|3:54-U1.000|3:33-U1.000|3:34-U1.000|5:56-U0.230|1:23,,"Balve Running",,,3113,,250,3,13676972864,0,168070,250480,30378,,67263633,,,,,,,,,,,,,,,,,,,,,,,,,,,,,,,,,,,,,,,,5,
86744897,b77c96e9-c67c-479d-95e8-291f49310929,1706345262,60,1706343869,,0,0,7.03,2137,2179,70,87,83,102,0,1.2,0.47,0.98,1.02,,480,143,171,,161,92,56.93,38.48,57.46,1,58.68,1245,89,,3,0.3,98,98,,,,,,51,81,11.88,12.91,12.84,-6.8,-27.5,294,294,,1,331,331,,,,,,,,,"7,7,14,36,26,3,1,5,1","2,33,60,5,0","0,0,73,20,7",,,,,122,,,,,,,,,,,,,,,,,,,,,,,,,,,,,,,,,,,,37.2,0,8,206,94,35,1037,0,,0,2,4,Balve,1,0,U1.000|5:52-U1.000|5:01-U1.000|5:02-U1.000|5:03-U0.572|2:49-U0.177|0:34-U0.193|0:55-U0.183|0:37-U0.192|0:54-U0.170|0:35-U0.230|1:06-U0.176|0:34-U1.000|5:51-U0.134|0:45,,"Balve Running",,,3113,,250,3,13682746385,0,168070,250480,30378,,67290772,,,,,,,,,,,,,,,,,,,,,,,,,,,,,,,,,,,,,,,,,
86843935,873b3890-0573-4cd0-80f5-5d3b891e5b46,1706437040,60,1706441891,,0,0,4.36,1897,2127,45,19,50,25,0,0.1,0.19,0.35,0.83,200,321,125,153,129,141,29,43.24,24.28,44.11,1,58.73,874,59,,2.5,0,104,99,,,,,,29,81,9.44,11,11.32,28.1,-0.7,223,208,,1,292,289,,,,,,,,,"35,1,4,18,37,4,1,0,0","19,43,38,0,0","27,13,20,39,1",,,,,85,,,,,,,,,,,,,,,,,,,,,,,,,,,,,,,,,,,,23.6,3,7,114,68,3,1031,1,,0,2,4,Hamm,1,0,U1.000|5:04-U1.000|4:51-U1.000|4:52-U1.000|6:31-U0.358|10:21,,"Hamm Running",,,3113,,250,3,13701569928,0,168070,250480,30378,,67381577,,,,,,,,,,,,,,,,,,,,,,,,,,,,,,,,,,,,,,,,4,
86843966,6999ae6a-da46-4084-b1f0-e51bd7e94c80,1706439681,60,1706441907,,0,0,9.96,2156,2156,28,37,61,67,0,0,0.14,,,,612,174,186,,172,7,64.88,58.6,65.03,1,58.78,4320,264,,4.6,0,104,99,,,,,,105,87,16.6,16.71,16.72,8,7.9,450,450,,1,455,455,,,,,,,,,"0,0,0,0,0,2,70,28,0","1,2,7,76,14","0,0,0,2,98",,,,,159,,,,,,,,,,,,,,,,,,,,,,,,,,,,,,,,,,,,117.3,5,7,112,66,1,1030,1,,0,2,4,Hamm,1,0,U1.000|3:29-U1.000|3:31-U1.000|3:40-U1.000|3:38-U1.000|3:32-U1.000|3:39-U1.000|3:40-U1.000|3:39-U1.000|3:43-U0.946|3:23-U0.015|0:02,,"Hamm Running",,,3113,,250,3,13701577150,0,168070,250480,30378,,67381604,,,,,,,,,,,,,,,,,,,,,,10,2156,,,0,"50. Sparkassen Winterlaufserie Hamm",,,,,,,0,0,30378,86843966,19308,,,
86843975,58f84414-a041-4d1a-82bc-438564ebafeb,1706442697,60,1706441916,,0,0,3.34,1076,1099,31,6,36,12,0,0,0.25,1.09,,,240,157,171,108,166,7,46.52,34.32,47.49,1,58.78,4320,50,,2.3,0,,100,,,,,,35,82,11.44,11.29,11.62,11,13.5,288,288,,1,295,295,,,,,,,,,"4,5,18,50,22,0,0,0,0","0,5,48,47,0","0,4,59,37,0",,,,,114,,,,,,,,,,,,,,,,,,,,,,,,,,,,,,,,,,,,49.3,7,7,113,63,5,1030,1,,0,2,4,Hamm,1,0,U1.000|5:31-U1.000|5:07-U1.000|5:14-U0.340|2:05,,"Hamm Running",,,3113,,250,3,13701580456,0,168070,250480,30378,,67381612,,,,,,,,,,,,,,,,,,,,,,,,,,,,,,,,,,,,,,,,,
86865158,8fa38f4a-775a-41b5-8fe2-93c096e15ff7,1706458561,60,1706457334,,0,0,7.01,2278,2294,72,93,85,106,0,1.1,0.44,0.98,0.94,,481,142,152,,149,12,52.92,35.55,53.39,1,58.77,4325,66,,2.6,0,97,98,,,,,,50,80,11.12,11.19,11.22,-6.1,-8.5,272,272,,1,277,277,,,,,,,,,"12,8,12,46,22,1,0,0,0","0,28,71,0,0","0,1,85,14,0",,,,,115,,,,,,,,,,,,,,,,,,,,,,,,,,,,,,,,,,,,25.9,8,12,166,54,3,1028,0,,0,2,4,Balve,1,0,U1.000|6:16-U1.000|5:13-U1.000|5:16-U1.000|5:13-U1.000|4:56-U1.000|5:03-U1.000|5:56-U0.012|0:05,,"Balve Running",,,3113,,250,3,13706897033,0,168070,250480,30378,,67400979,,,,,,,,,,,,,,,,,,,,,,,,,,,,,,,,,,,,,,,,,
86938508,bb1f8c1d-8824-4685-83ec-d587d7049699,1706532084,60,1706533881,,0,0,16.49,5194,5224,391,375,413,406,0,4.3,0.72,1.05,1.1,586,1121,142,160,100,158,18,55,39.29,56.68,1,58.77,3172,142,,3.5,0,98,99,,,,,,120,81,11.88,11.85,12.24,-3.4,7.7,289,289,,1,302,302,,,,,,,,,"11,10,18,24,22,14,1,0,0","0,42,58,0,0","0,1,69,29,1",,,,,118,,,,,,,,,,,,,,,,,,,,,,,,,,,,,,,,,,,,39,9,11,193,72,76,1028,1,,0,4,4,Balve,1,0,U1.000|5:39-U1.000|4:46-U1.000|5:05-U1.000|5:11-U1.000|5:19-U1.000|5:31-U1.000|5:54-U1.000|6:48-U1.000|5:44-U1.000|5:15-U1.000|4:40-U1.000|4:21-U1.000|4:19-U1.000|4:45-U1.000|5:41-U1.000|5:09-U0.493|2:27,,"Balve Running",,,3113,,250,3,13718210788,0,168070,250480,30378,,67467836,,,,,,,,,,,,,,,,,,,,,,,,,,,,,,,,,,,,,,,,"3,5",
87059845,afcbca1d-27e5-47ab-ba44-db51f6c66010,1706639447,60,1706644473,,0,0,5.58,1581,1856,22,33,29,39,0,0,0.19,,0.97,,365,146,168,,148,30,60.38,41.25,60.53,1,58.8,1454,95,,2.8,1.3,101,100,,,,,,42,82,12.62,13.26,13.44,2.5,-16.8,325,325,,1,357,357,,,,,,,,,"10,0,3,14,37,24,3,6,3","2,19,65,14,0","1,5,16,68,10",,,,,129,,,,,,,,,,,,,,,,,,,,,,,,,,,,,,,,,,,,43.2,10,19,253,74,80,1030,0,,1,4,4,Westick,1,0,U1.000|4:53-U1.000|4:40-U1.000|4:32-U1.000|4:34-U1.000|5:21-U0.576|2:21,,"Fröndenberg/Ruhr Running",,,3113,,250,3,13740190455,0,168070,250480,30378,,67579519,,,,,,,,,,,,,,,,,,,,,,,,,,,,,,,,,,,,,,,,,
87059846,3855eaed-2500-4129-957b-175afa467708,1706641391,60,1706644476,,0,0,7.93,2375,2375,0,0,0,0,0,0,0,,,,581,158,186,,177,53,50.43,39.47,50.43,1,58.81,5760,316,,3.5,3.8,100,106,,,,,,86,81,12.01,13.89,13.89,-0.7,-7.4,314,314,,1,380,380,,,,,,,,,"42,7,6,3,2,1,7,22,10","0,29,18,49,5","6,28,21,9,36",,,,,124,,,,,,,,,,,,,,,,,,,,,,,,,,,,,,,,,,,,70.5,9,19,253,73,81,1030,0,,1,4,4,Westick,1,0,U0.400|1:16-U0.210|1:28-U0.390|1:16-U0.190|1:27-U0.400|1:17-U0.400|3:17-U0.400|1:17-U0.210|1:35-U0.400|1:16-U0.190|1:30-U0.400|1:16-U0.400|3:09-U0.400|1:16-U0.210|1:33-U0.410|1:16-U0.190|1:25-U0.410|1:19-U0.400|3:03-U0.400|1:17-U0.210|1:36-U0.400|1:19-U0.200|1:29-U0.400|1:13-U0.310|2:45,,"Fröndenberg/Ruhr Track Running",,,3113,,250,3,13740191568,0,168070,250480,30378,,67579520,,,,,,,,,,,,,,,,,,,,,,,,,,,,,,,,,,,,,,,,,
87059848,3f220388-d875-4a3a-98a5-11be532e5ec0,1706643815,60,1706644477,,0,0,3.51,1098,1445,18,4,35,19,0,0,0.12,0.99,,,233,141,172,,138,6,55.98,35.66,56.61,1,58.8,5736,65,,2.2,1.7,97,98,,,,,,26,82,11.72,12.44,12.57,9.5,16.6,299,299,,1,330,330,,,,,,,,,"14,12,23,25,8,2,4,8,4","1,59,21,19,0","0,2,63,25,10",,,,,117,,,,,,,,,,,,,,,,,,,,,,,,,,,,,,,,,,,,33.9,8,19,251,73,87,1030,0,,1,4,4,Westick,1,0,U0.091|0:19-U1.000|4:19-U1.000|5:25-U1.000|5:35-U0.418|2:41,,"Fröndenberg/Ruhr Running",,,3113,,250,3,13740191702,0,168070,250480,30378,,67579522,,,,,,,,,,,,,,,,,,,,,,,,,,,,,,,,,,,,,,,,,
87110414,abc56443-eece-4fb1-ae5e-28cb7ffd4133,1706706627,60,1706708881,,0,0,17.35,5519,5736,349,352,376,380,0,3.9,0.67,0.97,1.01,508,1182,141,163,,156,22,54.84,39,56.19,1,58.8,4618,138,,3.4,0,97,98,,,,,,119,81,11.72,11.87,11.97,-7.7,-2.4,289,289,,1,299,299,,,,,,,,,"16,11,16,22,18,13,4,0,0","0,46,53,0,0","0,1,62,36,1",,,,,116,,,,,,,,,,,,,,,,,,,,,,,,,,,,,,,,,,,,33.5,7,12,224,77,83,1032,1,,0,4,4,Balve,1,0,U1.000|5:57-U1.000|5:02-U1.000|5:27-U1.000|5:24-U1.000|5:35-U1.000|5:43-U1.000|6:02-U1.000|6:54-U1.000|6:03-U1.000|5:25-U1.000|4:29-U1.000|4:22-U1.000|4:24-U1.000|4:54-U0.262|1:14-U1.000|3:54-U1.000|4:57-U1.000|5:41-U0.091|0:32,,"Balve Running",,,3113,,250,3,13750319132,0,168070,250480,30378,,67624935,,,,,,,,,,,,,,,,,,,,,,,,,,,,,,,,,,,,,,,,"4,5,5",
87172866,9da3c32c-6c88-49e7-a9f8-de3926cd4cda,1706776157,60,1706776826,,0,0,7.02,2215,2231,74,94,90,110,0,1.3,0.48,1,1,,476,144,162,,142,16,53.87,36.82,54.38,1,58.8,3521,80,,2.9,0,96,100,,,,,,51,81,11.42,11.86,11.94,-10.8,-25.3,281,281,,1,302,302,,,,,,,,,"11,6,15,38,17,11,3,0,0","0,29,69,2,0","0,0,70,27,3",,,,,117,,,,,,,,,,,,,,,,,,,,,,,,,,,,,,,,,,,,33.2,5,14,308,92,74,1027,0,,0,4,4,Balve,1,0,U1.000|6:12-U1.000|5:16-U1.000|5:24-U1.000|5:08-U1.000|4:25-U1.000|4:40-U1.000|5:43-U0.020|0:07,,"Balve Running",,,3113,,250,3,13761855496,0,168070,250480,30378,,67676684,,,,,,,,,,,,,,,,,,,,,,,,,,,,,,,,,,,,,,,,,
87219073,39df2b1f-12ca-40f1-98e0-056893174368,1706818488,60,1706817849,,0,0,7.66,2429,2884,140,119,145,123,0,2.4,0.62,0.98,1,347,513,136,159,,143,20,57.67,36.81,59.17,1,58.8,4320,89,,3,0,98,102,,,,,,48,80,11.61,12.36,12.43,7,19.9,292,292,,1,323,323,,,,,,,,,"16,13,19,22,9,8,12,1,0","1,66,33,0,0","0,1,61,32,6",,,,,118,,,,,,,,,,,,,,,,,,,,,,,,,,,,,,,,,,,,30,4,9,256,87,74,1032,0,,1,4,4,Balve,1,0,U1.000|6:28-U1.000|5:49-U0.662|3:30-U1.000|3:48-U1.000|3:59-U1.000|5:08-U1.000|5:43-U0.993|6:04,,"Balve Running",,,3113,,250,3,13770901831,0,168070,250480,30378,,67718911,,,,,,,,,,,,,,,,,,,,,,,,,,,,,,,,,,,,,,,,5,
87268816,9e754b2d-17c6-475b-827e-380bf5b32ef9,1706884435,60,1706884927,,0,0,13.74,3968,4034,351,334,375,361,0,4.1,0.77,0.99,1.06,673,938,153,171,,169,13,55.26,42.84,57.09,1,58.8,4321,161,,3.7,0,101,100,,,,,,114,81,13.12,13.43,13.92,-7.1,4.2,330,330,,1,362,362,,,,,,,,,"6,11,18,10,14,22,16,1,0","0,3,88,9,0","0,0,27,66,7",,,,,128,,,,,,,,,,,,,,,,,,,,,,,,,,,,,,,,,,,,46.7,8,19,241,80,76,1027,0,,0,4,4,Balve,1,0,U1.000|4:11-U1.000|4:48-U1.000|5:52-U1.000|5:52-U1.000|5:38-U1.000|5:59-U1.000|4:37-U1.000|3:59-U1.000|3:54-U1.000|3:58-U1.000|4:06-U1.000|4:51-U1.000|5:14-U0.739|3:10,,"Balve Running",,,3113,,250,3,13780828080,0,168070,250480,30378,,67763839,,,,,,,,,,,,,,,,,,,,,,,,,,,,,,,,,,,,,,,,"4,4",
87270893,,1706814900,60,1706887304,,0,0,1,300,300,,,,,0,,,,,,73,,,,,,,32.99,,1,,,,,,,,,,,,,,7,,,,,,,,,,,,,,,,,,,,,,,,,,,,,,,,,,,,,,,,,,,,,,,,,,,,,,,,,,,,,,,,,,,,,,,,,,1,,,0,0,,,"missing k",,,connect,,,3,13781297842,0,168070,250480,30378,,67765739,,,,,,,,,,,,,,,,,,,,,,,,,,,,,,,,,,,,,,,,,
87323174,caacb03f-ad28-4224-b6b4-8ed650e3925d,1706952636,60,1706951370,,0,0,7.22,2281,2306,88,105,93,110,0,1.4,0.46,0.97,0.93,580,492,139,155,,148,16,56.34,36.83,57.03,1,58.8,3215,70,,2.7,0,98,100,,,,,,53,80,11.46,11.55,11.62,-4.7,-10.1,281,281,,1,288,288,,,,,,,,,"7,9,9,42,28,5,0,0,0","2,62,37,0,0","0,1,71,28,0",,,,,119,,,,,,,,,,,,,,,,,,,,,,,,,,,,,,,,,,,,30.7,7,18,251,92,97,1026,0,,0,4,4,Balve,1,0,U1.000|5:50-U1.000|5:17-U1.000|5:03-U1.000|5:01-U1.000|4:48-U1.000|4:51-U1.000|5:52-U0.222|1:18,,"Balve Running",,,3113,,250,3,13790512308,0,168070,250480,30378,,67811065,,,,,,,,,,,,,,,,,,,,,,,,,,,,,,,,,,,,,,,,5,
87375331,34790217-31ab-4f0f-a5b8-014014043fba,1706986045,60,1706985100,,0,0,6.94,2468,2468,86,82,104,103,0,2.1,0.49,1.07,0.96,560,483,139,157,109,157,18,48.69,31.92,49.47,1,58.79,3459,50,,2.3,0,95,93,,,,,,57,79,10.23,10.24,11.57,-8.1,-39.5,249,249,,1,289,289,,,,,,,,,"20,15,42,19,3,1,0,0,0","0,48,52,0,0","0,8,87,3,2",,,,,107,,,,,,,,,,,,,,,,,,,,,,,,,,,,,,,,,,,,29.1,9,18,261,90,98,1025,0,,1,9,4,Balve,1,0,U1.000|6:33-U1.000|5:32-U1.000|5:42-U1.000|5:40-U1.000|5:32-U1.000|5:48-U0.942|6:22,,"Balve Running",,,3113,,250,3,13799842470,0,168070,250480,30378,,67856130,,,,,,,,,,,,,,,,,,,,,,,,,,,,,,,,,,,,,,,,4,
87417534,5a38faa0-f975-471d-9215-b8eae534ba9e,1707041432,60,1707042120,,0,0,5.13,1788,2747,48,45,59,58,0,0.8,0.36,1.05,0.72,596,356,134,159,,157,39,52.29,32.09,52.93,1,58.8,2529,72,,2.7,0.2,102,102,,,,,,29,80,10.33,11.74,12.13,27.4,-7,255,255,,1,314,314,,,,,,,,,"28,2,5,17,39,6,1,2,1","1,57,42,0,0","12,16,35,34,4",,,,,108,,,,,,,,,,,,,,,,,,,,,,,,,,,,,,,,,,,,19.8,9,23,255,88,99,1022,0,,0,4,4,Hacheney,1,0,U1.000|4:57-U1.000|4:44-U1.000|4:45-U1.000|7:30-U1.000|7:15-U0.134|0:38,,"Dortmund Running",,,3113,,250,3,13807132844,0,168070,250480,30378,,67892207,,,,,,,,,,,,,,,,,,,,,,,,,,,,,,,,,,,,,,,,5,
87417551,4ad8ec4d-27b4-4b12-9665-6ff658a76520,1707044416,60,1707042130,,0,0,5.06,1052,1052,13,22,15,23,0,0,0.04,,,,304,165,179,,167,11,74.19,58.93,74.27,1,58.8,4320,161,,3.6,0.2,105,105,,,,,,40,87,17.24,17.49,17.49,12.4,15.6,465,465,,1,475,475,,,,,,,,,"0,0,0,0,0,1,37,58,3","1,3,28,69,0","0,0,0,0,100",,,,,166,,,,,,,,,,,,,,,,,,,,,,,,,,,,,,,,,,,,68,9,23,255,89,99,1021,1,,0,6,4,Hacheney,1,0,U1.000|3:19-U1.000|3:26-U1.000|3:30-U1.000|3:41-U1.000|3:23-U0.059|0:12,,"Dortmund Running",,,3113,,250,3,13807136438,0,168070,250480,30378,,67892223,,,,,,,,,,,,,,,,,,,,,,,,,,,,,,,,,,,,,,,,,
87420320,c54edd1d-68d7-4239-b1fb-5f7bf592eeca,1707046070,60,1707044272,,0,0,5.27,1614,1614,72,50,86,65,0,1,0.32,1.15,0.92,1215,359,146,165,,165,14,54.85,37.5,56.06,1,58.8,4322,70,,2.7,0,97,100,,,,,,40,81,11.91,11.88,12.41,1.9,-3.2,297,297,,1,317,317,,,,,,,,,"0,2,12,56,26,2,1,0,0","0,12,87,1,0","0,0,64,32,5",,,,,121,,,,,,,,,,,,,,,,,,,,,,,,,,,,,,,,,,,,32,10,23,254,90,99,1021,1,,0,6,4,Hacheney,1,0,U1.000|5:10-U1.000|5:03-U1.000|5:08-U1.000|5:06-U1.000|5:06-U0.265|1:22,,"Dortmund Running",,,3113,,250,3,13807870537,0,168070,250480,30378,,67894766,,,,,,,,,,,,,,,,,,,,,,,,,,,,,,,,,,,,,,,,"5,5",
87449820,18d71628-7611-4bbb-9488-2d29f4340c7a,1707063051,60,1707061701,,0,0,7.09,1896,1896,75,105,85,116,0,1.2,0.47,0.86,0.95,,459,161,188,,173,25,56.4,44.79,56.84,1,58.8,4320,145,,3.5,0.1,102,100,,,,,,70,82,13.59,14.74,14.4,-6.1,-13.9,340,340,,1,371,371,,,,,,,,,"9,7,13,10,5,20,20,16,0","0,6,42,47,5","0,0,40,26,33",,,,,137,,,,,,,,,,,,,,,,,,,,,,,,,,,,,,,,,,,,91.2,10,23,264,88,99,1020,0,,0,4,4,Balve,1,0,U1.000|5:44-U1.000|4:30-U1.000|4:11-U1.000|3:35-U1.000|3:27-U1.000|3:31-U1.000|6:08-U0.090|0:31,,"Balve Running",,,3113,,250,3,13813428879,0,168070,250480,30378,,67921368,,,,,,,,,,,,,,,,,,,,,,,,,,,,,,,,,,,,,,,,,
87556551,4b021a02-d7fc-417b-814f-50c75b116cd1,1707158239,60,1707160050,,0,0,15.18,5131,5260,224,206,251,232,0,2,0.48,1.02,0.97,306,1042,134,151,,148,20,54.3,35.93,55.37,1,58.79,2679,101,,3.1,0,97,98,,,,,,89,80,10.8,10.78,11.02,-11.4,-12,266,266,,1,274,274,,,,,,,,,"10,13,37,28,12,1,0,0,0","0,85,15,0,0","0,2,81,16,0",,,,,111,,,,,,,,,,,,,,,,,,,,,,,,,,,,,,,,,,,,18.9,7,24,246,81,84,1018,0,,1,4,4,Balve,1,0,U1.000|6:14-U1.000|5:31-U1.000|5:47-U1.000|5:43-U1.000|5:54-U1.000|5:47-U1.000|5:54-U1.000|5:12-U1.000|5:05-U1.000|5:05-U1.000|5:19-U1.000|5:32-U1.000|5:17-U1.000|5:38-U1.000|6:28-U0.176|1:05,,"Balve Running",,,3113,,250,3,13829836018,0,168070,250480,30378,,68016636,,,,,,,,,,,,,,,,,,,,,,,,,,,,,,,,,,,,,,,,"4,5,5",
87697864,879aaba3-0a2b-48f9-aeed-9fc79ad90d92,1707246309,60,1707246947,,0,0,9.13,2525,2525,0,0,0,0,0,0,0,,,,638,153,177,110,176,43,58.29,43.74,58.29,1,58.79,2449,215,,3.7,2.4,97,100,,,,,,76,84,13.01,14.39,14.39,9,-5,345,344,,1,393,392,,,,,,,,,"35,4,4,2,2,7,18,18,10","0,20,50,30,0","3,20,21,10,46",,,,,129,,,,,,,,,,,,,,,,,,,,,,,,,,,,,,,,,,,,55,10,32,237,82,99,1007,0,,1,11,4,Westick,1,0,U1.010|3:35-U0.990|3:36-U0.400|2:41-U0.400|1:21-U0.110|0:43-U0.390|1:24-U0.410|2:55-U0.190|0:39-U0.090|0:38-U0.210|0:38-U0.090|0:45-U0.200|0:37-U0.110|0:49-U0.190|0:37-U0.400|3:11-U0.310|0:58-U0.090|0:48-U0.310|0:55-U0.100|0:48-U0.300|0:57-U0.100|0:49-U0.310|0:58-U0.090|0:43-U0.310|0:58-U0.090|0:47-U0.310|0:56-U0.400|3:23-U1.200|4:11-U0.020|0:44,,"Fröndenberg/Ruhr Track Running",,,3113,,250,3,13845325367,0,168070,250480,30378,,68142826,,,,,,,,,,,,,,,,,,,,,,,,,,,,,,,,,,,,,,,,,
87730188,,1707244200,60,1707260171,,0,0,9,2700,2700,,,,,0,,,,,,615,,,,,,,39.72,,1,,,,,,,,,,,,,,61,,,,,,,,,,,,,,,,,,,,,,,,,,,,,,,,,,,,,,,,,,,,,,,,,,,,,,,,,,,,,,,,,,,,,,,,,,1,,,0,0,,,"Wu cd ",,,connect,,,3,13848109420,0,168070,250480,30378,,68172158,,,,,,,,,,,,,,,,,,,,,,,,,,,,,,,,,,,,,,,,,
87804242,b0aff0f1-7aa6-45e2-9795-b20eb490c65c,1707321619,60,1707322219,,0,0,14.91,4106,4112,175,157,199,182,0,1.7,0.33,1.02,0.98,912,1006,152,177,,171,21,59.15,45.56,60.09,1,58.81,3744,219,,4.2,0,101,101,,,,,,124,81,13.26,13.28,13.68,0.5,-6.1,342,342,,1,357,357,,,,,,,,,"3,3,5,8,30,43,8,0,0","1,9,74,16,0","0,0,15,79,7",,,,,134,,,,,,,,,,,,,,,,,,,,,,,,,,,,,,,,,,,,67.6,4,3,73,88,99,1005,0,,0,4,4,Balve,1,0,U1.000|5:28-U1.000|4:30-U1.000|4:51-U1.000|4:40-U1.000|4:40-U1.000|4:28-U1.000|4:33-U1.000|4:26-U1.000|4:22-U1.000|4:38-U1.000|4:21-U1.000|4:15-U1.000|4:02-U1.000|3:54-U0.914|5:20,,"Balve Running",,,3113,,250,3,13857705583,0,168070,250480,30378,,68238409,,,,,,,,,,,,,,,,,,,,,,,,,,,,,,,,,,,,,,,,"4,5",
87913002,9d07c1e5-4dbd-4771-90cb-aafcc3f0c44e,1707419550,60,1707421750,,0,0,16.01,5246,5469,338,338,340,347,0,3.9,0.76,0.92,1.02,483,1075,142,167,108,156,26,52.38,37.42,53.75,1,58.81,2450,120,,3.3,0.1,95,102,,,,,,133,80,11.51,11.97,11.88,-8.9,-10,279,279,,1,293,293,,,,,,,,,"29,15,9,13,15,10,10,0,0","0,42,49,8,0","0,2,73,23,1",,,,,114,,,,,,,,,,,,,,,,,,,,,,,,,,,,,,,,,,,,54.6,9,15,219,94,99,993,0,,1,4,4,,1,0,U1.000|6:35-U1.000|6:56-U1.000|6:30-U1.000|6:48-U1.000|5:35-U1.000|5:02-U1.000|4:55-U1.000|5:42-U1.000|7:21-U1.000|5:58-U1.000|4:57-U1.000|4:44-U1.000|4:19-U1.000|3:50-U1.000|3:59-U1.000|4:12-U0.014|0:04,,"Balve Running",,,3113,,250,3,13875615671,0,168070,250480,30378,,68335166,,,,,,,,,,,,,,,,,,,,,,,,,,,,,,,,,,,,,,,,"4,4",
87971955,cca4cb82-e76e-4310-a738-fb5371c7e366,1707489816,60,1707489887,,0,0,9.58,3263,3364,165,155,179,169,0,2.6,0.57,1.05,1.06,565,654,138,160,116,160,23,51.83,34.35,53,1,58.77,1361,67,,2.7,0,94,102,,,,,,68,80,10.83,10.81,11.32,-2.8,-13.4,265,265,,1,283,283,,,,,,,,,"18,16,26,23,12,5,0,0,0","1,58,41,0,0","0,5,78,15,1",,,,,110,,,,,,,,,,,,,,,,,,,,,,,,,,,,,,,,,,,,30.3,11,17,208,87,97,987,1,,0,4,4,Balve,1,0,U1.000|5:55-U1.000|6:09-U1.000|5:42-U1.000|5:17-U1.000|5:46-U1.000|5:23-U1.000|5:44-U1.000|6:04-U1.000|4:47-U0.577|3:37,,"Balve Running",,,3113,,250,3,13885328566,0,168070,250480,30378,,68382950,,,,,,,,,,,,,,,,,,,,,,,,,,,,,,,,,,,,,,,,"4,5",
88038251,eaf82d5d-91f5-4d7e-9e5b-dc17c6f6d075,1707556153,60,1707561611,,0,0,23.62,6556,7478,161,143,186,170,0,0.1,0.2,1.13,0.99,295,1569,152,168,,162,27,58.57,46.83,59.12,1,58.77,3168,252,,4.5,0.1,100,100,,,,,,146,81,13.05,13.17,13.31,-0.1,-3.1,336,336,,1,346,346,,,,,,,,,"2,1,3,12,43,32,7,0,0","0,10,79,11,0","0,1,15,79,6",,,,,133,,,,,,,,,,,,,,,,,,,,,,,,,,,,,,,,,,,,35.1,9,9,164,91,91,989,0,,0,4,4,"Sundern (Sauerland)",1,0,U1.000|4:29-U1.000|4:23-U1.000|4:29-U1.000|4:40-U1.000|4:39-U1.000|4:34-U1.000|4:24-U1.000|4:21-U1.000|4:20-U1.000|4:24-U1.000|4:51-U1.000|4:38-U1.000|4:38-U1.000|4:29-U1.000|4:35-U1.000|4:28-U1.000|3:51-U1.000|4:36-U1.000|4:55-U1.000|4:53-U1.000|5:18-U1.000|4:57-U1.000|5:12-U0.619|3:09,,"Sundern (Sauerland) Running",,,3113,,250,3,13896195933,0,168070,250480,30378,,68440991,,,,,,,,,,,,,,,,,,,,,,,,,,,,,,,,,,,,,,,,"5,5",
88070119,65250fff-07e3-4c50-9a3c-d4346ccb469e,1707585034,60,1707583831,,0,0,7.02,2201,2201,73,91,81,101,0,0.9,0.39,0.93,0.97,529,464,142,166,,151,20,55.31,37.1,55.84,1,58.78,4320,80,,2.9,0,96,104,,,,,,36,80,11.53,11.97,12.03,-10.2,-23.9,280,280,,1,301,301,,,,,,,,,"12,11,13,33,9,18,4,1,0","0,40,58,1,0","0,4,67,24,5",,,,,120,,,,,,,,,,,,,,,,,,,,,,,,,,,,,,,,,,,,21.4,10,5,104,88,98,987,0,,0,4,4,Balve,1,0,U1.000|6:24-U1.000|5:21-U1.000|5:13-U0.790|4:12-U1.000|4:10-U1.000|4:17-U1.000|5:44-U0.232|1:21,,"Balve Running",,,3113,,250,3,13902444047,0,168070,250480,30378,,68468381,,,,,,,,,,,,,,,,,,,,,,,,,,,,,,,,,,,,,,,,5,
88110741,132b4137-5494-4aa1-a946-4041e1173f2f,1707628890,60,1707628696,,0,0,8.58,3064,3064,106,112,116,123,0,1.2,0.56,0.95,1.05,,592,136,153,,147,20,49.81,32.22,50.53,1,58.77,3576,54,,2.4,0,96,95,,,,,,59,80,10.15,10.2,10.24,2.4,0.8,247,247,,1,251,251,,,,,,,,,"22,23,30,22,3,0,0,0,0","0,65,35,0,0","0,2,95,3,0",,,,,105,,,,,,,,,,,,,,,,,,,,,,,,,,,,,,,,,,,,25.7,8,10,194,93,93,988,0,,1,4,4,Balve,1,0,U1.000|6:22-U1.000|5:34-U1.000|6:03-U1.000|6:12-U1.000|5:52-U1.000|5:37-U1.000|5:37-U1.000|5:47-U0.577|3:59,,"Balve Running",,,3113,,250,3,13908233333,0,168070,250480,30378,,68503008,,,,,,,,,,,,,,,,,,,,,,,,,,,,,,,,,,,,,,,,,
88207189,935792d7-e229-447b-a464-182fa5c87661,1707735352,330,1707722536,,0,0,0.45,826,826,9,12,4,9,0,0,0.1,,,,45,78,91,,90,17,,,,1,58.77,2112,1,,,0,,100,,,,,,2,55,,3.54,,70.6,,,,,,,,,,,,,,,,"94,6,0,0,0,0","100,0,0,0,0",,,,,,,,,,,,,,,,,,,,,,,,,,,,,,,,,,,,,,,,,,0.6,27,16,100,33,40,1018,8,,0,3,4,Kengeri,1,0,,,"Bengaluru Hiking",,,3113,,250,3,13924251804,0,168075,,30378,,68588416,,,,,,,,,,,,,,,,,,,,,,,,,,,,,,,,,,,,,,,,,
88225166,a35f28d9-59dd-46c0-aad5-730b15d34857,1707760219,330,1707743829,,0,0,11.3,3223,3344,162,139,170,146,0,1.7,0.57,0.99,1.03,,751,153,169,,164,16,56.11,42.82,57.25,1,58.64,4032,150,,3.6,0,106,99,,,,,,97,80,12.86,12.85,13.06,7.6,10.1,324,324,,1,332,332,,,,,,,,,"2,1,8,20,36,27,5,1,0","0,8,72,19,0","0,1,25,70,5",,,,,131,,,,,,,,,,,,,,,,,,,,,,,,,,,,,,,,,,,,47.9,27,16,101,33,13,1014,0,,1,2,4,Kengeri,1,0,U1.000|4:38-U1.000|4:23-U1.000|4:48-U1.000|4:36-U1.000|4:30-U1.000|4:35-U1.000|4:44-U1.000|5:13-U1.000|5:23-U1.000|4:29-U1.000|4:54-U0.302|1:32,,"Bengaluru Running",,,3113,,250,3,13927960998,0,168070,250480,30378,,68604310,,,,,,,,,,,,,,,,,,,,,,,,,,,,,,,,,,,,,,,,,
88303879,78d711ce-651d-4402-8701-11f57f90c3a8,1707815086,330,1707822775,,0,0,11.29,3298,3563,164,121,175,131,0,1.6,0.5,0.96,0.99,392,782,158,181,,170,12,52.01,41.64,53.19,1,57.6,4034,169,,3.7,0.3,102,99,,,,,,116,81,12.63,12.88,13.02,12.3,16.3,317,317,,1,333,333,,,,,,,,,"5,5,11,21,31,17,5,3,1","0,5,48,47,0","0,1,40,53,5",,,,,127,,,,,,,,,,,,,,,,,,,,,,,,,,,,,,,,,,,,85.7,21,11,105,62,31,1019,4,,0,2,4,Kengeri,1,0,U1.000|4:45-U1.000|4:20-U1.000|4:55-U1.000|4:51-U1.000|4:47-U1.000|4:37-U1.000|4:53-U1.000|5:33-U1.000|5:26-U1.000|4:23-U1.000|5:05-U0.291|1:21,,"Bengaluru Running",,,3113,,250,3,13941282820,0,168070,250480,30378,,68675692,,,,,,,,,,,,,,,,,,,,,,,,,,,,,,,,,,,,,,,,"5,5",
88373364,9822383c-877c-42df-adb5-4a3e59e2383b,1707901175,330,1707883490,,0,0,5.4,1633,1710,76,60,79,68,0,1.2,0.5,0.98,1.09,,365,149,169,116,150,13,54.18,38.12,55.33,1,57.35,2627,82,,2.9,0,103,99,,,,,,47,80,12.14,12.33,12.41,2.2,4.7,302,302,,1,313,313,,,,,,,,,"13,5,11,25,23,13,6,4,1","0,19,67,14,0","0,6,44,46,4",,,,,124,,,,,,,,,,,,,,,,,,,,,,,,,,,,,,,,,,,,44.8,22,12,105,72,39,1018,3,,0,3,4,Kengeri,1,0,U1.000|5:25-U1.000|4:37-U1.000|5:31-U1.000|4:24-U1.000|5:16-U0.395|2:00,,"Bengaluru Running",,,3113,,250,3,13953515052,0,168070,250480,30378,,68734699,,,,,,,,,,,,,,,,,,,,,,,,,,,,,,,,,,,,,,,,,
88540980,b18e08a3-4f3b-428a-a285-3ff1240bbf10,1708021791,330,1708012042,,0,0,2.06,626,679,19,7,23,12,0,0,0.19,1.07,,,125,129,145,,136,4,64.88,35.24,66.09,1,57.35,641,24,,1.7,0,,100,,,,,,11,80,12.07,11.88,12.18,8.3,3.6,302,302,,1,308,308,,,,,,,,,"8,5,14,26,26,16,3,1,0","2,93,5,0,0","0,1,43,56,0",,,,,123,,,,,,,,,,,,,,,,,,,,,,,,,,,,,,,,,,,,14.4,25,15,96,36,67,1013,0,,1,4,4,Kengeri,1,0,U1.000|4:56-U1.000|5:18-U0.057|0:12,,"Bengaluru Running",,,3113,,250,3,13975385011,0,168070,250480,30378,,68878506,,,,,,,,,,,,,,,,,,,,,,,,,,,,,,,,,,,,,,,,,
88597420,5b5eb642-f23c-4c61-b955-b0fd24845ccf,1708070789,330,1708054967,,0,0,10.76,3199,3606,142,130,163,156,0,1.2,0.46,1.12,0.87,,691,147,178,108,175,48,56.37,40.65,57.37,1,57.93,1381,177,,3.3,2.5,104,100,,,,,,85,80,12.21,13.27,13.79,11.3,-3.6,309,309,,1,368,368,,,,,,,,,"15,4,8,22,19,12,12,8,1","1,35,44,20,0","5,7,39,29,20",,,,,126,,,,,,,,,,,,,,,,,,,,,,,,,,,,,,,,,,,,58.4,19,16,100,71,45,1018,3,,0,3,4,"Jnana Bharathi",1,0,U1.000|4:45-U1.000|4:49-U1.000|5:19-U1.000|4:45-U1.000|4:43-U0.158|1:04-U0.818|4:06-U0.588|2:01-U0.163|1:18-U0.602|2:16-U0.637|3:58-U0.586|2:05-U0.127|1:33-U0.594|2:12-U0.099|1:08-U0.590|2:04-U0.797|5:14,,"Bengaluru Running",,,3113,,250,3,13983074678,0,168070,250480,30378,,68928168,,,,,,,,,,,,,,,,,,,,,,,,,,,,,,,,,,,,,,,,,
88687700,91285e1a-874c-4e5f-b93b-2b3ed91a9496,1708153159,330,1708137147,,0,0,11.47,3438,3501,167,163,175,176,0,1.7,0.54,0.99,1.05,260,775,151,167,,167,12,53.77,40.46,54.76,1,58.51,1464,139,,3.5,0,102,99,,,,,,96,80,12.19,12.35,12.51,4.8,7.8,301,301,,1,316,316,,,,,,,,,"6,5,15,23,27,18,4,1,0","0,6,88,6,0","0,1,49,48,2",,,,,125,,,,,,,,,,,,,,,,,,,,,,,,,,,,,,,,,,,,40.9,15,9,90,75,17,1016,0,,0,2,4,Kengeri,1,0,U1.000|4:51-U1.000|4:41-U1.000|5:09-U1.000|4:53-U1.000|4:57-U0.110|0:33-U1.000|4:12-U1.000|4:54-U1.000|5:33-U1.000|5:36-U1.000|4:32-U1.000|5:19-U0.355|2:05,,"Bengaluru Running",,,3113,,250,3,13996747607,0,168070,250480,30378,,69007823,,,,,,,,,,,,,,,,,,,,,,,,,,,,,,,,,,,,,,,,5,
88777503,5d3bb8d0-3bb6-4b4d-a74d-569733371986,1708242614,330,1708226123,,0,0,4.14,1297,1336,15,32,17,34,0,0,0.15,,1.05,,272,140,170,,170,29,56.4,35.98,56.37,1,58.68,770,58,,2.3,0.6,100,100,,,,,,28,80,11.37,12.08,11.95,-3,-16.2,277,277,,1,300,300,,,,,,,,,"12,12,18,24,21,6,3,3,1","0,62,32,7,0","0,4,72,20,4",,,,,120,,,,,,,,,,,,,,,,,,,,,,,,,,,,,,,,,,,,28.7,20,6,103,67,38,1016,2,,0,3,4,Kengeri,1,0,U1.000|5:12-U1.000|5:42-U0.392|2:10-U0.468|1:43-U1.000|5:23-U0.277|1:27,,"Bengaluru Running",,,3113,,250,3,14012578356,0,168070,250480,30378,,69088456,,,,,,,,,,,,,,,,,,,,,,,,,,,,,,,,,,,,,,,,,
89111845,25b29ca5-0ee7-4f22-9a23-f7561eb9c113,1708514433,330,1708522997,,0,0,6.22,1792,1858,16,10,49,40,0,0,0.04,,,,428,156,167,,162,7,53.9,40.7,54.13,1,58.71,1383,107,,3.2,0,101,98,,,,,,55,81,12.53,12.55,12.58,6,7.7,315,315,,1,317,317,,,,,,,,,"1,0,2,14,64,18,0,0,0","0,4,80,16,0","0,0,17,83,0",,,,,129,,,,,,,,,,,,,,,,,,,,,,,,,,,,,,,,,,,,47.7,31,4,11,44,13,1013,11,,0,2,4,Karapura,1,0,U1.000|4:32-U1.000|4:35-U1.000|4:56-U1.000|5:06-U1.000|4:56-U1.000|4:44-U0.217|1:03,,"Heggadadevankote Running",,,3113,,250,3,14065691572,0,168070,250480,30378,,69389026,,,,,,,,,,,,,,,,,,,,,,,,,,,,,,,,,,,,,,,,,
89161439,905046e4-5f7f-4593-b44d-5a259e4844a8,1708588285,330,1708572967,,0,0,12.59,3417,3685,101,96,119,115,0,0.1,0.3,1.01,1.01,,826,155,176,,169,12,58.56,45.74,59.17,1,58.77,2230,193,,4,0,103,100,,,,,,78,81,13.36,13.42,13.45,4.3,3.8,339,339,,1,342,342,,,,,,,,,"1,1,1,9,40,39,9,0,0","1,7,54,38,0","0,0,8,91,1",,,,,136,,,,,,,,,,,,,,,,,,,,,,,,,,,,,,,,,,,,45.4,23,3,249,68,53,1016,2,,0,3,4,Karapura,1,0,U1.000|4:54-U1.000|4:49-U1.000|4:55-U1.000|4:20-U1.000|4:28-U1.000|4:49-U1.000|4:40-U1.000|4:28-U1.000|4:14-U1.000|4:09-U1.000|4:15-U1.000|4:14-U0.592|2:44,,"Heggadadevankote Running",,,3113,,250,3,14075298658,0,168070,250480,30378,,69434576,,,,,,,,,,,,,,,,,,,,,,,,,,,,,,,,,,,,,,,,,
89247624,,1708663189,60,1708659896,,0,0,4,1200,1200,,,,,0,,,,,,268,,,,,,,37.79,,1,,,,,,,,,,,,,,6,,,,,,,,,,,,,,,,,,,,,,,,,,,,,,,,,,,,,,,,,,,,,,,,,,,,,,,,,,,,,,,,,,,,,,,,,,1,,,0,0,,,Bangalore,,,connect,,,3,14089442468,0,168070,250480,30378,,69513610,,,,,,,,,,,,,,,,,,,,,,,,,,,,,,,,,,,,,,,,,
89373474,832bc6ae-cb51-4daa-8c2f-e842e2a9bd5b,1708793658,60,1708792613,,0,0,5.01,1600,1606,48,73,54,81,0,0.7,0.41,0.97,1.07,,339,138,161,,161,18,56.12,35.57,56.43,1,58.77,885,54,,2.4,0,97,100,,,,,,28,79,11.26,11.51,11.35,-8.6,-9.5,271,271,,1,275,275,,,,,,,,,"5,11,29,24,26,6,1,0,0","1,54,46,0,0","0,1,83,16,0",,,,,119,,,,,,,,,,,,,,,,,,,,,,,,,,,,,,,,,,,,16.3,5,16,199,77,77,1003,0,,0,4,4,Balve,1,0,U1.000|5:56-U1.000|5:34-U1.000|5:18-U1.000|4:55-U1.000|4:55-U0.009|0:03,,"Balve Running",,,3113,,250,3,14112820532,0,168070,250480,30378,,69625999,,,,,,,,,,,,,,,,,,,,,,,,,,,,,,,,,,,,,,,,,
89430100,de915da4-0a7f-4da2-850c-3364d88d5dd9,1708852117,60,1708858366,,0,0,15.18,4102,4340,100,113,127,139,0,0.2,0.23,1.25,0.84,790,988,154,177,123,175,27,59.43,46.63,59.85,1,58.77,2911,283,,4.4,2.1,101,100,,,,,,118,82,13.3,14.4,14.63,11.3,10.1,340,340,,1,389,389,,,,,,,,,"3,2,8,23,27,4,20,11,0","0,3,76,20,0","0,1,40,29,30",,,,,135,,,,,,,,,,,,,,,,,,,,,,,,,,,,,,,,,,,,51.8,4,18,197,83,75,1003,1,,0,4,4,"Sundern (Sauerland)",1,0,U1.000|4:44-U1.000|4:41-U1.000|4:46-U1.000|3:39-U0.222|1:10-U1.000|3:37-U0.196|1:13-U1.000|3:37-U0.207|1:08-U1.000|3:37-U0.198|1:13-U1.000|3:40-U0.208|1:13-U1.000|3:31-U1.000|5:51-U0.349|1:15-U1.000|5:13-U1.000|5:11-U1.000|4:57-U0.800|4:05,,"Sundern (Sauerland) Running",,,3113,,250,3,14122414408,0,168070,250480,30378,,69674899,,,,,,,,,,,,,,,,,,,,,,,,,,,,,,,,,,,,,,,,5,
89471732,41219b45-07c9-45c5-9d0a-588bafc31ec7,1708879491,60,1708880225,,0,0,8.88,2530,2629,90,133,112,156,0,1.4,0.56,0.91,0.91,444,586,146,172,107,156,22,59.97,42.16,60.36,1,58.78,4320,142,,3.4,0.9,100,103,,,,,,57,81,12.61,13.85,13.71,1.2,-3.4,313,313,,1,356,356,,,,,,,,,"9,7,12,15,26,7,12,11,1","0,32,60,8,0","0,4,55,21,21",,,,,130,,,,,,,,,,,,,,,,,,,,,,,,,,,,,,,,,,,,37.4,6,11,180,74,21,1002,0,,0,2,4,Balve,1,0,U1.000|6:20-U1.000|4:46-U1.000|4:51-U0.753|3:45-U1.000|3:27-U1.000|3:37-U0.875|5:09-U0.291|1:00-U0.116|0:40-U0.274|1:01-U0.135|0:46-U0.321|1:05-U1.000|5:09-U0.119|0:35,,"Balve Running",,,3113,,250,3,14129378442,0,168070,250480,30378,,69712639,,,,,,,,,,,,,,,,,,,,,,,,,,,,,,,,,,,,,,,,5,
89525684,e9c7f259-1cc3-498b-a326-5f077e355cb4,1708952053,60,1708953351,,0,0,13.63,4271,4600,322,325,334,337,0,3.6,0.74,0.97,1.04,545,922,145,160,117,160,20,53.83,38.93,55.38,1,58.78,3171,131,,3.4,0,101,99,,,,,,22,81,11.99,12.02,12.14,-4.2,5,288,288,,1,294,294,,,,,,,,,"14,15,15,13,18,22,3,0,0","0,28,72,0,0","0,3,56,42,0",,,,,118,,,,,,,,,,,,,,,,,,,,,,,,,,,,,,,,,,,,4.6,6,11,56,87,98,1004,1,,0,6,4,Balve,1,0,U1.000|5:09-U1.000|5:00-U1.000|6:03-U1.000|6:13-U1.000|5:55-U1.000|6:09-U1.000|4:44-U1.000|4:24-U1.000|4:14-U1.000|4:13-U1.000|4:29-U1.000|5:27-U1.000|6:10-U0.625|3:00,,"Balve Running",,,3113,,250,3,14139729976,0,168070,250480,30378,,69757616,,,,,,,,,,,,,,,,,,,,,,,,,,,,,,,,,,,,,,,,"4,4",
89644466,7a0213c9-f2c4-4bd5-b4ae-8ea392b16e61,1709058647,60,1709060814,,0,0,5.79,1816,2212,28,37,28,37,0,0,0.18,1.31,1.03,,374,139,155,,147,27,56.85,36.65,57.08,1,58.82,1454,72,,2.7,0,103,102,,,,,,42,78,11.46,12.75,12.91,10.6,-24.4,286,286,,1,343,343,,,,,,,,,"25,4,1,9,36,19,1,1,3","1,37,62,0,0","4,14,24,55,4",,,,,123,,,,,,,,,,,,,,,,,,,,,,,,,,,,,,,,,,,,32.3,5,6,21,82,51,1018,0,,1,3,4,Westick,1,0,U1.000|4:49-U1.000|4:37-U1.000|4:36-U1.000|4:35-U1.000|6:13-U0.789|5:26,,"Fröndenberg/Ruhr Running",,,3113,,250,3,14160734529,0,168070,250480,30378,,69863883,,,,,,,,,,,,,,,,,,,,,,,,,,,,,,,,,,,,,,,,,
89644490,114ff585-eacc-4b22-a8f2-fb32b4559552,1709060915,60,1709060842,,0,0,6.64,2093,2093,0,0,0,0,0,0,0,,,,446,142,167,,158,34,54.95,36.74,54.95,1,58.82,2980,153,,3.1,2.4,,100,,,,,,52,79,11.43,13.76,13.76,11.4,1.1,295,295,,1,373,373,,,,,,,,,"49,5,3,1,1,3,11,21,7","0,48,44,8,0","18,23,16,5,38",,,,,120,,,,,,,,,,,,,,,,,,,,,,,,,,,,,,,,,,,,34.3,5,5,30,83,52,1018,0,,1,3,4,Westick,1,0,U1.000|3:25-U0.180|1:38-U0.220|0:35-U0.590|4:39-U1.010|3:25-U0.180|1:48-U0.220|0:38-U0.590|5:03-U1.010|3:25-U0.190|1:59-U0.210|0:37-U0.590|4:58-U0.610|2:04-U0.040|0:40,,"Fröndenberg/Ruhr Track Running",,,3113,,250,3,14160743182,0,168070,250480,30378,,69863904,,,,,,,,,,,,,,,,,,,,,,,,,,,,,,,,,,,,,,,,,
89644501,f98cbe8f-38d3-4867-89b2-f9339a9877fb,1709063199,60,1709060847,,0,0,2.34,864,879,4,9,6,11,0,0,0,,,,160,131,139,,139,6,50.08,28.44,50.05,1,58.82,2963,23,,1.6,0,,100,,,,,,16,79,9.66,9.84,9.83,-5.6,-7.6,231,231,,1,237,237,,,,,,,,,"31,25,27,16,1,0,0,0,0","0,100,0,0,0","0,18,81,0,0",,,,,103,,,,,,,,,,,,,,,,,,,,,,,,,,,,,,,,,,,,14.8,4,5,30,83,52,1018,0,,1,3,4,Westick,1,0,U1.000|6:22-U1.000|5:54-U0.336|2:07,,"Fröndenberg/Ruhr Running",,,3113,,250,3,14160745292,0,168070,250480,30378,,69863914,,,,,,,,,,,,,,,,,,,,,,,,,,,,,,,,,,,,,,,,,
89783091,37c7fc41-9f0e-446b-8637-2b2b7448ea88,1709107452,60,1709218082,,0,0,14.66,4327,4353,318,295,333,311,0,3.4,0.64,0.9,0.99,458,998,149,173,,168,27,55.83,41.98,57.44,1,58.81,3463,175,,3.8,0,101,99,,,,,,19,82,12.82,13.11,13.12,-12.5,-14.2,314,314,,1,327,327,,,,,,,,,"10,13,17,11,11,21,16,1,0","0,16,77,7,0","0,1,38,53,8",,,,,124,,,,,,,,,,,,,,,,,,,,,,,,,,,,,,,,,,,,6.6,0,5,200,93,73,1022,0,,0,4,4,Balve,1,0,U1.000|5:04-U1.000|5:09-U1.000|6:17-U1.000|6:05-U1.000|6:00-U1.000|6:03-U1.000|4:50-U1.000|4:15-U1.000|4:00-U1.000|3:59-U1.000|4:08-U0.438|1:49-U1.000|3:42-U1.000|3:51-U1.000|5:39-U0.224|1:16,,"Balve Running",,,3113,,250,3,14187315558,0,168070,250480,30378,,69987370,,,,,,,,,,,,,,,,,,,,,,,,,,,,,,,,,,,,,,,,"4,5",
89783092,d3188f91-6db7-4ff4-be0e-53deb70f5615,1709216976,60,1709218082,,0,0,14.83,4285,4599,207,163,238,198,0,1.9,0.38,1.02,0.92,404,801,112,171,,153,34,80.99,43.07,82.71,1,58.81,2821,112,,3.2,0,100,101,,,,,,48,80,12.67,12.65,13.06,31.6,32.4,317,317,,1,332,332,,,,,,,,,"3,3,7,17,43,23,3,0,0","50,14,24,13,0","0,0,35,59,6",,,,,130,,,,,,,,,,,,,,,29,,,,,,,,,,,,,,,,,,,,,43.8,10,16,182,62,93,1009,1,,0,4,4,Balve,1,0,U1.000|5:43-U1.000|4:42-U1.000|5:11-U1.000|5:07-U1.000|5:07-U1.000|5:03-U1.000|4:51-U1.000|4:39-U1.000|4:38-U1.000|4:50-U1.000|4:32-U1.000|4:24-U1.000|4:05-U1.000|4:12-U0.833|4:21,,"Balve Running",,,3113,,250,3,14187315734,0,168070,250480,30378,9598092,69987371,588,223,149,,6,78.25,90.33,44.68,,,,,,,,,0,,0,,0,,,,,,,,,,,,,,,,,,,"4,5",
89856321,2c6136e4-c2f2-4c85-9dff-cb5a20640ec1,1709305587,60,1709304893,,0,0,9.91,2802,2857,192,189,225,222,0,2.7,0.71,1,1.05,434,386,78,102,,96,30,,42.86,,1,58.81,1378,21,,1.5,0,,100,,,,,,6,81,13.04,13.7,13.47,7.6,1.1,326,326,,1,341,341,,,,,,,,,"5,6,13,18,22,25,5,5,1","99,1,0,0,0","0,0,30,64,6",,,,,131,,,,,,,,,,,,,,,16,,,,,,,,,,,,,,,,,,,,,1,9,18,187,67,95,1004,1,,0,4,4,Balve,1,0,U1.000|5:22-U1.000|4:25-U1.000|4:42-U1.000|4:41-U1.000|4:27-U1.000|4:47-U1.000|4:56-U0.229|0:42-U0.145|0:40-U0.226|0:42-U0.155|0:42-U0.222|0:42-U0.175|0:51-U0.211|0:41-U0.191|0:57-U0.215|0:42-U1.000|5:52-U0.146|0:51,,"Balve Running",,,3113,,250,3,14201902024,0,168070,250480,30378,9605244,70052045,567,218,150,,6,77.69,90.9,40.85,,,,,,,,,0,,0,,0,,,,,,,,,,,,,,,,,,,"5,5,5",
89972371,a627cfdd-ddc1-4842-8aef-004fc00c6a4b,1709397984,60,1709397107,,0,0,7.11,2205,2225,72,98,99,124,0,0.8,0.47,0.91,1.07,,307,62,108,105,91,26,,37.61,,1,58.81,120,19,,1.2,0,,100,,,,,,3,79,11.61,12.26,12.16,-4.4,-16,284,284,,1,307,307,,,,,,,,,"13,7,12,25,30,8,1,4,0","95,5,0,0,0","0,2,61,34,4",,,,,122,,,,,,,,,,,,,,,22,,,,,,,,,,,,,,,,,,,,,1.4,10,14,146,68,88,1002,0,,0,4,4,Balve,1,0,U1.000|5:34-U1.000|5:13-U1.000|5:02-U1.000|4:57-U0.622|2:48-U0.282|1:15-U0.383|1:44-U0.170|0:34-U0.253|1:17-U1.000|5:42-U0.399|2:39,,"Balve Running",,,3113,,250,3,14218678566,0,168070,250480,30378,9616287,70158153,623,231,150,,18,81.43,91.35,47.27,,,,,,,,,0,,0,,0,,,,,,,,,,,,,,,,,,,,
90040048,73257b5d-a812-4d56-a04f-e355b639956a,1709463485,60,1709466077,,0,0,4.19,1549,2314,58,55,60,55,0,0.6,0.3,1.11,0.74,1416,313,139,157,,153,35,46.41,29.54,47.25,1,58.86,816,59,,2.4,0.5,103,99,,,,,,30,80,9.83,11.43,12.14,26.1,-8.4,241,241,,1,311,311,,,,,,,,,"32,5,5,10,27,18,2,0,1","2,38,60,0,0","18,16,27,36,4",,,,,101,,,,,,,,,,,,,,,,,,,,,,,,,,,,,,,,,,,,21.8,12,9,75,70,60,1001,1,,0,3,4,Flittard,1,0,U1.000|4:48-U1.000|5:02-U1.000|5:57-U1.000|7:30-U0.189|2:32,,"Cologne Running",,,3113,,250,3,14229473737,0,168070,250480,30378,,70216664,,,,,,,,,,,,,,,,,,,,,,,,,,,,,,,,,,,,,,,,5,
90040077,b554f2b2-60bc-4da1-baa5-2453e823aee3,1709466303,60,1709466104,,0,0,10.05,2166,2166,47,39,62,54,0,0,0.1,,,,638,182,191,,187,7,60.54,58.93,60.95,1,58.86,4320,323,,5,0.1,104,98,,,,,,122,86,16.76,16.76,16.92,7.7,9.7,450,450,,1,457,457,,,,,,,,,"0,0,0,0,0,1,69,30,0","0,1,1,28,70","0,0,0,1,99",,,,,162,,,,,,,,,,,,,,,,,,,,,,,,,,,,,,,,,,,,154.4,12,9,75,70,60,1001,1,,0,3,4,Flittard,1,0,U1.000|3:32-U1.000|3:30-U1.000|3:30-U1.000|3:32-U1.000|3:31-U1.000|3:36-U1.000|3:39-U1.000|3:43-U1.000|3:43-U1.000|3:40-U0.053|0:09,,"Cologne Running",,,3113,,250,3,14229481921,0,168070,250480,30378,,70216692,,,,,,,,,,,,,,,,,,,,,,10,2166,,,0,"Bayer Kreuz",,,,,,,0,0,30378,90040077,,,,
90046744,6319d1c0-4d47-4cab-9ada-05e45b29036f,1709469530,60,1709474431,,0,0,5.32,1964,5321,36,44,56,63,0,0,0.22,1.07,0.51,,386,137,156,116,152,36,47.37,30.01,47.67,1,58.85,4327,44,,2.2,0,97,97,,,,,,35,81,9.65,11.05,11.15,22.3,9.9,236,236,,1,277,277,,,,,,,,,"19,4,21,40,14,2,1,0,0","4,38,58,0,0","12,3,74,10,1",,,,,100,,,,,,,,,,,,,,,,,,,,,,,,,,,,,,,,,,,,19.7,14,8,95,62,33,1000,2,,0,2,4,Flittard,1,0,U1.000|5:29-U1.000|5:32-U1.000|9:13-U1.000|5:33-U1.000|5:17-U0.317|1:39,,"Cologne Running",,,3113,,250,3,14231443916,0,168070,250480,30378,,70221965,,,,,,,,,,,,,,,,,,,,,,,,,,,,,,,,,,,,,,,,,
90107994,aec72a00-c97a-4a6b-bc8c-c7f802c634b4,1709538560,60,1709540938,,0,0,16.31,5411,5616,367,376,385,394,0,4,0.76,1,1.07,433,1132,147,169,,168,26,49.24,36.94,50.58,1,58.85,3465,143,,3.5,0,96,97,,,,,,154,80,11.25,11.33,11.48,-8.4,0.1,267,267,,1,275,275,,,,,,,,,"19,12,20,23,17,8,0,0,0","0,21,75,5,0","0,4,80,16,0",,,,,113,,,,,,,,,,,,,,,,,,,,,,,,,,,,,,,,,,,,55.5,6,9,295,93,98,1010,0,,0,9,4,Balve,1,0,U1.000|6:10-U1.000|5:12-U1.000|5:31-U1.000|5:27-U1.000|5:36-U1.000|5:52-U1.000|6:19-U1.000|7:10-U1.000|6:16-U1.000|5:44-U1.000|4:43-U1.000|4:34-U1.000|4:28-U1.000|4:45-U1.000|5:46-U1.000|5:07-U0.307|1:30,,"Balve Running",,,3113,,250,3,14243543576,0,168070,250480,30378,,70272727,,,,,,,,,,,,,,,,,,,,,,,,,,,,,,,,,,,,,,,,"4,4",
90229530,7a1cacbc-dd4c-4792-bdca-a0a73fb37d1c,1709629069,60,1709626435,,0,0,,876,876,,,,,0,,,,,,109,,,,,,,,,1,,,,,,,,,200,,,,,10,,,,,,,,,,,,,,,,,,,,,,,,,,,,,,,,,,,,,,,,,,,,,,,,,,,,,,,,,,,,,,,,,,,,,,,,,,1,,,1,0,,,,,,,,252,7,,0,168074,,30378,,70382472,,,,,,,,,,,,,,,,,,,,,,,,,,,,,,,,,,,,,,,,,
90305734,5d5e4871-3606-4b12-9254-9d747e4beea5,1709663447,60,1709668908,,0,0,5.47,1672,2202,22,46,20,45,0,0,0.15,,0.98,,352,141,152,,138,13,57.6,37.67,57.58,1,58.87,1413,77,,2.6,0.8,105,100,,,,,,41,80,11.69,12.71,12.67,9.9,-14.8,290,290,,1,329,329,,,,,,,,,"21,4,2,6,48,15,1,1,2","1,38,62,0,0","0,10,31,56,3",,,,,123,,,,,,,,,,,,,,,,,,,,,,,,,,,,,,,,,,,,33.8,6,4,248,93,98,1016,0,,1,4,4,Westick,1,0,U1.000|4:50-U1.000|4:38-U1.000|4:35-U1.000|4:42-U0.592|3:32-U0.875|5:34,,"Fröndenberg/Ruhr Running",,,3113,,250,3,14269386646,0,168070,250480,30378,,70451103,,,,,,,,,,,,,,,,,,,,,,,,,,,,,,,,,,,,,,,,,
90305735,85ee1920-c600-492c-868b-656f97e759d8,1709665662,60,1709668908,,0,0,0.03,11,92,0,0,0,0,0,1.2,1,,,,2,143,149,,,,45.17,21.92,45.17,1,58.87,1412,6,,0.4,0,,100,,,,,,0,82,9.94,9.94,9.94,18.9,7.5,240,240,,1,240,240,,,,,,,,,"0,100,0,0,0,0,0,0,0","0,44,56,0,0","0,0,100,0,0",,,,,100,,,,,,,,,,,,,,,,,,,,,,,,,,,,,,,,,,,,,6,4,248,93,98,1016,0,,1,4,4,Westick,1,0,U0.003|0:03-U0.025|0:08,,"Fröndenberg/Ruhr Running",,,3113,,250,3,14269386917,0,168070,250480,30378,,70451104,,,,,,,,,,,,,,,,,,,,,,,,,,,,,,,,,,,,,,,,,
90305745,06857e9b-95c4-425f-9868-cf73a5f3643d,1709665834,60,1709668913,,0,0,6.74,2417,2417,0,0,0,0,0,0,0,,,,465,142,191,97,185,59,46.86,31.54,46.86,1,58.88,3871,138,,2.8,2.5,103,100,,,,,,64,78,10.03,12.6,12.6,12.7,-8.6,255,255,,1,340,340,,,,,,,,,"61,3,2,1,1,1,4,19,7","0,52,30,17,1","21,33,12,6,28",,,,,107,,,,,,,,,,,,,,,,,,,,,,,,,,,,,,,,,,,,54,6,4,243,92,96,1016,0,,1,4,4,Westick,1,0,U0.390|1:18-U0.200|1:30-U0.400|1:21-U0.500|3:56-U0.390|1:17-U0.200|1:32-U0.400|1:16-U0.200|1:40-U0.390|1:16-U0.510|4:21-U0.410|1:16-U0.190|1:46-U0.410|1:17-U0.200|1:54-U0.400|1:17-U0.420|4:52-U0.200|0:35-U0.190|1:55-U0.210|0:36-U0.190|2:05-U0.210|0:36-U0.130|2:41,,"Fröndenberg/Ruhr Track Running",,,3113,,250,3,14269388295,0,168070,250480,30378,,70451112,,,,,,,,,,,,,,,,,,,,,,,,,,,,,,,,,,,,,,,,,
90305747,abbeef51-c7a6-48ef-93f6-cc8fde735e7e,1709668542,60,1709668914,,0,0,2.37,911,922,12,2,19,8,0,0,0.12,1.08,,,165,128,141,87,137,10,49,27.14,49.56,1,58.88,3851,20,,1.4,0,,100,,,,,,17,80,9.51,9.4,9.56,-11,-15.3,229,229,,1,232,232,,,,,,,,,"33,49,15,2,0,0,0,0,0","0,99,1,0,0","0,9,91,0,0",,,,,98,,,,,,,,,,,,,,,,,,,,,,,,,,,,,,,,,,,,14.5,6,4,243,92,96,1016,0,,1,4,4,Westick,1,0,U1.000|6:37-U1.000|6:22-U0.371|2:12,,"Fröndenberg/Ruhr Running",,,3113,,250,3,14269388533,0,168070,250480,30378,,70451113,,,,,,,,,,,,,,,,,,,,,,,,,,,,,,,,,,,,,,,,,
90364890,3d9c4c84-c452-45cd-8f0b-c2a8013ceb3d,1709734387,60,1709736656,,0,0,16.16,5010,5509,417,383,423,398,0,4.6,0.73,1.02,1.06,703,1075,146,164,120,153,18,54.03,39.95,55.9,1,58.86,2888,139,,3.5,0,96,98,,,,,,135,80,12.23,12.22,13.02,-2.1,6.9,297,297,,1,319,319,,,,,,,,,"13,10,13,25,18,15,6,0,0","0,24,73,2,0","0,0,59,36,4",,,,,121,,,,,,,,,,,,,,,,,,,,,,,,,,,,,,,,,,,,48.3,9,8,29,74,90,1023,1,,0,4,4,Balve,1,0,U1.000|5:54-U1.000|4:47-U1.000|5:12-U1.000|5:11-U1.000|5:12-U1.000|5:37-U1.000|6:03-U1.000|6:36-U1.000|6:09-U1.000|4:51-U1.000|4:14-U1.000|3:57-U1.000|4:04-U1.000|4:36-U1.000|5:31-U1.000|4:46-U0.161|0:49,,"Balve Running",,,3113,,250,3,14280256299,0,168070,250480,30378,,70502880,,,,,,,,,,,,,,,,,,,,,,,,,,,,,,,,,,,,,,,,"3,4,5",
90531126,5002b9bc-7a58-4483-bceb-2d80a65eb677,1709821693,60,1709898170,,0,0,10.61,3580,3916,277,225,306,259,0,4,0.63,1.11,0.89,576,729,140,167,,158,37,51.47,35,53.44,1,58.84,1597,97,,3,0.5,97,100,,,,,,85,79,11.08,11.08,13.09,5.8,-36.7,273,273,,1,340,340,,,,,,,,,"18,6,18,31,19,8,0,0,0","0,53,46,1,0","6,7,60,21,6",,,,,113,,,,,,,,,,,,,,,,,,,,,,,,,,,,,,,,,,,,32.7,7,14,91,67,93,1022,1,,0,4,4,Balve,1,0,U1.000|5:28-U1.000|5:48-U1.000|5:07-U1.000|4:36-U1.000|5:24-U1.000|4:51-U1.000|5:09-U0.415|2:16-U0.140|0:41-U0.181|1:43-U0.140|0:42-U0.172|1:43-U0.139|0:42-U0.165|1:37-U0.140|0:42-U0.170|1:48-U0.142|0:44-U1.000|5:51-U0.810|4:49,,"Balve Running",,,3113,,250,3,14308471255,0,168070,250480,30378,,70652376,,,,,,,,,,,,,,,,,,,,,,,,,,,,,,,,,,,,,,,,"4,4,5",
90538417,2a49ba26-e341-40da-85c9-3fdf1f97f9a1,1709902601,60,1709903012,,0,0,11.34,3703,3902,332,318,353,342,0,3.9,0.8,1.01,1.03,443,763,143,161,,159,19,52.12,36.56,54.08,1,58.83,1344,111,,3.2,0,101,97,,,,,,89,80,11.77,11.41,11.98,-0.5,5.7,281,281,,1,294,294,,,,,,,,,"16,12,17,22,25,7,1,0,0","0,32,68,0,0","0,14,40,46,0",,,,,115,,,,,,,,,,,,,,,,,,,,,,,,,,,,,,,,,,,,34.6,7,17,116,56,6,1012,2,,0,2,4,Balve,1,0,U1.000|4:45-U1.000|4:52-U1.000|6:04-U1.000|5:58-U1.000|5:57-U1.000|6:30-U1.000|5:07-U1.000|4:48-U1.000|4:58-U1.000|5:47-U1.000|5:27-U0.336|1:32,,"Balve Running",,,3113,,250,3,14309605972,0,168070,250480,30378,,70659335,,,,,,,,,,,,,,,,,,,,,,,,,,,,,,,,,,,,,,,,"4,4",
90694718,331ae493-090f-4d1f-a944-b88b26cf1581,1710063775,60,1710069541,,0,0,29.13,8185,8879,435,340,487,392,0,2.7,0.42,0.98,1.02,644,1882,152,167,116,160,20,57.69,46.88,58.99,1,58.86,3456,262,,4.7,0,100,101,,,,,,243,81,13.17,13.05,13.34,0.1,0.5,334,334,,1,342,342,,,,,,,,,"5,4,5,8,31,39,7,0,0","0,6,87,6,0","0,0,19,75,5",,,,,132,,,,,,,,,,,,,,,,,,,,,,,,,,,,,,,,,,,,51.3,12,14,101,58,78,996,2,,0,4,4,Helle,1,0,U1.000|4:52-U1.000|4:54-U1.000|4:50-U1.000|5:31-U1.000|5:37-U1.000|4:30-U1.000|5:11-U1.000|4:27-U1.000|4:32-U1.000|4:28-U1.000|4:25-U1.000|4:35-U1.000|4:29-U1.000|4:19-U1.000|4:26-U1.000|4:15-U1.000|4:21-U1.000|4:12-U1.000|4:33-U1.000|4:29-U1.000|4:14-U1.000|4:21-U1.000|5:06-U1.000|4:08-U1.000|4:34-U1.000|5:06-U1.000|4:09-U1.000|5:43-U1.000|5:27-U0.126|0:40,,"Balve Running",,,3113,,250,3,14338616705,0,168070,250480,30378,,70801290,,,,,,,,,,,,,,,,,,,,,,,,,,,,,,,,,,,,,,,,"4,4,5,5,5",
90794104,2f3bfff6-14af-4b5d-9b9e-142880788e31,1710164013,60,1710164775,,0,0,14.02,4156,4266,326,319,341,334,0,3.7,0.75,0.95,1.02,529,926,146,159,,159,14,57.11,41.62,58.79,1,58.85,2450,133,,3.4,0,101,100,,,,,,105,81,12.65,12.67,12.77,-7.2,-1.2,311,311,,1,317,317,,,,,,,,,"7,10,16,16,17,27,8,0,0","1,19,80,0,0","0,0,36,63,1",,,,,125,,,,,,,,,,,,,,,,,,,,,,,,,,,,,,,,,,,,37,7,19,210,86,97,1004,1,,0,6,4,Balve,1,0,U1.000|5:01-U1.000|5:03-U1.000|6:02-U1.000|5:49-U1.000|5:36-U1.000|6:02-U1.000|4:44-U1.000|4:13-U1.000|4:06-U1.000|4:04-U1.000|4:06-U1.000|5:02-U1.000|4:30-U1.000|4:53-U0.015|0:04,,"Balve Running",,,3113,,250,3,14355795974,0,168070,250480,30378,,70891724,,,,,,,,,,,,,,,,,,,,,,,,,,,,,,,,,,,,,,,,"4,5,5",
90965072,2d2dd63a-a9a0-4737-82e8-bfedc565899a,1710268301,60,1710329853,,0,0,6.17,1926,2359,45,59,48,62,0,0.1,0.2,,0.68,451,414,141,168,,168,39,56.13,37,56.48,1,58.93,1222,107,,2.8,2,104,100,,,,,,45,77,11.43,13.69,15.93,15.8,-62.8,289,289,,1,452,452,,,,,,,,,"25,1,1,5,40,17,2,8,2","2,33,64,1,0","12,10,21,48,10",,,,,125,,,,,,,,,,,,,,,,,,,,,,,,,,,,,,,,,,,,30.5,5,7,190,87,75,1016,0,,1,4,4,Westick,1,0,U1.000|4:52-U1.000|4:42-U1.000|4:36-U1.000|4:31-U0.211|1:14-U0.195|0:38-U0.104|1:02-U0.191|0:39-U0.108|0:49-U0.197|0:39-U0.107|0:58-U0.201|0:38-U0.114|0:59-U0.202|0:39-U0.101|1:07-U0.199|0:39-U0.236|3:23,,"Fröndenberg/Ruhr Running",,,3113,,250,3,14385830973,0,168070,250480,30378,,71037347,,,,,,,,,,,,,,,,,,,,,,,,,,,,,,,,,,,,,,,,5,
90965074,34004c71-62bd-48fc-afa7-d4866fe97863,1710270720,60,1710329854,,0,0,3.66,962,962,0,0,0,0,0,0,0,,,,256,167,187,,182,51,54.49,43.83,54.49,1,58.93,2529,182,,3.1,2.9,103,100,,,,,,42,81,13.68,15.22,15.22,11.7,7.2,359,359,,1,409,409,,,,,,,,,"23,1,2,2,1,7,36,28,1","0,15,12,55,18","14,8,6,8,65",,,,,141,,,,,,,,,,,,,,,,,,,,,,,,,,,,,,,,,,,,84.6,5,7,190,87,75,1016,0,,1,4,4,Westick,1,0,U1.200|4:13-U0.200|1:56-U1.200|4:14-U0.200|1:55-U0.810|2:59-U0.050|0:46,,"Fröndenberg/Ruhr Track Running",,,3113,,250,3,14385831503,0,168070,250480,30378,,71037349,,,,,,,,,,,,,,,,,,,,,,,,,,,,,,,,,,,,,,,,,
90965080,0d0230cc-caa7-4f90-b7c7-2c1e05152f57,1710271705,60,1710329856,,0,0,5.03,1641,1917,25,27,27,30,0,0,0.17,1.1,0.86,,345,139,150,107,149,9,54.15,34.69,54.46,1,58.92,3178,51,,2.4,0,95,100,,,,,,35,80,11.04,11.04,11.12,-2.6,-3.1,269,269,,1,274,274,,,,,,,,,"2,9,30,47,12,0,0,0,0","0,68,32,0,0","0,3,88,9,0",,,,,115,,,,,,,,,,,,,,,,,,,,,,,,,,,,,,,,,,,,23.3,5,7,190,87,75,1016,0,,1,4,4,Westick,1,0,U1.000|5:50-U1.000|5:31-U1.000|5:15-U1.000|5:23-U1.000|5:14-U0.027|0:08,,"Fröndenberg/Ruhr Running",,,3113,,250,3,14385831671,0,168070,250480,30378,,71037355,,,,,,,,,,,,,,,,,,,,,,,,,,,,,,,,,,,,,,,,,
90976368,5159a8f6-6204-4e66-8733-e60aa5938921,1710338020,60,1710339620,,0,0,15.35,4646,4863,311,318,321,340,0,3.5,0.68,1.02,1.07,593,1019,148,167,,153,19,54.63,40.92,55.97,1,58.92,2743,147,,3.5,0,97,99,,,,,,134,81,12.33,12.48,12.71,-6.3,3.4,299,299,,1,311,311,,,,,,,,,"12,9,11,22,20,18,8,0,0","0,10,85,5,0","0,1,52,46,1",,,,,122,,,,,,,,,,,,,,,,,,,,,,,,,,,,,,,,,,,,50.4,11,10,234,90,97,1016,1,,0,4,4,Balve,1,0,U1.000|5:29-U1.000|4:38-U1.000|5:18-U1.000|5:07-U1.000|5:17-U1.000|5:32-U1.000|5:54-U1.000|6:56-U1.000|5:32-U1.000|4:05-U1.000|4:04-U1.000|4:05-U1.000|4:22-U1.000|5:00-U1.000|4:36-U0.349|1:31,,"Balve Running",,,3113,,250,3,14388134827,0,168070,250480,30378,,71046118,,,,,,,,,,,,,,,,,,,,,,,,,,,,,,,,,,,,,,,,4,
91058116,12309ea5-56cb-41af-9e8a-32a704b5684c,1710423518,60,1710424980,,0,0,11.23,4018,4664,316,279,359,323,0,3.9,0.68,1.07,0.88,426,822,146,177,115,175,49,45.28,32.81,47.04,1,58.9,2031,151,,3.3,1.8,97,98,,,,,,105,78,10.41,10.82,12.24,24.7,-10.8,257,257,,1,321,321,,,,,,,,,"29,7,14,23,18,8,1,0,0","0,35,52,13,0","12,13,40,30,5",,,,,107,,,,,,,,,,,,,,,,,,,,,,,,,,,,,,,,,,,,40.6,15,14,188,66,82,1013,3,,0,4,4,Balve,1,0,U1.000|5:17-U1.000|5:30-U1.000|4:55-U1.000|4:27-U1.000|5:00-U1.000|5:03-U0.342|1:57-U0.141|0:43-U0.170|1:38-U0.141|0:43-U0.195|1:45-U0.144|0:44-U0.206|1:45-U0.136|0:46-U0.187|1:36-U0.136|0:44-U0.195|1:52-U0.146|0:46-U0.172|1:43-U0.144|0:39-U0.183|1:47-U0.147|0:43-U0.177|2:01-U0.139|0:44-U0.204|2:52-U0.142|0:42-U1.000|5:41-U0.785|4:54,,"Balve Running",,,3113,,250,3,14404182514,0,168070,250480,30378,,71113762,,,,,,,,,,,,,,,,,,,,,,,,,,,,,,,,,,,,,,,,"4,4,5,5",
91063765,,1710433605,60,1710430106,,0,0,1,300,300,,,,,0,,,,,,67,,,,,,,32.99,,1,,,,,,,,,,,,,,7,,,,,,,,,,,,,,,,,,,,,,,,,,,,,,,,,,,,,,,,,,,,,,,,,,,,,,,,,,,,,,,,,,,,,,,,,,1,,,0,0,,,Running,,,connect,,,3,14405298780,0,168070,250480,30378,,71118059,,,,,,,,,,,,,,,,,,,,,,,,,,,,,,,,,,,,,,,,,
91152291,569d6c9f-bf88-4ddb-b8f5-6522345fc5d3,1710522226,60,1710523596,,0,0,13,4427,4860,414,376,416,381,0,4.8,0.8,0.97,1.18,480,880,141,165,,151,20,50.42,35.18,52.59,1,58.82,1387,105,,3.2,0,97,95,,,,,,72,79,11.62,11.88,11.93,-16.4,-1.9,273,273,,1,281,281,,,,,,,,,"34,13,12,9,12,12,6,1,0","1,45,52,3,0","0,5,71,24,0",,,,,112,,,,,,,,,,,,,,,,,,,,,,,,,,,,,,,,,,,,26.3,12,16,227,80,91,1009,0,,0,4,4,Helle,1,0,U1.000|5:35-U1.000|6:23-U1.000|7:09-U1.000|6:03-U1.000|6:48-U1.000|8:13-U1.000|5:47-U1.000|5:30-U1.000|4:22-U1.000|4:11-U1.000|4:17-U1.000|3:45-U1.000|5:43-U0.003|0:02,,"Balve Running",,,3113,,250,3,14422490232,0,168070,250480,30378,,71198410,,,,,,,,,,,,,,,,,,,,,,,,,,,,,,,,,,,,,,,,"3,5",
91236674,45ee7b98-a9b2-42f6-8f74-9cada0ed0f12,1710600402,60,1710602861,,0,0,15.26,4188,4407,77,93,105,123,0,0,0.14,0.92,0.78,,993,155,183,89,169,54,57.76,45.82,58.05,1,58.87,2736,295,,4.3,2.6,101,101,,,,,,136,82,13.18,14.57,14.5,9.2,5.8,333,333,,1,379,379,,,,,,,,,"7,2,7,17,23,13,17,13,0","0,9,57,32,2","3,3,32,33,29",,,,,133,,,,,,,,,,,,,,,,,,,,,,,,,,,,,,,,,,,,89.2,8,14,299,70,75,1021,2,,0,4,4,"Sundern (Sauerland)",1,0,U1.000|4:12-U1.000|4:21-U1.000|4:34-U1.000|3:32-U1.000|3:38-U1.000|5:38-U1.000|3:30-U1.000|3:35-U1.000|5:46-U1.000|3:27-U1.000|3:42-U1.000|7:38-U1.000|5:04-U1.000|5:01-U1.000|4:56-U0.259|1:15,,"Sundern (Sauerland) Running",,,3113,,250,3,14436834611,0,168070,250480,30378,,71273449,,,,,,,,,,,,,,,,,,,,,,,,,,,,,,,,,,,,,,,,,
91300603,3340b4f8-4948-4b89-b2b1-1ffa16fac7cc,1710669293,60,1710673167,,0,0,21.71,6911,7097,613,564,660,612,0,5.3,0.79,0.96,1.06,585,1510,148,166,,161,25,51.34,39.65,53.27,1,58.85,3181,187,,3.9,0,98,98,,,,,,181,81,12.06,12.05,12.26,-6.6,2.2,292,292,,1,298,298,,,,,,,,,"20,13,14,12,15,19,6,0,0","0,21,73,6,0","0,0,58,40,1",,,,,116,,,,,,,,,,,,,,,,,,,,,,,,,,,,,,,,,,,,42.8,9,9,176,68,80,1023,2,,0,4,4,Helle,1,0,U1.000|5:17-U1.000|6:25-U1.000|7:06-U1.000|5:42-U1.000|6:28-U1.000|4:52-U1.000|5:12-U1.000|5:04-U1.000|5:54-U1.000|6:33-U1.000|4:48-U1.000|4:28-U1.000|5:24-U1.000|4:40-U1.000|4:53-U1.000|6:20-U1.000|4:41-U1.000|4:11-U1.000|4:21-U1.000|4:00-U1.000|4:32-U0.706|4:20,,"Balve Running",,,3113,,250,3,14448073169,0,168070,250480,30378,,71333403,,,,,,,,,,,,,,,,,,,,,,,,,,,,,,,,,,,,,,,,"4,4,4,4",
91372566,92322964-01ed-4311-a90a-cea79c72a2d9,1710748576,60,1710745880,,0,0,,893,893,,,,,0,,,,,,69,,,,,,,,,1,,,,,,,,,200,,,,,6,,,,,,,,,,,,,,,,,,,,,,,,,,,,,,,,,,,,,,,,,,,,,,,,,,,,,,,,,,,,,,,,,,,,,,,,,,1,,,1,0,,,,,,,,252,7,,0,168073,,30378,,71397763,,,,,,,,,,,,,,,,,,,,,,,,,,,,,,,,,,,,,,,,,
91396181,c9e0c661-dde7-4aca-982b-d33b3a4356e5,1710767935,60,1710768813,,0,0,10.82,3569,4395,334,137,351,158,0,3.7,0.69,0.99,0.99,487,779,145,158,,145,15,50.52,36,53.6,1,58.83,2174,119,,3.3,0,103,97,,,,,,86,80,11.93,11.24,12.54,-1.3,-11.2,299,299,,1,318,318,,,,,,,,,"20,14,16,16,23,10,1,0,0","0,13,86,0,0","0,1,49,48,2",,,,,114,,,,,,,,,,,,,,,,,,,,,,,,,,,,,,,,,,,,33.6,13,9,263,75,88,1016,2,,0,4,4,Balve,1,0,U1.000|4:58-U1.000|5:02-U1.000|6:14-U1.000|6:12-U1.000|5:55-U1.000|6:26-U1.000|4:56-U1.000|4:32-U1.000|5:15-U1.000|6:02-U0.824|3:58,,"Balve Running",,,3113,,250,3,14466242453,0,168070,250480,30378,,71416644,,,,,,,,,,,,,,,,,,,,,,,,,,,,,,,,,,,,,,,,"4,4",
91403125,,1710777351,60,1710773784,,0,0,3,900,900,,,,,0,,,,,,202,,,,,,,37.02,,1,,,,,,,,,,,,,,20,,,,,,,,,,,,,,,,,,,,,,,,,,,,,,,,,,,,,,,,,,,,,,,,,,,,,,,,,,,,,,,,,,,,,,,,,,1,,,0,0,,,"Uhr angehalten ",,,connect,,,3,14467218511,0,168070,250480,30378,,71422320,,,,,,,,,,,,,,,,,,,,,,,,,,,,,,,,,,,,,,,,,
91511772,10188e17-8245-4e9e-b377-d76160ae3ff6,1710873158,60,1710875892,,0,0,5.72,1714,2084,29,41,39,50,0,0.1,0.27,0.95,0.8,,390,145,169,,167,38,56.88,38.66,57.09,1,58.9,1426,113,,2.9,2.1,104,102,,,,,,44,78,11.98,13.34,13.74,12.8,-24.4,302,302,,1,373,373,,,,,,,,,"18,4,3,6,31,32,2,1,3","1,22,72,5,0","5,9,26,55,5",,,,,128,,,,,,,,,,,,,,,,,,,,,,,,,,,,,,,,,,,,33.9,12,4,176,72,47,1019,0,,1,3,4,Westick,1,0,U1.000|4:40-U1.000|4:38-U1.000|4:33-U1.000|4:26-U1.000|5:36-U0.722|4:41,,"Fröndenberg/Ruhr Running",,,3113,,250,3,14487724110,0,168070,250480,30378,,71521414,,,,,,,,,,,,,,,,,,,,,,,,,,,,,,,,,,,,,,,,,
91511836,b7de26e1-a89a-40db-a9f8-2756f4810d29,1710875361,60,1710875943,,0,0,9.51,2857,2857,0,0,0,0,0,0,0,,,,679,158,185,,178,52,50.24,39.8,50.24,1,58.9,5760,305,,3.7,3.5,102,107,,,,,,105,80,11.99,13.97,13.97,3.1,-3,312,312,,1,378,378,,,,,,,,,"42,3,3,3,2,2,6,32,7","0,23,20,53,4","15,23,13,8,41",,,,,125,,,,,,,,,,,,,,,,,,,,,,,,,,,,,,,,,,,,82.3,12,4,176,72,47,1019,0,,1,3,4,Westick,1,0,U0.400|1:19-U0.190|0:37-U0.210|1:34-U0.600|1:57-U0.200|1:36-U0.600|1:57-U0.390|3:59-U0.300|0:55-U0.100|0:52-U0.300|0:55-U0.100|0:55-U0.300|0:55-U0.100|0:59-U0.300|0:55-U0.100|0:59-U0.300|0:58-U0.400|3:03-U0.300|0:56-U0.100|0:49-U0.300|0:56-U0.090|0:50-U0.300|0:57-U0.100|0:51-U0.300|0:59-U0.100|0:59-U0.300|1:03-U0.500|4:48-U0.600|2:01-U0.200|1:44-U0.400|1:19-U0.200|0:39-U0.200|1:48-U0.600|2:00-U0.030|0:31,,"Fröndenberg/Ruhr Track Running",,,3113,,250,3,14487739587,0,168070,250480,30378,,71521477,,,,,,,,,,,,,,,,,,,,,,,,,,,,,,,,,,,,,,,,,
91511838,4844b32b-492d-419d-a80d-423208f80f97,1710878542,60,1710875947,,0,0,2,732,732,20,6,29,8,0,0,0.26,1.12,0.46,,142,130,134,,130,8,51.09,28.35,52.17,1,58.9,5743,20,,1.4,0,,100,,,,,,12,80,10.06,10.06,10.52,13.6,16,248,248,,1,262,262,,,,,,,,,"14,27,44,14,2,0,0,0,0","0,100,0,0,0","4,4,82,11,0",,,,,102,,,,,,,,,,,,,,,,,,,,,,,,,,,,,,,,,,,,12.9,12,5,177,71,78,1019,0,,1,4,4,Westick,1,0,U1.000|5:57-U0.995|6:15,,"Fröndenberg/Ruhr Running",,,3113,,250,3,14487741608,0,168070,250480,30378,,71521479,,,,,,,,,,,,,,,,,,,,,,,,,,,,,,,,,,,,,,,,,
91598234,c91af903-cd93-49b1-83b4-677529adddc9,1710956320,60,1710957723,,0,0,14.17,4412,4648,384,370,389,380,0,4.1,0.82,0.97,1.11,461,978,149,172,,146,23,52.27,39.34,54.09,1,58.9,4383,151,,3.6,0.1,102,97,,,,,,128,80,12.25,12.43,12.64,-6.9,4.8,298,298,,1,311,311,,,,,,,,,"18,13,15,14,14,17,9,0,0","0,18,73,9,0","0,0,58,37,4",,,,,120,,,,,,,,,,,,,,,,,,,,,,,,,,,,,,,,,,,,55.2,13,3,212,71,88,1019,0,,0,4,4,Balve,1,0,U1.000|5:03-U1.000|5:05-U1.000|6:08-U1.000|5:57-U1.000|5:56-U1.000|5:49-U1.000|5:51-U1.000|5:46-U1.000|4:35-U1.000|4:19-U1.000|4:07-U1.000|4:15-U1.000|3:59-U1.000|5:41-U0.171|1:00,,"Balve Running",,,3113,,250,3,14502966514,0,168070,250480,30378,,71597431,,,,,,,,,,,,,,,,,,,,,,,,,,,,,,,,,,,,,,,,3,
91684999,41382c75-d79c-48de-b169-c879ff47a7da,1711034472,60,1711045711,,0,0,18.16,5568,6610,510,423,520,437,0,4.6,0.81,0.98,1.12,589,1208,146,168,,162,19,54.78,40.85,57.01,1,58.89,4035,170,,3.8,0,98,99,,,,,,153,81,12.6,13.14,13.06,-11.1,-7.9,306,306,,1,317,317,,,,,,,,,"17,14,16,15,13,9,10,6,0","1,25,72,3,0","0,1,42,54,2",,,,,121,,,,,,,,,,,,,,,,,,,,,,,,,,,,,,,,,,,,46,12,12,306,65,90,1024,1,,0,4,4,Helle,1,0,U1.000|5:18-U1.000|5:56-U1.000|6:03-U1.000|6:36-U1.000|6:04-U1.000|4:34-U1.000|5:11-U1.000|4:53-U1.000|6:06-U1.000|6:13-U1.000|4:48-U1.000|4:47-U1.000|4:27-U1.000|3:35-U1.000|3:41-U1.000|3:31-U1.000|4:23-U1.000|5:51-U0.156|0:51,,"Balve Running",,,3113,,250,3,14518988125,0,168070,250480,30378,,71675184,,,,,,,,,,,,,,,,,,,,,,,,,,,,,,,,,,,,,,,,"3,4",
91685003,9b5a96a2-fcf7-4f12-8305-b2c6d331ed3d,1711041548,60,1711045713,,0,0,1.25,438,438,12,8,19,15,0,0.8,0.5,1,,,86,135,145,,145,5,51.46,28.37,52.28,1,58.89,4022,15,,1,0,,100,,,,,,9,79,10.39,10.41,10.53,8.9,5.2,250,250,,1,254,254,,,,,,,,,"10,20,45,21,4,0,0,0,0","0,63,37,0,0","0,3,97,0,0",,,,,108,,,,,,,,,,,,,,,,,,,,,,,,,,,,,,,,,,,,16.2,11,9,298,68,93,1024,0,,0,4,4,Balve,1,0,U1.000|5:46-U0.250|1:32,,"Balve Running",,,3113,,250,3,14518989536,0,168070,250480,30378,,71675188,,,,,,,,,,,,,,,,,,,,,,,,,,,,,,,,,,,,,,,,,
91775603,b3f4cf71-6634-47bb-8629-bdb52abf4a30,1711128522,60,1711147148,,0,0,9.13,3281,3700,133,132,145,149,0,2,0.47,1.04,1.02,309,586,134,150,108,141,13,50.35,32.13,51.27,1,58.89,2518,55,,2.4,0,96,95,,,,,,42,79,10.18,10.15,10.4,1.9,-2.5,241,241,,1,249,249,,,,,,,,,"24,24,28,19,3,1,0,0,0","1,73,26,0,0","0,7,87,6,0",,,,,106,,,,,,,,,,,,,,,,,,,,,,,,,,,,,,,,,,,,13.5,10,12,262,76,91,1013,0,,0,4,4,Balve,1,0,U1.000|5:54-U1.000|6:21-U1.000|5:49-U1.000|5:29-U1.000|6:06-U1.000|5:49-U1.000|5:58-U1.000|6:18-U1.000|6:09-U0.128|0:48,,"Balve Running",,,3113,,250,3,14536348140,0,168070,250480,30378,,71754886,,,,,,,,,,,,,,,,,,,,,,,,,,,,,,,,,,,,,,,,4,
91796407,be074ec4-4262-499f-9c0c-1fc67db6c4f4,1711187214,60,1711187726,,0,0,9.13,3226,3349,226,171,237,185,0,3.3,0.72,1.02,1.02,648,614,138,160,113,155,21,49.54,32.78,51.42,1,58.86,1537,67,,2.7,0,98,96,,,,,,65,80,10.67,10.35,10.96,-2.3,-2.5,256,256,,1,266,266,,,,,,,,,"27,12,21,27,11,1,0,0,0","0,68,32,0,0","0,3,84,13,0",,,,,106,,,,,,,,,,,,,,,,,,,,,,,,,,,,,,,,,,,,28.4,6,18,266,80,59,1010,2,,0,3,4,Helle,1,0,U1.000|5:33-U1.000|6:15-U1.000|6:59-U1.000|5:20-U1.000|5:17-U1.000|5:50-U1.000|6:01-U1.000|5:43-U1.000|6:04-U0.129|0:45,,"Balve Running",,,3113,,250,3,14541028567,0,168070,250480,30378,,71774123,,,,,,,,,,,,,,,,,,,,,,,,,,,,,,,,,,,,,,,,"4,4,5",
91898062,88bf3c87-327d-43ad-b481-4e252e7d4810,1711286432,60,1711287074,,0,0,6.95,2607,3114,204,209,206,209,0,3.5,0.94,1.42,1.51,499,470,131,152,87,150,22,49.11,29.94,50.85,1,58.78,803,50,,2.3,0,98,96,,,,,,46,80,10.58,10.09,10.93,-3.5,14.3,243,243,,1,258,258,,,,,,,,,"39,20,12,19,9,2,0,0,0","3,76,21,0,0","3,11,75,11,0",,,,,100,,,,,,,,,,,,,,,,,,,,,,,,,,,,,,,,,,,,20.5,6,24,263,85,98,1004,2,,0,4,4,Balve,1,0,U1.000|6:19-U1.000|6:49-U1.000|6:22-U1.000|7:24-U1.000|5:15-U1.000|5:09-U0.953|6:09,,"Balve Running",,,3113,,250,3,14560389068,0,168070,250480,30378,,71866595,,,,,,,,,,,,,,,,,,,,,,,,,,,,,,,,,,,,,,,,4,
91992950,e2af5b44-9c92-4bd3-884b-4a3d695d24ab,1711374013,60,1711374322,,0,0,13.02,3723,3749,205,206,228,229,0,2,0.51,0.96,1.04,303,828,145,162,,150,17,60.26,43.15,61.43,1,58.8,1338,126,,3.3,0.1,101,101,,,,,,93,81,12.82,12.9,12.96,-3.1,-4.9,318,318,,1,323,323,,,,,,,,,"2,2,10,20,35,25,6,0,0","0,17,82,1,0","0,0,27,72,1",,,,,130,,,,,,,,,,,,,,,,,,,,,,,,,,,,,,,,,,,,33.7,9,5,200,59,91,1006,2,,0,4,4,Balve,1,0,U1.000|4:59-U1.000|5:12-U1.000|4:48-U1.000|4:10-U1.000|5:20-U1.000|4:56-U1.000|4:23-U1.000|4:38-U1.000|4:18-U1.000|4:27-U1.000|5:07-U1.000|4:27-U1.000|5:11-U0.020|0:06,,"Balve Running",,,3113,,250,3,14574664461,0,168070,250480,30378,,71951982,,,,,,,,,,,,,,,,,,,,,,,,,,,,,,,,,,,,,,,,"5,5,5,5",
92168553,a2f9b5a9-60d0-42fb-8097-36a95e51f063,1711477877,60,1711540039,,0,0,6.57,2022,2502,38,59,51,66,0,0,0.21,1.16,0.77,,431,140,154,,153,34,57.65,37.77,57.84,1,58.89,1164,94,,3,0.7,105,99,,339,,,,50,79,11.59,13.29,13.73,16.1,-23.6,287,286,,1,365,365,,,,,,,,,"20,6,6,5,32,24,2,4,2","1,45,54,0,0","6,10,28,50,6",,,,,123,,,,,,,,,,,,,,,,,,,,,,,,,,,,,,,,,,,,35.2,11,7,121,64,37,989,0,,0,2,4,Westick,1,0,U1.000|4:41-U1.000|4:33-U1.000|4:32-U1.000|4:34-U0.198|0:59-U1.000|5:19-U0.217|1:19-U1.000|5:35-U0.154|2:10,,"Fröndenberg/Ruhr Running",,,3113,,250,3,14604016303,0,168070,250480,30378,,72113085,,,,,,,,,,,,,,,,,,,,,,,,,,,,,,,,,,,,,,,,,
92168554,c4b95ebd-f4b0-4fe3-93da-ab1f27f1abf1,1711480507,60,1711540039,,0,0,7.86,2109,2109,0,0,0,0,0,0,0,,,,493,150,178,,174,53,62.22,44.89,62.22,1,58.9,2448,175,,3.5,2,107,104,,353,,,,67,82,13.41,14.96,14.96,15.9,4.4,349,349,,1,399,399,,,,,,,,,"29,3,2,1,1,1,29,32,2","0,25,51,24,0","10,15,10,6,59",,,,,136,,,,,,,,,,,,,,,,,,,,,,,,,,,,,,,,,,,,63.6,10,7,122,65,37,989,0,,1,2,4,Westick,1,0,U1.000|3:27-U0.200|1:23-U1.000|3:27-U0.200|1:28-U1.000|3:30-U0.200|1:40-U1.000|3:32-U0.200|1:47-U1.000|3:27-U0.200|2:03-U1.000|3:35-U0.210|2:36-U0.310|0:57-U0.090|1:00-U0.200|0:34-U0.050|0:43,,"Fröndenberg/Ruhr Track Running",,,3113,,250,3,14604016582,0,168070,250480,30378,,72113086,,,,,,,,,,,,,,,,,,,,,,,,,,,,,,,,,,,,,,,,,
92168555,fe5caabe-b036-4661-827f-edcec34aa460,1711482882,60,1711540039,,0,0,2.7,928,933,60,37,63,41,0,1.6,0.54,1.18,0.94,293,187,135,141,,140,6,52.7,31.31,54.71,1,58.89,2428,30,,2,0,98,99,,159,,,,20,79,10.87,10.54,11.41,5.1,14,266,266,,1,286,286,,,,,,,,,"6,14,48,30,2,0,0,0,0","0,99,1,0,0","0,0,80,20,0",,,,,110,,,,,,,,,,,,,,,,,,,,,,,,,,,,,,,,,,,,20.7,9,7,125,66,37,989,0,,1,2,4,Westick,1,0,U1.000|5:47-U1.000|5:37-U0.704|4:03,,"Fröndenberg/Ruhr Running",,,3113,,250,3,14604016671,0,168070,250480,30378,,72113087,,,,,,,,,,,,,,,,,,,,,,,,,,,,,,,,,,,,,,,,5,
92202905,f833b982-6059-4be0-9e26-934af90f10f3,1711560755,60,1711562055,,0,0,15.09,4567,4811,226,218,251,245,0,2.9,0.52,0.99,1.03,410,966,141,157,,155,22,58.31,40.86,59.43,1,58.91,1728,124,,3.3,0.2,104,96,,783,,,,103,80,12.08,12.26,12.35,-0.4,-2.8,298,298,,1,307,307,,,,,,,,,"7,6,10,31,29,12,4,1,0","0,44,56,0,0","0,1,55,43,1",,,,,124,,,,,,,,,,,,,,,,,,,,,,,,,,,,,,,,,,,,31.8,8,8,265,84,99,989,0,,0,4,4,Balve,1,0,U1.000|4:53-U1.000|4:56-U1.000|4:42-U1.000|5:14-U1.000|5:20-U1.000|5:34-U1.000|5:20-U1.000|5:06-U1.000|5:16-U1.000|4:52-U1.000|4:47-U1.000|4:38-U1.000|5:03-U1.000|4:34-U1.000|5:21-U0.090|0:32,,"Balve Running",,,3113,,250,3,14609193898,0,168070,250480,30378,,72142636,,,,,,,,,,,,,,,,,,,,,,,,,,,,,,,,,,,,,,,,"4,4,5",
92281678,8b4d974d-4889-4a3e-804f-e4822d7ca6f1,1711647039,60,1711648281,,0,0,9.43,3163,3766,139,125,167,150,0,1.9,0.42,1.02,1,405,628,138,159,92,153,19,52.82,34.94,53.88,1,58.87,1189,73,,2.8,0,99,98,,546,,,,68,79,10.99,10.98,12.22,1.9,-28.2,265,265,,1,314,314,,,,,,,,,"13,9,27,33,14,4,1,0,0","1,56,43,0,0","2,4,77,16,1",,,,,113,,,,,,,,,,,,,,,,,,,,,,,,,,,,,,,,,,,,26.5,7,18,212,73,96,992,0,,0,4,4,Balve,1,0,U1.000|5:31-U1.000|5:42-U1.000|5:13-U1.000|5:01-U1.000|5:30-U1.000|5:16-U1.000|5:27-U0.298|1:58-U0.144|0:43-U1.000|6:37-U0.992|5:45,,"Balve Running",,,3113,,250,3,14623580400,0,168070,250480,30378,,72215008,,,,,,,,,,,,,,,,,,,,,,,,,,,,,,,,,,,,,,,,"4,5",
92320703,5b51bbf1-8e58-47bd-94ec-645372a6c505,1711702466,60,1711699620,,0,0,1.01,717,729,0,66,0,64,0,1.1,0.79,,0.92,,95,111,148,,148,40,26.77,,24.56,1,58.87,330,13,,0.9,0,,100,,138,,,,5,78,5.41,10.68,9.61,59.5,14.4,136,94,,1,214,205,,,,,,,,,"42,3,8,10,18,16,2,0,0","52,36,12,0,0","63,7,29,0,0",,,,,54,,,,,,,,,,,,,,,,,,,,,,,,,,,,,,,,,,,,6.9,8,22,176,87,98,994,1,,0,4,4,Balve,1,0,U1.000|11:45-U0.009|0:12,,"Balve Running",,,3113,,250,3,14630276332,0,168070,250480,30378,,72250228,,,,,,,,,,,,,,,,,,,,,,,,,,,,,,,,,,,,,,,,,
92328639,654a2c41-fec0-4a95-86e5-d061146ee558,1711703286,60,1711706855,,0,0,20.02,6388,7077,603,551,615,564,0,5.6,0.8,1.04,1.14,606,1378,152,172,,158,22,49.32,39.3,51.32,1,58.82,2329,191,,3.9,0,99,97,,1229,,,,193,80,12.16,12.26,12.59,-1.8,4,291,291,,1,304,304,,,,,,,,,"22,13,14,12,14,14,9,1,0","0,16,62,22,0","0,4,52,43,1",,,,,118,,,,,,,,,,,,,,,,,,,,,,,,,,,,,,,,,,,,54.1,9,21,182,87,97,995,1,,0,4,4,Balve,1,0,U1.000|5:16-U1.000|5:21-U1.000|6:06-U1.000|6:29-U1.000|6:07-U1.000|4:57-U1.000|4:24-U1.000|5:04-U1.000|6:07-U1.000|6:52-U1.000|5:54-U1.000|7:26-U1.000|5:03-U1.000|5:00-U1.000|4:27-U1.000|3:55-U1.000|3:59-U1.000|3:55-U1.000|4:14-U1.000|5:49-U0.017|0:05,,"Balve Running",,,3113,,250,3,14631640572,0,168070,250480,30378,,72257695,,,,,,,,,,,,,,,,,,,,,,,,,,,,,,,,,,,,,,,,"3,4,4,5",
92394369,1cc2631f-ed94-4ae5-a0f8-e5b5a596c7f7,1711783309,60,1711782603,,0,0,7,2299,2407,92,82,98,91,0,1.3,0.35,1.05,0.99,737,483,144,158,,147,9,51.27,35.11,52.19,1,58.77,1313,73,,2.8,0,97,97,,428,,,,56,80,11.15,11.1,11.73,-3.4,-19.5,270,270,,1,292,292,,,,,,,,,"10,8,15,50,15,1,1,0,0","0,25,75,0,0","0,1,87,10,2",,,,,114,,,,,,,,,,,,,,,,,,,,,,,,,,,,,,,,,,,,32.6,10,9,148,84,95,996,0,,0,4,4,Balve,1,0,U1.000|6:02-U1.000|5:13-U1.000|5:21-U1.000|5:18-U1.000|5:04-U1.000|5:13-U1.000|6:07-U0.002|0:01,,"Balve Running",,,3113,,250,3,14645040321,0,168070,250480,30378,,72317635,,,,,,,,,,,,,,,,,,,,,,,,,,,,,,,,,,,,,,,,4,
92541269,d5706899-c1aa-4d62-9274-0735a59b49a9,1711897614,120,1711907911,,0,0,23.81,7514,8471,439,372,473,409,0,3.5,0.59,0.97,1.06,431,1578,144,173,,173,33,53.86,40.33,55.27,1,58.76,2025,190,,3.9,0,100,99,,1425,,,,183,80,11.82,11.72,11.94,1.2,1,290,290,,1,295,295,,,,,,,,,"12,8,12,28,31,9,1,0,0","0,31,64,4,0","0,1,61,38,0",,,,,119,,,,,,,,,,,,,,,,,,,,,,,,,,,,,,,,,,,,46.8,15,9,117,58,83,996,1,,0,4,4,Helle,1,0,U1.000|5:06-U1.000|5:12-U1.000|5:13-U1.000|5:56-U1.000|5:47-U1.000|4:57-U1.000|6:07-U1.000|5:44-U1.000|5:22-U1.000|4:58-U1.000|4:47-U1.000|4:39-U1.000|5:02-U1.000|5:16-U1.000|5:00-U1.000|4:59-U1.000|4:51-U1.000|5:32-U1.000|4:43-U1.000|5:18-U1.000|5:07-U1.000|4:39-U1.000|6:09-U0.813|4:52,,"Balve Running",,,3113,,250,3,14672291509,0,168070,250480,30378,,72449602,,,,,,,,,,,,,,,,,,,,,,,,,,,,,,,,,,,,,,,,"4,4,5",
92613629,9cd15197-6124-4064-adbc-f9873d67b216,1711988212,120,1711986576,,0,0,13.05,4308,4917,418,372,424,376,0,4.8,0.82,1.02,1.12,496,868,136,163,,154,24,54.88,36.5,57.3,1,58.71,1366,109,,3.2,0,100,97,,844,,,,86,81,11.71,11.54,12.47,-12.3,0.4,284,284,,1,307,307,,,,,,,,,"22,17,15,14,17,13,2,0,0","1,60,37,2,0","0,3,64,29,4",0,3,,,112,,,,,,,,,,,,,,,,,,,,,,,,,,,,,,,,,,,,37.3,10,15,255,82,99,999,1,,0,4,4,Balve,1,0,U1.000|5:24-U1.000|5:30-U1.000|6:32-U1.000|6:13-U1.000|6:15-U1.000|5:46-U1.000|5:57-U1.000|5:37-U1.000|4:33-U1.000|4:33-U1.000|4:44-U1.000|4:18-U1.000|6:07-U0.051|0:17,,"Balve Running",,,3113,,250,3,14685843784,0,168070,250480,30378,,72514119,,,,,,,,,,,,,,,,,,,,,,,,,,,,,,,,,,,,,,,,"3,4",
92718926,6a2d6c0e-5e9d-48c2-81e6-af566022b07c,1712087705,120,1712085003,,0,0,2.93,946,946,15,8,16,9,0,0,0.08,1.07,,,203,139,146,111,145,5,54.85,33.91,55.36,1,58.77,3747,38,,2.1,0,98,100,,161,,,,20,80,11.23,11.22,11.34,1.9,4.9,278,278,,1,282,282,,,,,,,,,"2,5,33,43,14,3,0,0,0","0,46,54,0,0","0,0,83,17,0",0,4,,,116,,,,,,,,,,,,,,,,,,,,,,,,,,,,,,,,,,,,21.2,9,20,234,83,92,1008,0,,0,4,4,Westick,1,0,U1.000|5:43-U1.000|5:11-U0.927|4:52,,"Fröndenberg/Ruhr Running",,,3113,,250,3,14704739897,0,168070,250480,30378,,72609045,,,,,,,,,,,,,,,,,,,,,,,,,,,,,,,,,,,,,,,,,
92718927,838d0f82-4320-4137-8995-d8543783fe69,1712082794,120,1712085002,,0,0,5.95,1896,2307,53,48,65,58,0,0,0.24,1.14,0.51,,399,139,164,,159,39,55.75,36.03,56.42,1,58.77,1106,98,,2.9,1.3,103,103,,330,,,,42,80,11.25,13.06,13.56,18.9,-26.3,292,289,,1,366,365,,,,,,,,,"21,2,5,7,27,30,2,4,3","6,26,67,1,0","12,7,15,59,6",0,3,,,118,,,,,,,,,,,,,,,,,,,,,,,,,,,,,,,,,,,,32,10,20,233,77,82,1008,0,,0,4,4,Westick,1,0,U1.000|4:42-U1.000|4:28-U1.000|4:33-U1.000|4:31-U1.000|5:12-U0.314|4:23-U0.096|0:18-U0.030|0:21-U0.097|0:18-U0.028|0:21-U0.121|0:37-U0.099|0:19-U0.026|0:19-U0.095|0:18-U0.044|0:55,,"Fröndenberg/Ruhr Running",,,3113,,250,3,14704739393,0,168070,250480,30378,,72609046,,,,,,,,,,,,,,,,,,,,,,,,,,,,,,,,,,,,,,,,,
92718929,308d4ae2-9ca5-4111-b69e-eb1ab956a1b4,1712085199,120,1712085003,,0,0,6.7,2191,2191,0,0,0,0,0,0,0,,,,461,148,188,,180,56,49.66,35.19,49.66,1,58.78,2962,191,,3.2,2.9,108,107,,371,,,,68,76,11,14.2,14.2,4.9,-0.5,284,284,,1,387,387,,,,,,,,,"50,1,1,0,1,2,14,28,2","0,42,13,36,9","29,19,4,4,44",0,1,,,121,,,,,,,,,,,,,,,,,,,,,,,,,,,,,,,,,,,,65.5,9,21,234,83,89,1008,0,,0,4,4,Westick,1,0,U0.200|0:45-U0.200|0:42-U0.190|0:40-U0.200|0:39-U0.200|0:38-U0.410|4:37-U0.210|0:45-U0.200|0:44-U0.210|0:40-U0.200|0:39-U0.200|0:38-U0.400|4:47-U0.210|0:45-U0.200|0:42-U0.200|0:41-U0.200|0:38-U0.200|0:37-U0.410|4:25-U0.200|0:44-U0.200|0:43-U0.200|0:40-U0.200|0:38-U0.200|0:38-U0.410|4:48-U0.200|0:44-U0.200|0:42-U0.200|0:40-U0.200|0:39-U0.200|0:41-U0.050|0:52,,"Fröndenberg/Ruhr Track Running",,,3113,,250,3,14704739798,0,168070,250480,30378,,72609048,,,,,,,,,,,,,,,,,,,,,,,,,,,,,,,,,,,,,,,,,
92771632,28933723-9a3a-4c04-be89-10e8f0e0aa8e,1712152016,120,1712150396,,0,0,16.31,4925,5224,378,364,391,384,0,3.6,0.71,1,1.07,427,1119,151,170,,161,22,53.28,41.23,54.87,1,58.77,4037,180,,3.8,0,99,99,,1051,,,,151,81,12.39,12.38,12.59,-3.5,4,306,306,,1,313,313,,,,,,,,,"9,7,13,23,23,19,5,0,0","0,10,77,13,0","0,0,44,55,1",0,3,,,123,,,,,,,,,,,,,,,,,,,,,,,,,,,,,,,,,,,,62.1,10,18,204,83,97,1006,2,,0,4,4,Balve,1,0,U1.000|5:36-U1.000|4:37-U1.000|5:08-U1.000|5:05-U1.000|5:05-U1.000|5:18-U1.000|5:40-U1.000|6:34-U1.000|5:42-U1.000|5:04-U1.000|4:23-U1.000|4:03-U1.000|4:02-U1.000|4:29-U1.000|5:18-U1.000|4:41-U0.308|1:22,,"Balve Running",,,3113,,250,3,14714748021,0,168070,250480,30378,,72656637,,,,,,,,,,,,,,,,,,,,,,,,,,,,,,,,,,,,,,,,"4,5",
92893018,31ea6371-92ba-4f2f-a652-f9bdc3688176,1712253554,120,1712252181,,0,0,14.63,4655,4899,293,282,307,300,0,3.3,0.66,0.96,1.03,445,984,143,169,,169,22,53.81,38.45,55.19,1,58.76,2601,136,,3.3,0.8,100,97,,986,,,,107,80,11.77,11.91,11.93,-6.9,-3.5,287,287,,1,293,293,,,,,,,,,"16,12,15,19,23,11,4,1,0","1,40,58,2,0","0,1,69,28,2",0,3,,,118,,,,,,,,,,,,,,,,,,,,,,,,,,,,,,,,,,,,32.3,12,20,241,79,43,1009,0,,0,3,4,Balve,1,0,U1.000|5:12-U1.000|5:14-U1.000|6:24-U1.000|6:13-U1.000|6:02-U1.000|6:27-U1.000|5:02-U1.000|4:25-U1.000|4:22-U1.000|4:28-U1.000|4:47-U0.444|2:16-U1.000|4:20-U1.000|5:10-U1.000|6:07-U0.186|1:06,,"Balve Running",,,3113,,250,3,14734382952,0,168070,250480,30378,,72763120,,,,,,,,,,,,,,,,,,,,,,,,,,,,,,,,,,,,,,,,"4,5",
92960087,1d2d6bf7-b5f2-460e-b53d-da3ee94e3673,1712323085,120,1712318717,,0,0,8.07,2635,2695,122,141,133,154,0,2.1,0.62,0.98,1.03,377,577,147,162,,154,18,50.22,35.68,51.01,1,58.72,1602,87,,3,0,96,98,,576,,,,67,80,11.26,11.43,11.49,0,-3.3,274,274,,1,281,281,,,,,,,,,"16,9,17,30,21,7,1,0,0","0,13,84,2,0","0,2,80,18,0",,,,,115,,,,,,,,,,,,,,,,,,,,,,,,,,,,,,,,,,,,35.8,16,23,193,74,96,1009,3,,0,4,4,Balve,1,0,U1.000|5:39-U1.000|5:01-U1.000|5:29-U1.000|5:21-U1.000|5:17-U1.000|6:28-U1.000|5:58-U1.000|4:21-U0.073|0:20,,"Balve Running",,,3113,,250,3,14744576980,0,168070,250480,30378,,72823400,,,,,,,,,,,,,,,,,,,,,,,,,,,,,,,,,,,,,,,,4,
93127681,7604178e-8479-4b2d-942b-8abb99f5b86f,1712402569,120,1712493975,,0,0,3.14,1007,1007,13,7,38,32,0,0,0.06,,,,227,151,159,127,158,7,49.47,34.36,49.84,1,58.71,2752,49,,2.3,0,96,96,,267,,,,29,80,11.35,11.3,11.38,0.8,0.7,279,279,,1,281,281,,,,,,,,,"3,3,23,49,21,0,0,0,0","0,3,97,0,0","0,0,83,17,0",,,,,117,,,,,,,,,,,,,,,,,,,,,,,,,,,,,,,,,,,,35.8,19,19,179,61,81,1013,3,,0,4,4,Westick,1,0,U1.000|5:26-U1.000|5:17-U1.000|5:19-U0.143|0:45,,"Fröndenberg/Ruhr Running",,,3113,,250,3,14779146779,0,168070,250480,30378,,72973184,,,,,,,,,,,,,,,,,,,,,,,,,,,,,,,,,,,,,,,,,
93127772,72f5e34b-0902-478e-81c1-dd448edf04c5,1712492746,120,1712493985,,0,0,22.82,7255,8038,668,651,695,686,0,5.3,0.8,1.01,1.15,518,1534,146,168,,155,17,52.38,39.86,54.33,1,58.71,2608,181,,3.9,0,97,99,,1696,,,,184,80,12.22,12.35,12.69,0.1,2.2,293,293,,1,306,306,,,,,,,,,"19,14,18,11,12,14,10,1,0","1,21,74,4,0","0,1,63,35,1",,,,,118,,,,,,,,,,,,,,,,,,,,,,,,,,,,,,,,,,,,45.9,19,18,222,52,77,1016,3,,0,4,4,Balve,1,0,U1.000|6:05-U1.000|6:15-U1.000|5:56-U1.000|7:18-U1.000|5:10-U1.000|5:42-U1.000|5:14-U1.000|4:31-U1.000|5:31-U1.000|5:30-U1.000|4:39-U1.000|4:30-U1.000|4:24-U1.000|6:13-U1.000|6:17-U1.000|5:42-U1.000|5:42-U1.000|4:50-U1.000|4:16-U1.000|3:58-U1.000|4:03-U1.000|4:02-U0.817|5:08,,"Balve Running",,,3113,,250,3,14779147431,0,168070,250480,30378,,72973262,,,,,,,,,,,,,,,,,,,,,,,,,,,,,,,,,,,,,,,,"3,4,4,5",
93127911,d005df3a-87a3-497c-934e-93935241445b,1712400340,120,1712494000,,0,0,6.31,1805,1805,0,0,0,0,0,0,0,,,,431,163,184,,176,42,50.95,41.08,50.95,1,58.74,2304,193,,3.4,2.5,104,101,,501,,,,76,79,12.58,14.87,14.87,11,1.8,329,329,,1,398,398,,,,,,,,,"29,2,2,1,1,2,35,27,0","0,23,9,41,27","25,4,6,3,62",,,,,133,,,,,,,,,,,,,,,,,,,,,,,,,,,,,,,,,,,,104.6,17,17,173,66,76,1013,2,,0,4,4,Westick,1,0,U0.990|3:35-U1.000|3:32-U1.000|3:34-U0.470|8:06-U1.000|3:32-U0.200|1:15-U1.000|3:31-U0.200|1:24-U0.450|1:36,,"Fröndenberg/Ruhr Track Running",,,3113,,250,3,14779146488,0,168070,250480,30378,,72973382,,,,,,,,,,,,,,,,,,,,,,,,,,,,,,,,,,,,,,,,,
93128048,829ba8cd-b958-480c-a8c3-8c7343c71a4a,1712398215,120,1712494023,,0,0,4.18,1315,1714,26,35,34,44,0,0,0.15,,0.72,,284,146,162,109,156,43,53.07,35.82,53.33,1,58.71,1058,76,,2.6,0.7,99,99,,286,,,,35,77,11.37,12.34,12.52,11.5,-15.5,282,282,,1,324,324,,,,,,,,,"19,0,1,9,55,13,0,1,2","1,23,76,0,0","13,6,11,68,3",,,,,124,,,,,,,,,,,,,,,,,,,,,,,,,,,,,,,,,,,,40.1,17,17,173,66,76,1013,2,,0,4,4,Westick,1,0,U1.000|4:56-U1.000|4:43-U1.000|4:40-U1.000|6:22-U0.178|1:14,,"Fröndenberg/Ruhr Running",,,3113,,250,3,14779146060,0,168070,250480,30378,,72973497,,,,,,,,,,,,,,,,,,,,,,,,,,,,,,,,,,,,,,,,,
93138349,24045370-d8b5-400c-b865-5a08b71e2cb0,1689443516,120,1712501496,,0,0,19.51,2770,3095,274,274,319,320,0,2.5,0.51,,,675,204,,,,,,,,,1,,,,,,,,,190,,,,,20,84,,30.71,,,,84,74,,0,90,86,,,,,,,,,"26,15,13,9,10,11,16",,"73,27,0,0,0",,,,,,,,,,,,,,,,,,,,,100,,,,,,,,,,,,,,,,,,,,,24,20,196,70,48,1008,2,,0,3,4,Balve,1,0,,,,,,,,258,7,,0,168072,,30378,,72981883,,,,,,,,,,,,,,,,,,,,,,,,,,,,,,,,,,,,,,,,"5,5,5",
93222112,d0085e80-da4d-4816-8c5d-2703ca26ba8f,1712585924,120,1712584626,,0,0,44.57,5596,5880,111,104,116,124,0,0,0.09,,,,1196,,,,,,,,,1,,,,,,,,,190,,,,,67,86,,29.44,,,,114,110,,1,142,140,,,,,,,,,"2,4,9,36,47,1,1",,"36,58,5,0,0",,,,,,,,,,,,,,,,,,,,,,,,,,,,,,,,,,,,,,,,,,18,8,152,69,96,1008,3,,0,4,4,Beek,1,0,,,,,,,,258,7,,0,168072,,30378,,73055864,,,,,,,,,,,,,,,,,,,,,,,,,,,,,,,,,,,,,,,,,
93291011,26650270-6b90-4d8b-a465-4fd7d7ddaefe,1712596279,120,1712652991,,0,0,1.9,593,609,3,12,4,14,0,0,0.01,,,,126,133,143,,142,8,60.48,33.9,60.25,1,58.73,997,24,,1.7,0,103,103,,137,,,,12,79,11.39,11.59,11.44,-0.9,-2.8,276,276,,1,279,279,,,,,,,,,"3,4,13,44,34,2,0,0,0","2,94,5,0,0","0,0,78,22,0",,,,,122,,,,,,,,,,,,,,,,,,,,,,,,,,,,,,,,,,,,16.3,19,11,157,68,54,1006,2,,0,3,4,Beek,1,0,U1.000|5:19-U0.898|4:34,,"Berg en Dal Running",,,3113,,250,3,14808253295,0,168070,250480,30378,,73117381,,,,,,,,,,,,,,,,,,,,,,,,,,,,,,,,,,,,,,,,,
93295653,59a1b57e-a81a-48af-95ca-04a8d03e888b,1712661861,120,1712656910,,0,0,5.31,2041,2050,184,202,201,219,0,3.3,0.81,0.98,0.89,477,392,137,163,95,163,38,45.07,28.58,46.81,1,58.7,829,54,,2.4,0,99,98,,355,,,,46,81,10.08,9.59,10.58,12.9,10.2,232,232,,1,255,255,,,,,,,,,"47,10,19,13,9,3,0,0,0","1,55,42,2,0","6,22,53,19,0",,,,,96,,,,,,,,,,,,,,,,,,,,,,,,,,,,,,,,,,,,32.9,11,30,215,67,86,1009,2,,0,11,4,Beek,1,0,U1.000|6:12-U1.000|6:13-U1.000|6:29-U1.000|7:02-U1.000|6:37-U0.305|1:28,,"Berg en Dal Running",,,3113,,250,3,14808932354,0,168070,250480,30378,,73121534,,,,,,,,,,,,,,,,,,,,,,,,,,,,,,,,,,,,,,,,"4,4,5",
93382653,00496d2b-18ab-4cea-aa3e-a6a8b84fc050,1712748052,120,1712742181,,0,0,4.66,962,1304,103,98,108,104,0,1.9,0.7,,,698,205,,,,,,,,,1,,,,,,,,,190,,,,,14,,,24.72,,,,111,86,,1,133,124,,,,,,,,,"58,17,9,5,1,3,7",,"52,48,1,0,0",,,,,,,,,,,,,,,,,,,,,,,,,,,,,,,,,,,,,,,,,,11,16,254,66,44,1028,3,,0,3,4,Beek,1,0,,,,,,,,258,7,,0,168072,,30378,,73199587,,,,,,,,,,,,,,,,,,,,,,,,,,,,,,,,,,,,,,,,4,
93385783,05c49cec-368d-4eb6-aa8b-20d6e5e9da25,1712748226,120,1712746129,,0,0,15.28,4746,5018,266,249,304,300,0,1.7,0.44,0.94,0.95,400,1042,151,169,,161,18,51.46,39.69,52.64,1,58.71,1584,161,,3.6,0.1,104,98,,926,,,,147,81,11.98,11.86,12.2,-0.3,2.3,293,293,,1,302,302,,,,,,,,,"15,7,11,16,28,19,4,0,0","0,10,78,12,0","1,7,37,55,1",,,,,119,,,,,,,,,,,,,,,,,,,,,,,,,,,,,,,,,,,,53.1,12,16,246,68,60,1027,,,0,4,1,Beek,1,0,U1.000|4:54-U1.000|6:07-U1.000|4:53-U1.000|5:48-U1.000|5:49-U1.000|5:45-U1.000|5:05-U1.000|4:27-U1.000|4:29-U1.000|5:24-U1.000|4:44-U1.000|4:51-U1.000|5:42-U1.000|4:49-U1.000|4:55-U0.276|1:23,,"Berg en Dal Running",,,3113,,250,3,14826423086,0,168070,250480,30378,,73202499,,,,,,,,,,,,,,,,,,,,,,,,,,,,,,,,,,,,,,,,"4,5,5",
93535148,456341c8-2609-46f9-918f-c592abea92f2,1712859469,120,1712856852,,0,0,15.12,4146,4285,80,65,118,104,0,0,0.12,0.99,0.96,,1005,158,196,96,196,48,56.23,45.83,56.67,1,58.72,3456,300,,4.7,1.9,101,101,,859,,,,136,81,13.22,14,14.05,11.7,9,332,332,,1,361,361,,,,,,,,,"7,2,7,18,21,14,24,6,1","0,13,42,42,3","1,3,32,40,24",,,,,135,,,,,,,,,,,,,,,,,,,,,,,,,,,,,,,,,,,,99.4,13,7,231,75,90,1032,0,,0,4,4,Amecke,1,0,U1.000|5:03-U1.000|4:43-U1.000|4:33-U1.000|3:39-U1.000|3:45-U1.000|3:45-U1.000|4:38-U1.000|3:53-U1.000|3:47-U1.000|3:52-U1.000|6:10-U1.000|5:43-U1.000|5:18-U1.000|4:44-U1.000|4:57-U0.117|0:36,,"Sundern (Sauerland) Running",,,3113,,250,3,14849349902,0,168070,250480,30378,,73338206,,,,,,,,,,,,,,,,,,,,,,,,,,,,,,,,,,,,,,,,,
93601814,bf98a9f3-341a-4b9a-86cc-0d6848e158c7,1712932084,120,1712928889,,0,0,11.45,3319,3665,183,149,202,166,0,1.8,0.48,0.96,1.02,394,745,150,180,,175,27,56.56,42.06,57.89,1,58.73,2880,193,,3.5,2.3,100,100,,729,,,,101,81,12.85,13.26,13.35,-2.2,-9,316,316,,1,336,336,,,,,,,,,"7,5,13,19,28,15,7,6,0","0,19,66,14,0","0,0,46,43,12",,,,,128,,,,,,,,,,,,,,,,,,,,,,,,,,,,,,,,,,,,81.4,17,16,245,70,92,1030,3,,0,4,4,Balve,1,0,U1.000|5:27-U1.000|4:30-U1.000|4:53-U1.000|5:00-U1.000|5:04-U1.000|5:11-U1.000|4:59-U1.000|4:42-U0.214|1:03-U1.000|3:24-U1.000|3:37-U1.000|6:04-U0.240|1:24,,"Balve Running",,,3113,,250,3,14861502088,0,168070,250480,30378,,73399337,,,,,,,,,,,,,,,,,,,,,,,,,,,,,,,,,,,,,,,,"5,5",
93656950,81cbab24-6df4-496b-aae8-0f04c5e49649,1712994263,120,1712992171,,0,0,14.18,4656,5007,379,363,392,378,0,4,0.82,0.96,1.14,440,963,148,164,,159,19,49.41,36.97,51.11,1,58.7,2320,127,,3.4,0,98,96,,864,,,,124,81,11.8,12.32,12.11,-17.6,-7.9,278,278,,1,282,282,,,,,,,,,"31,17,9,13,8,14,7,2,0","0,18,80,2,0","0,1,82,17,0",,,,,113,,,,,,,,,,,,,,,,,,,,,,,,,,,,,,,,,,,,39.7,13,9,207,85,84,1027,0,,0,4,4,Balve,1,0,U1.000|5:34-U1.000|5:24-U1.000|6:49-U1.000|6:36-U1.000|6:18-U1.000|6:19-U1.000|6:42-U1.000|6:14-U1.000|4:45-U1.000|4:20-U1.000|4:12-U1.000|4:07-U1.000|3:40-U1.000|5:34-U0.183|1:01,,"Balve Running",,,3113,,250,3,14871857828,0,168070,250480,30378,,73450065,,,,,,,,,,,,,,,,,,,,,,,,,,,,,,,,,,,,,,,,3,
93749467,40ccfb30-952e-4ab0-80e6-3fec4711e911,1713082095,120,1713080016,,0,0,17.02,4973,4984,59,60,113,113,0,0,0.11,,0.91,,1100,147,158,,149,15,57.59,42.98,57.84,1,58.72,2016,158,,3.6,0,97,102,,896,,,,137,80,12.35,12.36,12.4,-0.2,-0.5,307,307,,1,310,310,,,,,,,,,"2,1,4,23,58,11,1,0,0","0,6,93,0,0","0,1,29,70,0",,,,,128,,,,,,,,,,,,,,,,,,,,,,,,,,,,,,,,,,,,38.6,12,11,281,75,93,1022,0,,0,4,4,"Bad Godesberg",1,0,U1.000|5:01-U1.000|4:51-U1.000|4:35-U1.000|4:43-U1.000|4:53-U1.000|5:06-U1.000|4:58-U1.000|4:54-U1.000|5:02-U1.000|4:46-U1.000|4:45-U1.000|4:50-U1.000|4:43-U1.000|4:41-U1.000|4:54-U1.000|5:06-U1.000|4:57-U0.016|0:06,,"Bonn Running",,,3113,,250,3,14889328888,0,168070,250480,30378,,73533387,,,,,,,,,,,,,,,,,,,,,,,,,,,,,,,,,,,,,,,,,
93881252,f771f0da-b7ce-445a-a2af-d12f5d0a6755,1713202456,120,1713201275,,0,0,15.37,5017,5669,322,315,338,327,0,3.5,0.73,0.98,1.01,462,1018,139,154,,146,14,54.12,37.47,55.55,1,58.68,1301,107,,3.2,0,98,98,,746,,,,119,81,11.56,11.66,11.73,-1,6.1,284,284,,1,289,289,,,,,,,,,"19,13,24,14,17,11,3,0,0","1,48,51,0,0","0,2,64,34,0",,,,,113,,,,,,,,,,,,,,,,,,,,,,,,,,,,,,,,,,,,35.4,7,27,257,82,97,1001,1,,0,11,4,Balve,1,0,U1.000|5:54-U1.000|4:46-U1.000|5:32-U1.000|5:40-U1.000|5:57-U1.000|6:13-U1.000|6:29-U1.000|7:16-U1.000|5:45-U1.000|4:37-U1.000|4:14-U1.000|4:17-U1.000|4:38-U1.000|5:35-U1.000|4:59-U0.372|1:46,,"Balve Running",,,3113,,250,3,14915323132,0,168070,250480,30378,,73648874,,,,,,,,,,,,,,,,,,,,,,,,,,,,,,,,,,,,,,,,"4,5",
93985193,6408331b-f0dc-4ace-9a85-be259807028f,1713292336,120,1713292415,,0,0,5.46,1658,2094,8,26,12,30,0,0,0.09,,0.99,,357,139,151,,146,23,59.16,37.96,59.03,1,58.74,932,86,,2.6,1.4,104,103,,313,,,,40,79,11.78,12.64,12.56,6.9,-11.8,298,298,,1,328,328,,,,,,,,,"16,5,7,11,35,22,1,1,2","1,41,58,0,0","2,10,26,58,4",,,,,125,,,,,,,,,,,,,,,,,,,,,,,,,,,,,,,,,,,,34.2,9,10,329,78,91,1005,0,,0,4,4,Westick,1,0,U1.000|5:02-U1.000|4:36-U1.000|4:30-U1.000|4:36-U1.000|5:52-U0.455|3:02,,"Fröndenberg/Ruhr Running",,,3113,,250,3,14933093335,0,168070,250480,30378,,73741312,,,,,,,,,,,,,,,,,,,,,,,,,,,,,,,,,,,,,,,,,
93985252,fc6fb2cf-513b-449e-996c-64acce7eeca0,1713294481,120,1713292447,,0,0,6.83,1892,1892,0,0,0,0,0,0,0,,,,461,157,183,,175,54,56.05,42.87,56.05,1,58.75,3378,194,,3.2,2.9,107,109,,341,,,,70,83,12.99,14.46,14.46,4.3,-2.9,346,346,,1,396,396,,,,,,,,,"36,6,4,2,1,2,8,37,5","0,25,18,55,2","7,17,21,10,45",,,,,130,,,,,,,,,,,,,,,,,,,,,,,,,,,,,,,,,,,,70.8,8,10,323,79,94,1005,0,,0,4,4,Westick,1,0,U0.400|1:20-U0.100|0:40-U0.400|1:18-U0.100|0:36-U0.410|1:19-U0.400|2:58-U0.400|1:19-U0.100|0:43-U0.400|1:18-U0.100|0:38-U0.400|1:20-U0.400|3:12-U0.400|1:18-U0.100|0:48-U0.400|1:18-U0.100|0:45-U0.400|1:19-U0.400|3:20-U0.400|1:19-U0.100|0:50-U0.400|1:19-U0.100|0:47-U0.400|1:14-U0.020|0:34,,"Fröndenberg/Ruhr Track Running",,,3113,,250,3,14933102321,0,168070,250480,30378,,73741368,,,,,,,,,,,,,,,,,,,,,,,,,,,,,,,,,,,,,,,,,
93985267,82d4a7c9-4d49-48a3-b900-03208078e7a3,1713296788,120,1713292455,,0,0,3.89,1498,1517,23,23,24,26,0,0,0.16,0.84,0.41,,288,133,174,,165,54,46.67,28,47.01,1,58.75,4320,52,,2.4,0,104,105,,240,,,,33,78,9.4,12.39,12.45,32.1,38.1,239,235,,1,338,336,,,,,,,,,"42,25,5,0,2,14,7,5,0","2,66,27,6,0","16,11,48,10,15",,,,,100,,,,,,,,,,,,,,,,,,,,,,,,,,,,,,,,,,,,37.4,8,8,312,81,96,1005,0,,0,4,4,Westick,1,0,U0.410|1:42-U0.104|0:48-U0.414|1:46-U0.103|0:51-U0.421|1:43-U0.084|0:57-U0.409|1:22-U1.000|9:47-U0.948|6:02,,"Fröndenberg/Ruhr Running",,,3113,,250,3,14933105808,0,168070,250480,30378,,73741383,,,,,,,,,,,,,,,,,,,,,,,,,,,,,,,,,,,,,,,,,
94049136,3a071f20-1e6e-4d42-b9e2-1efff5562c0f,1713362281,120,1713360330,,0,0,15.4,4923,5170,316,318,329,332,0,3.5,0.69,1,1.08,674,1045,140,156,,142,21,55.01,38.4,56.4,1,58.75,3170,120,,3.3,0,96,99,,927,,,,110,80,11.75,11.74,11.86,-5.6,0.8,290,290,,1,293,293,,,,,,,,,"16,9,15,28,19,10,3,0,0","1,48,51,0,0","0,1,57,42,0",,,,,117,,,,,,,,,,,,,,,,,,,,,,,,,,,,,,,,,,,,33.4,7,9,298,78,98,1011,2,,0,4,4,Balve,1,0,U1.000|5:49-U1.000|4:50-U1.000|5:17-U1.000|5:13-U1.000|5:22-U1.000|5:44-U1.000|6:10-U1.000|7:10-U1.000|5:57-U1.000|4:47-U1.000|4:14-U1.000|4:13-U1.000|4:37-U1.000|5:36-U1.000|5:08-U0.399|1:58,,"Balve Running",,,3113,,250,3,14944438572,0,168070,250480,30378,,73795687,,,,,,,,,,,,,,,,,,,,,,,,,,,,,,,,,,,,,,,,4,
94153978,ff00077f-5a9f-449d-9f66-c5e7c5f4cce7,1713464248,120,1713464367,,0,0,15.49,6770,7187,540,518,577,556,0,5.2,0.66,1.27,0.69,453,1192,134,175,,175,49,39.54,26.49,41.32,1,58.73,2167,150,,3.4,1.4,99,99,,1096,,,,135,76,8.6,9.86,12.89,33.1,-8.2,211,211,,1,349,348,,,,,,,,,"53,7,10,17,8,3,1,0,0","1,62,33,3,0","27,18,35,11,8",,,,,90,,,,,,,,,,,,,,,,,,,,,,,,,,,,,,,,,,,,35.5,8,11,297,62,94,1019,0,,0,4,4,Balve,1,0,U1.000|5:37-U1.000|5:47-U1.000|5:27-U1.000|4:58-U1.000|5:28-U1.000|5:10-U1.000|5:15-U0.263|1:46-U0.163|0:43-U0.215|2:15-U0.148|0:43-U0.202|1:27-U0.145|0:43-U0.194|1:35-U0.143|0:42-U0.200|1:43-U0.145|0:43-U0.204|1:48-U0.138|0:41-U0.186|1:36-U0.142|0:43-U0.197|1:48-U0.141|0:43-U0.183|1:42-U0.141|0:43-U0.192|1:51-U0.137|0:44-U0.209|5:26-U0.141|0:41-U0.179|3:00-U0.140|0:40-U0.186|2:19-U0.146|0:43-U0.188|1:59-U0.140|0:45-U0.181|2:14-U0.139|0:44-U0.185|2:22-U0.138|0:41-U0.201|2:24-U0.141|0:43-U0.189|2:29-U0.139|0:42-U0.190|3:00-U0.136|0:43-U0.182|2:45-U0.136|0:39-U1.000|10:01-U0.724|5:32,,"Balve Running",,,3113,,250,3,14964901707,0,168070,250480,30378,,73890078,,,,,,,,,,,,,,,,,,,,,,,,,,,,,,,,,,,,,,,,"4,4,4,4,5,5,5,5,5,5",
94219612,0c45cc31-895d-43bb-9d47-3926ff40e4e9,1713537655,120,1713542077,,0,0,14.69,4966,5300,263,261,286,289,0,2.7,0.59,0.99,1.04,535,988,136,154,,139,27,53.3,35.83,54.48,1,58.72,1593,115,,3.2,0,100,99,,799,,,,101,80,11.02,11.13,11.37,5.4,5.3,266,266,,1,278,278,,,,,,,,,"16,13,15,26,24,5,0,0,0","1,60,39,0,0","3,7,64,26,0",,,,,111,,,,,,,,,,,,,,,,,,,,,,,,,,,,,,,,,,,,27.4,7,18,298,85,98,1007,2,,0,6,4,Balve,1,0,U1.000|5:44-U1.000|4:48-U1.000|5:17-U1.000|5:11-U1.000|5:17-U1.000|5:35-U1.000|6:13-U1.000|4:53-U1.000|5:13-U1.000|5:44-U1.000|5:12-U1.000|5:00-U1.000|6:05-U1.000|6:54-U0.686|5:40,,"Balve Running",,,3113,,250,3,14977377376,0,168070,250480,30378,,73947353,,,,,,,,,,,,,,,,,,,,,,,,,,,,,,,,,,,,,,,,"4,5",
94323778,4780610b-bd07-4ce7-a0cc-10e0a1898caa,1713636112,120,1713647044,,0,0,9.53,3570,3674,103,109,126,133,0,1,0.39,1.03,0.97,507,668,136,154,,153,21,46.96,30.68,47.55,1,58.64,921,58,,2.5,0,95,95,,636,,,,72,78,9.73,9.69,9.88,-3.9,-7.9,233,233,,1,239,239,,,,,,,,,"32,32,24,9,3,0,0,0,0","0,74,26,0,0","0,16,82,2,0",,,,,103,,,,,,,,,,,,,,,,,,,,,,,,,,,,,,,,,,,,22.6,6,13,294,84,89,1020,0,,0,4,4,Balve,1,0,U1.000|6:34-U1.000|6:15-U1.000|5:58-U1.000|6:08-U1.000|6:16-U1.000|5:58-U1.000|6:05-U1.000|6:14-U1.000|6:27-U0.527|3:36,,"Balve Running",,,3113,,250,3,14997042556,0,168070,250480,30378,,74043746,,,,,,,,,,,,,,,,,,,,,,,,,,,,,,,,,,,,,,,,5,
94399036,9587ad6a-5ba3-4d91-9d49-09bb8ca466bd,1713719472,120,1713731772,,0,0,14.21,4531,5019,436,413,450,428,0,4.8,0.9,1.12,1.09,512,989,145,176,,173,27,52.68,38.27,54.79,1,58.63,2020,190,,3.9,0.6,100,100,,869,,,,121,81,11.96,11.93,13.43,-1.3,11.6,294,294,,1,347,347,,,,,,,,,"17,7,13,22,27,10,3,1,0","0,49,21,30,0","0,9,56,16,19",,,,,116,,,,,,,,,,,,,,,,,,,,,,,,,,,,,,,,,,,,68.1,6,15,38,58,41,1024,1,,0,3,4,Balve,1,0,U1.000|5:29-U1.000|5:15-U0.537|3:13-U0.189|1:01-U0.087|0:37-U0.391|2:02-U0.119|1:01-U0.674|3:01-U0.223|1:31-U0.238|1:01-U0.094|0:31-U0.417|2:00-U0.134|1:01-U0.607|3:02-U0.231|1:32-U0.251|1:06-U0.063|0:31-U0.353|2:03-U0.140|1:01-U0.694|3:00-U0.227|1:36-U1.000|4:53-U1.000|4:58-U1.000|4:40-U1.000|4:50-U0.315|1:27-U1.000|4:53-U1.000|6:49-U0.223|1:27,,"Balve Running",,,3113,,250,3,15013821268,0,168070,250480,30378,,74111655,,,,,,,,,,,,,,,,,,,,,,,,,,,,,,,,,,,,,,,,"3,5",
94472260,4ecbbac2-6254-4656-b485-9b3c8128347a,1713810806,120,1713811249,,0,0,13.16,4243,4278,249,204,279,234,0,3,0.61,1.03,1.05,415,876,139,157,105,156,21,54.95,37.55,56.47,1,58.63,1339,103,,3.1,0,103,100,,739,,,,97,80,11.6,11.46,12.12,-6.4,-5.8,289,289,,1,306,306,,,,,,,,,"12,9,18,32,18,9,1,0,0","0,56,43,0,0","0,4,59,34,3",,,,,116,,,,,,,,,,,,,,,,,,,,,,,,,,,,,,,,,,,,31.6,6,9,38,53,33,1022,0,,0,2,4,Helle,1,0,U1.000|5:21-U1.000|5:28-U1.000|5:43-U1.000|5:47-U1.000|6:02-U1.000|5:10-U1.000|5:02-U1.000|5:20-U1.000|5:17-U1.000|4:41-U1.000|5:13-U1.000|5:36-U1.000|5:12-U0.158|0:51,,"Balve Running",,,3113,,250,3,15026904872,0,168070,250480,30378,,74178745,,,,,,,,,,,,,,,,,,,,,,,,,,,,,,,,,,,,,,,,"4,5",
94558567,9d194ce9-1e37-4a3c-8b16-14a28ec6360e,1713897125,120,1713896489,,0,0,5.43,1823,2166,26,34,36,43,0,0,0.15,1.14,0.55,,370,141,160,,155,31,51.31,33.67,51.52,1,58.68,1106,90,,2.9,0.7,101,100,,317,,,,40,80,10.9,12.85,13.1,18.8,-19.9,290,267,,1,344,342,,,,,,,,,"19,4,6,12,30,23,2,3,1","7,20,73,0,0","13,10,23,50,4",,,,,112,,,,,,,,,,,,,,,,,,,,,,,,,,,,,,,,,,,,32.3,7,8,304,54,81,1017,1,,0,4,4,Westick,1,0,U1.000|5:01-U1.000|4:39-U1.000|4:32-U1.000|4:31-U0.178|0:50-U0.400|2:17-U0.142|0:28-U0.271|1:54-U0.436|6:12,,"Fröndenberg/Ruhr Running",,,3113,,250,3,15042988640,0,168070,250480,30378,,74254778,,,,,,,,,,,,,,,,,,,,,,,,,,,,,,,,,,,,,,,,,
94558680,448172fe-f03c-4f83-b3bc-6571c5abe263,1713899320,120,1713896573,,0,0,9,2859,2859,0,0,0,0,0,0,0,,,,620,150,178,,172,49,50.52,37.13,50.52,1,58.7,3662,229,,3.4,3,99,112,,491,,,,84,83,11.33,13.52,13.52,17.3,4,290,290,,1,358,358,,,,,,,,,"41,6,5,3,2,3,14,25,2","4,29,22,45,0","15,19,19,10,37",,,,,114,,,,,,,,,,,,,,,,,,,,,,,,,,,,,,,,,,,,57.9,6,6,267,60,59,1016,0,,0,3,4,Westick,1,0,U0.500|1:42-U0.210|1:12-U0.400|1:19-U0.090|0:37-U0.300|0:56-U0.410|2:52-U0.500|1:40-U0.190|1:12-U0.400|1:20-U0.100|0:36-U0.300|0:57-U0.260|3:05-U0.500|1:43-U0.200|1:18-U0.400|1:24-U0.100|0:45-U0.300|1:02-U0.400|3:05-U0.500|1:42-U0.200|1:32-U0.400|1:26-U0.100|0:58-U0.300|1:01-U0.400|3:14-U0.500|1:50-U0.200|1:40-U0.400|1:26-U0.100|0:49-U0.300|1:01-U0.040|4:12,,"Fröndenberg/Ruhr Track Running",,,3113,,250,3,15043016588,0,168070,250480,30378,,74254882,,,,,,,,,,,,,,,,,,,,,,,,,,,,,,,,,,,,,,,,,
94558693,47c7d134-d8e4-49d2-a94b-45c72b1104cd,1713902220,120,1713896583,,0,0,1,500,620,11,0,12,2,0,0,0.19,1.14,,,69,117,123,,121,6,39.23,18.22,40.3,1,58.7,3652,6,,0.4,0,,100,,73,,,,5,77,7.5,7.43,7.81,0.7,-12.5,172,172,,1,181,181,,,,,,,,,"100,0,0,0,0,0,0,0,0","4,96,0,0,0","6,73,21,0,0",,,,,78,,,,,,,,,,,,,,,,,,,,,,,,,,,,,,,,,,,,4.6,6,6,267,60,59,1016,0,,0,3,4,Westick,1,0,U1.000|8:17-U0.004|0:03,,"Fröndenberg/Ruhr Running",,,3113,,250,3,15043019479,0,168070,250480,30378,,74254894,,,,,,,,,,,,,,,,,,,,,,,,,,,,,,,,,,,,,,,,,
94614995,fbc1593e-d5ee-4b95-9159-3d5b1f5b38eb,1713964764,120,1713964149,,0,0,14.33,4380,4508,395,389,413,410,0,4.2,0.89,0.95,1.12,484,968,147,161,,158,25,54.48,40.23,56.37,1,58.69,2885,142,,3.5,0.2,100,98,,963,,,,122,82,12.7,13.34,13.17,-13.7,-6.8,307,307,,1,315,315,,,,,,,,,"18,17,13,14,8,11,13,6,0","0,15,84,1,0","0,1,38,60,1",,,,,120,,,,,,,,,,,,,,,,,,,,,,,,,,,,,,,,,,,,42.5,6,16,269,78,96,1007,2,,0,4,4,Balve,1,0,U1.000|4:55-U1.000|5:02-U1.000|6:27-U1.000|6:12-U1.000|6:02-U1.000|5:55-U1.000|6:00-U1.000|5:55-U1.000|4:36-U1.000|3:54-U1.000|3:39-U1.000|3:45-U1.000|3:33-U1.000|5:15-U0.326|1:50,,"Balve Running",,,3113,,250,3,15053951811,0,168070,250480,30378,,74306627,,,,,,,,,,,,,,,,,,,,,,,,,,,,,,,,,,,,,,,,3,
94732106,c2213321-18cb-4015-a092-57fe8edebdec,1714065990,120,1714074845,,0,0,13.67,4317,4802,366,391,377,403,0,4.1,0.83,0.97,1.11,477,901,140,158,101,149,26,55.85,38.58,57.57,1,58.66,1745,116,,3.3,0,103,96,,843,,,,95,80,12.19,12.52,12.45,-10.9,1.7,292,292,,1,295,295,,,,,,,,,"22,14,12,12,15,14,9,2,0","0,43,57,0,0","0,1,54,45,0",,,,,119,,,,,,,,,,,,,,,,,,,,,,,,,,,,,,,,,,,,29.6,6,12,217,71,96,1005,1,,0,4,4,Balve,1,0,U1.000|4:59-U1.000|5:05-U1.000|6:25-U1.000|6:12-U1.000|6:00-U1.000|6:05-U1.000|6:21-U1.000|6:20-U1.000|5:00-U1.000|4:12-U1.000|3:58-U1.000|4:00-U1.000|3:58-U0.671|3:22,,"Balve Running",,,3113,,250,3,15073556158,0,168070,250480,30378,,74410723,,,,,,,,,,,,,,,,,,,,,,,,,,,,,,,,,,,,,,,,3,
94777843,7a635881-0af9-4b95-a514-82cea15154b9,1714134894,120,1714132595,,0,0,14.86,4689,4812,184,175,208,201,0,1.9,0.43,1.03,0.99,307,990,142,159,,149,21,54.87,38.88,55.75,1,58.65,1460,123,,3.3,0,99,100,,917,,,,109,80,11.61,11.54,11.99,-3,0.8,284,284,,1,298,298,,,,,,,,,"4,5,16,48,23,5,0,0,0","0,37,62,0,0","0,1,77,20,2",,,,,119,,,,,,,,,,,,,,,,,,,,,,,,,,,,,,,,,,,,31.3,10,15,226,61,92,1005,3,,0,4,4,Balve,1,0,U1.000|5:40-U1.000|4:41-U1.000|5:11-U1.000|5:18-U1.000|5:30-U1.000|5:31-U1.000|5:16-U1.000|5:13-U1.000|5:09-U1.000|5:21-U1.000|5:09-U1.000|5:04-U1.000|4:54-U1.000|5:09-U0.864|5:05,,"Balve Running",,,3113,,250,3,15084547402,0,168070,250480,30378,,74452526,,,,,,,,,,,,,,,,,,,,,,,,,,,,,,,,,,,,,,,,"4,5",
94836727,1500b149-592e-4c9e-aba7-1e3998764908,1714207073,120,1714202392,,0,0,8.33,2432,2432,49,53,60,63,0,0,0.22,0.98,1,,565,153,167,,160,43,54.52,40.8,54.88,1,58.63,1408,126,,3.3,0,100,99,,438,,,,73,80,12.38,12.51,12.53,5.5,2.2,308,308,,1,313,313,,,,,,,,,"4,0,1,12,71,12,0,0,0","1,5,87,8,0","1,2,18,79,0",,,,,128,,,,,,,,,,,,,,,,,,,,,,,,,,,,,,,,,,,,49.9,10,7,112,78,73,1010,1,,0,4,4,Walldorf,1,0,U1.000|4:57-U1.000|4:44-U1.000|4:45-U1.000|4:38-U1.000|4:43-U1.000|4:45-U1.000|4:39-U1.000|4:49-U0.325|2:33,,"Walldorf Running",,,3113,,250,3,15095837217,0,168070,250480,30378,,74505075,,,,,,,,,,,,,,,,,,,,,,,,,,,,,,,,,,,,,,,,,
94963413,292252a9-5089-481d-af36-58f3b8d17e14,1714331049,120,1714325908,,0,0,6.1,2003,2003,106,118,115,128,0,2.1,0.75,0.99,1.01,373,405,136,148,,147,14,55.24,34.82,56.29,1,58.61,825,55,,2.4,0,100,99,,338,,,,45,79,11.21,11.2,11.4,-0.2,-0.4,275,275,,1,284,284,,,,,,,,,"18,7,11,39,22,2,0,0,0","1,74,25,0,0","0,1,77,21,1",,,,,116,,,,,,,,,,,,,,,,,,,,,,,,,,,,,,,,,,,,25.8,14,17,210,60,96,1014,0,,0,4,4,Balve,1,0,U1.000|6:03-U1.000|5:04-U1.000|5:04-U1.000|5:24-U1.000|5:46-U1.000|5:28-U0.101|0:35,,"Balve Running",,,3113,,250,3,15123576134,0,168070,250480,30378,,74619221,,,,,,,,,,,,,,,,,,,,,,,,,,,,,,,,,,,,,,,,5,
95016999,9a6af0ad-a63b-4ad2-8085-9da78d20fedc,1714400276,120,1714398142,,0,0,15.39,4711,5017,341,302,352,309,0,3.6,0.65,1,1.06,619,1021,143,161,,157,20,56.44,40.39,58.17,1,58.61,1398,132,,3.4,0,99,100,,1099,,,,125,80,12.34,12.25,12.52,-0.1,5.7,310,310,,1,317,317,,,,,,,,,"10,10,15,16,25,19,4,0,0","0,32,68,0,0","0,1,38,59,2",,,,,123,,,,,,,,,,,,,,,,,,,,,,,,,,,,,,,,,,,,45.6,18,11,171,51,88,1021,3,,0,4,4,Balve,1,0,U1.000|5:36-U1.000|4:36-U1.000|4:57-U1.000|4:58-U1.000|5:06-U1.000|5:23-U1.000|5:48-U1.000|6:55-U1.000|5:32-U1.000|4:26-U1.000|4:09-U1.000|4:07-U1.000|4:35-U1.000|5:41-U1.000|4:54-U0.386|1:47,,"Balve Running",,,3113,,250,3,15134699210,0,168070,250480,30378,,74668213,,,,,,,,,,,,,,,,,,,,,,,,,,,,,,,,,,,,,,,,"4,5",
95144258,807882a6-31ba-4d32-b9b5-db9314c2d75c,1714501991,120,1714500623,,0,0,5.45,1610,1963,25,35,43,44,0,0,0.08,0.87,0.76,,375,150,171,,170,39,55.26,39.21,55.44,1,58.66,1164,98,,3,0.9,104,102,,420,,,,46,79,12.41,13.7,14.32,9.2,-32.1,315,315,,1,402,402,,,,,,,,,"15,5,5,5,23,38,5,1,3","0,20,63,16,0","4,9,14,68,5",,,,,129,,,,,,,,,,,,,,,,,,,,,,,,,,,,,,,,,,,,48.5,21,7,54,64,46,1013,0,,0,3,4,Westick,1,0,U1.000|4:46-U1.000|4:28-U1.000|4:19-U1.000|4:14-U1.000|5:24-U0.454|3:38,,"Fröndenberg/Ruhr Running",,,3113,,250,3,15156572768,0,168070,250480,30378,,74783672,,,,,,,,,,,,,,,,,,,,,,,,,,,,,,,,,,,,,,,,,
95144341,d624a4ca-b37c-42d4-869e-94124247ae84,1714504027,120,1714500656,,0,0,8.21,2674,2674,0,0,0,0,0,0,0,,,,617,158,191,,187,49,45.47,35.83,45.47,1,58.68,3930,271,,3.5,3.3,105,101,,724,,,,98,80,11.05,13.63,13.63,21.4,3.5,289,289,,1,374,374,,,,,,,,,"48,5,3,2,1,1,11,26,3","0,25,27,35,14","17,22,17,6,38",,,,,115,,,,,,,,,,,,,,,,,,,,,,,,,,,,,,,,,,,,81.2,21,7,54,64,46,1013,0,,0,3,4,Westick,1,0,U1.000|3:31-U0.270|2:24-U1.000|3:28-U0.220|2:38-U0.600|2:04-U0.400|2:39-U0.600|2:05-U0.400|2:52-U0.400|1:19-U0.400|3:00-U0.400|1:19-U0.400|3:04-U0.190|0:35-U0.200|1:31-U0.200|0:32-U0.400|4:22-U1.000|3:18-U0.130|3:53,,"Fröndenberg/Ruhr Track Running",,,3113,,250,3,15156585107,0,168070,250480,30378,,74783715,,,,,,,,,,,,,,,,,,,,,,,,,,,,,,,,,,,,,,,,,
95144351,e7fc27bc-7af4-4a70-9683-426467ebf98c,1714506809,120,1714500662,,0,0,2.22,688,688,18,10,20,12,0,0,0.19,1.23,0.95,,163,155,164,,160,9,49.72,34.71,50.44,1,58.67,4322,39,,2.2,0,99,98,,185,,,,22,80,11.75,11.62,11.84,4.9,7.1,300,300,,1,303,303,,,,,,,,,"0,2,15,51,29,2,0,0,0","0,4,87,9,0","0,0,63,34,3",,,,,121,,,,,,,,,,,,,,,,,,,,,,,,,,,,,,,,,,,,39.1,21,7,56,66,59,1012,0,,0,3,4,Westick,1,0,U1.000|5:14-U1.000|5:05-U0.216|1:09,,"Fröndenberg/Ruhr Running",,,3113,,250,3,15156587084,0,168070,250480,30378,,74783721,,,,,,,,,,,,,,,,,,,,,,,,,,,,,,,,,,,,,,,,,
95209192,c5479de4-e50f-4e1c-98b8-b40aacb95ddf,1714566147,120,1714566063,,0,0,19.01,6342,6987,586,507,617,547,0,5.3,0.83,0.99,1.07,629,1305,148,175,,150,18,48.45,37.15,50.55,1,58.67,4429,163,,3.7,0,99,96,,1719,,,,172,80,11.79,11.52,12.13,3.2,10.9,281,281,,1,291,291,,,,,,,,,"26,15,12,14,15,14,3,0,0","0,22,61,17,0","0,1,68,29,1",,,,,112,,,,,,,,,,,,,,,,,,,,,,,,,,,,,,,,,,,,53.5,25,10,47,54,61,1006,4,,0,3,4,Helle,1,0,U1.000|5:30-U1.000|6:03-U1.000|6:25-U1.000|6:47-U1.000|4:43-U1.000|4:45-U1.000|4:50-U1.000|6:36-U1.000|6:44-U1.000|6:15-U1.000|5:22-U1.000|6:07-U1.000|7:07-U1.000|4:53-U1.000|4:38-U1.000|4:20-U1.000|4:15-U1.000|4:18-U1.000|5:59-U0.014|0:05,,"Balve Running",,,3113,,250,3,15169344065,0,168070,250480,30378,,74838225,,,,,,,,,,,,,,,,,,,,,,,,,,,,,,,,,,,,,,,,"4,4,4",
95232839,2b14e114-60ee-4507-a34d-8d7f9219c6d7,1714589184,120,1714584845,,0,0,17.13,2680,2735,298,293,302,301,0,2.6,0.54,,,778,573,,,,,,,,,1,,,,,,,,,190,,,,,34,,,31.21,,,,132,115,,1,149,143,,,,,,,,,"36,16,12,10,13,3,10",,"33,63,5,0,0",,,,,,,,,,,,,,,,,,,,,,,,,,,,,,,,,,,,,,,,,,23,8,77,60,85,1002,0,,0,4,4,Balve,1,0,,,,,,,,258,7,,0,168072,,30378,,74859317,,,,,,,,,,,,,,,,,,,,,,,,,,,,,,,,,,,,,,,,4,
95303046,909ecb56-4af3-4c5e-9532-af7f63919f11,1714658238,120,1714664121,,0,0,15.92,5276,5803,375,317,416,361,0,4.2,0.73,1.03,1.08,472,1057,141,159,,158,23,52.14,36.91,53.89,1,58.66,2852,115,,3.2,0,96,98,,1399,,,,122,80,11.44,11.27,11.86,-0.6,9.3,275,275,,1,288,288,,,,,,,,,"18,12,19,22,20,7,1,0,0","0,45,55,0,0","0,2,81,17,1",,,,,113,,,,,,,,,,,,,,,,,,,,,,,,,,,,,,,,,,,,36.5,23,7,108,51,77,998,3,,0,4,4,Balve,1,0,U1.000|6:12-U1.000|5:01-U1.000|5:27-U1.000|5:26-U1.000|5:42-U1.000|6:03-U1.000|6:15-U1.000|6:41-U1.000|6:39-U1.000|5:25-U1.000|4:31-U1.000|4:22-U1.000|4:38-U1.000|5:23-U1.000|5:40-U0.916|4:32,,"Balve Running",,,3113,,250,3,15189250545,0,168070,250480,30378,,74923973,,,,,,,,,,,,,,,,,,,,,,,,,,,,,,,,,,,,,,,,"4,4,5,5,5",
95435229,48435607-222f-44c5-abff-cdf87a2ffd4a,1714761514,120,1714807723,,0,0,9.02,3169,3230,136,149,145,162,0,1.7,0.58,1.03,1,525,588,131,157,,157,21,53.24,32.97,54.14,1,58.63,1296,59,,2.5,0,97,97,,501,,,,52,79,10.45,10.49,10.83,2.3,-10.2,251,251,,1,269,269,,,,,,,,,"20,21,29,21,7,1,1,0,0","1,90,10,0,0","0,10,80,9,1",,,,,108,,,,,,,,,,,,,,,,,,,,,,,,,,,,,,,,,,,,17.2,12,10,242,77,95,1014,0,,0,4,4,Balve,1,0,U1.000|5:46-U1.000|6:07-U1.000|5:45-U1.000|5:21-U1.000|5:57-U1.000|5:45-U1.000|5:28-U1.000|6:02-U1.000|6:30-U0.021|0:08,,"Balve Running",,,3113,,250,3,15214086309,0,168070,250480,30378,,75042304,,,,,,,,,,,,,,,,,,,,,,,,,,,,,,,,,,,,,,,,5,
95463000,a29c6e47-e136-4148-a754-c39bc546b9fc,1714836608,120,1714831881,,0,0,5.12,2107,2331,44,58,44,60,0,0,0.27,0.61,0.56,,362,134,161,,148,42,42.6,26.25,42.9,1,58.7,1106,94,,2.8,1.3,102,100,,391,,,,42,77,9.9,12.18,12.41,29.6,-15.1,221,216,,1,324,323,,,,,,,,,"42,1,1,3,18,30,4,0,1","0,46,53,1,0","30,12,8,49,1",,,,,95,,,,,,,,,,,,,,,,,,,,,,,,,,,,,,,,,,,,36.8,17,12,142,53,81,1014,2,,0,4,4,Westick,1,0,U1.000|4:42-U1.000|4:29-U1.000|4:25-U1.000|4:11-U1.000|15:43-U0.119|1:35,,"Fröndenberg/Ruhr Running",,,3113,,250,3,15220987736,0,168070,250480,30378,,75066931,,,,,,,,,,,,,,,,,,,,,,,,,,,,,,,,,,,,,,,,,
95471702,e81c08e4-21f9-4591-8b52-b6f1a2039da8,1714839242,120,1714834384,,0,0,5.33,2249,2249,0,0,0,0,0,0,0,,,,364,135,183,,170,59,40.91,25.52,40.91,1,58.71,3972,208,,2.7,3.5,109,104,,442,,,,55,71,8.52,13.42,13.42,12.1,1.1,220,216,,1,363,362,,,,,,,,,"63,0,0,0,0,1,6,27,2","9,48,7,36,1","56,6,2,2,34",,,,,100,,,,,,,,,,,,,,,,,,,,,,,,,,,,,,,,,,,,53.3,16,11,150,54,80,1013,3,,0,4,4,Westick,1,0,U1.010|3:16-U0.420|6:39-U1.000|3:17-U0.440|7:25-U1.000|3:17-U0.430|7:18-U1.010|3:30-U0.020|2:46,,"Fröndenberg/Ruhr Track Running",,,3113,,250,3,15221787607,0,168070,250480,30378,,75075394,,,,,,,,,,,,,,,,,,,,,,,,,,,,,,,,,,,,,,,,,
95489358,e7b8f165-fbb7-4e61-9466-2111a82b8566,1714841936,120,1714847030,,0,0,3.04,1071,1505,32,7,58,33,0,0.1,0.27,0.99,,,204,130,140,96,139,9,53.56,30.67,54.8,1,58.71,3933,31,,2,0,97,101,,231,,,,18,78,10.61,10.47,10.78,-4.5,-1.8,256,256,,1,263,263,,,,,,,,,"20,4,30,42,4,0,0,0,0","2,98,0,0,0","0,11,85,4,0",,,,,109,,,,,,,,,,,,,,,,,,,,,,,,,,,,,,,,,,,,15.5,15,10,153,55,85,1013,2,,0,4,4,Westick,1,0,U1.000|6:49-U1.000|5:29-U1.000|5:15-U0.041|0:17,,"Fröndenberg/Ruhr Running",,,3113,,250,3,15225326681,0,168070,250480,30378,,75090801,,,,,,,,,,,,,,,,,,,,,,,,,,,,,,,,,,,,,,,,,
95581396,c4a240a5-fc7f-4b23-955a-835cac74c957,1714932559,120,1714929067,,0,0,8.51,3275,3275,105,117,128,142,0,1.7,0.63,1.01,1.02,431,557,123,139,,137,19,51.26,29.46,51.95,1,58.71,1918,43,,2.2,0,97,96,,531,,,,51,78,9.48,9.45,9.57,2,4.4,225,225,,1,230,230,,,,,,,,,"39,31,26,4,0,0,0,0,0","1,99,0,0,0","0,12,87,1,0",,,,,100,,,,,,,,,,,,,,,,,,,,,,,,,,,,,,,,,,,,14.2,15,8,276,59,67,1009,0,,0,4,4,Balve,1,0,U1.000|6:33-U1.000|5:45-U1.000|6:21-U1.000|6:32-U1.000|6:10-U1.000|6:15-U1.000|6:18-U1.000|6:43-U0.509|3:57,,"Balve Running",,,3113,,250,3,15241887287,0,168070,250480,30378,,75173359,,,,,,,,,,,,,,,,,,,,,,,,,,,,,,,,,,,,,,,,5,
95660043,6341c9e6-7378-4150-b315-cbbaf0dbac61,1715022237,120,1715020377,,0,0,14.95,4908,5003,240,247,266,272,0,2.7,0.52,0.95,0.99,397,997,136,157,,155,18,55.26,37.14,56.32,1,58.68,1357,104,,3.1,0,100,98,,1033,,,,96,79,11.27,11.72,11.98,3,12.7,278,278,,1,304,304,,,,,,,,,"17,14,22,21,17,5,2,1,1","1,76,23,0,0","0,2,76,18,4",,,,,116,,,,,,,,,,,,,,,,,,,,,,,,,,,,,,,,,,,,31.6,13,3,358,89,98,1009,0,,0,4,4,Balve,1,0,U1.000|5:08-U1.000|5:19-U1.000|4:43-U1.000|5:35-U1.000|5:14-U1.000|5:16-U1.000|6:12-U1.000|5:29-U1.000|5:53-U1.000|5:35-U1.000|4:53-U1.000|6:27-U1.000|5:53-U1.000|4:52-U0.947|5:18,,"Balve Running",,,3113,,250,3,15257840595,0,168070,250480,30378,,75238937,,,,,,,,,,,,,,,,,,,,,,,,,,,,,,,,,,,,,,,,"4,5,5",
95748863,69ef5cd9-c21e-4794-a6cb-2094c09776d2,1715111575,120,1715108746,,0,0,2.79,957,957,25,9,40,24,0,0,0.09,1.1,,,202,138,145,,145,4,51.38,31.46,52.32,1,58.74,5743,34,,2.1,0,96,97,,181,,,,20,79,10.72,10.48,10.86,2,5.9,266,266,,1,273,273,,,,,,,,,"6,11,55,26,1,1,0,0,0","0,71,29,0,0","0,0,92,8,0",,,,,111,,,,,,,,,,,,,,,,,,,,,,,,,,,,,,,,,,,,19.5,14,7,28,75,88,1020,0,,0,4,4,Westick,1,0,U1.000|5:46-U1.000|5:41-U0.789|4:30,,"Fröndenberg/Ruhr Running",,,3113,,250,3,15275079548,0,168070,250480,30378,,75313957,,,,,,,,,,,,,,,,,,,,,,,,,,,,,,,,,,,,,,,,,
95748864,0e62e3f5-0eaf-4f11-bac8-32c899cec5c6,1715106924,120,1715108746,,0,0,4.31,1321,1808,28,29,43,44,0,0,0.19,0.94,1.03,,303,144,164,,164,29,55.83,37.02,56.26,1,58.71,1422,94,,2.5,2.1,103,102,,261,,,,32,80,11.82,13.1,13.3,4,-31.2,299,299,,1,358,358,,,,,,,,,"16,2,6,25,35,11,1,2,3","1,26,72,2,0","2,8,39,46,5",,,,,122,,,,,,,,,,,,,,,,,,,,,,,,,,,,,,,,,,,,30.4,15,10,25,69,88,1020,1,,0,4,4,Westick,1,0,U1.000|5:13-U1.000|4:51-U1.000|4:47-U0.236|1:08-U0.579|3:36-U0.492|2:26,,"Fröndenberg/Ruhr Running",,,3113,,250,3,15275079049,0,168070,250480,30378,,75313958,,,,,,,,,,,,,,,,,,,,,,,,,,,,,,,,,,,,,,,,,
95748866,efddc2c9-7ddd-4081-8074-9281b94e05d1,1715108874,120,1715108746,,0,0,9.31,2597,2597,0,0,0,0,0,0,0,,,,622,160,187,,174,53,54.04,43.36,54.04,1,58.75,5760,332,,3.7,3.7,107,102,,546,,,,99,83,12.9,15.08,15.08,11.1,1.2,344,344,,1,414,414,,,,,,,,,"27,4,6,5,3,4,16,28,7","0,21,18,52,10","14,9,17,6,53",,,,,130,,,,,,,,,,,,,,,,,,,,,,,,,,,,,,,,,,,,85.2,14,7,28,75,88,1020,0,,0,4,4,Westick,1,0,U0.390|1:24-U0.400|1:24-U0.400|1:23-U0.400|1:18-U0.400|2:17-U0.400|1:24-U0.400|1:24-U0.400|1:20-U0.390|2:39-U0.400|1:18-U0.400|1:18-U0.410|4:44-U0.400|1:24-U0.400|1:24-U0.400|1:23-U0.400|1:21-U0.400|2:34-U0.400|1:25-U0.400|1:24-U0.400|1:21-U0.390|2:30-U0.410|1:20-U0.400|1:23-U0.120|3:56,,"Fröndenberg/Ruhr Track Running",,,3113,,250,3,15275079465,0,168070,250480,30378,,75313959,,,,,,,,,,,,,,,,,,,,,,,,,,,,,,,,,,,,,,,,,
95832830,31b98131-35d5-4551-a05f-1ba6c0698e5c,1715194999,120,1715192751,,0,0,14.08,4312,4853,261,234,273,256,0,2.4,0.56,0.99,1.04,350,922,140,159,,155,24,58.01,40.08,59.47,1,58.75,4288,113,,3.2,0,102,100,,787,,,,94,79,12.19,12.11,12.37,-0.8,2.8,306,306,,1,314,314,,,,,,,,,"8,9,13,26,26,15,3,1,0","0,45,54,0,0","0,1,41,57,2",,,,,124,,,,,,,,,,,,,,,,,,,,,,,,,,,,,,,,,,,,27.2,15,6,28,62,5,1026,0,,0,2,4,Balve,1,0,U1.000|4:45-U1.000|4:51-U1.000|4:52-U1.000|5:16-U1.000|4:50-U1.000|5:20-U1.000|5:23-U1.000|5:24-U1.000|5:37-U1.000|4:45-U1.000|4:29-U1.000|5:13-U1.000|5:05-U1.000|5:36-U0.080|0:26,,"Balve Running",,,3113,,250,3,15291515833,0,168070,250480,30378,,75388788,,,,,,,,,,,,,,,,,,,,,,,,,,,,,,,,,,,,,,,,"4,5,5,5",
95887767,48013aff-188e-4454-9979-02a0fc0075a3,1715249544,120,1715251903,,0,0,1.1,397,617,9,1,8,2,0,0,0.07,1.14,,,84,137,159,,145,27,48.71,27.02,49.64,1,58.74,3451,18,,1.2,0,97,97,,71,,,,8,76,10.2,10.77,11.23,-25.3,-34.7,250,250,,1,285,285,,,,,,,,,"28,4,28,33,2,1,2,3,0","0,52,48,0,0","4,15,67,10,4",,,,,109,,,,,,,,,,,,,,,,,,,,,,,,,,,,,,,,,,,,13.5,15,4,19,62,10,1028,3,,0,2,4,Allendorf,1,0,U1.000|5:57-U0.102|0:40,,"Sundern (Sauerland) Running",,,3113,,250,3,15301264474,0,168070,250480,30378,,75437350,,,,,,,,,,,,,,,,,,,,,,,,,,,,,,,,,,,,,,,,,
95887798,fd0e691d-aeb2-4a85-9910-e823d02797d9,1715251606,120,1715251942,,0,0,20.77,5350,5350,382,375,425,418,0,3.4,0.62,1.01,1.06,456,1486,175,186,145,181,16,51.86,50.54,53.06,1,58.74,4519,475,,5,1.6,102,97,,1360,,,,268,83,14.52,14.65,14.75,6,11.9,369,369,,1,375,375,,,,,,,,,"2,2,4,12,18,27,27,8,0","0,0,3,81,15","0,0,4,78,18",,,,,140,,,,,,,,,,,,,,,,,,,,,,,,,,,,,,,,,,,,121.5,16,6,20,57,42,1027,4,,0,3,4,Allendorf,1,0,U1.000|3:58-U1.000|3:54-U1.000|4:13-U1.000|4:40-U1.000|4:39-U1.000|4:19-U1.000|4:59-U1.000|3:53-U1.000|4:14-U1.000|4:26-U1.000|3:59-U1.000|5:08-U1.000|4:24-U1.000|3:53-U1.000|4:29-U1.000|4:21-U1.000|4:01-U1.000|4:40-U1.000|4:12-U1.000|3:42-U0.770|3:06,,"Sundern (Sauerland) Running",,,3113,,250,3,15301277207,0,168070,250480,30378,,75437379,,,,,,,,,,,,,,,,,,,,,,,,,,,,,,,,,,,,,,,,"4,4",
95989984,26d06f2b-8016-42cc-85e3-4b6c685a9eaa,1715350104,120,1715347594,,0,0,13.73,4476,4627,145,147,177,180,0,1.3,0.39,0.98,1.05,,929,142,161,,157,21,52.71,37.19,53.39,1,58.73,2883,105,,3.2,0,96,97,,1104,,,,101,79,11.21,11.21,11.27,3.6,5.6,272,272,,1,274,274,,,,,,,,,"8,8,18,49,14,3,0,0,0","0,32,68,0,0","0,0,91,9,0",,,,,116,,,,,,,,,,,,,,,,,,,,,,,,,,,,,,,,,,,,30.1,20,8,23,49,69,1023,4,,0,4,4,Balve,1,0,U1.000|5:59-U1.000|4:57-U1.000|5:26-U1.000|5:16-U1.000|5:35-U1.000|5:34-U1.000|5:13-U1.000|5:14-U1.000|5:15-U1.000|5:31-U1.000|5:17-U1.000|5:53-U1.000|5:21-U0.728|4:04,,"Balve Running",,,3113,,250,3,15321167047,0,168070,250480,30378,,75524421,,,,,,,,,,,,,,,,,,,,,,,,,,,,,,,,,,,,,,,,,
96066090,9af3cb9f-ef04-489a-b281-f172488efcb8,1715432910,120,1715428651,,0,0,8.43,2590,2845,131,134,153,159,0,2.3,0.61,0.97,0.98,1385,594,151,171,,162,17,52.16,38.45,53.14,1,58.71,1885,113,,3.2,0.4,97,99,,635,,,,75,79,11.95,12.1,12.77,-0.8,10.8,295,295,,1,327,327,,,,,,,,,"8,9,13,26,27,11,5,1,0","0,8,71,20,0","0,1,57,39,3",,,,,124,,,,,,,,,,,,,,,,,,,,,,,,,,,,,,,,,,,,55.8,21,8,52,53,80,1022,4,,0,4,4,Balve,1,0,U1.000|6:01-U1.000|4:51-U1.000|5:20-U1.000|5:19-U1.000|5:12-U0.215|1:07-U1.000|4:00-U1.000|4:27-U1.000|5:43-U0.217|1:10,,"Balve Running",,,3113,,250,3,15336826612,0,168070,250480,30378,,75591349,,,,,,,,,,,,,,,,,,,,,,,,,,,,,,,,,,,,,,,,5,
96160437,,1715527101,120,1715519931,,0,0,2,720,720,,,,,0,,,,,,142,,,,,,,28.9,,1,,,,,,,,,,,,,,17,,,,,,,,,,,,,,,,,,,,,,,,,,,,,,,,,,,,,,,,,,,,,,,,,,,,,,,,,,,,,,,,,,,,,,,,,,1,,,0,0,,,"Uhr angehalten",,,connect,,,3,15356160444,0,168070,250480,30378,,75674013,,,,,,,,,,,,,,,,,,,,,,,,,,,,,,,,,,,,,,,,,
96160453,02fefd39-df89-4fcb-ab78-0e4be50ab11e,1715522121,120,1715519944,,0,0,12.37,3779,4669,328,349,342,368,0,3.8,0.9,0.97,1.16,485,863,152,168,,165,19,52.04,39.79,53.63,1,58.69,1596,152,,3.5,0.3,100,98,,1047,,,,111,80,12.67,13.74,13.41,-13.6,-7.5,307,307,,1,323,323,,,,,,,,,"24,16,15,9,7,6,15,8,1","1,9,73,16,0","0,0,45,53,2",,,,,123,,,,,,,,,,,,,,,,,,,,,,,,,,,,,,,,,,,,53.8,23,11,140,43,26,1017,5,,0,2,4,Balve,1,0,U1.000|5:17-U1.000|5:12-U1.000|6:40-U1.000|6:18-U1.000|6:14-U1.000|6:17-U1.000|4:58-U1.000|3:51-U1.000|3:38-U1.000|3:44-U1.000|3:26-U1.000|5:07-U0.365|2:16,,"Balve Running",,,3113,,250,3,15356163535,0,168070,250480,30378,,75674029,,,,,,,,,,,,,,,,,,,,,,,,,,,,,,,,,,,,,,,,"4,5",
96265246,c17fb034-5ba0-4b7c-b2fb-ebede93d676f,1715623365,120,1715621273,,0,0,14.16,4666,4767,209,206,239,238,0,1.7,0.45,1,1.06,305,935,137,157,,151,28,54.49,36.81,55.5,1,58.67,1235,105,,3.1,0,101,98,,852,,,,11,79,11.17,11.29,11.43,-0.4,-1.1,274,274,,1,284,284,,,,,,,,,"15,12,21,28,16,6,1,1,0","0,65,34,0,0","0,3,76,19,1",,,,,115,,,,,,,,,,,,,,,,,,,,,,,,,,,,,,,,,,,,1.7,21,11,147,60,6,1010,,,0,2,1,Balve,1,0,U1.000|4:59-U1.000|5:08-U1.000|5:08-U1.000|5:34-U1.000|5:19-U1.000|6:01-U1.000|5:36-U1.000|6:03-U1.000|5:11-U1.000|5:41-U1.000|5:05-U1.000|5:52-U1.000|5:22-U1.000|5:51-U0.164|0:56,,"Balve Running",,,3113,,250,3,15375263081,0,168070,250480,30378,,75768140,,,,,,,,,,,,,,,,,,,,,,,,,,,,,,,,,,,,,,,,"5,5,5",
96382135,4e3814cc-66cb-4695-9820-130c37f32a6a,1715711616,120,1715711344,,0,0,5.14,1584,2023,24,39,41,50,0,0,0.23,1.21,0.58,,353,145,159,,155,35,54.94,37.17,55.06,1,58.71,1048,95,,2.8,1.4,106,102,,403,,,,43,79,11.9,13.02,13.31,13.9,-14.1,300,300,,1,357,357,,,,,,,,,"15,4,6,7,29,30,7,1,1","1,25,74,0,0","9,6,14,66,4",,,,,123,,,,,,,,,,,,,,,,,,,,,,,,,,,,,,,,,,,,40.5,22,13,121,45,5,1006,1,,0,2,4,Westick,1,0,U1.000|4:42-U1.000|4:32-U1.000|4:26-U1.000|4:25-U1.000|6:37-U0.141|1:43,,"Fröndenberg/Ruhr Running",,,3113,,250,3,15393994002,0,168070,250480,30378,,75866955,,,,,,,,,,,,,,,,,,,,,,,,,,,,,,,,,,,,,,,,,
96382179,c0bf6d3f-6d68-49e9-8494-b8b7e06bdee5,1715713678,120,1715711374,,0,0,6.54,2234,2234,0,0,0,0,0,0,0,,,,464,149,180,,179,53,46.62,33.36,46.62,1,58.71,4512,231,,3.1,3.4,100,102,,585,,,,72,78,10.53,13.36,13.36,19.1,4.6,273,273,,1,365,365,,,,,,,,,"49,6,4,3,2,2,6,22,6","0,41,14,45,0","22,21,16,9,31",,,,,113,,,,,,,,,,,,,,,,,,,,,,,,,,,,,,,,,,,,63.1,21,11,108,49,3,1006,0,,0,2,4,Westick,1,0,U1.000|3:12-U0.400|2:47-U0.200|0:37-U0.100|0:32-U0.190|0:38-U0.110|0:32-U0.200|0:39-U0.100|0:38-U0.200|0:40-U0.100|0:35-U0.200|0:41-U0.220|3:19-U0.200|0:37-U0.100|0:49-U0.200|0:37-U0.100|0:51-U0.200|0:38-U0.100|0:58-U0.200|0:39-U0.100|0:53-U0.200|0:40-U1.020|10:47-U1.000|3:21-U0.100|1:33,,"Fröndenberg/Ruhr Track Running",,,3113,,250,3,15394006980,0,168070,250480,30378,,75866995,,,,,,,,,,,,,,,,,,,,,,,,,,,,,,,,,,,,,,,,,
96382199,8ce86f37-8345-49fe-bd86-a59d071a8bcb,1715716335,120,1715711385,,0,0,4.19,1419,1419,13,9,30,27,0,0,0.05,,,,290,136,142,,140,8,53.18,32.82,53.44,1,58.7,4483,41,,2.2,0,97,98,,336,,,,31,80,10.67,10.62,10.73,-1.4,0.1,263,263,,1,266,266,,,,,,,,,"1,10,59,29,1,0,0,0,0","0,98,2,0,0","0,0,97,3,0",,,,,111,,,,,,,,,,,,,,,,,,,,,,,,,,,,,,,,,,,,22.3,21,11,108,49,3,1006,0,,0,2,4,Westick,1,0,U1.000|5:47-U1.000|5:41-U1.000|5:34-U1.000|5:33-U0.188|1:04,,"Fröndenberg/Ruhr Running",,,3113,,250,3,15394010268,0,168070,250480,30378,,75867014,,,,,,,,,,,,,,,,,,,,,,,,,,,,,,,,,,,,,,,,,
96482605,935e0af9-ad3d-4f0b-877c-adf82cc35c23,1715799604,120,1715794953,,0,0,6.27,2159,2247,100,99,106,104,0,1.8,0.66,0.97,1.1,316,417,133,158,95,150,27,53.57,32.95,54.64,1,58.71,3079,52,,2.4,0,97,103,,401,,,,45,78,10.78,11.71,11.48,-10.2,-17.9,264,264,,1,285,285,,,,,,,,,"32,27,14,8,4,5,8,2,0","0,81,19,0,0","0,7,74,17,1",,,,,112,,,,,,,,,,,,,,,,,,,,,,,,,,,,,,,,,,,,31,19,4,209,61,85,1006,1,,0,4,4,Balve,1,0,U1.000|5:49-U1.000|6:06-U1.000|6:33-U1.000|5:32-U1.000|3:46-U1.000|6:21-U0.269|1:52,,"Balve Running",,,3113,,250,3,15410213746,0,168070,250480,30378,,75957563,,,,,,,,,,,,,,,,,,,,,,,,,,,,,,,,,,,,,,,,"5,5",
96580972,14996286-abf7-436a-9af0-ef89f5b4f123,1715884386,120,1715879251,,0,0,4.74,1685,1761,88,98,91,102,0,1.8,0.78,1.04,1.05,,323,131,148,98,147,15,52.47,31.19,53.54,1,58.71,1675,36,,2.1,0,99,97,,298,,,,28,79,10.35,10.43,10.57,7.2,7.3,249,249,,1,258,258,,,,,,,,,"32,18,18,18,13,1,0,0,0","1,87,12,0,0","0,6,85,9,0",,,,,107,,,,,,,,,,,,,,,,,,,,,,,,,,,,,,,,,,,,14.7,17,4,218,77,67,1005,1,,0,4,4,Balve,1,0,U1.000|5:50-U1.000|5:15-U1.000|6:11-U1.000|6:31-U0.742|4:19,,"Balve Running",,,3113,,250,3,15425782152,0,168070,250480,30378,,76047020,,,,,,,,,,,,,,,,,,,,,,,,,,,,,,,,,,,,,,,,,
96638719,8a75bae5-ab15-4f91-8ad2-841eda5890fd,1715952616,120,1715947449,,0,0,5.01,1637,1975,94,71,99,70,0,1.6,0.54,0.99,1.02,345,343,136,149,,148,17,55.58,34.62,57.19,1,58.7,935,54,,2.4,0,99,100,,304,,,,31,80,11.47,11.22,11.56,5,7.3,281,281,,1,286,286,,,,,,,,,"11,13,15,36,18,5,1,0,0","1,74,25,0,0","0,3,72,24,0",,,,,115,,,,,,,,,,,,,,,,,,,,,,,,,,,,,,,,,,,,20.9,18,13,66,66,87,1006,3,,0,4,4,Balve,1,0,U1.000|5:45-U1.000|5:08-U1.000|5:22-U1.000|5:37-U1.000|5:23-U0.014|0:04,,"Balve Running",,,3113,,250,3,15437171919,0,168070,250480,30378,,76097023,,,,,,,,,,,,,,,,,,,,,,,,,,,,,,,,,,,,,,,,5,
96715721,9bf5834d-d616-4166-861f-b399ec08d5c9,1716030578,120,1716030100,,0,0,0.63,195,195,12,13,11,12,0,1,0.65,1.95,1.52,,40,126,148,92,,,65.22,30.35,66.64,1,58.7,,11,,0.7,0,,100,,31,,,,3,79,11.64,11.48,11.56,20.2,30.3,290,290,,1,289,289,,,,,,,,,"6,1,16,31,44,2,0,0,0","8,81,12,0,0","0,0,60,40,0",,,,,123,,,,,,,,,,,,,,,,,,,,,,,,,,,,,,,,,,,,4.4,16,7,27,71,49,1010,3,,0,3,4,,1,0,,,"Balve Running",,,3113,,250,3,15452185763,0,168070,250480,30378,,76164899,,,,,,,,,,,,,,,,,,,,,,,,,,,,,,,,,,,,,,,,,
96715722,d903e44c-f945-4eca-81ef-c1147efd6328,1716034804,120,1716030100,,0,0,3,1125,1217,31,28,48,49,0,0,0.2,1.05,1.04,,215,134,151,,149,21,47.78,28.44,48.44,1,58.68,3157,28,,2,0,98,96,,266,,,,18,79,9.68,9.67,9.83,-1.7,-3.5,234,234,,1,239,239,,,,,,,,,"22,42,26,9,0,0,0,0,0","0,86,14,0,0","0,4,95,1,0",,,,,101,,,,,,,,,,,,,,,,,,,,,,,,,,,,,,,,,,,,13.3,16,6,29,71,59,1010,4,,0,3,4,,1,0,U1.000|5:58-U1.000|6:19-U1.000|6:28,,"Balve Running",,,3113,,250,3,15452186134,0,168070,250480,30378,,76164900,,,,,,,,,,,,,,,,,,,,,,,,,,,,,,,,,,,,,,,,,
96715723,a939ed7d-d20e-45fc-9b18-5b94aa0ee360,1716031513,120,1716030100,,0,0,10.51,2584,2584,247,245,256,254,0,3,0.71,0.94,0.99,566,708,172,182,134,174,13,56.48,50.66,58.13,1,58.68,3180,262,,4.6,0.3,100,99,,677,,,,116,83,15.41,15.54,15.53,-3.3,6.8,400,400,,1,404,404,,,,,,,,,"0,0,5,14,19,13,29,20,0","0,1,3,91,5","0,0,2,48,50",,,,,147,,,,,,,,,,,,,,,,,,,,,,,,,,,,,,,,,,,,98.4,16,6,29,71,57,1010,4,,0,3,4,Balve,1,0,U1.000|4:06-U1.000|5:00-U1.000|4:52-U1.000|4:59-U1.000|4:26-U1.000|3:27-U1.000|3:32-U1.000|3:40-U1.000|3:29-U1.000|3:42-U0.507|1:51,,"Balve Running",,,3113,,250,3,15452186001,0,168070,250480,30378,,76164901,,,,,,,,,,,,,,,,,,,,,,,,,,,,,,,,,,,,,,,,4,
96771440,20af5f55-335f-4280-8fc6-264c97c000f1,1716106518,120,1716105807,,0,0,19.59,5968,6158,422,415,439,435,0,3.9,0.66,0.96,1.08,572,1322,143,164,,160,20,56.78,41.41,58.31,1,58.68,2737,160,,3.7,0,99,100,,1094,,,,134,80,12.45,12.49,12.67,-10.8,-1.3,309,309,,1,316,316,,,,,,,,,"12,11,12,19,18,17,11,0,0","0,36,63,1,0","0,0,39,60,1",,,,,123,,,,,,,,,,,,,,,,,,,,,,,,,,,,,,,,,,,,31.1,14,3,281,89,73,1011,1,,0,4,4,Balve,1,0,U1.000|5:35-U1.000|4:52-U1.000|5:18-U1.000|5:13-U1.000|5:20-U1.000|5:35-U1.000|5:56-U1.000|7:02-U1.000|5:42-U1.000|5:42-U1.000|4:39-U1.000|5:18-U1.000|4:21-U1.000|4:16-U1.000|4:00-U1.000|3:53-U1.000|4:04-U1.000|5:13-U1.000|4:15-U0.590|3:14,,"Balve Running",,,3113,,250,3,15465976972,0,168070,250480,30378,,76213675,,,,,,,,,,,,,,,,,,,,,,,,,,,,,,,,,,,,,,,,4,
96852543,aef870ac-de89-4410-8d18-bed435432acf,1716200193,120,1716199259,,0,0,15.75,5284,5931,457,361,465,373,0,4.5,0.82,0.95,1.11,546,1092,144,169,,161,17,49.94,36.36,52.11,1,58.64,2036,137,,3.4,0,97,96,,1005,,,,127,80,11.63,11.52,11.83,-9.1,0.3,285,285,,1,290,290,,,,,,,,,"30,13,14,12,14,14,3,0,0","0,32,64,4,0","0,0,65,33,1",,,,,112,,,,,,,,,,,,,,,,,,,,,,,,,,,,,,,,,,,,43.1,16,2,333,78,48,1011,3,,0,3,4,Helle,1,0,U1.000|5:45-U1.000|6:10-U1.000|6:33-U1.000|6:54-U1.000|6:36-U1.000|5:01-U1.000|5:28-U1.000|5:21-U1.000|6:30-U1.000|6:30-U1.000|4:25-U1.000|4:11-U1.000|4:22-U1.000|4:37-U1.000|4:36-U0.750|5:06,,"Balve Running",,,3113,,250,3,15485382205,0,168070,250480,30378,,76286105,,,,,,,,,,,,,,,,,,,,,,,,,,,,,,,,,,,,,,,,"4,4",
97062375,3fcbe986-fa00-4652-b73f-9c536fcbb3d2,1716316329,120,1716401417,,0,0,4.82,1430,1814,8,27,8,26,0,0,0.05,0.95,0.66,,315,139,151,,144,30,60.89,38.73,60.72,1,58.71,990,78,,2.6,1.1,104,105,,291,,,,30,79,12.02,12.87,12.82,8.3,-10.7,295,295,,1,324,324,,,,,,,,,"14,1,1,7,40,33,0,1,2","3,37,60,0,0","5,7,21,65,3",,,,,128,,,,,,,,,,,,,,,,,,,,,,,,,,,,,,,,,,,,26.3,17,8,149,85,99,1005,1,,0,6,4,Westick,1,0,U1.000|4:58-U1.000|4:31-U1.000|4:28-U1.000|4:30-U0.268|1:10-U0.554|4:12,,"Fröndenberg/Ruhr Running",,,3113,,250,3,15527661650,0,168070,250480,30378,,76473620,,,,,,,,,,,,,,,,,,,,,,,,,,,,,,,,,,,,,,,,,
97062376,34c602c5-572b-4d13-b036-4a935676841e,1716318166,120,1716401417,,0,0,6.54,1953,1953,0,0,0,0,0,0,0,,,,432,152,180,,176,50,53.52,39.13,53.52,1,58.72,2938,191,,3.2,2.8,110,104,,372,,,,63,82,12.05,14.87,14.87,24.3,1.4,312,312,,1,396,396,,,,,,,,,"36,3,3,2,1,1,13,38,2","1,28,17,53,0","23,9,10,8,50",,,,,123,,,,,,,,,,,,,,,,,,,,,,,,,,,,,,,,,,,,75.7,16,7,158,91,99,1006,1,,0,6,4,Westick,1,0,U0.390|1:17-U0.100|0:37-U0.400|1:20-U0.100|0:32-U0.400|1:19-U0.100|0:38-U0.400|1:24-U0.410|3:20-U1.010|3:22-U1.000|3:28-U0.230|3:15-U0.400|1:19-U0.100|0:36-U0.400|1:18-U0.100|0:35-U0.400|1:18-U0.090|0:43-U0.400|1:18-U0.110|4:53,,"Fröndenberg/Ruhr Track Running",,,3113,,250,3,15527662428,0,168070,250480,30378,,76473621,,,,,,,,,,,,,,,,,,,,,,,,,,,,,,,,,,,,,,,,,
97062377,27d5cc97-ce0b-42dd-b75e-c42a9e349aeb,1716320154,120,1716401418,,0,0,2.68,885,885,2,0,4,2,0,0,0,,,,184,134,140,,135,7,55.89,32.79,55.99,1,58.72,2913,30,,2,0,101,101,,154,,,,16,79,10.91,10.97,10.99,-3.9,-4.3,263,263,,1,266,266,,,,,,,,,"7,9,28,43,12,1,0,0,0","0,100,0,0,0","0,2,98,1,0",,,,,115,,,,,,,,,,,,,,,,,,,,,,,,,,,,,,,,,,,,14.9,16,7,158,91,99,1006,1,,0,6,4,Westick,1,0,U1.000|5:48-U1.000|5:16-U0.676|3:42,,"Fröndenberg/Ruhr Running",,,3113,,250,3,15527662741,0,168070,250480,30378,,76473622,,,,,,,,,,,,,,,,,,,,,,,,,,,,,,,,,,,,,,,,,
97062385,e93f0b55-01b5-489f-bf28-e03aedb9cbb4,1716402741,120,1716401422,,0,0,15.49,4872,5517,332,307,345,323,0,3.7,0.72,1,1.08,618,1025,137,158,,146,21,57.72,39.15,59.36,1,58.71,2021,115,,3.2,0,98,100,,864,,,,96,79,12,11.99,12.4,-4.9,-2.6,295,295,,1,309,309,,,,,,,,,"14,12,16,21,19,16,4,0,0","1,62,38,0,0","0,1,64,33,2",,,,,121,,,,,,,,,,,,,,,,,,,,,,,,,,,,,,,,,,,,30.2,17,9,247,68,85,1010,1,,0,4,4,Balve,1,0,U1.000|5:51-U1.000|4:45-U1.000|5:14-U1.000|5:14-U1.000|5:23-U1.000|5:36-U1.000|6:01-U1.000|6:55-U1.000|5:22-U1.000|4:15-U1.000|4:20-U1.000|4:04-U1.000|4:30-U1.000|5:33-U1.000|5:26-U0.491|2:44,,"Balve Running",,,3113,,250,3,15527663845,0,168070,250480,30378,,76473629,,,,,,,,,,,,,,,,,,,,,,,,,,,,,,,,,,,,,,,,4,
97145086,db153300-40cf-4cc8-b1f5-43f3d98401b7,1716486115,120,1716484198,,0,0,15.27,4356,4941,160,142,200,180,0,0.7,0.31,0.99,0.97,521,984,152,183,,180,44,56.63,43.81,57.44,1,58.74,2304,266,,3.9,2.8,97,102,,1082,,,,143,80,12.85,14.35,14.37,3.4,-4.7,325,325,,1,380,380,,,,,,,,,"13,8,14,18,14,2,16,15,0","0,21,47,31,1","2,2,44,24,27",,,,,131,,,,,,,,,,,,,,,,,,,,,,,,,,,,,,,,,,,,90.1,19,6,245,55,72,1015,2,,0,4,4,Balve,1,0,U1.000|5:56-U1.000|4:43-U1.000|5:29-U0.070|0:23-U1.000|3:23-U1.000|3:33-U0.195|0:42-U1.000|5:12-U1.000|5:13-U0.284|1:31-U1.000|3:29-U1.000|3:36-U0.188|0:39-U1.000|5:52-U1.000|5:42-U0.273|2:03-U1.000|3:25-U1.000|3:31-U0.193|0:43-U1.000|7:07-U0.061|0:22,,"Balve Running",,,3113,,250,3,15542885793,0,168070,250480,30378,,76547521,,,,,,,,,,,,,,,,,,,,,,,,,,,,,,,,,,,,,,,,5,
97234084,b5e02d29-db30-4e61-92fa-3198f72f95cd,1716578826,120,1716575385,,0,0,9.08,3282,3515,119,130,128,143,0,1.6,0.52,1,1.04,318,566,124,151,113,146,25,54.87,31.89,55.67,1,58.73,1052,48,,2.3,0,96,99,,547,,,,45,78,10.17,10.13,10.36,-2.2,-10.5,238,238,,1,246,246,,,,,,,,,"23,25,32,14,5,1,0,0,0","2,94,5,0,0","0,12,83,6,0",,,,,106,,,,,,,,,,,,,,,,,,,,,,,,,,,,,,,,,,,,13.8,15,5,83,85,98,1016,0,,0,4,4,Balve,1,0,U1.000|6:06-U1.000|6:26-U1.000|6:03-U1.000|5:39-U1.000|6:10-U1.000|5:55-U1.000|5:59-U1.000|5:47-U1.000|6:11-U0.083|0:26,,"Balve Running",,,3113,,250,3,15560050006,0,168070,250480,30378,,76626522,,,,,,,,,,,,,,,,,,,,,,,,,,,,,,,,,,,,,,,,5,
97313119,b113c229-83e9-4943-b066-7bf81e464f03,1716667147,120,1716662035,,0,0,4.4,1629,1726,79,70,81,74,0,1.8,0.86,1.01,1.04,,300,131,149,,144,15,49.91,29.58,51.14,1,58.71,652,35,,2.1,0,97,96,,289,,,,29,78,9.99,9.97,10.22,7.1,8.4,239,239,,1,248,248,,,,,,,,,"42,15,22,18,3,0,0,0,0","1,85,14,0,0","0,8,85,7,0",,,,,104,,,,,,,,,,,,,,,,,,,,,,,,,,,,,,,,,,,,16.8,16,5,252,72,33,1017,0,,0,2,4,Balve,1,0,U1.000|5:59-U1.000|5:29-U1.000|6:48-U1.000|6:30-U0.404|2:22,,"Balve Running",,,3113,,250,3,15577135124,0,168070,250480,30378,,76697419,,,,,,,,,,,,,,,,,,,,,,,,,,,,,,,,,,,,,,,,,
97351919,f2055254-902d-4540-88a7-70928ab0b67f,1716714425,120,1716715473,,0,0,19.98,6279,6379,333,317,371,362,0,2.9,0.46,0.96,1.04,424,1382,149,169,,158,31,51.67,40,52.79,1,58.69,2029,184,,3.9,0,100,98,,1464,,,,174,80,11.86,11.72,12.01,-2.7,2.5,288,288,,1,294,294,,,,,,,,,"10,8,12,30,28,10,1,0,0","0,16,74,10,0","0,4,57,39,0",,,,,119,,,,,,,,,,,,,,,,,,,,,,,,,,,,,,,,,,,,47.8,19,10,158,69,66,1017,3,,0,4,4,Lendringsen,1,0,U1.000|5:41-U1.000|5:42-U1.000|6:12-U1.000|6:59-U1.000|5:09-U1.000|5:10-U1.000|4:56-U1.000|4:39-U1.000|5:00-U1.000|5:19-U1.000|5:15-U1.000|4:54-U1.000|4:27-U1.000|4:38-U1.000|5:31-U1.000|5:17-U1.000|4:39-U1.000|5:02-U1.000|5:14-U0.975|4:54,,"Menden (Sauerland) Running",,,3113,,250,3,15584741486,0,168070,250480,30378,,76732813,,,,,,,,,,,,,,,,,,,,,,,,,,,,,,,,,,,,,,,,"4,4,5",
97423187,9376afea-e86c-4755-b80e-770c9f786773,1716741140,120,1716795686,,0,0,46.72,7013,7731,744,744,783,789,0,3.6,0.55,,,829,1500,,,,,,,,,1,,,,,,,,,190,,,,,87,80,,29.28,,,,134,114,,1,159,151,,,,,,,,,"25,15,20,12,10,6,12",,"40,50,9,1,0",,,,,,,,,,,,,,,,,,,,,,,,,,,,,,,,,,,,,,,,,,19,15,183,56,91,1015,1,,0,4,4,Balve,1,0,,,,,,,,258,7,,0,168072,,30378,,76794956,,,,,,,,,,,,,,,,,,,,,,,,,,,,,,,,,,,,,,,,"4,4,4,5",
97437376,d32deb09-12e5-456e-ac46-a513af204261,1716812713,120,1716809324,,0,0,10.08,3347,3390,162,155,177,170,0,1.8,0.6,0.95,1.07,362,641,132,151,,151,16,56.55,35.54,57.73,1,58.69,1048,62,,2.6,0,98,100,,683,,,,58,79,11.18,11.46,11.47,-2.8,-2,268,268,,1,279,279,,,,,,,,,"22,11,16,19,17,10,3,1,0","0,91,9,0,0","0,8,69,22,0",,,,,114,,,,,,,,,,,,,,,,,,,,,,,,,,,,,,,,,,,,20.3,18,9,236,66,57,1017,5,,0,3,4,Balve,1,0,U1.000|6:03-U1.000|6:15-U1.000|5:53-U1.000|4:43-U1.000|5:29-U1.000|4:45-U1.000|5:18-U1.000|6:09-U1.000|4:31-U1.000|6:12-U0.082|0:28,,"Balve Running",,,3113,,250,3,15603117812,0,168070,250480,30378,,76807445,,,,,,,,,,,,,,,,,,,,,,,,,,,,,,,,,,,,,,,,5,
97466614,fd20c2e0-abd3-409d-b6df-2281bea117dc,1716830639,120,1716826477,,0,0,8.53,2836,2868,127,86,145,106,0,2,0.56,0.99,1.12,622,555,134,147,,146,21,55.42,35.06,56.77,1,58.69,1281,61,,2.6,0,99,100,,483,,,,53,79,11.25,11.44,11.5,-1.8,-4.4,272,272,,1,279,279,,,,,,,,,"23,15,18,19,11,9,5,0,0","1,83,16,0,0","0,2,75,23,0",,,,,114,,,,,,,,,,,,,,,,,,,,,,,,,,,,,,,,,,,,21.5,17,5,295,68,94,1016,1,,0,4,4,Helle,1,0,U1.000|6:08-U1.000|4:50-U1.000|5:51-U1.000|5:41-U1.000|5:33-U1.000|5:43-U1.000|6:07-U1.000|4:10-U0.525|3:14,,"Balve Running",,,3113,,250,3,15607577141,0,168070,250480,30378,,76833531,,,,,,,,,,,,,,,,,,,,,,,,,,,,,,,,,,,,,,,,5,
97582068,1a9ea609-8449-41cf-90dd-167f1140fae2,1716921129,120,1716926674,,0,0,5.48,1604,1981,23,23,31,27,0,0,0.02,,0.16,,352,141,157,,157,21,60.77,39.65,61.09,1,58.75,990,75,,2.7,0.3,104,103,,301,,,,36,81,12.43,13.65,14.59,9.8,-34.5,313,309,,1,398,397,,,,,,,,,"14,2,2,4,35,34,3,2,4","1,39,60,0,0","6,5,10,73,6",,,,,127,,,,,,,,,,,,,,,,,,,,,,,,,,,,,,,,,,,,27.5,17,12,202,61,92,1016,1,,0,4,4,Westick,1,0,U1.000|4:47-U1.000|4:38-U1.000|4:28-U1.000|4:18-U0.228|1:01-U0.090|0:19-U0.110|0:44-U1.000|5:17-U0.056|1:13,,"Fröndenberg/Ruhr Running",,,3113,,250,3,15628394704,0,168070,250480,30378,,76938139,,,,,,,,,,,,,,,,,,,,,,,,,,,,,,,,,,,,,,,,,
97582095,a5d226a6-01fb-401b-9bab-dff85c0e2ee0,1716923216,120,1716926699,,0,0,6.66,1888,1888,0,0,0,0,0,0,0,,,,428,155,180,,176,56,55.5,41.66,55.5,1,58.76,3737,215,,3.2,3.2,108,105,,383,,,,65,81,12.69,14.89,14.89,8.8,0.6,327,327,,1,396,396,,,,,,,,,"35,2,2,3,5,6,8,35,5","0,30,8,63,0","18,14,7,15,46",,,,,131,,,,,,,,,,,,,,,,,,,,,,,,,,,,,,,,,,,,64.8,16,12,209,63,95,1016,1,,0,4,4,Westick,1,0,U1.000|3:15-U0.400|3:09-U0.200|0:37-U0.110|0:25-U0.190|0:38-U0.100|0:27-U0.200|0:38-U0.100|0:27-U0.190|0:39-U0.110|0:27-U0.200|0:40-U0.100|0:27-U0.200|0:39-U0.400|3:33-U0.200|0:39-U0.100|0:29-U0.200|0:38-U0.100|0:29-U0.200|0:38-U0.100|0:30-U0.200|0:39-U0.100|0:30-U0.200|0:39-U0.100|0:29-U0.200|0:40-U0.330|3:45-U1.000|3:14-U0.130|2:06,,"Fröndenberg/Ruhr Track Running",,,3113,,250,3,15628400384,0,168070,250480,30378,,76938160,,,,,,,,,,,,,,,,,,,,,,,,,,,,,,,,,,,,,,,,,
97582104,7b71c75c-785a-4dc9-9d02-a929cd33ae14,1716925455,120,1716926708,,0,0,3.4,1086,1086,13,13,13,12,0,0,0.06,1.09,,,226,135,143,,137,8,57.69,34.72,57.97,1,58.76,4320,38,,2.1,0,102,100,,195,,,,20,80,11.28,11.29,11.39,2.1,0.9,273,273,,1,278,278,,,,,,,,,"1,3,27,51,17,0,0,0,0","0,94,6,0,0","0,0,91,9,0",,,,,117,,,,,,,,,,,,,,,,,,,,,,,,,,,,,,,,,,,,16.2,16,12,218,65,97,1016,0,,0,4,4,Westick,1,0,U1.000|5:18-U1.000|5:08-U1.000|5:28-U0.395|2:12,,"Fröndenberg/Ruhr Running",,,3113,,250,3,15628402148,0,168070,250480,30378,,76938169,,,,,,,,,,,,,,,,,,,,,,,,,,,,,,,,,,,,,,,,,
97652017,c1aa7230-1a1e-414d-9fc3-a47f85df69e8,1716986661,120,1716991669,,0,0,12.23,4040,4146,227,222,248,241,0,2.7,0.64,0.97,1.08,404,795,136,153,,151,18,54.84,36.28,56.12,1,58.76,3250,86,,3,0,96,99,,811,,,,89,79,11.32,11.39,11.67,-3.5,-3.3,270,270,,1,281,281,,,,,,,,,"15,13,26,19,17,7,2,0,0","1,65,34,0,0","1,4,76,18,1",,,,,115,,,,,,,,,,,,,,,,,,,,,,,,,,,,,,,,,,,,29.6,16,17,228,79,60,1011,4,,0,3,4,Balve,1,0,U1.000|5:38-U1.000|5:52-U1.000|5:07-U1.000|5:17-U1.000|6:02-U1.000|5:46-U1.000|5:50-U1.000|5:14-U1.000|4:33-U1.000|5:13-U1.000|5:58-U1.000|5:35-U0.233|1:15,,"Balve Running",,,3113,,250,3,15639386377,0,168070,250480,30378,,76998451,,,,,,,,,,,,,,,,,,,,,,,,,,,,,,,,,,,,,,,,"4,5,5",
97755793,859ec2e6-3611-4e06-b7dd-7c649034090f,1717096760,120,1717091609,,0,0,0.17,78,99,0,0,3,2,0,0,0,,,,11,112,116,,,,45.71,17.24,45.71,1,58.8,4318,1,,0.1,0,,100,,11,,,,1,74,7.8,7.78,7.79,18.3,19.6,179,179,,1,177,177,,,,,,,,,"79,21,0,0,0,0,0,0,0","0,100,0,0,0","0,83,17,0,0",,,,,88,,,,,,,,,,,,,,,,,,,,,,,,,,,,,,,,,,,,0.9,15,9,324,81,86,1006,1,,0,4,4,Amecke,1,0,,,"Sundern (Sauerland) Running",,,3113,,250,3,15660208362,0,168070,250480,30378,,77090505,,,,,,,,,,,,,,,,,,,,,,,,,,,,,,,,,,,,,,,,,
97755801,d1d1ac1b-edf2-4de1-8820-b4dfe06e6fa2,1717092580,120,1717091610,,0,0,16.19,4071,4155,59,60,76,78,0,0,0.03,1.04,,,1014,154,179,,140,41,64.96,50.94,65.25,1,58.8,4320,265,,4.6,0.2,102,105,,791,,,,128,81,14.36,14.87,14.94,0.7,1.2,372,372,,1,394,394,,,,,,,,,"2,1,2,8,12,33,32,9,0","1,19,46,35,0","1,1,9,57,32",,,,,147,,,,,,,,,,,,,,,,,,,,,,,,,,,,,,,,,,,,68,15,10,322,79,80,1006,1,,0,4,4,Amecke,1,0,U1.000|5:13-U1.000|5:24-U1.000|4:19-U1.000|3:41-U1.000|4:07-U1.000|3:41-U1.000|4:08-U1.000|3:39-U1.000|4:20-U1.000|3:42-U1.000|4:05-U1.000|3:36-U1.000|4:05-U1.000|3:41-U1.000|4:05-U1.000|5:00-U0.185|1:04,,"Sundern (Sauerland) Running",,,3113,,250,3,15660208051,0,168070,250480,30378,,77090513,,,,,,,,,,,,,,,,,,,,,,,,,,,,,,,,,,,,,,,,,
97874157,49ff954a-729d-41e7-960d-ead3dd9f69f9,1717236605,120,1717236187,,0,0,19.47,5730,6623,304,269,344,306,0,2.3,0.51,1,1.06,323,1313,159,200,,163,39,51.06,43.09,52.16,1,58.78,3754,259,,4.4,1.2,100,99,,1164,,,,170,81,12.6,12.89,13.12,7.1,-1.9,313,313,,1,333,333,,,,,,,,,"13,6,8,16,26,18,8,4,1","0,5,50,37,8","1,4,34,55,7",,,,,126,,,,,,,,,,,,,,,,,,,,,,,,,,,,,,,,,,,,152.9,14,8,303,88,99,1016,3,,0,4,4,Aachen-Mitte,1,0,U1.000|5:22-U1.000|5:16-U1.000|5:13-U1.000|4:49-U1.000|4:36-U1.000|4:41-U1.000|5:00-U1.000|4:37-U1.000|4:28-U1.000|4:37-U1.000|4:53-U1.000|4:31-U1.000|5:15-U1.000|3:35-U1.000|4:51-U1.000|4:20-U1.000|5:24-U0.607|4:33-U0.095|0:22-U0.129|0:49-U0.097|0:24-U1.000|5:03-U0.545|2:54,,"Aachen Running",,,3113,,250,3,15684554359,0,168070,250480,30378,,77195718,,,,,,,,,,,,,,,,,,,,,,,,,,,,,,,,,,,,,,,,"4,5,5",
97975591,8cebd44c-196d-436a-a811-c5dd950d533c,1717346331,120,1717344460,,0,0,12.02,4348,4923,290,259,290,263,0,3.6,0.79,0.97,1.04,450,727,123,142,,138,18,55.33,32.56,57.15,1,58.78,1801,55,,2.4,0,,100,,671,,,,71,78,10.54,10.5,10.92,-3.5,7.5,246,246,,1,258,258,,,,,,,,,"39,15,19,13,8,5,1,0,0","3,96,1,0,0","0,12,83,5,0",,,,,106,,,,,,,,,,,,,,,,,,,,,,,,,,,,,,,,,,,,18.1,17,13,334,70,74,1020,2,,0,4,4,Balve,1,0,U1.000|5:16-U1.000|5:38-U1.000|6:46-U1.000|7:07-U1.000|6:41-U1.000|7:17-U1.000|6:19-U1.000|5:54-U1.000|5:50-U1.000|4:41-U1.000|4:33-U1.000|6:18-U0.020|0:07,,"Balve Running",,,3113,,250,3,15708133006,0,168070,250480,30378,,77286026,,,,,,,,,,,,,,,,,,,,,,,,,,,,,,,,,,,,,,,,4,
98057592,73d2812a-80da-4ec6-8e63-ea1752b6bd06,1717439548,120,1717437590,,0,0,16,4878,5144,330,315,335,319,0,3.3,0.7,0.98,1.04,720,1004,139,154,,149,16,58.87,40.71,60.45,1,58.78,1338,111,,3.2,0,101,100,,769,,,,107,80,12.31,12.36,12.54,-4,3.9,298,298,,1,305,305,,,,,,,,,"10,9,13,23,20,19,6,0,0","1,57,43,0,0","0,0,54,44,1",,,,,123,,,,,,,,,,,,,,,,,,,,,,,,,,,,,,,,,,,,30.5,14,7,329,68,81,1018,1,,0,4,4,Balve,1,0,U1.000|5:40-U1.000|4:42-U1.000|5:07-U1.000|5:07-U1.000|5:09-U1.000|5:35-U1.000|5:48-U1.000|6:51-U1.000|5:41-U1.000|4:13-U1.000|4:16-U1.000|4:02-U1.000|4:24-U1.000|5:03-U1.000|5:10-U1.000|4:29-U0.004|0:02,,"Balve Running",,,3113,,250,3,15725190154,0,168070,250480,30378,,77360007,,,,,,,,,,,,,,,,,,,,,,,,,,,,,,,,,,,,,,,,4,
98159719,b82476e6-3ea1-4a91-8c69-f5675b47623a,1717525963,120,1717535750,,0,0,5.65,1708,2112,30,18,42,30,0,0,0.08,,0.27,,341,138,155,,155,27,60.05,38.24,60.6,1,58.79,874,65,,2.5,0.5,106,105,,313,,,,40,79,11.99,12.98,13.88,15.6,-24.1,298,298,,1,367,367,,,,,,,,,"20,3,2,4,40,24,3,2,3","2,38,59,0,0","8,7,10,70,5",,,,,126,,,,,,,,,,,,,,,,,,,,,,,,,,,,,,,,,,,,30.9,19,10,225,61,55,1010,1,,0,3,4,Westick,1,0,U1.000|4:36-U1.000|4:37-U1.000|4:31-U1.000|4:26-U0.247|1:09-U0.196|1:15-U1.000|6:22-U0.209|1:31,,"Fröndenberg/Ruhr Running",,,3113,,250,3,15745815839,0,168070,250480,30378,,77452742,,,,,,,,,,,,,,,,,,,,,,,,,,,,,,,,,,,,,,,,,
98159720,4708424f-2400-4d21-b43a-7b2ae713f544,1717528159,120,1717535751,,0,0,5.69,1588,1588,0,0,0,0,0,0,0,,,,348,155,180,108,174,45,56.58,42.04,56.58,1,58.8,2211,169,,3,2.8,108,107,,318,,,,56,81,12.9,14.78,14.78,17.5,7.3,329,329,,1,390,390,,,,,,,,,"28,5,5,4,2,1,17,36,1","0,28,27,44,0","14,13,15,7,51",,,,,133,,,,,,,,,,,,,,,,,,,,,,,,,,,,,,,,,,,,78.7,19,9,228,64,53,1010,0,,0,3,4,Westick,1,0,U0.800|2:41-U0.410|2:46-U0.800|2:39-U0.300|2:08-U0.800|2:40-U0.190|1:28-U0.810|2:42-U0.090|0:57-U0.810|2:50-U0.420|4:37-U0.260|0:59,,"Fröndenberg/Ruhr Track Running",,,3113,,250,3,15745816304,0,168070,250480,30378,,77452743,,,,,,,,,,,,,,,,,,,,,,,,,,,,,,,,,,,,,,,,,
98159721,43e2a8d0-ad1d-4e0c-8564-d201c72c0575,1717530233,120,1717535752,,0,0,2.62,928,928,15,12,21,17,0,0,0.08,1.19,,,173,130,150,95,150,24,53.2,30.15,53.65,1,58.8,2189,23,,1.6,0,,100,,158,,,,17,80,10.25,10.2,10.66,-3,6.9,241,241,,1,255,255,,,,,,,,,"14,30,33,19,3,0,0,0,0","0,94,6,0,0","0,1,95,3,1",,,,,106,,,,,,,,,,,,,,,,,,,,,,,,,,,,,,,,,,,,14.8,19,9,228,64,53,1010,0,,0,3,4,Westick,1,0,U1.000|5:58-U1.000|5:54-U0.624|3:37,,"Fröndenberg/Ruhr Running",,,3113,,250,3,15745816410,0,168070,250480,30378,,77452744,,,,,,,,,,,,,,,,,,,,,,,,,,,,,,,,,,,,,,,,,
98201660,a86a3620-aa10-4b9c-bc8f-d764c518809c,1717593252,120,1717591507,,0,0,0.81,295,295,32,5,31,4,0,1.4,0.75,0.88,1.14,,57,129,147,,147,9,51.89,25.83,56.59,1,58.8,1153,11,,0.8,0,,100,,51,,,,6,79,11.15,10.01,11.27,12.1,11.6,280,280,,1,285,285,,,,,,,,,"34,24,22,15,5,0,0,0,0","12,77,11,0,0","0,0,79,21,0",,,,,104,,,,,,,,,,,,,,,,,,,,,,,,,,,,,,,,,,,,10.3,14,9,266,84,98,1013,4,,0,4,4,Balve,1,0,,,"Balve Running",,,3113,,250,3,15755032588,0,168070,250480,30378,,77490936,,,,,,,,,,,,,,,,,,,,,,,,,,,,,,,,,,,,,,,,,
98201692,11b57985-3960-41a3-a732-d24c8a535e75,1717593648,120,1717591550,,0,0,14.91,4883,4899,281,317,288,323,0,3.2,0.69,0.95,1.08,442,980,136,156,,139,21,55.42,37.23,56.55,1,58.77,2031,103,,3.1,0,98,98,,777,,,,104,80,11.37,11.51,11.69,-9.4,0.9,271,271,,1,281,281,,,,,,,,,"17,10,17,22,23,10,1,0,0","0,73,27,0,0","1,2,84,13,0",,,,,115,,,,,,,,,,,,,,,,,,,,,,,,,,,,,,,,,,,,33.7,14,8,275,83,98,1013,4,,0,4,4,,1,0,U1.000|5:08-U1.000|5:24-U1.000|5:21-U1.000|5:29-U1.000|5:45-U1.000|6:43-U1.000|7:14-U1.000|6:04-U1.000|4:44-U1.000|4:35-U1.000|4:22-U1.000|4:36-U1.000|5:12-U1.000|6:20-U0.908|4:26,,"Balve Running",,,3113,,250,3,15755043578,0,168070,250480,30378,,77490965,,,,,,,,,,,,,,,,,,,,,,,,,,,,,,,,,,,,,,,,"4,5",
98206870,6b0b087e-e0c4-42b8-94b0-17056d6696f2,1717593319,120,1717594853,,0,0,0.58,254,254,0,0,0,0,0,0,0,,,,53,145,157,,152,15,35.58,20.09,35.58,1,,,,,,,,,190,,,,,7,78,8.29,8.27,8.27,-1.6,-3.9,190,190,,1,190,190,,,,,,,,,"99,1,0,0,0,0,0,0,0","0,28,72,0,0","0,87,13,0,0",,,,,88,,,,,,,,,,,,,,,,,,,,,,,,,,,,,,,,,,,,15.5,,,,,,,,,,1,,,1,0,U0.502|3:41-U0.078|0:32-U0.000|0:01,,,,,,,518,7,,0,168070,250480,30378,,77495675,,,,,,,,,,,,,,,,,,,,,,,,,,,,,,,,,,,,,,,,,
98317730,cb35dd47-b71e-4576-ab26-9659f1c3ffbb,1717698158,120,1717696743,,0,0,16.6,5387,5637,281,270,314,292,0,2.9,0.64,0.97,0.95,369,1065,139,173,,173,25,54.51,37.96,55.69,1,58.79,1454,125,,3.3,0.1,100,101,,911,,,,123,79,11.63,12.19,12.4,-4.8,-15.6,283,283,,1,314,314,,,,,,,,,"16,12,21,18,12,11,8,2,0","2,55,33,11,0","4,4,56,29,7",,,,,117,,,,,,,,,,,,,,,,,,,,,,,,,,,,,,,,,,,,64.6,16,11,294,57,57,1017,1,,0,3,4,Balve,1,0,U1.000|5:43-U1.000|6:07-U1.000|5:33-U1.000|5:07-U1.000|6:26-U1.000|6:06-U1.000|5:53-U1.000|5:09-U1.000|5:54-U1.000|5:07-U1.000|4:30-U1.000|8:06-U1.000|3:56-U1.000|3:56-U1.000|4:12-U1.000|4:07-U0.604|3:55,,"Balve Running",,,3113,,250,3,15777777280,0,168070,250480,30378,,77594577,,,,,,,,,,,,,,,,,,,,,,,,,,,,,,,,,,,,,,,,"4,5,5",
98396819,1c482766-d115-4245-854d-0005bca43568,1717783934,120,1717782114,,0,0,14.52,4649,5044,311,280,330,303,0,3.5,0.68,0.95,1.03,486,910,134,157,,144,20,58.06,38.15,59.75,1,58.79,1224,87,,3,0,99,100,,819,,,,90,78,11.84,11.82,12.03,-7.2,-3.7,289,289,,1,299,299,,,,,,,,,"20,15,11,14,21,16,3,0,0","1,76,23,0,0","0,2,65,30,2",,,,,120,,,,,,,,,,,,,,,,,,,,,,,,,,,,,,,,,,,,28.4,18,10,311,48,94,1017,,,0,4,1,Balve,1,0,U1.000|5:13-U1.000|5:30-U1.000|6:47-U1.000|6:25-U1.000|6:24-U1.000|6:22-U1.000|5:15-U1.000|4:54-U1.000|4:51-U1.000|4:31-U1.000|4:29-U0.353|1:35-U1.000|3:55-U1.000|4:42-U1.000|5:38-U0.169|0:59,,"Balve Running",,,3113,,250,3,15793811576,0,168070,250480,30378,,77663228,,,,,,,,,,,,,,,,,,,,,,,,,,,,,,,,,,,,,,,,4,
98522958,7980450f-d2fb-4ad6-819c-4b00909b0550,1717868881,120,1717932303,,0,0,13.24,4469,4724,257,242,268,257,0,2.7,0.62,0.98,1.09,350,851,134,161,103,142,21,54.4,35.6,55.78,1,58.76,1069,77,,2.8,0,97,98,,807,,,,87,78,11.13,11.1,11.38,-5.6,-4.3,269,269,,1,279,279,,,,,,,,,"15,20,23,20,15,4,1,1,0","0,77,22,0,0","0,5,74,20,1",,,,,114,,,,,,,,,,,,,,,,,,,,,,,,,,,,,,,,,,,,27,17,16,278,56,29,1010,1,,0,2,4,Balve,1,0,U1.000|5:45-U1.000|6:03-U1.000|5:37-U1.000|5:18-U1.000|6:13-U1.000|5:56-U1.000|6:00-U1.000|5:09-U1.000|5:33-U1.000|5:01-U1.000|4:49-U1.000|5:46-U1.000|5:36-U0.243|1:43,,"Balve Running",,,3113,,250,3,15822079874,0,168070,250480,30378,,77774012,,,,,,,,,,,,,,,,,,,,,,,,,,,,,,,,,,,,,,,,"4,5",
98538489,7bccedd7-40e4-4975-903e-c451004e27da,1717940783,120,1717943007,,0,0,30.46,7883,8923,145,123,269,250,0,0,0.14,1.13,0.94,,1913,157,176,103,163,23,60.96,51.77,61.37,1,58.83,4320,321,,5,0.1,104,101,,1764,,,,246,81,13.99,14.15,14.41,-0.1,-6.7,361,361,,1,378,378,,,,,,,,,"0,2,5,5,13,53,21,1,0","0,10,48,41,0","0,0,10,74,16",,,,,143,,,,,,,,,,,,,,,,,,,,,,,,,,,,,,,,,,,,72,18,14,273,47,52,1009,4,,0,3,4,"Sundern (Sauerland)",1,0,U1.000|4:40-U1.000|4:27-U1.000|4:23-U1.000|4:25-U1.000|4:22-U1.000|4:27-U1.000|4:12-U1.000|4:16-U1.000|4:13-U1.000|4:08-U1.000|4:26-U1.000|4:17-U1.000|4:14-U1.000|4:14-U1.000|4:12-U1.000|4:13-U1.000|4:06-U1.000|4:02-U1.000|4:06-U1.000|3:56-U1.000|4:00-U1.000|4:04-U1.000|4:00-U1.000|3:53-U1.000|3:50-U1.000|4:11-U1.000|4:12-U1.000|4:15-U1.000|5:13-U1.000|5:43-U0.456|2:44,,"Sundern (Sauerland) Running",,,3113,,250,3,15825320551,0,168070,250480,30378,,77785939,,,,,,,,,,,,,,,,,,,,,,,,,,,,,,,,,,,,,,,,,
98618342,1eff18df-02b2-4796-ab40-322d98ccc326,1718038781,120,1718034701,,0,0,7.7,2899,2958,107,68,122,81,0,1.5,0.45,1.02,0.97,590,510,125,147,,141,15,51.69,30.02,52.9,1,58.83,2794,44,,2.2,0,,100,,490,,,,27,77,9.85,9.71,10.07,0.9,3.3,239,239,,1,248,248,,,,,,,,,"37,24,25,8,2,1,1,1,0","1,97,2,0,0","0,13,81,6,0",,,,,103,,,,,,,,,,,,,,,,,,,,,,,,,,,,,,,,,,,,8.2,13,19,220,80,87,1004,2,,0,4,4,Helle,1,0,U1.000|6:08-U1.000|6:16-U1.000|6:16-U1.000|6:22-U1.000|6:26-U1.000|6:48-U1.000|5:39-U0.704|4:23,,"Balve Running",,,3113,,250,3,15841499400,0,168070,250480,30378,,77856497,,,,,,,,,,,,,,,,,,,,,,,,,,,,,,,,,,,,,,,,5,
98752365,d55d551b-1d60-476e-be57-cfceff5dda2f,1718197019,120,1718192708,,0,0,7.62,2654,2678,131,142,153,162,0,2.4,0.62,1.03,1.02,518,498,135,149,120,145,19,51.85,32.92,52.86,1,58.9,3436,46,,2.3,0,97,98,,526,,,,49,77,10.62,10.48,10.87,-2.2,-3.8,256,256,,1,266,266,,,,,,,,,"19,15,31,28,7,0,0,0,0","1,74,26,0,0","0,8,82,9,0",,,,,112,,,,,,,,,,,,,,,,,,,,,,,,,,,,,,,,,,,,20.7,13,11,273,65,76,1019,4,,0,4,4,Balve,1,0,U1.000|6:34-U1.000|5:25-U1.000|5:48-U1.000|5:40-U1.000|5:37-U1.000|6:06-U1.000|5:24-U0.615|3:40,,"Balve Running",,,3113,,250,3,15872224968,0,168070,250480,30378,,77972836,,,,,,,,,,,,,,,,,,,,,,,,,,,,,,,,,,,,,,,,"5,5",
98875277,c4b174e7-8866-4ecc-9048-2e3c878d1e95,1718303428,120,1718303619,,0,0,9.63,3521,3830,210,143,215,152,0,2.6,0.56,0.97,0.96,362,651,131,150,,145,23,50.68,31.6,52.49,1,58.9,1647,60,,2.5,0,98,98,,589,,,,47,77,10.38,10.24,10.79,0.3,1.3,255,255,,1,270,270,,,,,,,,,"32,16,26,18,5,1,0,0,0","1,87,12,0,0","1,11,77,9,2",,,,,107,,,,,,,,,,,,,,,,,,,,,,,,,,,,,,,,,,,,12.8,16,10,209,55,86,1015,1,,0,4,4,Helle,1,0,U1.000|5:51-U1.000|5:45-U1.000|6:27-U1.000|5:39-U1.000|6:01-U1.000|6:19-U1.000|5:28-U1.000|6:26-U1.000|6:28-U0.626|4:17,,"Balve Running",,,3113,,250,3,15895980393,0,168070,250480,30378,,78080219,,,,,,,,,,,,,,,,,,,,,,,,,,,,,,,,,,,,,,,,"4,5",
98875293,6861e459-0ac3-4ac0-889a-242f1ebfac59,1718307426,120,1718303629,,0,0,4.7,1752,1770,63,51,76,65,0,0.9,0.4,1,0.96,223,314,125,146,,142,23,52.33,29.45,53.36,1,58.9,1616,30,,2,0,,100,,271,,,,19,78,9.88,9.83,10.09,5.8,-1.2,239,239,,1,248,248,,,,,,,,,"29,22,29,17,3,0,0,0,0","2,95,3,0,0","2,10,85,3,0",,,,,103,,,,,,,,,,,,,,,,,,,,,,,,,,,,,,,,,,,,8.7,15,8,193,58,85,1015,0,,0,4,4,Balve,1,0,U1.000|6:16-U1.000|5:42-U1.000|6:02-U1.000|6:17-U0.699|4:55,,"Balve Running",,,3113,,250,3,15895983725,0,168070,250480,30378,,78080234,,,,,,,,,,,,,,,,,,,,,,,,,,,,,,,,,,,,,,,,5,
98947066,9197f3d4-01d3-4a1b-9436-89c56caa152b,1718389676,120,1718385852,,0,0,7.54,2911,3032,98,70,112,86,0,1.2,0.38,0.97,1.01,235,488,122,143,,143,26,51.53,29.09,52.6,1,58.9,758,37,,2.1,0,,100,,462,,,,40,77,9.58,9.54,9.75,-6.7,-7.2,228,228,,1,235,235,,,,,,,,,"43,21,16,12,6,2,0,0,0","1,98,1,0,0","1,17,79,4,0",,,,,101,,,,,,,,,,,,,,,,,,,,,,,,,,,,,,,,,,,,11.5,18,16,189,71,55,1007,1,,0,3,4,Helle,1,0,U1.000|6:14-U1.000|6:28-U1.000|6:34-U1.000|6:54-U1.000|6:34-U1.000|6:52-U1.000|5:30-U0.543|3:26,,"Balve Running",,,3113,,250,3,15910602505,0,168070,250480,30378,,78142379,,,,,,,,,,,,,,,,,,,,,,,,,,,,,,,,,,,,,,,,4,
99009478,a7bbb805-dbae-4747-a56f-0cac9a8b001f,1718471053,120,1718466944,,0,0,8.37,2784,2950,113,109,137,136,0,1.6,0.48,0.96,0.95,537,540,136,167,,163,20,54.37,34.99,55.31,1,58.92,990,71,,2.7,0,99,102,,505,,,,55,78,11.02,11.46,11.67,-8.5,-18.4,266,266,,1,291,291,,,,,,,,,"14,21,27,20,6,6,6,1,0","1,71,21,8,0","0,4,75,16,5",,,,,116,,,,,,,,,,,,,,,,,,,,,,,,,,,,,,,,,,,,37.9,17,19,220,53,77,1007,2,,0,4,4,Balve,1,0,U1.000|6:14-U1.000|5:38-U1.000|6:16-U1.000|5:56-U1.000|5:16-U0.174|0:46-U1.000|3:50-U1.000|5:10-U1.000|6:09-U0.191|1:11,,"Balve Running",,,3113,,250,3,15925783280,0,168070,250480,30378,,78198992,,,,,,,,,,,,,,,,,,,,,,,,,,,,,,,,,,,,,,,,5,
99077533,a49036ce-3135-429d-8289-0be31e8f677a,1718538539,120,1718535640,,0,0,10,2852,3010,30,29,45,45,0,0,0.02,,,,635,148,170,,169,27,58.79,42.45,59.02,1,59.01,1280,111,,3.2,0,103,103,,542,,,,75,80,12.65,12.96,12.99,1.7,-5,320,320,,1,333,333,,,,,,,,,"5,6,8,16,28,26,10,2,0","0,17,69,14,0","0,1,32,62,5",,,,,131,,,,,,,,,,,,,,,,,,,,,,,,,,,,,,,,,,,,52.1,16,20,203,66,83,1008,4,,0,4,4,Amecke,1,0,U1.000|5:10-U1.000|4:54-U1.000|4:45-U1.000|4:46-U1.000|4:44-U1.000|4:32-U1.000|4:39-U1.000|4:13-U1.000|4:04-U1.000|5:44,,"Sundern (Sauerland) Running",,,3113,,250,3,15937553835,0,168070,250480,30378,,78261752,,,,,,,,,,,,,,,,,,,,,,,,,,,,,,,,,,,,,,,,,
99089994,561b47c9-e7ec-4c2b-b5ff-172c73c82109,1718546654,120,1718543891,,0,0,2.69,2984,3486,57,57,67,65,0,1.7,0.62,,,117,169,85,117,,100,27,,,,1,59.01,1138,3,,0.2,0,,100,,422,,,,10,54,,4.03,,-53.6,,,,,,,,,,,,,,,,"86,14,0,0,0,0","86,14,0,0,0",,2029,7,,,,,,,,,,,,,,,,,,,,,,,,,,,,,,,,,,,,,,,2.3,17,20,208,63,90,1008,3,,0,4,4,Balve,1,0,,,"Balve Hiking",,,3113,,250,3,15940087415,0,168075,,30378,,78272434,,,,,,,,,,,,,,,,,,,,,,,,,,,,,,,,,,,,,,,,4,
99181914,709a2bc2-1ab7-4cba-85ef-0a9288160c69,1718647748,120,1718650196,,0,0,15.97,5227,5513,430,384,435,395,0,4.4,0.83,0.99,1.11,535,1050,142,160,,151,17,52.45,37.47,54.39,1,58.98,1299,112,,3.2,0,100,98,,1049,,,,118,79,11.84,11.79,12.02,-5,5.6,284,284,,1,289,289,,,,,,,,,"26,13,12,12,14,16,6,0,0","0,34,66,0,0","0,1,69,30,1",,,,,116,,,,,,,,,,,,,,,,,,,,,,,,,,,,,,,,,,,,33.4,18,9,245,71,83,1013,1,,0,4,4,Helle,1,0,U1.000|5:36-U1.000|5:57-U1.000|6:22-U1.000|6:53-U1.000|6:27-U1.000|4:57-U1.000|5:24-U1.000|5:26-U1.000|6:10-U1.000|6:45-U1.000|4:08-U1.000|4:12-U1.000|4:07-U1.000|4:18-U1.000|4:26-U0.968|5:59,,"Balve Running",,,3113,,250,3,15961277149,0,168070,250480,30378,,78352690,,,,,,,,,,,,,,,,,,,,,,,,,,,,,,,,,,,,,,,,"4,4",
99221880,5f583879-8f73-4a64-9e51-d5bad430eedc,1718705504,120,1718698392,,0,0,,71,71,0,0,0,0,0,,,,,,6,92,103,,,,,,,1,,,,,,,,,190,,,,,0,,,,,,,,,,,,,,,,,,,,,,"84,16,0,0,0",,,,,,,,,,,,,,,,,,,,,,,,,,,,,,,,,,,,,,,,,,0.2,,,,,,,,,,1,,,1,0,U0.000|0:06-U0.000|0:09-U0.000|0:35-U0.000|0:20,,,,,,,518,7,,0,168070,250480,30378,,78385352,,,,,,,,,,,,,,,,,,,,,,,,,,,,,,,,,,,,,,,,,
99223519,,1718103900,,1718701554,,0,0,15,5400,,,,,,0,,,,,,1320,,,,,,,33.33,,1,,,,,,,,,,,,,,211,,,,,,,,,,,,,,,,,,,,,,,,,,,,,,,,,,,,,,,,,,,,,,,,,,,,,,,,,,,,,,,,,,,,,,,,,,1,,,0,0,,,,,,,,,0,,0,168070,250482,30378,,,,,,,,,,,,,,,,,,,,,,,,,,,,,,,,,,,,,,,,,,,
99273629,7e4360b8-cbc9-4aa0-8433-392a2506f4d2,1718735714,120,1718736725,,0,0,4.3,1266,2028,4,23,9,26,0,0,0.08,,0.85,,271,142,159,,159,7,59.77,38.81,59.52,1,59.02,874,61,,2.5,0,105,103,,246,,,,29,78,12.09,12.78,12.59,3.3,0.3,304,304,,1,321,321,,,,,,,,,"7,4,16,7,21,39,4,0,0","2,35,63,0,0","3,2,31,64,0",,,,,131,,,,,,,,,,,,,,,,,,,,,,,,,,,,,,,,,,,,34.1,18,8,271,88,99,1012,1,,0,4,4,Westick,1,0,U1.000|5:54-U1.000|4:39-U1.000|4:22-U1.000|4:17-U0.300|1:54,,"Fröndenberg/Ruhr Running",,,3113,,250,3,15978744210,0,168070,250480,30378,,78430785,,,,,,,,,,,,,,,,,,,,,,,,,,,,,,,,,,,,,,,,,
99273631,05879678-7db0-4cca-95fb-012b709bfa20,1718739962,120,1718736725,,0,0,2.26,715,715,0,0,3,3,0,0,0,,,,147,141,156,101,156,13,55.21,33.96,55.21,1,59.07,2442,29,,2,0,103,103,,167,,,,15,81,11.36,11.41,11.41,-1.6,-2.5,283,283,,1,285,285,,,,,,,,,"3,5,15,50,25,1,0,0,0","0,34,66,0,0","0,3,78,19,0",,,,,117,,,,,,,,,,,,,,,,,,,,,,,,,,,,,,,,,,,,20.4,18,8,281,87,98,1012,0,,0,4,4,Westick,1,0,U1.000|5:30-U1.000|5:07-U0.257|1:18,,"Fröndenberg/Ruhr Running",,,3113,,250,3,15978745603,0,168070,250480,30378,,78430787,,,,,,,,,,,,,,,,,,,,,,,,,,,,,,,,,,,,,,,,,
99273635,789bdad3-c3d1-479d-8a77-9d6d6e69cf56,1718737796,120,1718736726,,0,0,7.21,2028,2028,0,0,0,0,0,0,0,,,,448,158,187,,181,54,54.49,42.24,54.49,1,59.06,2477,198,,3.3,2.9,106,108,,399,,,,73,81,12.79,14.95,14.95,27.3,8.8,339,339,,1,407,407,,,,,,,,,"30,2,2,3,3,3,24,34,1","0,20,27,34,18","18,9,9,7,56",,,,,132,,,,,,,,,,,,,,,,,,,,,,,,,,,,,,,,,,,,90.6,18,8,281,87,98,1012,0,,0,4,4,Westick,1,0,U1.000|3:29-U0.200|1:09-U1.000|3:22-U0.200|1:09-U1.000|3:23-U0.200|1:24-U1.000|3:30-U0.210|2:28-U1.000|3:25-U0.200|1:59-U0.500|1:52-U0.110|1:16-U0.400|1:21-U0.190|3:59,,"Fröndenberg/Ruhr Track Running",,,3113,,250,3,15978745462,0,168070,250480,30378,,78430791,,,,,,,,,,,,,,,,,,,,,,,,,,,,,,,,,,,,,,,,,
99322215,de7db461-b1ab-4b67-80a3-cc8a845ddf87,1718801799,120,1718800175,,0,0,15.75,4945,5298,310,308,325,328,0,3.5,0.69,0.98,1.04,585,1046,149,170,134,165,24,51.73,39.29,53,1,59.05,2171,134,,3.4,0,100,99,,1004,,,,128,79,11.94,11.81,12.05,-1.1,4.5,288,288,,1,293,293,,,,,,,,,"13,8,12,21,32,12,1,0,0","0,21,68,10,0","0,1,63,36,0",,,,,121,,,,,,,,,,,,,,,,,,,,,,,,,,,,,,,,,,,,51.6,16,11,15,77,96,1018,4,,0,4,4,Balve,1,0,U1.000|5:46-U1.000|4:38-U1.000|5:05-U1.000|4:58-U1.000|5:04-U1.000|5:32-U1.000|6:09-U1.000|7:11-U1.000|5:43-U1.000|4:35-U1.000|4:32-U1.000|4:24-U1.000|4:39-U1.000|5:22-U1.000|5:11-U0.747|3:35,,"Balve Running",,,3113,,250,3,15989632583,0,168070,250480,30378,,78475308,,,,,,,,,,,,,,,,,,,,,,,,,,,,,,,,,,,,,,,,"4,5",
99430503,e3fb46fe-f7af-4418-a216-f82f207de995,1718905503,120,1718904906,,0,0,14.03,5100,6439,322,251,363,291,0,3.8,0.68,1.07,0.81,300,910,135,181,,174,49,49.19,32.78,50.89,1,59.05,1225,94,,3,0.6,99,100,,1061,,,,74,78,10.24,11,12.73,18.7,-29.2,256,256,,1,344,344,,,,,,,,,"32,12,18,16,12,6,4,0,0","1,70,27,3,0","10,18,46,19,7",,,,,106,,,,,,,,,,,,,,,,,,,,,,,,,,,,,,,,,,,,22.5,21,4,115,73,75,1017,1,,0,4,4,Balve,1,0,U1.000|5:53-U1.000|5:58-U1.000|5:13-U1.000|5:44-U1.000|4:45-U1.000|4:47-U1.000|5:36-U1.000|5:32-U1.000|5:51-U0.468|3:38-U0.314|2:09-U0.302|1:11-U0.335|2:48-U0.297|1:13-U0.345|3:09-U0.305|1:14-U0.339|3:45-U0.302|1:14-U0.343|4:15-U0.306|1:20-U1.000|7:28-U0.371|2:16,,"Balve Running",,,3113,,250,3,16011449225,0,168070,250480,30378,,78572458,,,,,,,,,,,,,,,,,,,,,,,,,,,,,,,,,,,,,,,,"4,5",
99539231,40630a37-4f7f-44ea-9819-81c2f377aaa2,1719002758,120,1719009627,,0,0,6.11,2128,2429,102,99,106,107,0,1.8,0.56,1,1.04,351,410,128,149,,149,20,55.34,32.46,56.51,1,59.04,702,40,,2.2,0,98,98,,351,,,,32,78,10.61,10.76,11.02,-8.5,-9.6,257,257,,1,271,271,,,,,,,,,"19,24,28,19,3,2,4,0,0","1,89,10,0,0","0,0,85,15,0",,,,,110,,,,,,,,,,,,,,,,,,,,,,,,,,,,,,,,,,,,13.9,17,13,253,86,100,1010,0,,0,4,4,Balve,1,0,U1.000|6:23-U1.000|5:31-U1.000|5:51-U1.000|6:07-U1.000|5:50-U1.000|5:13-U0.109|0:34,,"Balve Running",,,3113,,250,3,16030022294,0,168070,250480,30378,,78670937,,,,,,,,,,,,,,,,,,,,,,,,,,,,,,,,,,,,,,,,5,
99559458,c5ea7f59-e3ce-49fe-a3e3-7da2ebb4ef14,1719046801,120,1719045355,,0,0,15.24,4074,4170,68,48,96,75,0,0,0.08,1.03,,,993,161,184,,179,44,56.43,47.23,56.83,1,59.12,2304,240,,4.1,2.1,105,102,,895,,,,147,82,13.58,14.45,14.5,6.4,2.9,346,346,,1,379,379,,,,,,,,,"6,2,5,14,19,24,20,10,0","0,3,49,41,7","2,3,19,50,26",,,,,137,,,,,,,,,,,,,,,,,,,,,,,,,,,,,,,,,,,,105.9,15,16,233,80,62,1013,2,,0,3,4,Langscheid,1,0,U1.000|4:47-U1.000|4:10-U1.000|4:13-U1.000|4:44-U0.603|2:04-U0.203|1:04-U1.000|3:28-U0.105|0:24-U0.377|2:04-U1.000|3:34-U1.000|3:50-U0.723|4:21-U1.000|3:34-U0.118|0:24-U0.314|2:07-U0.554|2:02-U1.000|5:24-U1.000|4:58-U1.000|4:48-U1.000|4:43-U0.246|1:11,,"Sundern (Sauerland) Running",,,3113,,250,3,16034561033,0,168070,250480,30378,,78688507,,,,,,,,,,,,,,,,,,,,,,,,,,,,,,,,,,,,,,,,,
99653547,85b68e64-85f1-4d9c-82f2-9391350a4439,1719141657,120,1719142076,,0,0,19.16,6984,7175,567,505,589,526,0,5,0.81,0.97,1.08,526,1304,138,167,109,153,21,47.67,33.48,49.61,1,59.05,1439,114,,3.2,0,97,97,,1419,,,,127,79,10.67,10.53,10.9,-3.4,3.3,248,248,,1,256,256,,,,,,,,,"41,18,11,10,15,5,1,0,0","0,60,39,1,0","0,9,86,5,0",,,,,104,,,,,,,,,,,,,,,,,,,,,,,,,,,,,,,,,,,,30.8,20,6,303,64,85,1020,4,,0,4,4,Helle,1,0,U1.000|6:08-U1.000|6:48-U1.000|6:38-U1.000|7:24-U1.000|5:33-U1.000|5:27-U1.000|5:26-U1.000|7:23-U1.000|7:26-U1.000|7:24-U1.000|6:18-U1.000|6:26-U1.000|7:14-U1.000|5:05-U1.000|4:31-U1.000|4:44-U1.000|4:56-U1.000|4:45-U1.000|5:52-U0.158|0:57,,"Balve Running",,,3113,,250,3,16054308553,0,168070,250480,30378,,78773092,,,,,,,,,,,,,,,,,,,,,,,,,,,,,,,,,,,,,,,,"4,4,4",
99744465,b2dbbb39-a6b8-4faf-8c09-5e741d796ac0,1719240689,120,1719237127,,0,0,0.85,311,311,16,8,17,10,0,0,0.27,0.96,1.01,,55,123,137,,137,26,54.55,25.83,56.46,1,59.05,,7,,0.5,0,,100,,79,,,,4,78,10.1,9.93,10.2,3,10.8,244,244,,1,248,248,,,,,,,,,"36,19,24,20,2,0,0,0,0","6,94,0,0,0","0,0,100,0,0",,,,,105,,,,,,,,,,,,,,,,,,,,,,,,,,,,,,,,,,,,4.4,25,8,33,50,39,1019,6,,0,3,4,Balve,1,0,,,"Balve Running",,,3113,,250,3,16072575715,0,168070,250480,30378,,78852341,,,,,,,,,,,,,,,,,,,,,,,,,,,,,,,,,,,,,,,,,
99754688,9d154cda-d756-4821-adbd-0d01c7c92e42,1719252654,120,1719247213,,0,0,10.26,1472,1472,103,99,120,117,0,0.7,0.32,1.49,0.5,,180,114,142,98,134,37,,,,1,59.05,,10,,0.7,0,,100,,290,,,,13,,,28.47,,-3.2,10.2,112,99,,1,144,138,,,,,,,,,"19,7,19,24,20,9,1","17,82,1,0,0","47,49,4,0,0",,,,,,,,,,,,,,,,,,,,,,,,,,,,,,,,,,,,,,,,,7.4,24,10,38,53,45,1018,2,,0,3,4,Balve,1,0,U5.000|12:15-U5.000|11:09-U0.260|1:09,,"Balve Cycling",,,3113,,250,3,16075324305,0,168072,,30378,,78861532,,,,,,,,,,,,,,,,,,,,,,,,,,,,,,,,,,,,,,,,,
99846583,603bef46-8da9-4e03-be82-cfea082aa83e,1719340181,120,1719343920,,0,0,4.83,1436,2314,17,12,26,25,0,0,0.04,0.86,,,311,141,161,,143,17,59.61,38.64,59.95,1,59.09,990,67,,2.7,0,105,106,,360,,,,32,79,12.24,12.86,12.95,2.5,-9.6,312,312,,1,338,338,,,,,,,,,"12,8,6,12,22,33,4,1,2","2,40,57,1,0","5,3,26,61,6",,,,,128,,,,,,,,,,,,,,,,,,,,,,,,,,,,,,,,,,,,33.7,26,12,72,52,2,1013,1,,0,2,4,Westick,1,0,U1.000|5:40-U1.000|4:42-U1.000|4:18-U1.000|4:17-U0.219|0:58-U0.615|4:01,,"Fröndenberg/Ruhr Running",,,3113,,250,3,16095639842,0,168070,250480,30378,,78943989,,,,,,,,,,,,,,,,,,,,,,,,,,,,,,,,,,,,,,,,,
99846624,d9c16420-c219-461a-b86c-f347c1539927,1719342609,120,1719343928,,0,0,6.84,2136,2136,0,0,0,0,0,0,0,,,,477,158,183,116,183,48,47.9,37.21,47.9,1,59.1,2611,182,,3.2,2.8,107,104,,593,,,,73,79,11.52,13.85,13.85,27.1,13.1,302,302,,1,376,376,,,,,,,,,"42,4,3,1,2,3,11,28,5","0,23,19,53,4","20,16,13,11,40",,,,,122,,,,,,,,,,,,,,,,,,,,,,,,,,,,,,,,,,,,78.9,26,12,72,52,2,1013,1,,0,2,4,Westick,1,0,U0.390|1:17-U0.110|0:34-U0.400|1:17-U0.100|0:37-U0.400|1:17-U0.100|0:35-U0.400|1:17-U0.100|0:37-U0.400|1:18-U0.410|3:47-U0.390|1:19-U0.110|0:49-U0.400|1:24-U0.100|0:41-U0.400|1:23-U0.100|0:45-U0.400|1:23-U0.100|0:51-U0.400|1:26-U0.160|2:49-U0.410|1:21-U1.060|8:50,,"Fröndenberg/Ruhr Track Running",,,3113,,250,3,16095650175,0,168070,250480,30378,,78944030,,,,,,,,,,,,,,,,,,,,,,,,,,,,,,,,,,,,,,,,,
99846632,c911f0ef-4fac-49a8-ba8e-657e2a2910df,1719345042,120,1719343929,,0,0,2.42,885,901,2,0,14,11,0,0,0,,,,167,138,146,112,144,8,47.48,28.85,47.58,1,59.09,2591,23,,1.6,0,97,98,,234,,,,17,79,9.85,9.98,9.99,-2.5,-3.2,239,239,,1,244,244,,,,,,,,,"26,25,36,10,2,0,0,0,0","0,63,37,0,0","0,6,92,2,0",,,,,104,,,,,,,,,,,,,,,,,,,,,,,,,,,,,,,,,,,,18.4,25,10,76,57,0,1013,0,,0,2,4,Westick,1,0,U1.000|6:24-U1.000|6:03-U0.415|2:18,,"Fröndenberg/Ruhr Running",,,3113,,250,3,16095652342,0,168070,250480,30378,,78944040,,,,,,,,,,,,,,,,,,,,,,,,,,,,,,,,,,,,,,,,,
99902270,d5039e90-0ea7-419e-b286-6f9bc61e0277,1719405989,120,1719403483,,0,0,13.24,4255,4509,118,110,152,144,0,0.7,0.33,0.97,1.05,,857,143,168,,156,24,53.15,37.71,53.78,1,59.08,1739,93,,3,0,98,99,,1181,,,,93,78,11.34,11.35,11.45,0.4,-1.6,276,276,,1,281,281,,,,,,,,,"5,8,20,43,20,2,1,0,0","0,36,61,3,0","0,0,84,16,0",,,,,120,,,,,,,,,,,,,,,,,,,,,,,,,,,,,,,,,,,,37.9,27,4,117,50,34,1011,6,,0,2,4,Balve,1,0,U1.000|5:53-U1.000|4:51-U1.000|5:26-U1.000|5:26-U1.000|5:37-U1.000|5:40-U1.000|5:22-U1.000|5:18-U1.000|5:26-U1.000|5:21-U1.000|4:52-U1.000|4:47-U1.000|5:32-U0.242|1:24,,"Balve Running",,,3113,,250,3,16106327551,0,168070,250480,30378,,78993113,,,,,,,,,,,,,,,,,,,,,,,,,,,,,,,,,,,,,,,,,
100007444,eb6d8e14-a743-48d8-b4e9-deb94cf4a90e,1719513039,120,1719510838,,0,0,14.1,4587,4844,385,356,402,377,0,3.9,0.73,0.94,1.07,423,921,144,163,110,157,21,51.87,37.36,53.76,1,59.01,1266,98,,3.1,0,100,96,,1145,,,,93,79,11.91,11.98,12.11,-4.9,8.7,286,286,,1,293,293,,,,,,,,,"27,15,11,12,10,18,5,0,0","0,34,64,1,0","0,0,70,29,1",,,,,117,,,,,,,,,,,,,,,,,,,,,,,,,,,,,,,,,,,,29.4,26,9,270,57,39,1009,1,,0,3,4,Balve,1,0,U1.000|5:01-U1.000|5:09-U1.000|6:24-U1.000|6:22-U1.000|6:16-U1.000|6:11-U1.000|6:44-U1.000|6:17-U1.000|4:44-U1.000|4:20-U1.000|4:16-U1.000|4:12-U1.000|4:10-U1.000|5:47-U0.099|0:34,,"Balve Running",,,3113,,250,3,16128682168,0,168070,250480,30378,,79087524,,,,,,,,,,,,,,,,,,,,,,,,,,,,,,,,,,,,,,,,3,
100079449,e7778609-f946-4bb1-b37e-b9beba6a8ddb,1719598763,120,1719599568,,0,0,1.25,332,367,4,8,2,4,0,0,0.17,,,,80,150,163,,162,18,63.01,38.81,63.01,1,59.01,352,25,,1.6,0.1,,100,,81,,,,2,79,13.47,13.63,13.47,2.8,2.8,342,342,,1,343,343,,,,,,,,,"1,3,4,8,28,37,13,7,0","0,0,90,10,0","0,0,4,95,1",,,,,143,,,,,,,,,,,,,,,,,,,,,,,,,,,,,,,,,,,,2.5,21,11,258,47,27,1017,2,,0,2,4,"Sundern (Sauerland)",1,0,U1.000|4:28-U0.252|1:03,,"Sundern (Sauerland) Running",,,3113,,250,3,16145171947,0,168070,250480,30378,,79153555,,,,,,,,,,,,,,,,,,,,,,,,,,,,,,,,,,,,,,,,,
100079450,c9cfebb3-b1a0-4fdc-aa57-0157a73b054b,1719599399,120,1719599568,,0,0,15.6,3461,3461,40,30,90,80,0,0,0.06,,,,952,179,191,,179,7,60.07,58.72,60.31,1,59.11,4320,351,,5,0.9,109,100,,961,,,,140,84,16.28,16.34,16.48,6.3,8.3,436,436,,1,445,445,,,,,,,,,"0,0,0,0,1,8,67,21,1","0,1,2,45,51","0,0,0,13,87",,,,,161,,,,,,,,,,,,,,,,,,,,,,,,,,,,,,,,,,,,127.1,21,9,260,48,28,1017,1,,0,2,4,Amecke,1,0,U1.000|3:37-U1.000|3:35-U1.000|3:41-U1.000|3:53-U1.000|3:42-U1.000|3:39-U1.000|3:44-U1.000|3:42-U1.000|3:51-U1.000|3:46-U1.000|3:40-U1.000|3:44-U1.000|3:42-U1.000|3:37-U1.000|3:34-U0.601|2:14,,"Sundern (Sauerland) Running",,,3113,,250,3,16145172204,0,168070,250480,30378,,79153556,,,,,,,,,,,,,,,,,,,,,,,,,,,,,,,,,,,,,,,,,
100079454,8887182c-aa35-4c6d-9cec-317b8661e55a,1719603607,120,1719599569,,0,0,3.34,1272,1272,18,23,38,43,0,0.2,0.33,1.21,0.79,,257,144,166,,155,27,42.71,28.12,42.91,1,59.1,4326,42,,2.2,0.1,96,99,,297,,,,28,80,9.45,10.57,10.63,19.8,0.4,230,228,,1,260,259,,,,,,,,,"11,15,38,28,6,1,0,0,0","0,21,76,3,0","12,1,82,4,0",,,,,98,,,,,,,,,,,,,,,,,,,,,,,,,,,,,,,,,,,,26.8,21,8,263,50,22,1017,0,,0,2,4,Amecke,1,0,U1.000|5:48-U1.000|5:40-U1.000|5:30-U0.344|4:14,,"Sundern (Sauerland) Running",,,3113,,250,3,16145172432,0,168070,250480,30378,,79153560,,,,,,,,,,,,,,,,,,,,,,,,,,,,,,,,,,,,,,,,,
100109058,2cd31249-4b36-4ec2-b0b2-92af644ab667,1719651425,120,1719647519,,0,0,8.62,2955,2960,103,108,119,125,0,1.4,0.42,0.94,1,468,578,141,156,,156,21,50.01,33.84,50.71,1,59.1,3503,57,,2.5,0,96,97,,633,,,,6,79,10.65,10.63,10.77,-3,-6,252,252,,1,258,258,,,,,,,,,"17,11,27,34,8,1,1,0,0","0,51,49,0,0","0,2,92,6,0",,,,,111,,,,,,,,,,,,,,,,,,,,,,,,,,,,,,,,,,,,1.2,18,2,77,67,43,1016,2,,0,3,4,Balve,1,0,U1.000|6:19-U1.000|5:21-U1.000|5:52-U1.000|5:41-U1.000|5:31-U1.000|5:25-U1.000|5:24-U1.000|5:34-U0.622|4:09,,"Balve Running",,,3113,,250,3,16151613624,0,168070,250480,30378,,79180286,,,,,,,,,,,,,,,,,,,,,,,,,,,,,,,,,,,,,,,,5,
100176293,67470f3a-725a-4cec-bab3-d8c8cf2f1454,1719736148,120,1719733583,,0,0,12.19,4388,4589,200,204,212,220,0,2.3,0.56,1.03,1.02,263,841,139,159,,148,15,47.97,32.79,48.92,1,59.09,2066,75,,2.8,0,96,95,,727,,,,65,79,10.27,10.25,10.38,0.5,1.9,243,243,,1,247,247,,,,,,,,,"26,22,26,19,6,1,0,0,0","0,55,45,0,0","0,8,90,1,0",,,,,105,,,,,,,,,,,,,,,,,,,,,,,,,,,,,,,,,,,,15.1,16,8,311,93,99,1006,2,,0,6,4,Balve,1,0,U1.000|5:43-U1.000|5:47-U1.000|5:39-U1.000|6:05-U1.000|6:05-U1.000|6:24-U1.000|5:58-U1.000|6:27-U1.000|5:32-U1.000|5:56-U1.000|6:23-U1.000|5:50-U0.193|1:19,,"Balve Running",,,3113,,250,3,16167793621,0,168070,250480,30378,,79238392,,,,,,,,,,,,,,,,,,,,,,,,,,,,,,,,,,,,,,,,"5,5",
100316064,2e4210e6-9979-4c86-a31b-58e4bdfc348e,1719860637,120,1719862721,,0,0,14.62,4903,5374,375,323,387,337,0,4,0.79,0.92,1.06,550,938,135,155,,148,15,54.33,36.16,56.29,1,59.05,1248,88,,3,0,97,99,,769,,,,13,79,11.52,11.62,11.72,-10,1.3,278,278,,1,284,284,,,,,,,,,"35,11,11,11,13,17,3,0,0","1,75,25,0,0","0,4,74,22,0",,,,,113,,,,,,,,,,,,,,,,,,,,,,,,,,,,,,,,,,,,2,15,10,305,80,94,1016,0,,0,4,4,Helle,1,0,U1.000|5:54-U1.000|5:50-U1.000|7:19-U1.000|6:48-U1.000|6:46-U1.000|6:29-U1.000|5:32-U1.000|5:41-U1.000|5:23-U1.000|4:14-U1.000|4:29-U1.000|4:17-U1.000|4:13-U1.000|4:40-U0.615|4:07,,"Balve Running",,,3113,,250,3,16194613460,0,168070,250480,30378,,79364252,,,,,,,,,,,,,,,,,,,,,,,,,,,,,,,,,,,,,,,,3,
100437091,a6acdd85-a61b-4bc2-8642-c0dfb31f8aa4,1719945025,120,1719982713,,0,0,5.06,1581,2211,26,16,33,22,0,0,0.08,1.12,0.49,,310,137,152,,133,24,58.19,36.53,58.7,1,59.09,816,54,,2.4,0.1,105,106,,278,,,,25,77,11.59,12.63,13.79,9.9,-38.5,295,295,,1,382,382,,,,,,,,,"22,1,6,11,27,29,3,1,2","1,47,52,0,0","9,11,16,61,4",,,,,125,,,,,,,,,,,,,,,,,,,,,,,,,,,,,,,,,,,,20,15,9,285,83,98,1013,1,,0,4,4,Westick,1,0,U1.000|5:09-U1.000|4:33-U1.000|4:28-U1.000|4:24-U0.126|0:39-U0.929|7:09,,"Fröndenberg/Ruhr Running",,,3113,,250,3,16216592480,0,168070,250480,30378,,79475201,,,,,,,,,,,,,,,,,,,,,,,,,,,,,,,,,,,,,,,,,
100437102,731abb70-dc2f-4270-a960-d296a7e607fe,1719947322,120,1719982740,,0,0,5.14,1880,1880,0,0,0,0,0,0,0,,,,321,137,191,105,190,60,47.91,30.29,47.91,1,59.09,2768,85,,2.2,2.3,,100,,319,,,,33,75,9.84,13.11,13.11,20.9,2.9,253,253,,1,360,360,,,,,,,,,"62,3,1,1,1,1,4,17,11","0,67,20,9,4","31,27,7,5,31",,,,,109,,,,,,,,,,,,,,,,,,,,,,,,,,,,,,,,,,,,48.7,15,9,287,81,96,1013,1,,0,4,4,Westick,1,0,U1.000|3:20-U0.400|3:32-U0.210|0:34-U0.200|1:52-U0.200|0:33-U0.200|1:53-U0.200|0:33-U0.190|2:05-U0.200|0:33-U0.200|2:06-U0.210|0:35-U0.190|2:23-U0.210|0:35-U0.400|5:09-U1.010|3:13-U0.120|2:24,,"Fröndenberg/Ruhr Track Running",,,3113,,250,3,16216596688,0,168070,250480,30378,,79475211,,,,,,,,,,,,,,,,,,,,,,,,,,,,,,,,,,,,,,,,,
100437113,6c4581d0-18ec-455d-a573-76f7e142bfc8,1719949447,120,1719982756,,0,0,3.33,1141,1141,8,8,15,14,0,0,0.06,,,,222,136,143,,143,5,52.42,31.9,52.57,1,59.09,2749,32,,2,0,,100,,192,,,,17,80,10.52,10.6,10.61,-4.4,-6.9,258,258,,1,262,262,,,,,,,,,"9,13,41,33,5,0,0,0,0","0,91,9,0,0","0,1,96,2,0",,,,,109,,,,,,,,,,,,,,,,,,,,,,,,,,,,,,,,,,,,12.8,15,9,287,81,96,1013,1,,0,4,4,Westick,1,0,U1.000|6:13-U1.000|5:36-U1.000|5:27-U0.327|1:46,,"Fröndenberg/Ruhr Running",,,3113,,250,3,16216599095,0,168070,250480,30378,,79475220,,,,,,,,,,,,,,,,,,,,,,,,,,,,,,,,,,,,,,,,,
100447128,4f1081dc-d0e3-4f86-9b82-700ec680c09b,1719995126,120,1719990586,,0,0,5.9,2189,2296,89,87,105,103,0,1.9,0.63,1.07,1.1,257,400,130,153,,149,28,50.24,30.02,51.2,1,59.09,1971,43,,2.1,0.3,99,100,,358,,,,9,80,9.95,10.44,10.61,12.6,5.8,237,237,,1,257,257,,,,,,,,,"41,15,18,14,3,5,3,0,0","1,85,14,0,0","2,19,66,12,0",,,,,101,,,,,,,,,,,,,,,,,,,,,,,,,,,,,,,,,,,,3.4,12,9,251,84,94,1012,2,,0,4,4,Balve,1,0,U1.000|6:33-U1.000|5:11-U1.000|6:00-U1.000|6:39-U1.000|7:02-U0.900|5:05,,"Balve Running",,,3113,,250,3,16217899170,0,168070,250480,30378,,79484846,,,,,,,,,,,,,,,,,,,,,,,,,,,,,,,,,,,,,,,,5,
100486743,9c2ae341-34eb-4d02-a4d2-7d1da817fd97,1720031225,120,1720028489,,0,0,11.42,3719,4032,195,216,213,233,0,2.5,0.54,0.99,1.09,380,715,133,150,,148,26,57.39,36.7,58.47,1,59.09,2165,71,,2.7,0,100,99,,764,,,,18,80,11.48,11.6,11.87,-0.5,-2.3,277,277,,1,287,287,,,,,,,,,"19,12,18,20,18,8,5,0,0","1,86,13,0,0","0,5,70,23,2",,,,,115,,,,,,,,,,,,,,,,,,,,,,,,,,,,,,,,,,,,3,12,11,248,81,79,1009,1,,0,4,4,Balve,1,0,U1.000|4:53-U1.000|4:56-U1.000|4:48-U1.000|5:22-U1.000|5:55-U1.000|5:39-U1.000|5:38-U1.000|6:07-U1.000|4:47-U1.000|5:32-U1.000|5:45-U0.416|2:38,,"Balve Running",,,3113,,250,3,16226825548,0,168070,250480,30378,,79521019,,,,,,,,,,,,,,,,,,,,,,,,,,,,,,,,,,,,,,,,"4,5,5",
100575037,c450ed63-9e9b-4260-ad49-725032fc0afd,1720117343,120,1720117037,,0,0,17.69,5645,6488,471,432,483,452,0,4.8,0.73,0.96,1.08,502,1117,140,159,107,148,21,55.14,38.91,57.1,1,59.06,1475,118,,3.3,0,102,98,,980,,,,140,80,12.11,12.47,12.85,-6.2,4.5,293,293,,1,313,313,,,,,,,,,"25,12,13,13,13,11,9,3,0","1,41,59,0,0","0,2,57,38,3",,,,,118,,,,,,,,,,,,,,,,,,,,,,,,,,,,,,,,,,,,37.1,17,13,280,59,32,1010,1,,0,2,4,Balve,1,0,U1.000|4:48-U1.000|5:10-U1.000|5:36-U1.000|6:08-U1.000|6:32-U1.000|6:43-U1.000|6:04-U1.000|5:05-U1.000|5:22-U1.000|5:25-U1.000|6:52-U1.000|4:56-U1.000|3:55-U1.000|3:56-U1.000|4:16-U1.000|3:48-U1.000|5:05-U0.688|4:24,,"Balve Running",,,3113,,250,3,16244600904,0,168070,250480,30378,,79601310,,,,,,,,,,,,,,,,,,,,,,,,,,,,,,,,,,,,,,,,"3,4,5,5",
100628723,36c28980-de02-4ec0-b413-9b88b97ad66a,1720185308,120,1720182676,,0,0,12.89,4047,4368,243,225,273,258,0,2.3,0.62,0.96,1.02,417,807,139,156,,154,23,56.78,38.67,58.2,1,59.06,1222,91,,3,0.1,100,100,,705,,,,82,80,11.89,12.03,12.19,-6.5,-7.4,290,290,,1,301,301,,,,,,,,,"9,12,20,28,16,8,7,0,0","0,52,48,0,0","0,0,59,39,2",,,,,119,,,,,,,,,,,,,,,,,,,,,,,,,,,,,,,,,,,,29.5,15,18,222,70,90,1012,4,,0,4,4,Balve,1,0,U1.000|6:00-U1.000|5:10-U1.000|5:37-U1.000|5:30-U1.000|5:27-U1.000|5:35-U1.000|5:09-U1.000|4:55-U1.000|5:23-U1.000|5:29-U1.000|3:55-U1.000|3:58-U0.893|5:19,,"Balve Running",,,3113,,250,3,16255079999,0,168070,250480,30378,,79648488,,,,,,,,,,,,,,,,,,,,,,,,,,,,,,,,,,,,,,,,5,
100731924,79acc868-2a2a-402a-9208-c1d62c0766ab,1720289159,120,1720297214,,0,0,15.29,3793,3890,67,79,91,104,0,0,0.06,,0.71,,940,157,182,,178,40,64.23,51.52,64.52,1,59.15,2592,236,,4.3,0.5,103,109,,744,,,,127,82,14.48,15.03,15.17,3.6,-0.5,380,380,,1,406,406,,,,,,,,,"4,2,7,4,8,18,50,7,1","1,14,26,59,0","0,4,14,30,52",,,,,147,,,,,,,,,,,,,,,,,,,,,,,,,,,,,,,,,,,,81.6,18,25,248,60,76,1005,1,,0,11,4,"Sundern (Sauerland)",1,0,U1.000|5:11-U1.000|4:46-U1.000|4:29-U1.000|3:54-U1.000|3:56-U1.000|4:02-U1.000|3:51-U1.000|3:49-U1.000|3:38-U1.000|3:40-U1.000|3:46-U1.000|5:08-U1.000|3:53-U1.000|3:46-U1.000|3:45-U0.287|1:37,,"Sundern (Sauerland) Running",,,3113,,250,3,16276283693,0,168070,250480,30378,,79735666,,,,,,,,,,,,,,,,,,,,,,,,,,,,,,,,,,,,,,,,,
100779171,821fb5fe-ffdb-431e-80d8-cdaa94cedd16,1720351950,120,1720349633,,0,0,14.55,4623,4672,308,304,324,321,0,3.3,0.59,0.9,0.97,453,956,143,158,,138,20,53.9,38.5,55.33,1,59.15,1872,104,,3.1,0,99,100,,824,,,,102,80,11.9,12.07,12.17,-12.2,-6.7,289,289,,1,299,299,,,,,,,,,"24,15,9,12,10,26,4,0,0","0,28,71,0,0","0,2,62,34,2",,,,,118,,,,,,,,,,,,,,,,,,,,,,,,,,,,,,,,,,,,29.5,16,15,225,56,59,1014,4,,0,3,4,Balve,1,0,U1.000|5:44-U1.000|5:29-U1.000|6:48-U1.000|6:33-U1.000|6:23-U1.000|6:36-U1.000|5:13-U1.000|4:24-U1.000|4:16-U1.000|4:18-U1.000|4:25-U1.000|4:13-U1.000|4:13-U1.000|5:02-U0.550|3:27,,"Balve Running",,,3113,,250,3,16286004578,0,168070,250480,30378,,79778466,,,,,,,,,,,,,,,,,,,,,,,,,,,,,,,,,,,,,,,,"4,5",
100947759,364e999b-11d7-4bee-bec0-0be792024664,1720444224,120,1720505848,,0,0,13.57,4478,4770,310,277,338,305,0,3.6,0.78,0.96,1.04,432,878,135,153,119,138,20,55.42,36.63,57.15,1,59.1,1253,85,,3,0,100,97,,984,,,,60,79,11.48,11.42,11.73,-1.8,6.6,279,279,,1,287,287,,,,,,,,,"23,14,13,14,23,12,1,0,0","0,74,26,0,0","1,2,70,26,1",,,,,115,,,,,,,,,,,,,,,,,,,,,,,,,,,,,,,,,,,,14.2,21,8,233,49,73,1018,5,,0,4,4,Balve,1,0,U1.000|5:14-U1.000|5:14-U1.000|6:30-U1.000|6:27-U1.000|6:22-U1.000|6:29-U1.000|5:11-U1.000|4:50-U1.000|4:36-U1.000|5:07-U1.000|4:31-U1.000|5:38-U1.000|5:44-U0.567|2:46,,"Balve Running",,,3113,,250,3,16316425307,0,168070,250480,30378,,79929552,,,,,,,,,,,,,,,,,,,,,,,,,,,,,,,,,,,,,,,,"4,4,5",
101009440,2de85db0-92fa-4d71-8d8b-64cbb2b5cd7b,1720554469,120,1720551468,,0,0,2.22,792,792,4,6,14,15,0,0,0.07,,1.01,,158,145,151,,147,6,45.87,29.48,45.92,1,59.24,2805,24,,1.7,0,95,94,,219,,,,15,79,10.07,10.1,10.1,2.4,3,240,240,,1,242,242,,,,,,,,,"17,31,33,15,4,0,0,0,0","0,12,88,0,0","0,3,97,0,0",,,,,106,,,,,,,,,,,,,,,,,,,,,,,,,,,,,,,,,,,,14.5,27,10,151,55,12,1012,0,,0,2,4,Westick,1,0,U1.000|5:53-U1.000|6:05-U0.216|1:15,,"Fröndenberg/Ruhr Running",,,3113,,250,3,16328376552,0,168070,250480,30378,,79986958,,,,,,,,,,,,,,,,,,,,,,,,,,,,,,,,,,,,,,,,,
101009442,d81e02a5-fa1b-4a10-a1a4-f388aa20fb1d,1720549987,120,1720551469,,0,0,5.17,1618,2110,26,25,38,38,0,0,0.11,1.31,0.43,,330,143,160,,154,24,54.92,36.51,55.27,1,59.18,932,61,,2.6,0,104,102,,445,,,,30,77,11.45,12.57,13.19,11.9,-26.8,286,286,,1,354,354,,,,,,,,,"22,1,3,14,39,16,2,1,3","1,34,65,0,0","8,8,23,58,3",,,,,124,,,,,,,,,,,,,,,,,,,,,,,,,,,,,,,,,,,,26.3,28,10,163,49,5,1012,1,,0,2,4,Westick,1,0,U1.000|5:14-U1.000|4:41-U1.000|4:42-U1.000|4:37-U1.000|6:33-U0.165|1:11,,"Fröndenberg/Ruhr Running",,,3113,,250,3,16328376045,0,168070,250480,30378,,79986960,,,,,,,,,,,,,,,,,,,,,,,,,,,,,,,,,,,,,,,,,
101009444,08b6dd60-a42c-4fc4-ac81-d7e3307e853e,1720552199,120,1720551469,,0,0,6.94,2072,2072,0,0,0,0,0,0,0,,,,471,165,187,,184,45,47.44,39.28,47.44,1,59.24,2821,245,,3.4,3.3,108,104,,572,,,,80,80,12.05,14.74,14.74,26.3,7.1,315,315,,1,396,396,,,,,,,,,"36,1,0,0,0,2,27,31,0","0,20,15,28,37","27,8,4,3,58",,,,,126,,,,,,,,,,,,,,,,,,,,,,,,,,,,,,,,,,,,97,28,10,163,49,5,1012,1,,0,2,4,Westick,1,0,U1.210|4:10-U0.210|1:42-U1.200|4:11-U0.190|2:04-U1.200|4:12-U0.200|2:29-U1.200|4:12-U0.190|3:08-U1.200|4:20-U0.140|4:03,,"Fröndenberg/Ruhr Track Running",,,3113,,250,3,16328376432,0,168070,250480,30378,,79986962,,,,,,,,,,,,,,,,,,,,,,,,,,,,,,,,,,,,,,,,,
101065142,3fd704b0-a61f-43e7-a495-cb5008f6b065,1720620113,120,1720618796,,0,0,15.68,5111,5713,308,281,333,309,0,3.5,0.71,0.98,1.07,452,1006,143,162,,154,20,52.23,37.59,53.61,1,59.22,1885,106,,3.2,0,98,98,,1231,,,,108,79,11.53,11.51,11.74,0.2,4.4,275,275,,1,283,283,,,,,,,,,"17,11,16,22,24,9,1,0,0","1,35,63,2,0","1,1,81,17,1",,,,,117,,,,,,,,,,,,,,,,,,,,,,,,,,,,,,,,,,,,38.7,24,13,233,66,88,1015,4,,0,4,4,Balve,1,0,U1.000|5:58-U1.000|4:45-U1.000|5:18-U1.000|5:19-U1.000|5:23-U1.000|5:53-U1.000|6:11-U1.000|7:10-U1.000|5:35-U1.000|4:36-U1.000|5:15-U1.000|4:20-U1.000|4:44-U1.000|5:32-U1.000|5:41-U0.684|3:29,,"Balve Running",,,3113,,250,3,16339950261,0,168070,250480,30378,,80034987,,,,,,,,,,,,,,,,,,,,,,,,,,,,,,,,,,,,,,,,"4,5",
101174739,69431f8e-d9ce-46e6-8933-3c085e143f25,1720721633,120,1720719985,,0,0,13.58,4988,5414,319,246,353,279,0,2.6,0.56,1.13,0.94,301,897,132,161,,160,38,49.93,32.29,51.72,1,59.19,1182,94,,2.9,0.9,100,97,,1088,,,,88,76,10.17,10.65,11.9,13.2,-23.8,248,248,,1,314,314,,,,,,,,,"36,11,16,17,13,3,2,1,0","1,80,19,0,0","5,16,64,10,3",,,,,107,,,,,,,,,,,,,,,,,,,,,,,,,,,,,,,,,,,,22.4,23,8,275,55,61,1017,1,,0,3,4,Helle,1,0,U1.000|5:34-U1.000|5:48-U1.000|6:17-U1.000|5:32-U1.000|5:17-U1.000|6:01-U1.000|4:52-U1.000|5:40-U1.000|5:45-U1.000|5:37-U0.680|4:35-U0.143|0:30-U0.176|1:34-U0.097|0:21-U0.134|1:06-U0.060|0:14-U0.100|0:54-U0.026|0:07-U0.089|1:04-U0.138|0:30-U0.164|1:32-U0.089|0:21-U0.126|1:18-U0.063|0:14-U0.101|1:04-U0.029|0:07-U0.080|1:13-U0.134|0:30-U0.169|1:43-U0.098|0:22-U0.121|1:11-U0.061|0:15-U0.091|1:10-U0.027|0:08-U0.586|4:42,,"Balve Running",,,3113,,250,3,16360905882,0,168070,250480,30378,,80132877,,,,,,,,,,,,,,,,,,,,,,,,,,,,,,,,,,,,,,,,"5,5,5,5",
101239059,8a2a4548-9c25-4214-80de-02b960cea0d4,1720789343,120,1720792295,,0,0,13.67,4329,4546,310,298,321,308,0,3.4,0.74,0.95,1.04,438,898,147,165,,145,19,52.15,38.46,53.67,1,59.16,1297,107,,3.2,0,101,98,,1053,,,,81,79,11.96,11.91,12.1,-4.9,2.7,287,287,,1,293,293,,,,,,,,,"16,15,14,15,18,19,3,0,0","0,20,75,5,0","0,0,64,36,0",,,,,120,,,,,,,,,,,,,,,,,,,,,,,,,,,,,,,,,,,,28.5,21,9,220,82,78,1008,4,,0,4,4,Balve,1,0,U1.000|5:13-U1.000|5:26-U1.000|6:32-U1.000|6:12-U1.000|6:21-U1.000|6:10-U1.000|4:54-U1.000|4:33-U1.000|4:27-U1.000|4:06-U1.000|4:22-U1.000|5:27-U1.000|5:31-U0.665|2:57,,"Balve Running",,,3113,,250,3,16373424015,0,168070,250480,30378,,80191062,,,,,,,,,,,,,,,,,,,,,,,,,,,,,,,,,,,,,,,,"4,5",
101306191,55874464-c3bb-4792-bf15-6bc9e63067aa,1720872400,120,1720871560,,0,0,15.22,4031,4052,42,50,79,88,0,0,0.08,,,,931,152,174,,166,17,62.07,47.74,62.24,1,59.25,1454,148,,3.5,0,100,100,,773,,,,116,81,13.59,13.85,13.89,2,4.6,349,349,,1,360,360,,,,,,,,,"1,1,2,8,32,38,14,3,0","0,4,85,11,0","0,0,9,80,12",,,,,140,,,,,,,,,,,,,,,,,,,,,,,,,,,,,,,,,,,,50.4,16,20,235,68,76,1013,4,,0,4,4,"Sundern (Sauerland)",1,0,U1.000|4:35-U1.000|4:28-U1.000|4:32-U1.000|4:18-U1.000|4:28-U1.000|4:37-U1.000|4:18-U1.000|3:49-U1.000|4:23-U1.000|4:28-U1.000|4:42-U1.000|4:37-U1.000|4:33-U1.000|4:12-U1.000|4:09-U0.216|1:02,,"Sundern (Sauerland) Running",,,3113,,250,3,16387696280,0,168070,250480,30378,,80251513,,,,,,,,,,,,,,,,,,,,,,,,,,,,,,,,,,,,,,,,,
101374694,50dc1690-de7b-4ec1-9010-13442e6d8827,1720951467,120,1720950812,,0,0,20,5556,5750,119,118,186,184,0,0,0.23,1.02,0.84,,1290,154,183,,172,37,57.43,46.17,57.86,1,59.3,2736,284,,4.3,2.4,104,100,,1358,,,,131,82,13.09,14.44,14.55,9.7,2.6,337,334,,1,390,390,,,,,,,,,"5,6,15,21,13,10,17,10,3","0,25,37,35,3","2,1,45,25,26",,,,,132,,,,,,,,,,,,,,,,,,,,,,,,,,,,,,,,,,,,77.8,18,13,227,63,33,1014,4,,0,2,4,Menden,1,0,U1.000|4:51-U1.000|4:44-U1.000|3:58-U0.059|0:20-U0.132|0:29-U0.285|0:53-U0.187|0:52-U1.000|3:35-U0.532|2:53-U1.000|3:37-U1.000|3:50-U0.496|2:24-U1.000|3:37-U1.000|3:48-U0.543|2:53-U1.000|3:35-U1.000|3:57-U1.000|5:21-U1.000|5:27-U0.288|1:25-U0.338|1:00-U0.097|0:31-U0.326|1:02-U0.077|0:30-U0.308|1:01-U1.000|7:22-U1.000|5:30-U1.000|5:33-U1.000|5:38-U0.334|2:01,,"Menden (Sauerland) Running",,,3113,,250,3,16402537041,0,168070,250480,30378,,80313189,,,,,,,,,,,,,,,,,,,,,,,,,,,,,,,,,,,,,,,,,
101462217,d79cf7f3-429b-4b1a-b2f8-246ba5d6f058,1721056053,120,1721053685,,0,0,13.08,4496,4734,310,273,326,294,0,3.4,0.75,0.96,1.05,404,849,134,153,,137,19,53.19,34.81,54.94,1,59.3,1282,76,,2.8,0,98,100,,1123,,11,1,85,79,11.06,10.89,11.11,-5.8,-0.5,268,268,,1,272,272,,,,,,,,,"33,13,11,15,19,8,0,0,0","0,81,19,0,0","0,3,83,14,0",,,,,110,,,,,,,,,,,,,,,,,,,,,,,,,,,,,,,,,,,,25.3,25,6,164,43,89,1011,3,,0,4,4,Balve,1,0,U1.000|5:44-U1.000|5:31-U1.000|6:56-U1.000|6:53-U1.000|6:52-U1.000|6:57-U1.000|5:18-U1.000|5:01-U1.000|4:48-U1.000|4:31-U1.000|4:48-U1.000|5:54-U1.000|5:19-U0.083|0:26,,"Balve Running",,,3113,,250,3,16423336032,0,168070,250480,30378,,80387763,,,,,,,,,,,,,,,,,,,,,,,,,,,,,,,,,,,,,,,,"4,5",
101463267,,1721061475,120,1721054313,,0,0,0.6,180,180,,,,,0,,,,,,41,,,,,,,31.32,,1,,,,,,,,,,,,,,4,,,,,,,,,,,,,,,,,,,,,,,,,,,,,,,,,,,,,,,,,,,,,,,,,,,,,,,,,,,,,,,,,,,,,,,,,,1,,,0,0,,,"Uhr angehalten",,,connect,,,3,16423489687,0,168070,250480,30378,,80388777,,,,,,,,,,,,,,,,,,,,,,,,,,,,,,,,,,,,,,,,,
101465337,f1f9ee96-de94-4518-823e-8100b722271e,1721062371,120,1721056525,,0,0,3.02,1240,1250,74,84,98,108,0,1,0.47,1.38,1.04,,217,130,157,,154,40,44.34,25.5,45.5,1,59.3,1235,31,,1.7,0.4,,100,,285,,11,3,22,77,8.76,9.11,9.3,16.9,8.6,208,208,,1,228,228,,,,,,,,,"66,7,7,4,2,3,7,4,0","0,85,15,0,0","4,50,34,8,5",,,,,95,,,,,,,,,,,,,,,,,,,,,,,,,,,,,,,,,,,,17.2,26,6,157,45,94,1010,3,,0,4,4,Balve,1,0,U0.284|1:42-U0.138|0:32-U0.169|1:16-U0.094|0:23-U0.129|1:01-U0.061|0:15-U0.090|0:41-U0.031|0:08-U0.069|0:51-U0.131|0:30-U0.170|1:23-U0.095|0:23-U0.127|1:08-U0.066|0:14-U0.098|0:53-U0.026|0:08-U0.070|0:55-U0.133|0:30-U0.171|1:40-U0.091|0:22-U0.124|1:13-U0.055|0:14-U0.098|0:55-U0.025|0:07-U0.473|3:18,,"Balve Running",,,3113,,250,3,16424041471,0,168070,250480,30378,,80390659,,,,,,,,,,,,,,,,,,,,,,,,,,,,,,,,,,,,,,,,,
101572945,7334b67b-938e-471a-862d-5c9212cb3168,1721154722,120,1721156337,,0,0,5.21,1580,2021,12,16,23,26,0,0,0.08,,0.38,,304,139,154,,143,18,59.26,37.91,59.37,1,59.34,874,65,,2.5,0.5,107,102,,300,,11,4,36,77,11.83,12.76,12.78,16.1,-1,302,302,,1,330,330,,,,,,,,,"23,1,1,3,24,39,5,1,3","1,33,66,0,0","10,10,4,72,4",,,,,128,,,,,,,,,,,,,,,,,,,,,,,,,,,,,,,,,,,,33.8,19,16,233,70,52,1013,1,,0,3,4,Westick,1,0,U1.000|4:31-U1.000|4:30-U1.000|4:24-U1.000|4:19-U0.169|0:52-U0.137|0:24-U0.176|1:35-U0.282|1:52-U0.226|1:44-U0.223|2:11,,"Fröndenberg/Ruhr Running",,,3113,,250,3,16445487573,0,168070,250480,30378,,80486979,,,,,,,,,,,,,,,,,,,,,,,,,,,,,,,,,,,,,,,,,
101572950,472c7520-95e7-44f6-9d29-f6c242b05ca3,1721156781,120,1721156341,,0,0,6.77,2060,2060,0,0,0,0,0,0,0,,,,442,152,180,,169,49,52.29,38.35,52.29,1,59.35,2221,194,,3.1,3,110,108,,404,,,,68,80,11.83,14.5,14.5,23.5,0.8,312,311,,1,395,395,,,,,,,,,"40,3,2,2,1,3,15,29,4","0,34,15,50,0","22,15,9,7,47",,,,,123,,,,,,,,,,,,,,,,,,,,,,,,,,,,,,,,,,,,63.6,19,18,232,69,43,1013,0,,0,3,4,Westick,1,0,U1.000|3:25-U0.990|3:36-U0.400|2:52-U0.600|2:02-U0.200|1:35-U0.600|2:04-U0.200|1:44-U0.610|2:07-U0.230|4:16-U1.010|3:10-U0.400|3:58-U0.200|0:36-U0.100|0:44-U0.200|0:40-U0.030|1:33,,"Fröndenberg/Ruhr Track Running",,,3113,,250,3,16445487890,0,168070,250480,30378,,80486984,,,,,,,,,,,,,,,,,,,,,,,,,,,,,,,,,,,,,,,,,
101572953,c4e54a65-326b-4f1b-8d53-25b969a3eb1c,1721159376,120,1721156341,,0,0,2.67,906,906,12,12,18,18,0,0,0.08,1.11,0.92,,179,133,143,104,143,9,54.55,31.76,54.85,1,59.35,2195,27,,1.9,0,,100,,154,,7,3,17,80,10.66,10.67,10.77,-1.5,-0.6,260,260,,1,265,265,,,,,,,,,"8,16,35,32,8,1,0,0,0","1,97,1,0,0","0,0,92,8,0",,,,,111,,,,,,,,,,,,,,,,,,,,,,,,,,,,,,,,,,,,16.8,19,18,232,69,43,1013,0,,0,3,4,Westick,1,0,U1.000|6:00-U1.000|5:28-U0.668|3:39,,"Fröndenberg/Ruhr Running",,,3113,,250,3,16445488068,0,168070,250480,30378,,80486987,,,,,,,,,,,,,,,,,,,,,,,,,,,,,,,,,,,,,,,,,
101614117,f3b80f63-038b-4ce9-a3f1-3e55725d698f,1721206443,120,1721204180,,0,0,15.64,4774,4814,146,153,189,198,0,1.2,0.36,0.96,0.98,352,1018,147,169,,167,16,54.57,40.58,55.17,1,59.36,2016,125,,3.3,0,98,101,,984,,13,2,120,80,11.93,12.11,12.14,-5.7,-9.8,297,297,,1,306,306,,,,,,,,,"6,8,17,25,24,14,4,0,0","0,25,63,13,0","0,1,57,40,2",,,,,123,,,,,,,,,,,,,,,,,,,,,,,,,,,,,,,,,,,,50.5,16,12,254,82,88,1020,2,,0,4,4,Balve,1,0,U1.000|6:09-U1.000|5:10-U1.000|5:41-U1.000|5:40-U1.000|5:49-U1.000|5:26-U1.000|4:59-U1.000|4:36-U1.000|4:47-U1.000|5:00-U1.000|4:56-U1.000|4:12-U1.000|4:12-U1.000|4:09-U1.000|5:04-U0.640|3:44,,"Balve Running",,,3113,,250,3,16452913462,0,168070,250480,30378,,80524246,,,,,,,,,,,,,,,,,,,,,,,,,,,,,,,,,,,,,,,,5,
101735856,fbf76656-fe3b-4063-a2e2-2857862aa99f,1721326447,120,1721326854,,0,0,16.04,6390,7386,343,350,392,399,0,3.9,0.65,1.15,0.79,385,1092,133,177,116,171,56,44.75,29.71,45.91,1,59.33,1410,139,,3.1,2.1,96,100,,1423,,18,3,113,77,9.18,9.87,10.83,20.7,-30.4,227,226,,1,283,283,,,,,,,,,"48,11,15,11,5,6,3,0,0","0,74,19,6,0","14,26,44,6,9",,,,,98,,,,,,,,,,,,,,,,,,,,,,,,,,,,,,,,,,,,33.7,25,5,38,55,53,1022,1,,0,3,4,Balve,1,0,U1.000|5:52-U1.000|6:11-U1.000|5:37-U1.000|6:01-U1.000|5:29-U1.000|5:45-U1.000|5:43-U1.000|6:11-U0.844|6:35-U0.320|3:28-U0.310|1:16-U0.337|2:48-U0.308|1:16-U0.335|2:48-U0.309|1:13-U0.347|2:45-U0.301|1:15-U0.334|2:50-U0.303|1:14-U0.346|4:26-U0.296|1:18-U0.333|3:05-U0.298|1:16-U0.338|3:44-U0.296|1:16-U0.335|3:20-U0.297|1:17-U0.338|3:27-U0.302|1:13-U0.815|7:52,,"Balve Running",,,3113,,250,3,16480073711,0,168070,250480,30378,,80633531,,,,,,,,,,,,,,,,,,,,,,,,,,,,,,,,,,,,,,,,"4,5,5,5",
101735888,,1721334069,120,1721326889,,0,0,1,300,300,,,,,0,,,,,,68,,,,,,,32.99,,1,,,,,,,,,,,,,,6,,,,,,,,,,,,,,,,,,,,,,,,,,,,,,,,,,,,,,,,,,,,,,,,,,,,,,,,,,,,,,,,,,,,,,,,,,1,,,0,0,,,"Uhr angehalten ",,,connect,,,3,16480085912,0,168070,250480,30378,,80633561,,,,,,,,,,,,,,,,,,,,,,,,,,,,,,,,,,,,,,,,,
101793720,958a2775-bda2-46e5-8398-d922422c5559,1721393720,120,1721390673,,0,0,11.77,3892,3979,275,253,295,276,0,3.3,0.8,0.93,1.08,430,772,139,156,,139,14,53.26,36.13,54.92,1,59.25,1199,80,,2.9,0,98,97,,902,,11,3,53,79,11.54,11.52,11.6,-13.8,-7.8,274,274,,1,278,278,,,,,,,,,"31,12,12,12,14,11,6,0,0","0,55,44,0,0","0,0,86,13,0",,,,,115,,,,,,,,,,,,,,,,,,,,,,,,,,,,,,,,,,,,13.1,26,6,122,48,88,1019,4,,0,4,4,Balve,1,0,U1.000|5:21-U1.000|5:34-U1.000|6:57-U1.000|6:43-U1.000|6:37-U1.000|6:25-U1.000|4:42-U1.000|4:43-U1.000|4:34-U1.000|4:15-U1.000|4:18-U0.772|4:44,,"Balve Running",,,3113,,250,3,16491005560,0,168070,250480,30378,,80686158,,,,,,,,,,,,,,,,,,,,,,,,,,,,,,,,,,,,,,,,4,
101862464,2893a0d7-c05b-4226-834b-f26139b374de,1721469970,120,1721470355,,0,0,17.31,5148,5907,94,79,177,154,0,0,0.15,0.88,0.3,,1161,159,184,116,168,41,50.4,42.17,50.79,1,59.29,2016,223,,3.9,2.2,102,101,,1429,,19,4,178,81,12.34,13.36,13.38,11.4,4.7,317,314,,1,353,352,,,,,,,,,"18,9,12,10,8,10,22,9,1","0,9,45,38,9","6,6,35,27,27",,,,,125,,,,,,,,,,,,,,,,,,,,,,,,,,,,,,,,,,,,104.3,25,7,172,60,18,1012,5,,0,2,4,"Sundern (Sauerland)",1,0,U1.000|4:51-U1.000|4:26-U1.000|4:06-U1.000|5:14-U0.299|1:02-U0.199|1:07-U0.315|1:03-U0.197|1:07-U0.302|1:01-U0.927|6:30-U1.000|3:42-U1.000|3:32-U0.524|3:13-U1.000|3:44-U1.000|3:47-U0.587|4:01-U1.000|3:45-U1.000|3:52-U0.674|6:04-U0.301|1:01-U0.112|0:46-U0.298|1:02-U0.097|0:46-U0.279|1:01-U1.000|6:44-U1.000|5:59-U0.204|2:20,,"Sundern (Sauerland) Running",,,3113,,250,3,16505709630,0,168070,250480,30378,,80748154,,,,,,,,,,,,,,,,,,,,,,,,,,,,,,,,,,,,,,,,,
101984325,d96eeb4d-ac12-4bd5-9632-b40aedd84ffe,1721589433,120,1721589264,,0,0,11.74,4122,4256,269,263,282,277,0,3.2,0.81,0.95,1.05,416,785,135,151,,137,25,51.34,33.66,52.82,1,59.21,1154,70,,2.7,0,96,96,,856,,11,1,72,79,10.79,10.73,10.89,-13.3,-2.5,257,257,,1,262,262,,,,,,,,,"37,13,13,11,19,6,1,0,0","0,71,29,0,0","1,4,91,4,0",,,,,108,,,,,,,,,,,,,,,,,,,,,,,,,,,,,,,,,,,,20.6,22,10,286,80,55,1010,0,,0,3,4,Balve,1,0,U1.000|6:28-U1.000|5:59-U1.000|7:13-U1.000|6:44-U1.000|6:38-U1.000|6:34-U1.000|5:05-U1.000|4:57-U1.000|4:50-U1.000|4:43-U1.000|4:37-U0.741|4:52,,"Balve Running",,,3113,,250,3,16531949999,0,168070,250480,30378,,80859941,,,,,,,,,,,,,,,,,,,,,,,,,,,,,,,,,,,,,,,,4,
102052934,1a28f8e5-446e-4a34-874d-1f4b820ba6eb,1721672932,120,1721671173,,0,0,13.02,4532,4970,350,328,365,345,0,3.9,0.8,0.96,1.08,425,838,129,145,95,134,20,54.87,34.29,56.81,1,59.2,995,69,,2.7,0,97,98,,877,,11,2,66,78,11.1,10.9,11.16,-8.3,3.5,265,265,,1,269,269,,,,,,,,,"37,14,11,12,14,9,2,0,0","1,92,7,0,0","0,3,87,10,0",,,,,110,,,,,,,,,,,,,,,,,,,,,,,,,,,,,,,,,,,,14.8,22,10,265,59,63,1017,1,,0,4,4,Balve,1,0,U1.000|5:33-U1.000|5:37-U1.000|6:58-U1.000|6:29-U1.000|6:38-U1.000|6:46-U1.000|7:00-U1.000|5:39-U1.000|4:32-U1.000|4:38-U1.000|4:43-U1.000|4:32-U1.000|6:20-U0.021|0:05,,"Balve Running",,,3113,,250,3,16546586007,0,168070,250480,30378,,80923758,,,,,,,,,,,,,,,,,,,,,,,,,,,,,,,,,,,,,,,,3,
102157475,67c57daa-9bb3-42ef-954a-866b484727cd,1721759516,120,1721770554,,0,0,5.1,1607,2049,5,9,20,23,0,0,0.04,,,,317,134,152,,124,20,59.22,36.18,59.23,1,59.21,758,54,,2.3,0.2,105,105,,358,,7,3,31,77,11.41,12.09,12.07,8.2,-4.2,285,285,,1,307,307,,,,,,,,,"19,3,8,10,31,25,1,1,2","1,49,50,0,0","6,10,23,59,2",,,,,124,,,,,,,,,,,,,,,,,,,,,,,,,,,,,,,,,,,,26.1,22,13,272,74,77,1016,1,,0,4,4,Westick,1,0,U1.000|5:31-U1.000|4:35-U1.000|4:35-U1.000|4:28-U0.488|2:59-U0.113|0:22-U0.496|4:17,,"Fröndenberg/Ruhr Running",,,3113,,250,3,16567843713,0,168070,250480,30378,,81016500,,,,,,,,,,,,,,,,,,,,,,,,,,,,,,,,,,,,,,,,,
102157617,8866a91b-e346-47fd-bad9-3d0debfd5ee8,1721761677,120,1721770603,,0,0,7.63,2142,2142,0,0,0,0,0,0,0,,,,492,157,180,,180,50,55.13,42.49,55.13,1,59.22,3146,183,,3.2,2.7,107,107,,554,,,,74,82,12.81,14.52,14.52,15.7,-1.7,335,335,,1,392,392,,,,,,,,,"36,4,2,2,2,3,19,24,8","0,27,18,55,0","10,20,13,8,49",,,,,130,,,,,,,,,,,,,,,,,,,,,,,,,,,,,,,,,,,,70.8,21,13,273,77,80,1016,1,,0,4,4,Westick,1,0,U1.010|3:38-U0.990|3:41-U0.230|2:02-U0.390|1:17-U0.200|1:13-U0.400|1:17-U0.200|1:16-U0.410|1:16-U0.090|0:43-U0.400|1:20-U0.680|5:17-U1.010|3:12-U0.420|3:20-U0.200|0:36-U0.100|0:39-U0.200|0:38-U0.100|0:39-U0.210|0:36-U0.150|1:58-U0.200|0:33-U0.040|0:31,,"Fröndenberg/Ruhr Track Running",,,3113,,250,3,16567851913,0,168070,250480,30378,,81016527,,,,,,,,,,,,,,,,,,,,,,,,,,,,,,,,,,,,,,,,,
102157683,ad691ada-7508-4977-aaf1-66c85fe94311,1721764354,120,1721770634,,0,0,3.6,1315,1315,12,12,22,21,0,0,0.06,,,,252,136,144,110,144,8,48.44,29.7,48.64,1,59.22,3113,28,,2,0,,100,,295,,7,3,25,78,9.88,9.91,9.98,-3.1,-4.5,237,237,,1,241,241,,,,,,,,,"16,40,37,7,0,0,0,0,0","0,96,4,0,0","0,3,95,2,0",,,,,105,,,,,,,,,,,,,,,,,,,,,,,,,,,,,,,,,,,,17.9,20,14,272,78,80,1017,0,,0,4,4,Westick,1,0,U1.000|6:11-U1.000|6:19-U1.000|5:53-U0.597|3:32,,"Fröndenberg/Ruhr Running",,,3113,,250,3,16567856706,0,168070,250480,30378,,81016538,,,,,,,,,,,,,,,,,,,,,,,,,,,,,,,,,,,,,,,,,
102209067,d5e3c59c-ea4f-4926-afda-f914fa9739d1,1721830890,120,1721829452,,0,0,15.74,5339,5617,328,306,335,313,0,3.7,0.77,0.98,1.07,465,1037,135,157,,151,19,53.57,35.89,55.04,1,59.2,2030,103,,3,0.7,97,98,,1159,,13,2,33,78,11.08,10.99,11.19,-6,-2.3,264,264,,1,269,269,,,,,,,,,"24,15,17,19,19,6,1,0,0","0,77,22,0,0","0,1,87,11,1",,,,,113,,,,,,,,,,,,,,,,,,,,,,,,,,,,,,,,,,,,7.1,20,11,315,63,51,1020,5,,0,3,4,Balve,1,0,U1.000|6:12-U1.000|5:07-U1.000|5:42-U1.000|5:48-U1.000|5:53-U1.000|6:09-U1.000|7:20-U1.000|7:19-U1.000|5:22-U1.000|4:43-U1.000|4:38-U1.000|4:31-U1.000|5:02-U1.000|5:59-U1.000|5:40-U0.736|3:36,,"Balve Running",,,3113,,250,3,16578268978,0,168070,250480,30378,,81060409,,,,,,,,,,,,,,,,,,,,,,,,,,,,,,,,,,,,,,,,"4,5",
102331401,dd2b8322-cbe3-4124-8228-e443cd5a22c3,1721931864,120,1721930934,,0,0,12.28,4187,5830,184,188,205,208,0,1.2,0.34,1.02,0.72,335,792,135,160,,152,37,53.23,34.97,54.19,1,59.24,1222,96,,2.9,0.9,102,102,,886,,9,3,81,77,10.74,11.26,11.64,15.1,-8.8,267,267,,1,297,297,,,,,,,,,"23,8,13,21,22,9,3,0,0","1,65,34,0,0","8,12,44,32,4",,,,,114,,,,,,,,,,,,,,,,,,,,,,,,,,,,,,,,,,,,30.2,22,4,206,61,96,1013,1,,0,4,4,Küntrop,1,0,U1.000|4:58-U1.000|4:58-U1.000|5:10-U1.000|5:29-U1.000|5:16-U1.000|4:54-U1.000|4:32-U1.000|4:28-U1.000|5:44-U0.961|8:15-U0.300|1:15-U0.337|3:00-U0.308|1:19-U1.000|8:18-U0.371|2:11,,"Neuenrade Running",,,3113,,250,3,16589251818,0,168070,250480,30378,,81169383,,,,,,,,,,,,,,,,,,,,,,,,,,,,,,,,,,,,,,,,4,
102379112,4b7bff2d-8857-495d-a158-c536e4f102e1,1721995026,120,1721991539,,0,0,10.88,3558,3640,173,175,197,200,0,1.8,0.61,0.96,1.05,177,705,141,160,,160,22,53,36.39,54.03,1,59.21,1126,73,,2.8,0,99,100,,831,,11,3,20,79,11.32,11.23,11.38,-2.2,-1.5,271,271,,1,274,274,,,,,,,,,"14,11,22,24,22,7,0,0,0","0,49,50,0,0","0,1,87,13,0",,,,,116,,,,,,,,,,,,,,,,,,,,,,,,,,,,,,,,,,,,3.5,20,14,233,78,76,1011,5,,0,4,4,Balve,1,0,U1.000|5:50-U1.000|4:54-U1.000|5:29-U1.000|5:35-U1.000|5:40-U1.000|5:50-U1.000|5:21-U1.000|4:52-U1.000|5:36-U1.000|5:16-U0.884|4:55,,"Balve Running",,,3113,,250,3,16594173766,0,168070,250480,30378,,81212641,,,,,,,,,,,,,,,,,,,,,,,,,,,,,,,,,,,,,,,,5,
102468191,9a315615-d988-4cc7-b9ea-e78171080b3f,1722090624,120,1722089266,,0,0,16.26,5124,5412,215,208,235,231,0,2.2,0.53,0.93,1.04,288,1033,143,162,,160,24,54.45,39.22,55.37,1,59.21,1280,113,,3.2,0,103,99,,1213,,11,4,20,78,11.7,11.67,11.75,-1.4,-0.3,282,282,,1,285,285,,,,,,,,,"10,10,16,26,24,13,2,0,0","0,31,68,0,0","0,1,75,24,0",,,,,122,,,,,,,,,,,,,,,,,,,,,,,,,,,,,,,,,,,,3,21,6,193,76,99,1014,4,,0,4,4,Balve,1,0,U1.000|5:14-U1.000|5:08-U1.000|5:02-U1.000|5:24-U1.000|5:25-U1.000|5:39-U1.000|6:00-U1.000|5:27-U1.000|4:48-U1.000|5:11-U1.000|5:13-U1.000|4:38-U1.000|4:55-U1.000|4:47-U1.000|5:49-U1.000|5:07-U0.257|1:38,,"Balve Running",,,3113,,250,3,16604047857,0,168070,250480,30378,,81292304,,,,,,,,,,,,,,,,,,,,,,,,,,,,,,,,,,,,,,,,"4,5",
102606677,98d564a0-cfa6-4aae-a1da-0ad4c3af8463,1722152602,120,1722234083,,0,0,14.26,4735,5009,369,349,371,361,0,3.9,0.83,0.96,1.15,401,931,139,160,114,138,20,52.99,36.51,54.78,1,59.17,1247,93,,3,0,96,99,,815,,7,3,83,80,11.64,11.75,11.76,-14.5,-5,272,272,,1,276,276,,,,,,,,,"35,14,12,10,6,12,10,1,0","1,58,42,0,0","0,3,80,17,0",,,,,113,,,,,,,,,,,,,,,,,,,,,,,,,,,,,,,,,,,,20.5,15,11,315,88,51,1023,1,,0,3,4,Balve,1,0,U1.000|5:45-U1.000|5:52-U1.000|6:58-U1.000|6:27-U1.000|6:35-U1.000|6:30-U1.000|6:53-U1.000|6:09-U1.000|4:48-U1.000|4:14-U1.000|4:07-U1.000|4:01-U1.000|3:47-U1.000|5:25-U0.255|1:25,,"Balve Running",,,3113,,250,3,16617600395,0,168070,250480,30378,,81410373,,,,,,,,,,,,,,,,,,,,,,,,,,,,,,,,,,,,,,,,3,
102608802,ab229b50-afb6-436a-b542-ff78426a92fb,1722241519,120,1722236922,,0,0,8.51,2526,2530,102,111,115,124,0,1.4,0.43,0.94,1.01,514,533,144,167,,152,20,58.08,40.07,58.87,1,59.21,1872,84,,2.9,0,100,104,,467,,9,4,52,80,12.36,12.5,12.5,-3.7,-9.9,302,302,,1,310,310,,,,,,,,,"7,9,10,17,30,19,8,0,0","1,35,60,4,0","0,0,52,48,0",,,,,126,,,,,,,,,,,,,,,,,,,,,,,,,,,,,,,,,,,,32.3,15,3,118,85,9,1025,1,,0,2,4,Balve,1,0,U1.000|5:55-U1.000|4:47-U1.000|5:20-U1.000|4:57-U1.000|4:52-U0.242|1:10-U1.000|4:07-U1.000|4:10-U1.000|5:23-U0.266|1:25,,"Balve Running",,,3113,,250,3,16617862562,0,168070,250480,30378,,81412341,,,,,,,,,,,,,,,,,,,,,,,,,,,,,,,,,,,,,,,,5,
102655212,f73ca5e2-183e-4e7c-9947-3eef402db5b3,1722281450,120,1722277578,,0,0,7.04,2693,2988,100,48,116,68,0,0.9,0.37,0.97,1.1,494,448,123,148,,138,24,51.64,29.27,53.02,1,59.21,1396,35,,2.1,0,,100,,514,,9,1,28,77,9.8,9.61,9.86,-1,-1.6,235,235,,1,237,237,,,,,,,,,"48,22,15,11,3,0,0,0,0","1,97,2,0,0","0,7,93,0,0",,,,,102,,,,,,,,,,,,,,,,,,,,,,,,,,,,,,,,,,,,9.4,24,4,102,63,10,1021,0,,0,2,4,Helle,1,0,U1.000|6:17-U1.000|6:41-U1.000|6:29-U1.000|6:34-U1.000|6:47-U1.000|6:03-U1.000|5:48-U0.041|0:14,,"Balve Running",,,3113,,250,3,16622943898,0,168070,250480,30378,,81454542,,,,,,,,,,,,,,,,,,,,,,,,,,,,,,,,,,,,,,,,5,
102687319,,1722283200,120,1722320401,,0,0,0.5,300,300,,,,,0,,,,,,46,,,,,,,,,1,,,,,,,,,,,,,,6,,,,,,,,,,,,,,,,,,,,,,,,,,,,,,,,,,,,,,,,,,,,,,,,,,,,,,,,,,,,,,,,,,,,,,,,,,1,,,0,0,,,"Uhr angehalten",,,connect,,,3,16626290443,0,168070,250480,30378,,81482292,,,,,,,,,,,,,,,,,,,,,,,,,,,,,,,,,,,,,,,,,
102751137,a927688f-bf1a-4c8b-bfab-bf352fab53f4,1722364275,120,1722367158,,0,0,5.29,1731,2168,27,20,48,40,0,0,0.12,0.94,,,330,134,149,,146,30,56.52,34.67,56.97,1,59.27,874,52,,2.3,0.2,104,103,,463,,7,3,27,77,11.12,11.65,11.71,10.1,-1.1,279,279,,1,299,299,,,,,,,,,"23,3,9,12,34,15,1,1,2","3,51,47,0,0","7,11,23,58,1",,,,,119,,,,,,,,,,,,,,,,,,,,,,,,,,,,,,,,,,,,17.9,28,7,7,51,14,1015,1,,0,2,4,Westick,1,0,U1.000|5:25-U1.000|4:52-U1.000|4:38-U1.000|4:41-U1.000|6:49-U0.287|2:26,,"Fröndenberg/Ruhr Running",,,3113,,250,3,16632507907,0,168070,250480,30378,,81539193,,,,,,,,,,,,,,,,,,,,,,,,,,,,,,,,,,,,,,,,,
102751139,e279372a-6441-406d-b69f-e8e5169eb823,1722368869,120,1722367158,,0,0,2.38,861,861,17,8,26,15,0,0,0.08,1.1,,,164,136,140,,140,6,49.02,29.18,49.68,1,59.29,2282,21,,1.5,0,,100,,238,,9,3,14,79,10.11,9.97,10.15,0.3,0.6,247,247,,1,249,249,,,,,,,,,"14,39,35,12,1,0,0,0,0","0,100,0,0,0","0,0,100,0,0",,,,,105,,,,,,,,,,,,,,,,,,,,,,,,,,,,,,,,,,,,11.2,27,5,11,60,29,1015,0,,0,2,4,Westick,1,0,U1.000|6:01-U1.000|6:07-U0.383|2:13,,"Fröndenberg/Ruhr Running",,,3113,,250,3,16632508394,0,168070,250480,30378,,81539194,,,,,,,,,,,,,,,,,,,,,,,,,,,,,,,,,,,,,,,,,
102751140,6ccd1868-f009-4798-858c-3517f8fb0de4,1722366600,120,1722367159,,0,0,5.94,1613,1613,0,0,0,0,0,0,0,,,,379,160,182,115,178,50,55.86,43.53,55.86,1,59.29,2304,205,,3.1,3.2,109,107,,447,,,,56,82,13.26,15.14,15.14,13.2,3.9,354,354,,1,415,415,,,,,,,,,"30,1,1,2,1,3,26,37,0","0,23,12,59,6","13,16,5,5,62",,,,,135,,,,,,,,,,,,,,,,,,,,,,,,,,,,,,,,,,,,73.2,28,6,10,56,31,1015,1,,0,2,4,Westick,1,0,U1.000|3:30-U0.200|1:48-U1.000|3:29-U0.210|2:02-U1.000|3:27-U0.210|2:05-U1.000|3:27-U0.210|2:10-U1.000|3:24-U0.110|1:32,,"Fröndenberg/Ruhr Track Running",,,3113,,250,3,16632508191,0,168070,250480,30378,,81539195,,,,,,,,,,,,,,,,,,,,,,,,,,,,,,,,,,,,,,,,,
102832773,f783a0c4-3cbc-438b-94b8-01c810122dae,1722451230,120,1722449272,,0,0,14.19,4701,4887,179,151,207,178,0,1.2,0.4,0.97,1.09,235,925,133,151,,146,23,56.19,36.59,57.2,1,59.28,1285,86,,3,0,97,100,,1035,,11,3,64,78,11.15,11.19,11.26,-4.1,-5,272,272,,1,276,276,,,,,,,,,"15,12,26,24,14,5,3,1,0","0,87,13,0,0","0,1,85,14,0",,,,,116,,,,,,,,,,,,,,,,,,,,,,,,,,,,,,,,,,,,13.7,24,4,23,70,90,1014,0,,0,4,4,Helle,1,0,U1.000|5:38-U1.000|5:42-U1.000|5:51-U1.000|5:55-U1.000|6:12-U1.000|5:37-U1.000|5:00-U1.000|5:36-U1.000|5:28-U1.000|4:41-U1.000|6:13-U1.000|5:49-U1.000|5:00-U1.000|4:32-U0.189|1:07,,"Balve Running",,,3113,,250,3,16640756648,0,168070,250480,30378,,81608818,,,,,,,,,,,,,,,,,,,,,,,,,,,,,,,,,,,,,,,,"4,5",
102837487,,1722459564,120,1722452392,,0,0,0.4,180,180,,,,,0,,,,,,28,,,,,,,18.74,,1,,,,,,,,,,,,,,3,,,,,,,,,,,,,,,,,,,,,,,,,,,,,,,,,,,,,,,,,,,,,,,,,,,,,,,,,,,,,,,,,,,,,,,,,,1,,,0,0,,,"Uhr gestoppt",,,connect,,,3,16641240843,0,168070,250480,30378,,81613012,,,,,,,,,,,,,,,,,,,,,,,,,,,,,,,,,,,,,,,,,
102923889,eae98370-a81d-47d3-b0ca-334c15b0d42b,1722532804,120,1722530936,,0,0,14.07,4778,4970,369,366,377,376,0,4,0.81,0.98,1.14,397,916,135,152,,152,24,53.49,35.52,55.24,1,59.23,1137,82,,2.9,0,97,97,,923,,13,3,85,79,11.34,11.29,11.41,-12.9,-3.6,267,267,,1,271,271,,,,,,,,,"37,15,10,9,11,14,4,0,0","1,75,25,0,0","0,1,90,9,0",,,,,112,,,,,,,,,,,,,,,,,,,,,,,,,,,,,,,,,,,,21.7,21,4,11,83,98,1011,2,,0,4,4,Balve,1,0,U1.000|5:30-U1.000|5:43-U1.000|7:04-U1.000|6:38-U1.000|6:31-U1.000|6:24-U1.000|6:52-U1.000|6:22-U1.000|4:50-U1.000|4:31-U1.000|4:22-U1.000|4:31-U1.000|4:03-U1.000|5:50-U0.069|0:27,,"Balve Running",,,3113,,250,3,16648653032,0,168070,250480,30378,,81688052,,,,,,,,,,,,,,,,,,,,,,,,,,,,,,,,,,,,,,,,3,
103008870,146f0af6-2e1f-4e53-b78a-c1be80ae1be3,1722619503,120,1722619824,,0,0,1.67,531,531,36,26,39,28,0,1.4,0.64,0.96,1.02,490,112,139,158,92,155,15,55.9,32.73,57.8,1,59.24,352,23,,1.6,0,101,101,,121,,7,3,12,78,11.94,11.54,12.05,11.9,0.6,293,293,,1,297,297,,,,,,,,,"15,7,14,27,29,9,0,0,0","4,42,54,0,0","0,0,62,38,0",,,,,121,,,,,,,,,,,,,,,,,,,,,,,,,,,,,,,,,,,,19.5,23,7,322,62,24,1011,2,,0,2,4,Balve,1,0,U1.000|5:05-U0.670|3:46,,"Balve Running",,,3113,,250,3,16657290651,0,168070,250480,30378,,81763610,,,,,,,,,,,,,,,,,,,,,,,,,,,,,,,,,,,,,,,,5,
103008871,c987632c-5f41-46d9-adcc-db9b141c7a59,1722622036,120,1722619824,,0,0,13.69,4386,4853,276,254,287,268,0,3.1,0.6,0.92,1,395,872,141,170,,148,21,54.36,37.94,55.82,1,59.26,1338,101,,3.1,0.1,97,102,,1006,,15,3,101,79,11.81,11.92,12.07,-6,-7.4,285,285,,1,299,299,,,,,,,,,"24,15,13,12,13,12,10,1,0","0,53,34,12,0","0,4,66,28,2",,,,,119,,,,,,,,,,,,,,,,,,,,,,,,,,,,,,,,,,,,56.1,23,7,336,61,12,1011,1,,0,2,4,Helle,1,0,U1.000|5:41-U1.000|6:08-U1.000|6:33-U1.000|6:36-U1.000|6:38-U1.000|5:30-U1.000|5:08-U1.000|4:54-U1.000|4:38-U1.000|4:13-U1.000|3:57-U1.000|4:00-U1.000|4:31-U0.685|4:39,,"Balve Running",,,3113,,250,3,16657290875,0,168070,250480,30378,,81763611,,,,,,,,,,,,,,,,,,,,,,,,,,,,,,,,,,,,,,,,"4,5,5",
103059949,dd37774d-be18-4f9f-a270-768f1b7ba1e1,1722684584,120,1722684915,,0,0,21.62,6847,7302,609,505,621,524,0,5.1,0.8,0.99,1.11,563,1455,149,168,,158,23,51.19,39.88,53.28,1,59.24,1881,162,,3.7,0.1,101,99,,1718,,15,4,190,80,12.33,12.15,12.43,-2.6,0.4,294,294,,1,300,300,,,,,,,,,"25,11,12,11,12,16,10,2,0","0,17,73,10,0","0,0,56,44,0",,,,,118,,,,,,,,,,,,,,,,,,,,,,,,,,,,,,,,,,,,48.3,23,10,258,69,74,1012,4,,0,4,4,Helle,1,0,U1.000|5:35-U1.000|5:43-U1.000|5:59-U1.000|6:51-U1.000|4:40-U1.000|4:27-U1.000|4:10-U1.000|6:08-U1.000|6:02-U1.000|7:05-U1.000|5:22-U1.000|5:30-U1.000|7:15-U1.000|5:06-U1.000|5:14-U1.000|4:23-U1.000|3:48-U1.000|3:57-U1.000|4:01-U1.000|4:02-U1.000|4:43-U0.624|4:04,,"Balve Running",,,3113,,250,3,16662870035,0,168070,250480,30378,,81809052,,,,,,,,,,,,,,,,,,,,,,,,,,,,,,,,,,,,,,,,"4,4,4,5",
103110094,d1a33912-db02-44e7-8299-760ec4fc3e04,1722753409,120,1722747415,,0,0,2.86,1065,1065,70,80,73,84,0,1.8,0.7,0.99,1.08,536,191,130,156,,156,32,50.02,28.59,51.31,1,59.24,839,20,,1.4,0,,100,,171,,7,3,15,78,10.12,9.91,10.18,-3.3,-2.8,234,234,,1,240,240,,,,,,,,,"39,17,20,24,1,0,0,0,0","2,83,16,0,0","0,19,81,0,0",,,,,103,,,,,,,,,,,,,,,,,,,,,,,,,,,,,,,,,,,,10.5,16,10,236,94,98,1013,0,,0,4,4,Balve,1,0,U1.000|6:34-U1.000|5:22-U0.864|5:48,,"Balve Running",,,3113,,250,3,16668719836,0,168070,250480,30378,,81854878,,,,,,,,,,,,,,,,,,,,,,,,,,,,,,,,,,,,,,,,5,
103413397,665ce9c4-f520-4b7a-8eff-95bb26a38702,1722860465,120,1723021302,,0,0,10.48,2996,3498,54,47,74,77,0,0,0.12,0.98,0.88,,655,148,160,,160,12,58.62,42.48,59.04,1,59.3,1222,102,,3.1,0,107,103,,831,,13,4,67,80,12.67,12.94,13,6.9,8.4,314,314,,1,328,328,,,,,,,,,"11,5,7,14,30,22,7,2,3","0,12,88,0,0","0,4,34,56,7",,,,,131,,,,,,,,,,,,,,,,,,,,,,,,,,,,,,,,,,,,26.4,25,7,185,55,4,1015,7,,0,2,4,Paris,1,0,U1.000|4:51-U1.000|4:01-U1.000|4:37-U1.000|4:36-U1.000|5:09-U1.000|5:04-U1.000|4:35-U1.000|5:04-U1.000|4:45-U1.000|4:45-U0.475|2:30,,"Paris Running",,,3113,,250,3,16697267564,0,168070,250480,30378,,82116215,,,,,,,,,,,,,,,,,,,,,,,,,,,,,,,,,,,,,,,,,
103413435,503eceaa-ce8e-4e3c-b7ba-5ac69b2e4310,1722948488,120,1723021369,,0,0,15.4,4447,5689,110,50,148,92,0,0,0.16,0.96,0.79,,933,142,161,126,158,11,61.22,43.23,62.06,1,59.36,1280,116,,3.2,0,104,101,,1102,,16,4,85,81,12.71,13.1,13.31,4.8,11.5,317,317,,1,342,342,,,,,,,,,"12,5,8,14,29,22,6,1,3","0,28,71,0,0","2,4,33,55,6",,,,,128,,,,,,,,,,,,,,,,,,,,,,,,,,,,,,,,,,,,24,27,13,228,51,13,1012,7,,0,2,4,Clichy,1,0,U1.000|4:27-U1.000|5:10-U1.000|4:40-U1.000|4:27-U1.000|4:26-U1.000|4:12-U1.000|4:45-U1.000|4:55-U1.000|4:42-U1.000|5:01-U1.000|5:37-U1.000|6:04-U1.000|4:40-U1.000|4:51-U1.000|4:27-U0.398|1:45,,"Clichy Running",,,3113,,250,3,16697274685,0,168070,250480,30378,,82116247,,,,,,,,,,,,,,,,,,,,,,,,,,,,,,,,,,,,,,,,,
103413471,d89f3aa3-d8c8-433f-82f3-517577333017,1723015597,120,1723021428,,0,0,13.63,4031,4982,122,68,140,71,0,0.4,0.25,1.08,0.61,,880,141,161,,148,46,60,41.64,60.96,1,59.42,1454,132,,3.4,0,103,105,,708,,15,4,76,82,12.58,12.77,13.11,-3.2,-12,318,312,,1,335,333,,,,,,,,,"11,3,6,12,22,27,14,4,0","1,33,66,0,0","6,4,21,59,11",,,,,124,,,,,,,,,,,,,,,,,,,,,,,,,,,,,,,,,,,,23.2,17,8,303,83,59,1014,0,,0,3,4,Clichy,1,0,U1.000|4:57-U1.000|4:55-U1.000|4:51-U1.000|5:10-U1.000|4:51-U1.000|4:29-U1.000|4:34-U1.000|7:24-U1.000|5:33-U1.000|4:31-U1.000|4:29-U1.000|4:16-U1.000|4:27-U0.626|2:44,,"Clichy Running",,,3113,,250,3,16697280475,0,168070,250480,30378,,82116277,,,,,,,,,,,,,,,,,,,,,,,,,,,,,,,,,,,,,,,,,
103542013,8525587a-5748-47b5-938c-8361f9f7bd8d,1723143796,120,1723140438,,0,0,11.95,3574,3665,267,222,275,231,0,3.1,0.78,0.97,1.09,505,761,144,169,,147,19,57.54,40.68,59.41,1,59.45,1280,109,,3.2,0,98,102,,760,,13,4,91,79,12.73,12.65,12.88,-6.7,3.1,315,315,,1,324,324,,,,,,,,,"13,10,14,14,15,22,11,1,0","0,41,49,9,0","0,0,41,56,4",,,,,127,,,,,,,,,,,,,,,,,,,,,,,,,,,,,,,,,,,,48.6,21,6,241,60,41,1017,0,,0,3,4,Balve,1,0,U1.000|5:25-U1.000|5:59-U1.000|6:33-U1.000|4:43-U1.000|5:42-U1.000|4:21-U1.000|3:55-U1.000|4:06-U1.000|4:06-U1.000|4:11-U1.000|4:38-U0.948|5:54,,"Balve Running",,,3113,,250,3,16710694749,0,168070,250480,30378,,82232462,,,,,,,,,,,,,,,,,,,,,,,,,,,,,,,,,,,,,,,,4,
103576900,,1723102560,120,1723181853,,0,0,1,300,300,,,,,0,,,,,,68,,,,,,,32.99,,1,,,,,,,,,,,,,,7,,,,,,,,,,,,,,,,,,,,,,,,,,,,,,,,,,,,,,,,,,,,,,,,,,,,,,,,,,,,,,,,,,,,,,,,,,1,,,0,0,,,"Uhr stopp ",,,connect,,,3,16713763055,0,168070,250480,30378,,82262413,,,,,,,,,,,,,,,,,,,,,,,,,,,,,,,,,,,,,,,,,
103588207,a5141a95-c6ac-4865-b2c7-99d28c7ffe1f,1723193283,120,1723189485,,0,0,9.62,3331,3335,177,132,206,162,0,2,0.5,1.01,1.06,304,644,135,157,,157,31,52.23,33.7,53.72,1,59.41,1070,62,,2.6,0,99,97,,575,,9,2,43,79,10.89,10.56,10.98,-0.3,0.6,265,265,,1,270,270,,,,,,,,,"19,16,26,26,12,1,0,0,0","1,70,28,0,0","0,7,80,13,0",,,,,110,,,,,,,,,,,,,,,,,,,,,,,,,,,,,,,,,,,,12.2,19,15,203,73,88,1015,1,,0,4,4,Helle,1,0,U1.000|5:35-U1.000|5:35-U1.000|5:59-U1.000|5:52-U1.000|5:37-U1.000|6:01-U1.000|5:15-U1.000|5:29-U1.000|6:12-U0.618|3:57,,"Balve Running",,,3113,,250,3,16714472945,0,168070,250480,30378,,82272950,,,,,,,,,,,,,,,,,,,,,,,,,,,,,,,,,,,,,,,,"4,5,5",
103694843,82948ee2-ac18-4a1a-8562-a6556b081783,1723293472,120,1723293291,,0,0,19.44,6064,6627,501,488,532,523,0,4.6,0.79,1.01,1.15,548,1307,151,179,,162,28,51.19,40.26,52.86,1,59.38,1894,163,,3.8,0,99,98,,1494,,17,4,163,80,12.35,12.5,12.57,-3.7,-3.1,294,294,,1,302,302,,,,,,,,,"24,11,11,15,17,8,7,6,0","0,23,59,18,0","0,2,53,43,2",,,,,120,,,,,,,,,,,,,,,,,,,,,,,,,,,,,,,,,,,,66.6,23,13,253,56,8,1021,7,,0,2,4,Balve,1,0,U1.000|5:00-U1.000|6:31-U1.000|6:39-U1.000|6:59-U1.000|6:19-U1.000|4:47-U1.000|5:39-U1.000|5:07-U1.000|4:26-U1.000|5:23-U1.000|6:06-U1.000|5:18-U1.000|5:04-U1.000|5:01-U1.000|3:36-U1.000|3:26-U1.000|3:24-U1.000|3:49-U1.000|5:28-U0.440|3:02,,"Balve Running",,,3113,,250,3,16724790611,0,168070,250480,30378,,82369680,,,,,,,,,,,,,,,,,,,,,,,,,,,,,,,,,,,,,,,,"3,4,5,5",
103757220,f0d33525-7549-4c3d-a89f-c77f0573a3b2,1723371310,120,1723366486,,0,0,7.08,2149,2314,79,74,88,83,0,0.9,0.37,0.95,1.01,471,483,157,177,,163,13,50.07,38.57,50.8,1,59.34,1362,101,,3.1,0.1,98,98,,558,,13,2,15,78,12.11,12.2,12.25,-0.5,-6,292,292,,1,298,298,,,,,,,,,"8,9,9,23,32,14,4,1,0","0,5,53,42,0","0,0,64,34,3",,,,,127,,,,,,,,,,,,,,,,,,,,,,,,,,,,,,,,,,,,8,21,3,334,70,28,1023,4,,0,2,4,Balve,1,0,U1.000|5:53-U1.000|4:47-U1.000|5:00-U0.818|4:15-U1.000|4:03-U1.000|4:34-U1.000|5:50-U0.258|1:26,,"Balve Running",,,3113,,250,3,16731695830,0,168070,250480,30378,,82424770,,,,,,,,,,,,,,,,,,,,,,,,,,,,,,,,,,,,,,,,5,
103875023,071cadfd-9958-4fa6-8954-f1eb205a796f,1723486625,120,1723484888,,0,0,13.89,4896,5229,342,324,363,342,0,3.8,0.75,0.98,1.09,440,933,137,161,,131,33,50.15,33.96,51.76,1,59.27,1205,86,,3,0,101,95,,1302,,17,3,54,78,10.92,10.75,11.05,-2.2,7.4,259,259,,1,266,266,,,,,,,,,"35,11,13,16,17,7,1,0,0","1,58,41,0,0","2,3,84,11,0",,,,,109,,,,,,,,,,,,,,,,,,,,,,,,,,,,,,,,,,,,12.2,30,6,190,58,35,1010,1,,0,2,4,Balve,1,0,U1.000|5:18-U1.000|5:29-U1.000|6:33-U1.000|6:44-U1.000|6:34-U1.000|6:44-U1.000|6:55-U1.000|7:12-U1.000|4:43-U1.000|4:35-U1.000|4:45-U1.000|4:46-U1.000|5:15-U0.894|6:02,,"Balve Running",,,3113,,250,3,16744805100,0,168070,250480,30378,,82529231,,,,,,,,,,,,,,,,,,,,,,,,,,,,,,,,,,,,,,,,3,
103963001,509067aa-6f9b-4241-82b5-726590de1c12,1723573827,120,1723572756,,0,0,5.02,1565,1954,12,20,27,33,0,0,0.12,,0.53,,318,142,164,,163,46,55.7,36.61,55.75,1,59.35,816,72,,2.4,1.4,104,102,,344,,7,3,30,78,11.49,12.1,12.07,15.6,5.2,284,284,,1,301,301,,,,,,,,,"16,1,2,9,58,9,1,1,2","1,24,74,2,0","7,7,19,64,3",,,,,123,,,,,,,,,,,,,,,29,,,,,,,,,,,,,,,,,,,,,20.3,29,8,102,67,58,1010,1,,0,3,4,Westick,1,0,U1.000|4:55-U1.000|4:42-U1.000|4:41-U1.000|4:43-U0.199|1:01-U0.817|6:03,,"Fröndenberg/Ruhr Running",,,3113,,250,3,16754285162,0,168070,250480,30378,10901436,82610006,422,11,9,32,16,0.67,1.26,2.27,0.73,0.55,1.13,28,0,52,3.1,409,0,13.34,0,147,0,,,,,,,,,,,,,,,,,,,,
103963051,f97bba52-e7cf-49f1-a79e-fb102bca9770,1723575843,120,1723572788,,0,0,6.97,2544,2544,0,0,0,0,0,0,0,,,,471,145,181,100,177,56,44.59,30.95,44.59,1,59.36,3720,191,,3,3.2,110,111,,598,,,,64,78,9.87,13.26,13.26,24.2,-6.1,252,251,,1,354,354,,,,,,,,,"49,6,4,2,2,1,10,22,5","4,44,13,39,0","32,14,15,6,33",,,,,105,,,,,,,,,,,,,,,31,,,,,,,,,,,,,,,,,,,,,51.6,28,8,113,69,48,1010,1,,0,3,4,Westick,1,0,U1.210|4:09-U0.400|2:45-U0.300|0:56-U0.100|0:42-U0.300|1:03-U0.110|1:07-U0.290|1:02-U0.110|1:31-U0.300|0:56-U0.420|3:17-U0.390|1:21-U0.400|1:17-U0.400|3:26-U0.300|0:55-U0.200|1:31-U0.200|0:37-U0.200|2:13-U0.200|0:37-U0.200|4:07-U0.810|2:37-U0.130|6:17,,"Fröndenberg/Ruhr Track Running",,,3113,,250,3,16754291311,0,168070,250480,30378,10901442,82610050,417,13,12,80,66,0.78,2.86,3.3,0.83,0.24,1.4,64,16,25,4.8,300,0,9.07,0,143,0,,,,,,,,,,,,,,,,,,,,
103963077,a32989fe-8ada-432d-bc27-9917bc57dab7,1723578528,120,1723572808,,0,0,3.54,1253,1260,25,17,29,20,0,0,0.11,1.13,0.9,,235,133,138,,138,8,51.78,30.81,52.38,1,59.36,3698,27,,2,0,,100,,276,,11,2,18,79,10.29,10.2,10.37,-3.4,-3.2,246,246,,1,250,250,,,,,,,,,"5,32,52,11,0,0,0,0,0","0,100,0,0,0","0,3,93,5,0",,,,,107,,,,,,,,,,,,,,,27,,,,,,,,,,,,,,,,,,,,,10.3,28,8,121,71,59,1009,0,,0,3,4,Westick,1,0,U1.000|6:06-U1.000|5:53-U1.000|5:47-U0.544|3:06,,"Fröndenberg/Ruhr Running",,,3113,,250,3,16754294788,0,168070,250480,30378,10901448,82610072,451,7,6,11,2,0.22,0.33,1.41,0.65,0.36,1.1,16,10,87,1.7,205,1,9.21,1,135,0,,,,,,,,,,,,,,,,,,,,
104039712,b6d34872-06dc-443a-a370-d27c45d1d34b,1723652153,120,1723647806,,0,0,7.96,2829,2829,111,111,,,4,1.6,0.52,1.01,1.05,,554,132,152,,142,35,52,32.24,52.9,1,,,,,,,,,190,,,,,46,,10.32,10.61,10.76,12.8,8.3,252,250,,1,264,263,,,,,,,,,"19,12,24,24,19,3,0,0,0","1,85,15,0,0","5,6,75,15,0",,,,,,,,,,,,,,,,,,,,,,,,,,,,,,,,,,,,,,,,,16.5,25,9,254,75,90,1012,2,,0,4,4,Balve,1,0,U1.000|5:39-U1.000|5:21-U1.000|5:33-U1.000|5:41-U1.000|5:38-U1.000|6:51-U1.000|7:06-U0.953|5:20,,,,,,,58,7,,0,168070,250480,30378,,82677544,,,,,,,,,,,,,,,,,,,,,,,,,,,,,,,,,,,,,,,,,
104150719,c6ae4b2e-7e9d-41b9-81c0-d5ca82999219,1723743141,120,1723742128,,0,0,18.1,5940,6041,405,390,419,407,0,4.1,0.79,0.96,1.06,467,1196,139,159,,152,20,53.76,37.73,55.3,1,59.29,1612,118,,3.3,0,97,98,,1413,,13,3,116,80,11.52,11.4,11.59,-0.2,0,279,279,,1,284,284,,,,,,,,,"23,14,13,15,20,13,2,0,0","0,52,48,0,0","0,2,72,25,0",,,,,114,,,,,,,,,,,,,,,,,,,,,,,,,,,,,,,,,,,,28.6,25,10,240,61,68,1016,1,,0,4,4,Balve,1,0,U1.000|5:36-U1.000|5:30-U1.000|6:48-U1.000|6:27-U1.000|6:18-U1.000|6:08-U1.000|5:06-U1.000|4:34-U1.000|4:36-U1.000|5:54-U1.000|6:42-U1.000|5:24-U1.000|4:43-U1.000|4:40-U1.000|4:25-U1.000|4:14-U1.000|5:43-U1.000|5:38-U0.095|0:35,,"Balve Running",,,3113,,250,3,16772020940,0,168070,250480,30378,,82779303,,,,,,,,,,,,,,,,,,,,,,,,,,,,,,,,,,,,,,,,"4,4,5",
104222603,19ac97c9-1e6a-4072-8df5-7bcafa3c1cc5,1723818600,120,1723813523,1723914471,0,0,6.39,2070,2070,94,95,,,4,1.4,0.44,1.12,1.07,348,441,139,163,,163,36,54.63,35.48,55.61,1,,,,,,,,,190,,,,,34,,11.29,11.37,11.67,5.6,-4.2,277,277,,1,290,290,,,,,,,,,"12,9,18,29,26,5,1,0,0","0,69,28,3,0","0,7,69,20,4",,,,,,,,,,,,,,,,,,,,,,,,,,,,,,,,,,,,,,,,,19.1,24,13,241,62,94,1016,4,,0,4,4,Balve,1,0,U1.000|5:40-U1.000|5:02-U1.000|5:07-U1.000|5:00-U1.000|5:59-U1.000|5:37-U0.382|2:07,,,,,,,58,7,,0,168070,250480,30378,,82845280,,,,,,,,,,,,,,,,,,,,,,,,,,,,,,,,,,,,,,,,5,
104314139,b34af105-24fb-41c2-90ef-4e72df655d84,1723896000,120,1723901590,1723914512,0,0,20.36,5046,5046,383,423,370,397,4,4.2,0.62,1.03,1.07,495,1323,175,185,140,175,13,54.38,52.76,55.52,1,59.29,4320,327,,5,0.3,105,98,,1401,,20,4,177,84,14.95,14.93,15.09,6.7,8.1,382,382,,1,388,388,,,,,,,,,"3,3,5,9,12,21,31,16,1","0,0,2,81,17","0,0,4,67,30",,,,,144,,,,,,,,,,,,,,,,,,,,,,,,,,,,,,,,,,,,72.8,22,9,280,80,86,1013,4,,0,4,4,Menden,1,0,U1.000|4:05-U1.000|4:05-U1.000|4:10-U1.000|3:41-U1.000|3:43-U1.000|4:34-U1.000|3:54-U1.000|4:07-U1.000|4:30-U1.000|3:46-U1.000|3:26-U1.000|4:34-U1.000|3:47-U1.000|4:32-U1.000|4:48-U1.000|4:06-U1.000|3:35-U1.000|4:58-U1.000|4:00-U1.000|4:06-U0.355|1:37,,"Menden (Sauerland) Running",,,3113,,250,3,16787333464,0,168070,250480,30378,,82926672,,,,,,,,,,,,,,,,,,,,,,,,,,,,,,,,,,,,,,,,"4,4,4,5,5,5",
104314153,61ab2029-55ff-46de-859f-9a82e30324c2,1723901986,120,1723901603,,0,0,3.19,1188,1347,62,37,72,43,0,0.4,0.32,1.12,1.22,,237,146,161,110,151,25,43.09,28.8,44.55,1,59.29,4322,34,,2.1,0,95,99,,287,,7,3,10,81,10.14,10.11,10.52,-19.3,-17.6,244,244,,1,258,258,,,,,,,,,"42,8,15,15,11,8,0,0,0","0,25,75,0,0","2,17,61,20,0",,,,,99,,,,,,,,,,,,,,,,,,,,,,,,,,,,,,,,,,,,5,22,8,286,78,79,1013,4,,0,4,4,Menden,1,0,U1.000|6:31-U1.000|6:50-U1.000|5:33-U0.188|0:54,,"Menden (Sauerland) Running",,,3113,,250,3,16787336177,0,168070,250480,30378,,82926685,,,,,,,,,,,,,,,,,,,,,,,,,,,,,,,,,,,,,,,,,
104412260,39feb95c-fcd8-42ba-a914-494839d5bd9d,1723988779,120,1723986445,,0,0,13.36,4454,4507,316,304,334,325,0,3.7,0.8,0.97,0.99,457,880,140,156,,137,31,52.24,36.15,53.82,1,59.28,2848,92,,3.1,0,100,97,,909,,13,1,29,80,11.31,11.17,11.51,-4.8,3.7,272,271,,1,279,279,,,,,,,,,"18,17,15,17,25,8,0,0,0","1,42,57,0,0","1,6,67,25,0",,,,,112,,,,,,,,,,,,,,,,,,,,,,,,,,,,,,,,,,,,4.8,19,11,343,76,98,1012,4,,0,4,4,Balve,1,0,U1.000|6:12-U1.000|5:15-U1.000|6:27-U1.000|6:26-U1.000|6:08-U1.000|6:31-U1.000|5:07-U1.000|4:48-U1.000|4:48-U1.000|4:35-U1.000|4:39-U1.000|5:44-U1.000|5:48-U0.360|1:47,,"Balve Running",,,3113,,250,3,16795785655,0,168070,250480,30378,,83016119,,,,,,,,,,,,,,,,,,,,,,,,,,,,,,,,,,,,,,,,"4,4",
104536339,1f5d59c1-f80f-4c38-aa5b-464965e6e183,1724094904,120,1724093362,,0,0,13.25,4870,5246,231,219,261,250,0,2.5,0.56,1.02,1.1,279,863,123,149,77,144,35,54.25,32.2,55.48,1,59.28,1222,62,,2.6,0,99,99,,752,,11,1,56,79,10.11,10.14,10.36,-7.4,-11.1,240,240,,1,249,249,,,,,,,,,"40,21,17,11,7,5,0,0,0","1,94,5,0,0","0,15,80,4,1",,,,,103,,,,,,,,,,,,,,,,,,,,,,,,,,,,,,,,,,,,11.3,20,3,55,72,4,1017,0,,0,2,4,Helle,1,0,U1.000|6:27-U1.000|6:25-U1.000|6:28-U1.000|6:56-U1.000|6:29-U1.000|6:56-U1.000|5:30-U1.000|5:41-U1.000|6:30-U1.000|4:41-U1.000|6:19-U1.000|5:39-U1.000|5:38-U0.250|1:31,,"Balve Running",,,3113,,250,3,16806917743,0,168070,250480,30378,,83129566,,,,,,,,,,,,,,,,,,,,,,,,,,,,,,,,,,,,,,,,"5,5,5,5",
104645892,55d2bcc9-fe0d-4cf9-a821-12814bd5db0a,1724178673,120,1724176773,,0,0,6.36,2406,2505,33,27,69,61,0,0,0.08,0.97,0.28,,423,132,164,,152,73,48.15,29.47,48.51,1,59.35,1899,102,,2.7,2.2,104,102,,533,,7,3,47,75,9.87,11.06,11.2,24.8,-3.8,241,236,,1,282,281,,,,,,,,,"41,1,2,10,30,9,1,2,2","12,41,46,1,0","21,15,25,36,4",,,,,106,,,,,,,,,,,,,,,28,,,,,,,,,,,,,,,,,,,,,27.1,23,11,206,65,24,1009,0,,0,2,4,Westick,1,0,U1.000|5:03-U1.000|4:43-U1.000|4:47-U1.000|4:38-U0.338|6:03-U0.132|0:26-U0.158|1:22-U0.106|0:23-U0.156|1:14-U0.093|0:18-U0.120|1:16-U0.337|2:35-U0.145|0:30-U0.150|1:38-U0.114|0:23-U0.128|1:18-U0.207|1:44-U0.068|0:14-U0.106|1:32,,"Fröndenberg/Ruhr Running",,,3113,,250,3,16815646625,0,168070,250480,30378,10959772,83226784,446,15,14,73,73,0.61,2.01,0,0.72,0.53,1.28,28,0,50,1.6,287,0,11.63,0,138,0,,,,,,,,,,,,,,,,,,,,
104645967,08d46818-b361-4ba0-90a2-846474ea5ad4,1724181376,120,1724176838,,0,0,7.54,2532,2532,0,0,0,0,0,0,0,,,,523,152,196,,177,53,46.31,34.36,46.31,1,59.36,5760,266,,3.2,3.7,101,108,,639,,,,81,79,10.72,13,13,15.7,-2.4,271,271,,1,343,343,,,,,,,,,"57,1,1,1,2,2,5,21,10","0,29,23,46,2","21,27,12,10,30",,,,,113,,,,,,,,,,,,,,,34,,,,,,,,,,,,,,,,,,,,,68.1,24,10,215,65,38,1009,0,,0,3,4,Westick,1,0,U0.200|0:37-U0.100|0:43-U0.200|0:36-U0.100|0:43-U0.200|0:35-U0.100|0:46-U0.200|0:36-U0.100|0:40-U0.200|0:36-U0.100|0:43-U0.200|0:36-U0.400|4:33-U0.400|1:19-U0.190|1:23-U0.400|1:18-U0.200|1:24-U0.400|1:18-U0.100|0:48-U0.410|1:19-U0.100|0:58-U0.390|1:19-U0.100|0:52-U0.400|1:19-U0.410|5:03-U0.200|0:36-U0.100|0:46-U0.200|0:38-U0.100|0:49-U0.200|0:38-U0.100|0:55-U0.190|0:37-U0.100|0:41-U0.210|0:34-U0.100|0:50-U0.200|0:34-U0.240|4:29,,"Fröndenberg/Ruhr Track Running",,,3113,,250,3,16815657203,0,168070,250480,30378,10959782,83226855,385,13,12,61,35,0.83,1.36,0.03,0.72,0.34,1.5,32,22,80,0.7,352,1,11.12,1,154,1,,,,,,,,,,,,,,,,,,,,
104647428,9bd51cad-6a12-4d98-9dfb-db2b50ba18ba,1724184122,120,1724177774,,0,0,2.28,770,770,30,16,34,20,0,0.4,0.26,1.44,0.93,1240,161,142,183,,183,45,50.46,31.51,51.67,1,59.35,5744,30,,2,0,95,97,,180,,7,3,17,80,10.98,10.68,11.83,3.5,17.9,271,271,,1,293,293,,,,,,,,,"9,12,36,35,9,0,0,0,0","0,25,73,1,1","0,0,88,2,9",,,,,111,,,,,,,,,,,,,,,33,,,,,,,,,,,,,,,,,,,,,19,23,10,220,68,48,1009,0,,0,3,4,Westick,1,0,U1.000|5:43-U1.000|5:35-U0.279|1:33,,"Fröndenberg/Ruhr Running",,,3113,,250,3,16815838292,0,168070,250480,30378,10959971,83228200,413,13,12,16,1,0.77,1.16,0,0.53,0.38,0.62,0,23,85,0.6,373,0,14.57,0,134,0,,,,,,,,,,,,,,,,,,,5,
104750726,f269a347-54fc-491b-a10f-fba6564471c1,1724248518,120,1724245821,,0,0,14.64,4484,4484,145,146,,,4,0.8,0.27,0.99,1.04,,896,134,155,,147,22,61.33,40.2,62.08,1,,,,,,,,,190,,,,,79,,11.9,11.9,11.98,-3.6,-4.2,289,289,,1,292,292,,,,,,,,,"3,6,14,32,36,8,1,0,0","0,89,11,0,0","0,1,67,32,0",,,,,,,,,,,,,,,,,,,,,,,,,,,,,,,,,,,,,,,,,20.3,18,20,265,57,75,1018,3,,0,4,4,Balve,1,0,U1.000|5:40-U1.000|4:54-U1.000|4:58-U1.000|5:06-U1.000|5:32-U1.000|5:41-U1.000|5:14-U1.000|4:55-U1.000|4:48-U1.000|4:43-U1.000|4:54-U1.000|4:56-U1.000|5:27-U1.000|4:30-U0.614|3:26,,,,,,,58,7,,0,168070,250480,30378,,83321312,,,,,,,,,,,,,,,,,,,,,,,,,,,,,,,,,,,,,,,,,
104912117,3c0c1a3f-458a-4ea6-ab54-0be5776aa774,1724353896,120,1724352950,,0,0,16.21,4853,5168,125,122,173,172,0,0.6,0.27,0.87,0.91,,1043,152,180,106,178,48,53.35,41.62,53.87,1,59.37,4320,192,,3.8,1.5,96,107,,1199,,17,4,153,79,12.2,13.05,13.05,4.3,-2.2,307,307,,1,338,338,,,,,,,,,"19,8,10,12,11,8,30,2,0","1,31,28,41,0","3,8,40,27,21",,,,,127,,,,,,,,,,,,,,,,,,,,,,,,,,,,,,,,,,,,75.6,21,13,202,62,46,1010,0,,0,3,4,,1,0,U1.000|6:04-U1.000|5:35-U1.000|5:00-U1.000|5:09-U0.278|1:01-U0.231|1:01-U0.542|2:01-U0.206|1:01-U0.800|3:04-U0.399|2:01-U1.000|3:52-U0.045|0:11-U0.249|2:26-U1.000|3:56-U0.278|1:06-U0.491|3:02-U1.000|3:56-U0.290|1:09-U0.568|3:01-U1.000|3:53-U0.040|0:10-U0.344|2:02-U0.824|3:03-U0.332|1:58-U0.556|2:02-U0.175|1:02-U0.305|1:01-U1.000|9:16-U0.257|1:50,,"Balve Running",,,3113,,250,3,16834233340,0,168070,250480,30378,,83465573,,,,,,,,,,,,,,,,,,,,,,,,,,,,,,,,,,,,,,,,,
105042476,61acbf88-8b99-440d-af7b-946d9ad688fd,1724439696,120,1724446272,,0,0,8.12,3046,3166,133,129,147,142,0,2.3,0.65,0.99,1.02,578,533,126,147,,147,23,51.44,30.27,52.52,1,59.37,2929,41,,2.2,0,98,98,,499,,7,1,28,78,9.83,9.68,9.94,-2.4,-6.3,233,233,,1,238,238,,,,,,,,,"34,29,26,10,1,0,0,0,0","1,94,5,0,0","0,14,84,2,0",,,,,103,,,,,,,,,,,,,,,,,,,,,,,,,,,,,,,,,,,,7.1,21,13,226,75,96,1011,0,,0,4,4,Balve,1,0,U1.000|6:13-U1.000|6:41-U1.000|6:01-U1.000|5:52-U1.000|6:25-U1.000|6:13-U1.000|6:08-U1.000|6:32-U0.119|0:43,,"Balve Running",,,3113,,250,3,16843087853,0,168070,250480,30378,,83571421,,,,,,,,,,,,,,,,,,,,,,,,,,,,,,,,,,,,,,,,"5,5",
105134426,305b7685-974c-402f-bf44-12a1963ef646,1724522091,120,1724520973,,0,0,14,4778,5601,391,357,421,386,0,4.5,0.8,1,1.08,501,941,138,157,106,146,22,51.7,35.3,53.65,1,59.34,1746,91,,3,0,102,96,,1235,,13,3,37,78,11.26,10.95,11.59,-10.4,-12.2,268,268,,1,281,281,,,,,,,,,"28,13,15,20,16,7,1,0,0","1,51,48,0,0","0,6,77,15,1",,,,,113,,,,,,,,,,,,,,,,,,,,,,,,,,,,,,,,,,,,7,28,18,181,51,22,1005,0,,0,2,4,Balve,1,0,U1.000|5:31-U1.000|5:23-U1.000|6:33-U1.000|6:29-U1.000|6:34-U1.000|6:31-U1.000|6:55-U1.000|5:39-U1.000|4:48-U1.000|4:37-U1.000|4:38-U1.000|4:47-U1.000|5:12-U0.996|6:02,,"Balve Running",,,3113,,250,3,16850783157,0,168070,250480,30378,,83654251,,,,,,,,,,,,,,,,,,,,,,,,,,,,,,,,,,,,,,,,"3,4",
105206027,3c5194e3-a135-486a-b685-2676ad4a0bf7,1724591956,120,1724594242,,0,0,9.7,9345,9345,376,360,409,393,0,4.7,0.83,,,216,553,88,129,,126,37,,,,1,59.35,527,7,,0.5,0,,100,,1368,,,,31,54,,4.17,,-57.6,,,,,,,,,,,,,,,,"84,16,0,0,0,0","79,21,0,0,0",,7288,2,,,,,,,,,,,,,,,,,,,,,,,,,,,,,,,,,,,,,,,3.2,19,15,244,53,26,1022,4,,0,2,4,Balve,1,0,U2.696|51:28-U7.003|1:44:17,,"Balve Hiking",,,3113,,250,3,16857700781,0,168075,,30378,,83718765,,,,,,,,,,,,,,,,,,,,,,,,,,,,,,,,,,,,,,,,2,
105223645,c9282b5a-d30d-4a8b-b79e-75609ef06441,1724607056,120,1724605988,1724656576,0,0,16.07,5135,5939,503,530,461,497,4,4.9,0.77,0.96,0.98,719,1087,144,173,,130,53,53.03,38.55,54.98,1,59.34,1728,165,,3.5,1.4,96,100,,954,,16,4,122,80,12.08,12.14,12.98,-7.5,0.9,290,289,,1,323,323,,,,,,,,,"21,9,12,15,23,10,7,3,0","1,49,23,27,0","3,14,38,33,13",,,,,117,,,,,,,,,,,,,,,32,,,,,,,,,,,,,,,,,,,,,57.2,18,10,244,53,32,1022,1,,0,2,4,Helle,1,0,U0.977|7:06-U1.000|5:43-U1.000|5:05-U0.194|0:56-U1.000|6:14-U1.000|4:41-U1.000|4:54-U0.645|5:17-U1.000|5:48-U1.000|5:18-U0.188|0:53-U1.000|5:29-U1.000|3:28-U1.000|3:47-U1.000|4:58-U1.000|4:40-U1.000|4:45-U1.000|6:10-U0.068|0:24,,"Balve Running",,,3113,,250,3,16859535480,0,168070,250480,30378,11006828,83735050,408,9,8,52,41,0.14,0.3,0,0.57,0.21,1.29,22,42,86,0.3,199,1,9.83,1,126,1,,,,,,,,,,,,,,,,,,,"3,4",
105363038,2cf4db22-bc87-42ed-8840-947ba9b4b807,1724699516,120,1724699404,,0,0,11.5,3883,3883,210,221,225,236,0,2.7,0.68,0.95,1.02,368,743,137,158,,150,26,52.88,35.19,54.01,1,59.31,1122,72,,2.7,0,98,99,,678,,11,1,68,78,11.01,11.07,11.16,-0.1,-2.4,260,260,,1,268,268,,,,,,,,,"21,18,23,17,10,8,4,0,0","0,69,30,0,0","1,6,83,9,1",,,,,114,,,,,,,,,,,,,,,29,,,,,,,,,,,,,,,,,,,,,23.1,18,2,248,65,26,1022,0,,0,2,4,Balve,1,0,U1.000|5:42-U1.000|5:55-U1.000|5:15-U1.000|4:50-U1.000|6:18-U1.000|6:01-U1.000|6:10-U1.000|5:17-U1.000|5:04-U1.000|6:07-U1.000|4:29-U0.497|3:34,,"Balve Running",,,3113,,250,3,16868660879,0,168070,250480,30378,11018282,83858145,440,5,3,27,19,0,0.05,2.02,0.66,0.37,1.42,23,10,77,2.1,177,1,5.78,1,114,1,,,,,,,,,,,,,,,,,,,"5,5",
105488284,c07bb848-a7a1-4883-b05d-89eb4d00e81b,1724783639,120,1724798899,,0,0,4.73,1474,1983,28,32,35,40,0,0,0.04,0.9,0.7,,319,149,169,,169,50,52.21,36.5,52.54,1,59.34,1626,113,,2.7,2.3,103,101,,370,,9,3,38,77,11.56,12.27,12.29,14.1,-5.4,291,291,,1,315,315,,,,,,,,,"24,4,1,2,39,23,1,1,4","0,22,70,7,0","6,14,11,64,5",,,,,125,,,,,,,,,,,,,,,33,,,,,,,,,,,,,,,,,,,,,33.7,23,5,117,58,24,1019,0,,0,2,4,Westick,1,0,U1.000|4:41-U1.000|4:40-U1.000|4:30-U0.594|2:32-U0.206|1:49-U0.929|6:22,,"Fröndenberg/Ruhr Running",,,3113,,250,3,16879134366,0,168070,250480,30378,11027072,83960081,393,8,7,34,15,0.34,0.48,1.44,0.82,0.5,1.41,41,0,56,1.9,333,0,12.46,0,152,0,,,,,,,,,,,,,,,,,,,,
105488307,822fa867-277b-49f7-96ee-465402c28e83,1724785724,120,1724798936,,0,0,9.45,3234,3234,0,0,0,0,0,0,0,,,,639,148,177,,164,58,46.95,34.13,46.95,1,59.38,3514,184,,3.3,2.7,104,103,,772,,,,87,77,10.52,12.59,12.59,10.2,6.4,266,266,,1,333,333,,,,,,,,,"46,4,2,1,2,10,29,6,0","0,42,16,43,0","19,22,12,17,29",,,,,114,,,,,,,,,,,,,,,33,,,,,,,,,,,,,,,,,,,,,53.6,23,3,108,62,14,1019,0,,0,2,4,Westick,1,0,U1.400|5:48-U0.600|2:12-U0.400|4:15-U0.600|2:21-U0.200|1:29-U0.600|2:20-U0.200|1:59-U0.600|2:19-U0.400|4:48-U0.300|1:08-U0.200|1:49-U0.300|1:09-U0.200|1:42-U0.290|1:09-U0.200|1:45-U0.300|1:09-U0.200|1:50-U0.300|1:07-U0.200|1:58-U0.300|1:08-U0.410|5:03-U0.800|3:19-U0.400|1:30-U0.050|0:40,,"Fröndenberg/Ruhr Track Running",,,3113,,250,3,16879137984,0,168070,250480,30378,11027073,83960102,397,10,9,60,26,0.16,0.63,0.01,0.83,0.21,1.66,54,23,73,0.5,354,0,12.16,0,154,0,,,,,,,,,,,,,,,,,,,,
105488309,cb7b289c-51d8-4619-9832-cc8cc25b0a80,1724789207,120,1724798942,,0,0,1.14,388,388,9,0,12,3,0,0,0.18,0.96,,,78,137,148,,148,11,52.36,29.02,53.38,1,59.38,3506,14,,0.9,0,,100,,74,,7,3,7,78,10.84,10.63,10.93,2.7,3.9,269,269,,1,272,272,,,,,,,,,"7,8,48,29,8,0,0,0,0","0,92,8,0,0","0,1,91,8,0",,,,,113,,,,,,,,,,,,,,,29,,,,,,,,,,,,,,,,,,,,,9.1,23,3,108,62,14,1019,0,,0,2,4,Westick,1,0,U1.000|5:38-U0.139|0:49,,"Fröndenberg/Ruhr Running",,,3113,,250,3,16879138521,0,168070,250480,30378,11027074,83960104,429,9,8,11,0,0.34,0.34,0,0.67,0.59,0.82,10,0,95,0,369,0,25.01,0,139,0,,,,,,,,,,,,,,,,,,,,
105619579,7c283880-34d3-448d-8812-ce8839de204f,1724915930,120,1724916391,,0,0,21.33,7009,7320,514,499,545,529,0,4.5,0.78,1.01,1.08,499,1457,147,168,,165,29,49.83,38.15,51.36,1,59.35,2176,163,,3.7,0,101,97,,1595,,13,4,169,79,11.51,11.37,11.75,0.4,2.4,274,274,,1,285,285,,,,,,,,,"17,16,17,15,23,12,0,0,0","0,26,69,5,0","1,3,69,26,0",,,,,116,,,,,,,,,,,,,,,,,,,,,,,,,,,,,,,,,,,,39.7,19,8,170,81,3,1016,0,,0,2,4,Balve,1,0,U1.000|4:53-U1.000|4:54-U1.000|6:43-U1.000|6:10-U1.000|5:52-U1.000|6:05-U1.000|6:28-U1.000|4:54-U1.000|5:38-U1.000|5:06-U1.000|4:49-U1.000|6:04-U1.000|5:18-U1.000|5:18-U1.000|7:38-U1.000|5:03-U1.000|4:36-U1.000|4:29-U1.000|4:39-U1.000|4:46-U1.000|5:25-U0.328|2:01,,"Balve Running",,,3113,,250,3,16890360462,0,168070,250480,30378,,84076219,,,,,,,,,,,,,,,,,,,,,,,,,,,,,,,,,,,,,,,,"4,4,5,5",
105713419,2aa93043-82ce-454f-9511-c8004f8d5613,1725002514,120,1725000322,,0,0,13.57,4751,4751,294,301,309,316,0,3.3,0.73,0.96,1,410,930,140,156,,151,19,49.18,34.17,50.46,1,59.29,1320,88,,3,0,97,96,,846,,13,1,103,79,10.72,10.56,10.79,-4.3,2.8,251,251,,1,256,256,,,,,,,,,"32,12,16,23,17,1,0,0,0","0,46,54,0,0","0,9,89,2,0",,,,,108,,,,,,,,,,,,,,,,,,,,,,,,,,,,,,,,,,,,28.3,16,8,29,90,98,1022,0,,0,4,4,Balve,1,0,U1.000|5:47-U1.000|5:29-U1.000|7:02-U1.000|6:47-U1.000|6:35-U1.000|6:51-U1.000|5:32-U1.000|5:15-U1.000|5:06-U1.000|4:59-U1.000|4:53-U1.000|6:01-U1.000|5:54-U0.571|3:01,,"Balve Running",,,3113,,250,3,16898702944,0,168070,250480,30378,,84156585,,,,,,,,,,,,,,,,,,,,,,,,,,,,,,,,,,,,,,,,"4,5",
105819193,45bcfeb0-8743-464a-822c-ef6544ee1bbe,1725092935,120,1725090644,,0,0,13.83,4425,4683,368,348,390,372,0,4.2,0.83,1,1.12,466,960,151,172,,156,23,49.61,38.03,51.33,1,59.24,1484,134,,3.5,0,100,96,,880,,11,4,137,80,12.09,12.02,12.33,-15.1,-9.3,286,286,,1,296,296,,,,,,,,,"24,15,11,15,12,12,9,2,0","0,12,72,16,0","0,1,69,28,2",,,,,117,,,,,,,,,,,,,,,,,,,,,,,,,,,,,,,,,,,,55.9,16,8,59,85,59,1023,1,,0,3,4,Balve,1,0,U1.000|5:25-U1.000|5:27-U1.000|6:45-U1.000|6:36-U1.000|5:41-U1.000|6:08-U1.000|6:24-U1.000|5:28-U1.000|3:53-U1.000|3:52-U1.000|4:12-U1.000|4:12-U1.000|4:44-U0.833|4:56,,"Balve Running",,,3113,,250,3,16906894203,0,168070,250480,30378,,84252163,,,,,,,,,,,,,,,,,,,,,,,,,,,,,,,,,,,,,,,,"3,4",
105958982,26a8a0ff-812d-497d-9b51-7adc88e395ef,1725187403,120,1725200041,,0,0,1.62,517,762,7,1,13,7,0,0,0,1.06,,,112,144,156,94,154,10,53.12,32.49,53.64,1,59.22,477,26,,1.8,0,98,99,,127,,7,3,14,78,11.44,11.37,11.51,2.6,0.2,282,282,,1,285,285,,,,,,,,,"8,4,14,51,23,1,1,0,0","0,21,79,0,0","0,0,82,18,0",,,,,121,,,,,,,,,,,,,,,,,,,,,,,,,,,,,,,,,,,,26.2,24,7,127,67,33,1018,3,,0,2,4,,1,0,U1.000|5:26-U0.617|3:11,,"Balve Running",,,3113,,250,3,16919390934,0,168070,250480,30378,,84374476,,,,,,,,,,,,,,,,,,,,,,,,,,,,,,,,,,,,,,,,,
105959090,8b2e16a0-d55f-499f-83e6-26d882d04d53,1725188571,120,1725200079,,0,0,10.29,2622,2622,227,218,255,245,0,3,0.67,1,1.03,527,699,173,184,141,180,15,53.54,48.52,55.06,1,59.2,2750,226,,4.2,0.3,101,99,,728,,20,4,129,82,14.76,14.46,14.95,8,12.7,376,376,,1,386,386,,,,,,,,,"3,3,6,7,13,29,29,10,0","0,1,2,91,7","0,0,5,70,25",,,,,144,,,,,,,,,,,,,,,,,,,,,,,,,,,,,,,,,,,,113.9,25,8,124,63,39,1017,4,,0,3,4,,1,0,U1.000|4:25-U1.000|4:52-U1.000|3:41-U1.000|3:54-U1.000|4:02-U1.000|4:50-U1.000|4:26-U1.000|3:57-U1.000|4:45-U1.000|3:48-U0.285|1:04,,"Balve Running",,,3113,,250,3,16919396923,0,168070,250480,30378,,84374504,,,,,,,,,,,,,,,,,,,,,,,,,,,,,,,,,,,,,,,,"4,5,5",
105959101,6d63cb78-efbd-4379-bb3f-e0df4a650859,1725192314,120,1725200083,,0,0,0.88,367,367,20,9,20,8,0,0.2,0.31,1.19,0.82,,65,129,133,98,132,4,43.9,22.28,45.81,1,59.22,2734,8,,0.6,0,,100,,100,,7,3,7,77,9.03,8.64,9.39,16.7,24.3,216,216,,1,227,227,,,,,,,,,"69,22,10,0,0,0,0,0,0","0,100,0,0,0","0,37,61,2,0",,,,,93,,,,,,,,,,,,,,,,,,,,,,,,,,,,,,,,,,,,10.3,27,7,125,61,55,1017,4,,0,3,4,Mellen,1,0,,,"Balve Running",,,3113,,250,3,16919397729,0,168070,250480,30378,,84374509,,,,,,,,,,,,,,,,,,,,,,,,,,,,,,,,,,,,,,,,,
106026571,515a89eb-280e-4ba4-8c4d-3c2d4d502590,1725261424,120,1725261716,,0,0,20.19,6980,7202,517,501,543,530,0,5.1,0.82,0.94,1.1,536,1372,138,157,,144,35,50.89,35.79,52.55,1,59.19,2320,128,,3.4,0,101,96,,1333,,13,1,162,79,11.22,11.12,11.26,-3.2,0.6,261,261,,1,266,266,,,,,,,,,"33,11,10,13,20,13,0,0,0","0,54,46,0,0","0,5,85,10,0",,,,,110,,,,,,,,,,,,,,,,,,,,,,,,,,,,,,,,,,,,31.7,19,5,174,84,4,1013,0,,0,2,4,Balve,1,0,U1.000|5:26-U1.000|5:26-U1.000|6:44-U1.000|6:27-U1.000|6:22-U1.000|6:10-U1.000|5:14-U1.000|4:38-U1.000|4:38-U1.000|9:07-U1.000|7:28-U1.000|5:18-U1.000|4:58-U1.000|7:38-U1.000|5:25-U1.000|4:35-U1.000|4:31-U1.000|4:30-U1.000|4:36-U1.000|5:59-U0.190|1:09,,"Balve Running",,,3113,,250,3,16924655543,0,168070,250480,30378,,84433641,,,,,,,,,,,,,,,,,,,,,,,,,,,,,,,,,,,,,,,,"3,4,4",
106185002,e722295e-af9a-4f7b-8e0e-3c556f13b662,1725388298,120,1725385114,,0,0,5.03,1515,1979,28,34,30,35,0,0,0.12,1.12,0.56,,330,143,163,,151,32,57.58,38.14,57.89,1,59.25,932,87,,2.6,1.5,101,104,,370,,7,3,41,78,11.88,12.49,12.67,11,-4.2,301,301,,1,324,324,,,,,,,,,"14,0,2,11,47,20,1,3,1","1,24,73,1,0","7,3,13,73,4",,,,,128,,,,,,,,,,,,,,,,,,,,,,,,,,,,,,,,,,,,37.6,24,6,254,73,56,1014,0,,0,3,4,Westick,1,0,U1.000|4:57-U1.000|4:38-U1.000|4:28-U1.000|4:40-U0.209|1:04-U0.094|0:19-U0.038|0:21-U0.103|0:19-U0.026|0:17-U0.100|0:19-U0.029|0:18-U0.094|0:21-U0.028|0:16-U0.096|0:21-U0.211|2:37,,"Fröndenberg/Ruhr Running",,,3113,,250,3,16938475683,0,168070,250480,30378,,84571236,,,,,,,,,,,,,,,,,,,,,,,,,,,,,,,,,,,,,,,,,
106189390,e6ba432c-5901-4de2-8376-5a6470b138c0,1725392523,120,1725386611,,0,0,2.73,979,979,34,24,38,29,0,0.7,0.37,1.29,0.94,871,192,136,144,,143,9,49.55,29.8,50.54,1,59.26,2829,26,,1.8,0,95,100,,227,,7,3,21,79,10.24,10.12,10.8,8.2,19.6,250,250,,1,267,267,,,,,,,,,"17,30,35,16,3,0,0,0,0","0,88,12,0,0","0,7,80,8,5",,,,,106,,,,,,,,,,,,,,,,,,,,,,,,,,,,,,,,,,,,21.1,22,6,282,78,50,1015,0,,0,3,4,Westick,1,0,U1.000|6:00-U1.000|5:45-U0.734|4:34,,"Fröndenberg/Ruhr Running",,,3113,,250,3,16938790477,0,168070,250480,30378,,84575173,,,,,,,,,,,,,,,,,,,,,,,,,,,,,,,,,,,,,,,,5,
106248117,,1725390360,120,1725439601,1725439645,0,0,5.87,2138,2138,,,,,0,,,,,,419,,,,,,,30.69,,1,,,,,,,,,,,,,,55,,,,,,,,,,,,,,,,,,,,,,,,,,,,,,,,,,,,,,,,,,,,,,,,,,,,,,,,,,,,,,,,,,,,,,,,,,1,,,0,0,,,"Fröndenberg Track 3x1000 2x 500",,"Aerobic TE: 3.2
Anaerobic TE: 3.1
Load 206
",connect,,,3,16943494705,0,168070,250480,30378,,84625649,,,,,,,,,,,,,,,,,,,,,,,,,,,,,,,,,,,,,,,,,
106302815,dc8e2962-6cc9-4676-9aa2-a0d5d20d34c7,1725475143,120,1725473620,,0,0,15.34,4780,4949,404,415,416,426,0,4.8,0.83,0.94,1.07,686,1044,142,169,,155,34,55.73,39.55,57.5,1,59.26,2310,138,,3.5,0,100,99,,860,,11,4,120,80,12.31,12.09,12.66,0.2,7.8,297,297,,1,309,309,,,,,,,,,"20,11,10,10,18,28,4,0,0","1,46,46,7,0","1,2,48,45,4",,,,,120,,,,,,,,,,,,,,,,,,,,,,,,,,,,,,,,,,,,47,18,6,345,89,98,1015,0,,0,4,4,Helle,1,0,U1.000|6:35-U0.054|0:21-U1.000|6:14-U1.000|5:47-U1.000|4:39-U1.000|4:19-U1.000|4:32-U0.821|3:48-U1.000|6:21-U1.000|6:00-U1.000|5:23-U1.000|4:31-U1.000|4:23-U1.000|4:24-U1.000|4:24-U1.000|4:46-U0.464|3:12,,"Balve Running",,,3113,,250,3,16948178581,0,168070,250480,30378,,84675140,,,,,,,,,,,,,,,,,,,,,,,,,,,,,,,,,,,,,,,,"4,4",
106377326,275552de-e481-4461-9e7f-0d00bf4d4f98,1725542950,120,1725540230,,0,0,13.63,4309,4398,303,285,339,325,0,3.8,0.75,1.01,1.06,473,942,152,169,,146,23,49.89,38.53,51.34,1,59.24,2030,138,,3.4,0,102,97,,1176,,15,4,133,79,11.96,11.76,12.09,0.3,7.8,287,287,,1,293,293,,,,,,,,,"17,12,13,16,22,18,2,0,0","0,15,64,20,0","0,3,57,40,0",,,,,120,,,,,,,,,,,,,,,,,,,,,,,,,,,,,,,,,,,,58.8,28,16,75,56,33,1008,5,,0,2,4,Balve,1,0,U1.000|4:56-U1.000|5:08-U1.000|6:16-U1.000|6:04-U1.000|5:54-U1.000|6:21-U1.000|5:01-U1.000|4:24-U1.000|4:36-U1.000|4:36-U1.000|4:24-U1.000|5:25-U1.000|5:43-U0.633|3:02,,"Balve Running",,,3113,,250,3,16954217703,0,168070,250480,30378,,84738473,,,,,,,,,,,,,,,,,,,,,,,,,,,,,,,,,,,,,,,,"4,5",
106528256,6a875cca-9b64-4b89-894c-6f0b05f895ed,1725643336,120,1725639820,,0,0,11.7,3616,3616,278,272,289,283,0,3.3,0.79,0.98,1.11,471,785,150,165,,152,15,52.26,39.09,53.83,1,59.2,1414,123,102,3.3,0,102,98,,1004,,,,106,79,12.34,12.37,12.39,-8.4,0.1,338,338,,0,341,341,,,,,86,76,86,76,"18,16,15,12,8,17,14,0,0","1,11,86,2,0","0,0,12,85,3",,,,,123,272,,103,84,,,,,,,,,,,,,,,,,,,,,,,,,,,,,,,,47,23,8,148,71,63,1012,1,,0,4,4,Balve,1,0,U1.000|5:08-U1.000|5:10-U1.000|6:28-U1.000|6:10-U1.000|6:09-U1.000|6:03-U1.000|4:21-U1.000|4:04-U1.000|4:10-U1.000|3:59-U1.000|4:09-U0.697|4:26,,"Balve Running",,,4375,,657,3,16964520440,0,168070,250480,30378,,84865621,,,,,,,,,,,,,,,,,,,,,,,,,,,,,,,,,,,,,,,,4,
106583222,c4885b3d-6f1a-493b-b641-8e25f9fa1723,1725699903,120,1725700132,,0,0,21.01,7180,7180,560,557,588,587,0,5.2,0.77,0.96,1.1,566,1452,143,162,,147,39,49.27,36.39,50.91,1,59.16,1750,153,103,3.6,0,103,96,,1994,,13,3,178,78,11.35,11.26,11.49,4.8,5,323,316,,0,326,323,,,,,86,74,86,74,"31,12,8,12,22,13,2,0,0","0,38,62,0,0","2,0,24,73,1",,,,,113,276,,98,87,,,,,,,,,,,,,,,,,,,,,,,,,,,,,,,,38.2,19,4,142,79,73,1013,2,,0,4,4,Balve,1,0,U1.000|4:22-U1.000|5:01-U1.000|5:42-U1.000|6:18-U1.000|7:13-U1.000|5:42-U1.000|4:55-U1.000|4:42-U1.000|5:41-U1.000|6:44-U1.000|7:52-U1.000|5:38-U1.000|6:03-U1.000|8:19-U1.000|6:38-U1.000|4:48-U1.000|4:29-U1.000|4:25-U1.000|4:29-U1.000|4:38-U1.000|5:57-U0.013|0:04,,"Balve Running",,,4375,,657,3,16969572280,0,168070,250480,30378,,84910572,,,,,,,,,,,,,,,,,,,,,,,,,,,,,,,,,,,,,,,,"4,4,4,5",
106709572,de8c1c76-867f-4687-a218-e3ed9c8ce2b1,1725793606,120,1725792595,,0,0,14.23,4646,5193,301,297,317,310,0,3.3,0.67,0.92,1.06,405,925,138,168,,168,42,54.61,37.23,56.05,1,59.16,1164,92,98,3,0,98,100,,1290,,13,3,112,79,11.6,12.02,11.97,-8.1,-3.5,329,328,,0,339,338,,,,,91,82,92,83,"36,10,11,7,13,8,13,1,0","2,64,22,12,0","1,0,24,61,14",,,,,116,274,,98,84,,,,,,,,,,,,,,,,,,,,,,,,,,,,,,,,59.9,20,10,228,80,71,1011,3,,0,4,4,Balve,1,0,U1.000|5:18-U1.000|5:41-U1.000|7:08-U1.000|6:55-U1.000|6:40-U1.000|6:23-U1.000|5:20-U1.000|4:32-U1.000|4:30-U0.796|3:30-U1.000|3:39-U1.000|3:48-U1.000|3:49-U1.000|7:24-U0.437|2:49,,"Balve Running",,,4375,,657,3,16979604203,0,168070,250480,30378,,85023129,,,,,,,,,,,,,,,,,,,,,,,,,,,,,,,,,,,,,,,,"4,5",
106858608,4c1927c2-8b00-4b5c-a94a-7e12424a5a3e,1725884699,120,1725881889,,0,0,12.21,4306,4336,303,298,315,309,0,3.5,0.83,1.03,1.11,504,810,131,158,,140,23,52.99,33.59,54.65,1,59.03,1070,72,100,2.7,0,100,94,,1188,,9,1,86,78,10.76,10.55,10.87,-5.6,-4.9,308,306,,0,315,313,,,,,93,83,93,86,"34,12,10,28,15,2,0,0,0","1,94,5,0,0","1,1,39,57,2",,,,,109,284,,98,90,,,,,,,,,,,,,,,,,,,,,,,,,,,,,,,,24.9,18,7,239,72,62,1003,3,,0,3,4,Balve,1,0,U1.000|5:27-U1.000|5:43-U1.000|7:19-U1.000|6:58-U1.000|6:38-U1.000|6:27-U1.000|5:32-U1.000|5:11-U1.000|5:06-U1.000|4:59-U1.000|5:08-U1.000|5:56-U0.212|1:23,,"Balve Running",,,4375,,657,3,16988395660,0,168070,250480,30378,,85153528,,,,,,,,,,,,,,,,,,,,,,,,,,,,,,,,,,,,,,,,"4,5",
107024436,c07e1b5b-1014-422d-a529-2fde7191d812,1725993367,120,1725993300,,0,0,5.89,2134,2134,0,0,6,7,0,0,0.01,0.15,,,401,135,160,,152,43,49.39,30.89,49.39,1,59.15,1278,103,102,2.7,2,102,104,,491,,7,3,50,65,10.08,11.78,11.78,26.2,-2.6,340,282,,0,362,344,,,,,87,48,92,84,"29,3,6,12,27,20,1,1,2","11,34,55,0,0","22,4,12,47,15",,,,,127,261,,99,78,,,,,,,,,,,,,,,,,,,,,,,,,,,,,,,,39,16,22,217,70,97,1008,0,,0,4,4,Westick,1,0,U1.000|5:04-U1.000|4:21-U1.000|4:32-U1.000|4:38-U0.413|8:03-U1.000|5:03-U0.474|3:54,,"Fröndenberg/Ruhr Running",,,4375,,657,3,17000697059,0,168070,250480,30378,,85301148,,,,,,,,,,,,,,,,,,,,,,,,,,,,,,,,,,,,,,,,,
107024443,d8769c49-ea22-41b9-8dc9-555b4b884de1,1725995610,120,1725993303,,0,0,8.22,2325,2325,0,1,0,1,0,0,0,,,,515,151,199,,198,66,57.76,42.31,57.75,1,59.38,3312,205,105,3.3,2.9,105,97,,621,,,,79,78,12.73,14.98,14.98,16.6,-2.5,369,355,,0,427,421,,,,,30,1,63,52,"37,2,1,0,1,1,21,33,4","0,37,25,35,2","16,9,14,3,59",,,,,136,227,,91,67,,,,,,,,,,,,,,,,,,,,,,,,,,,,,,,,91,16,22,217,70,97,1008,0,,0,4,4,Westick,1,0,U0.990|3:30-U1.010|3:30-U0.990|3:29-U0.410|3:33-U1.000|3:27-U0.600|2:14-U0.530|4:59-U1.010|3:15-U0.420|4:03-U0.500|1:36-U0.140|1:45-U0.510|1:31-U0.110|1:53,,"Fröndenberg/Ruhr Track Running",,,4375,,657,3,17000698310,0,168070,250480,30378,,85301155,,,,,,,,,,,,,,,,,,,,,,,,,,,,,,,,,,,,,,,,,
107024451,9a838763-0e32-4a27-8b15-2bcc75a137a9,1725998250,120,1725993306,,0,0,2.82,1065,1302,0,1,7,8,0,0,0,,,,201,134,143,101,139,13,47.36,28.08,47.34,1,59.37,3287,25,95,1.7,0,95,95,,285,,7,3,23,78,9.53,9.64,9.63,4.4,9.3,279,276,,0,282,281,,,,,50,49,50,49,"25,42,32,1,0,0,0,0,0","0,96,4,0,0","1,1,80,18,0",,,,,102,286,,94,92,,,,,,,,,,,,,,,,,,,,,,,,,,,,,,,,20.4,16,25,214,73,97,1007,0,,1,11,4,Westick,1,0,U1.000|6:09-U1.000|6:06-U0.824|5:31,,"Fröndenberg/Ruhr Running",,,4375,,657,3,17000699308,0,168070,250480,30378,,85301163,,,,,,,,,,,,,,,,,,,,,,,,,,,,,,,,,,,,,,,,,
107120770,c70aeb4b-3ec4-4d2b-bdf3-bd874290ed0b,1726057845,120,1726055284,,0,0,13.57,4364,4364,312,310,329,326,0,3.5,0.79,0.97,1.04,454,922,139,153,,142,21,55.12,37.75,56.7,1,59.36,2243,100,100,3.1,0,100,98,,1208,,11,3,99,79,11.75,11.59,11.81,-8.1,4.2,348,347,,0,353,352,,,,,86,79,86,79,"18,18,10,14,19,20,0,0,0","0,49,51,0,0","0,1,14,77,8",,,,,118,274,,101,86,,,,,,,,,,,,,,,,,,,,,,,,,,,,,,,,29.9,12,19,263,72,61,1006,3,,0,3,4,Balve,1,0,U1.000|5:19-U1.000|5:25-U1.000|6:41-U1.000|6:17-U1.000|6:16-U1.000|6:20-U1.000|5:15-U1.000|4:34-U1.000|4:25-U1.000|4:22-U1.000|4:26-U1.000|5:25-U1.000|5:16-U0.567|2:43,,"Balve Running",,,4375,,657,3,17006204385,0,168070,250480,30378,,85390465,,,,,,,,,,,,,,,,,,,,,,,,,,,,,,,,,,,,,,,,"4,5",
107257742,489d2d3e-69fb-4b15-b3ca-6f070e5dabe3,1726168736,120,1726166287,,0,0,11.74,4201,4518,284,285,294,292,0,3.4,0.84,1,1.08,423,755,122,143,,141,27,56.59,32.92,58.28,1,59.33,1063,64,98,2.6,0,98,96,,1071,,9,1,68,77,10.61,10.42,10.65,-8.2,-0.2,300,299,,0,303,302,,,,,93,87,93,87,"39,11,9,26,14,1,0,0,0","5,93,2,0,0","0,0,48,51,1",,,,,109,287,,98,90,,,,,,,,,,,,,,,,,,,,,,,,,,,,,,,,19.5,10,3,279,79,36,1015,0,,1,2,4,Balve,1,0,U1.000|5:20-U1.000|5:34-U1.000|7:04-U1.000|7:00-U1.000|6:53-U1.000|6:59-U1.000|5:36-U1.000|5:12-U1.000|5:11-U1.000|5:02-U1.000|5:04-U0.736|5:06,,"Balve Running",,,4375,,657,3,17018131927,0,168070,250480,30378,,85513844,,,,,,,,,,,,,,,,,,,,,,,,,,,,,,,,,,,,,,,,4,
107488678,9ab0eb0e-2266-495d-9a06-3f701a619372,1726390838,120,1726385377,,0,0,3.56,1229,1636,56,55,60,58,0,1.4,0.66,0.94,0.98,470,230,127,156,,136,13,56.47,31.76,57.59,1,59.33,584,28,100,2,0,100,100,,317,,7,3,22,79,10.77,10.85,10.97,16.5,14.6,306,303,,0,315,313,,,,,97,95,97,95,"28,11,22,9,25,5,0,0,0","3,87,10,0,0","1,0,49,45,4",,,,,110,276,,96,87,,,,,,,,,,,,,,,,,,,,,,,,,,,,,,,,17,9,5,292,85,25,1028,1,,0,2,4,Balve,1,0,U1.000|4:44-U1.000|5:31-U1.000|6:15-U0.564|3:58,,"Balve Running",,,4375,,657,3,17037304136,0,168070,250480,30378,,85721778,,,,,,,,,,,,,,,,,,,,,,,,,,,,,,,,,,,,,,,,5,
107587015,d4baae7b-153c-49f0-989d-d384f79e7bd3,1661450656,120,1726465213,,0,0,2.3,428,429,38,4,37,5,0,0.6,0.37,,,,85,,,,,,,,,1,58.99,0,,,,,,,,,,,,6,,,23.18,,,,102,102,,1,107,107,,,,,,,,,"43,19,6,9,22,0,0",,"54,46,0,0,0",,,,,,,,,,,,,,,,,,,,,,,,,,,,,,,,,,,,,,,,,,28,5,116,40,,1014,1,291,0,3,3,Balve,1,0,,,"Balve Cycling",,,Edge_130,,336,3,17045970780,0,168072,,30378,,85812053,,,,,,,,,,,,,,,,,,,,,,,,,,,,,,,,,,,,,,,,,
107587030,6f6ee334-7be9-4a13-b71b-25baba877cd1,1661453357,120,1726465220,,0,0,3.3,637,637,39,32,43,37,0,0.5,0.43,,,,104,,,,,,,,,1,58.99,0,,,,,,,,,,,,9,,,21.11,,,,98,70,,1,119,109,,,,,,,,,"36,17,32,10,5,0,0",,"71,29,0,0,0",,,,,,,,,,,,,,,,,,,,,,,,,,,,,,,,,,,,,,,,,,28,5,116,45,,1014,0,294,0,3,3,,1,0,,,"Balve Cycling",,,Edge_130,,336,3,17045971426,0,168072,,30378,,85812059,,,,,,,,,,,,,,,,,,,,,,,,,,,,,,,,,,,,,,,,,
107591448,da01742f-835f-4608-8345-4e911f64fb57,1726473569,120,1726470655,,0,0,15,4013,4204,20,21,38,37,0,0,0.05,,,,987,159,170,,164,14,57.43,47.13,57.52,1,59.35,2448,218,103,4.2,0.4,103,100,,1113,,13,4,150,81,13.47,13.5,13.53,3,1.5,378,376,,0,379,378,,,,,81,61,81,66,"1,1,1,2,31,63,2,0,0","0,2,45,53,0","0,0,2,88,9",,,,,138,251,,108,78,,,,,,,,,,,37,,,,,,,,,,,,,,,,,,,,,68.3,14,6,299,91,100,1024,,,0,4,1,"Bad Godesberg",1,0,U1.000|4:34-U1.000|4:27-U1.000|4:30-U1.000|4:25-U1.000|4:25-U1.000|4:20-U1.000|4:27-U1.000|4:40-U1.000|4:30-U1.000|4:28-U1.000|4:24-U1.000|4:14-U1.000|4:19-U1.000|4:21-U1.000|4:48-U0.003|0:02,,"Bonn Running",,,4375,,657,3,17046431828,0,168070,250480,30378,11202833,85815577,376,6,4,18,13,0.09,0.16,0.7,0.49,0.2,1.28,10,58,95,0.9,309,1,7.49,1,150,1,,,,,,,,,,,,,,,,,,,,
107603469,2d5e9de9-6a37-4120-b7aa-95c78b60e36d,1726487874,120,1726480744,,0,0,0.17,57,57,0,2,1,2,0,0,0,,,,6,99,108,,,,,,,1,59.35,2279,0,,,0,,100,,7,,,,0,,,10.04,,67.3,92.6,15,4,,1,17,12,,,,,79,79,79,79,"60,14,26,0,0,0,0","60,40,0,0,0","100,0,0,0,0",,,,,,,,,,,,,,,,,,,,,,,,,,,,,,,,,,,,,,,,,0.4,16,13,324,77,79,1024,3,,0,4,4,"Bad Godesberg",1,0,,,"Bonn Cycling",,,4375,,657,3,17047284646,0,168072,,30378,,85826117,,,,,,,,,,,,,,,,,,,,,,,,,,,,,,,,,,,,,,,,,
107751067,3fcea06a-5075-427e-9482-3b66740dd6eb,1726595078,120,1726590584,,0,0,11.45,2183,2356,30,36,72,81,0,0,0.04,0.85,,,368,132,152,,135,27,,,,1,59.35,816,41,,2.2,0,,100,,374,,,,43,,,21.73,,24.9,-12,53,47,,1,66,63,,,,,97,95,97,95,"26,7,36,28,4,0,0","1,87,13,0,0","90,10,0,0,0",,,,,,,,,,,,,,,,,,,,,,,,,,,,,,,,,,,,,,,,,21.1,22,15,26,63,11,1025,1,,0,2,4,"Bad Godesberg",1,0,U5.000|13:13-U4.036|12:35-U2.411|10:36,,"Bonn Cycling",,,4375,,657,3,17058966359,0,168072,,30378,,85954629,,,,,,,,,,,,,,,,,,,,,,,,,,,,,,,,,,,,,,,,,
107761099,511e15ce-fe35-45ff-b316-47b898ef5a5d,1726600631,120,1726596048,,0,0,0.42,132,132,0,0,0,0,0,0,0,,,,29,147,166,,160,3,52.64,28.81,52.64,1,59.38,1159,17,,0.6,0.6,,100,,36,,7,3,4,77,11.4,11.54,11.54,31.9,7.4,327,312,,0,328,326,,,,,85,81,88,86,"23,26,16,5,2,7,7,10,5","2,26,52,21,0","5,8,42,22,24",,,,,124,269,,96,77,,,,,,,,,,,31,,,,,,,,,,,,,,,,,,,,,10.6,20,12,27,71,6,1025,0,,0,2,4,Nordstadt,1,0,,,"Bonn Track Running",,,4375,,657,3,17060080015,0,168070,250480,30378,11214329,85963941,404,6,5,41,0,0.31,0.61,0.61,0.56,0.42,0.82,4,4,96,0.7,338,0,11.52,0,156,0,,,,,,,,,,,,,,,,,,,,
107761102,6351303f-008e-46ef-ac37-9aabcece660f,1726598106,120,1726596050,,0,0,5.2,1746,1930,14,21,21,28,0,0,0,,,,342,133,146,114,145,22,55.26,33.58,55.36,1,59.38,1164,45,100,2.3,0,100,100,,483,,7,3,36,74,10.72,11,10.99,5.9,2.5,316,303,,0,317,313,,,,,92,89,92,89,"9,3,21,56,11,0,0,0,0","1,78,21,0,0","4,1,20,73,2",,,,,121,281,,104,86,,,,,,,,,,,28,,,,,,,,,,,,,,,,,,,,,22.8,20,12,27,71,6,1025,0,,0,2,4,Nordstadt,1,0,U1.000|5:50-U1.000|5:20-U1.000|5:19-U1.000|6:29-U1.000|5:07-U0.200|1:02,,"Bonn Running",,,4375,,657,3,17060079339,0,168070,250480,30378,11214330,85963944,450,12,11,41,15,0.39,0.81,0.83,0.76,0.43,1.27,53,2,86,1.4,464,1,18.87,1,142,1,,,,,,,,,,,,,,,,,,,,
107761123,304bd5dc-4cf4-4a54-af2f-925089483dd0,1726600893,120,1726596059,1726645119,0,0,7.07,1924,1924,0,1,0,2,0,0,0,,,,500,169,186,,185,46,51.24,43.87,51.23,1,59.39,4297,303,100,3.8,3.5,100,100,,498,,16,4,89,77,13.24,14.37,14.36,14.8,4,399,373,,0,412,405,,,,,43,15,61,38,"23,5,5,7,6,3,21,31,0","0,3,23,57,18","7,0,20,19,54",,,,,143,239,,105,73,,,,,,,,,,,39,,,,,,,,,,,,,,,,,,,,,98.6,19,15,35,73,13,1025,0,,0,2,4,Nordstadt,1,0,U0.390|1:25-U0.200|1:00-U0.400|1:24-U0.200|1:08-U0.410|1:25-U0.190|1:04-U0.400|1:24-U0.200|1:07-U0.410|1:23-U0.200|1:06-U0.400|1:23-U0.200|1:12-U0.400|1:24-U0.200|1:15-U0.400|1:25-U0.200|1:20-U0.400|1:25-U0.190|1:13-U0.410|1:24-U0.200|1:13-U0.400|1:23-U0.200|1:29-U0.400|1:18-U0.070|2:14,,"12x (400m / 200m rest)",,,4375,,657,3,17060081807,0,168070,250480,30378,11214331,85963962,355,7,5,26,4,0.15,0.32,0.66,0.48,0.2,1.62,5,66,100,0.8,2009,0,,0,,0,,,,,,,,,,,,,,,,,,,,
107761127,3b1bc494-2230-4eb9-b81a-b662dddf1a5a,1726602862,120,1726596061,,0,0,0.73,275,275,0,4,0,4,0,0,0,,,,52,138,144,,144,6,45.77,24.56,45.46,1,59.37,4292,8,,0.5,0,,95,,73,,7,3,6,77,9.31,9.54,9.36,0.3,3.2,265,265,,0,266,266,,,,,36,35,37,36,"16,75,9,0,0,0,0,0,0","0,93,7,0,0","0,0,100,0,0",,,,,103,292,,96,93,,,,,,,,,,,32,,,,,,,,,,,,,,,,,,,,,12.4,19,15,35,73,13,1025,0,,1,2,4,Nordstadt,1,0,,,"Bonn Running",,,4375,,657,3,17060082514,0,168070,250480,30378,11214332,85963966,434,8,7,7,0,0.48,0.63,0.63,0.7,0.48,0.99,39,4,100,0.7,248,1,9.64,0,140,0,,,,,,,,,,,,,,,,,,,,
107768029,643b599c-625f-4239-88e9-ae1b1c4c7895,1726603746,120,1726598880,,0,0,11.58,2309,2309,16,9,34,28,0,0,0,,,,362,127,149,,145,33,,,,1,59.39,4245,31,,2,0,,100,,357,,,,41,,,20.6,,-17.8,-14,52,45,,1,64,61,,,,,35,34,35,34,"22,14,39,24,0,0,0","1,92,8,0,0","97,3,0,0,0",,,,,,,,,,,,,,,,,,,,28,,,,,,,,,,,,,,,,,,,,,18.2,18,12,34,76,25,1026,0,,1,2,4,Nordstadt,1,0,U5.000|16:33-U1.894|7:27-U0.020|0:02-U4.665|14:23-U0.000|0:03,,"Bonn Cycling",,,4375,,657,3,17060588442,0,168072,,30378,11215320,85968535,472,10,9,43,17,0.29,0.82,0.74,1.14,0.54,1.74,90,0,59,1.3,169,0,42,0,157,0,,,,,,,,,,,,,,,,,,,,
107834017,8d8e0295-3e5d-4e47-8c5e-79cc5c208eb8,1726666193,120,1726663921,,0,0,14.74,4712,4788,308,313,327,330,0,3.6,0.53,0.98,1.04,704,1019,150,168,,163,23,50.13,38.27,51.4,1,59.36,3184,142,99,3.5,0.1,99,97,,1308,,16,1,142,78,11.84,11.63,11.97,5.8,7.8,337,332,,0,342,339,,,,,79,66,79,70,"19,6,9,25,29,13,0,0,0","0,14,72,14,0","1,0,19,72,8",,,,,120,275,,103,86,,,,,,,,,,,,,,,,,,,,,,,,,,,,,,,,54.9,24,17,72,53,4,1024,4,,0,2,4,"Bad Godesberg",1,0,U1.000|6:16-U1.000|5:43-U1.000|5:14-U1.000|4:59-U1.000|4:52-U1.000|5:04-U1.000|4:53-U1.000|6:23-U1.000|6:10-U1.000|4:47-U1.000|4:33-U1.000|6:26-U1.000|4:50-U1.000|4:44-U0.741|3:37,,"Bonn Running",,,4375,,657,3,17066333553,0,168070,250480,30378,,86024771,,,,,,,,,,,,,,,,,,,,,,,,,,,,,,,,,,,,,,,,"4,4,4",
107916025,d08e66c8-9997-4377-9113-78f087ab763a,1726731804,120,1726729528,,0,0,14.57,4092,4376,30,27,44,43,0,0,0.06,,,,957,153,169,117,154,12,57.19,44.45,57.35,1,59.36,3171,170,102,3.7,0.1,102,100,,1136,,13,3,131,79,12.84,12.88,12.91,1.4,-0.7,361,359,,0,363,361,,,,,83,71,83,71,"0,0,2,11,60,25,2,0,0","0,6,79,14,0","1,0,2,91,7",,,,,135,262,,109,81,,,,,,,,,,,,,,,,,,,,,,,,,,,,,,,,55.8,14,4,55,90,0,1023,,,0,2,1,"Bad Godesberg",1,0,U1.000|4:45-U1.000|4:31-U1.000|4:47-U1.000|4:50-U1.000|4:49-U1.000|4:45-U1.000|4:32-U1.000|5:04-U1.000|4:34-U1.000|4:15-U1.000|4:27-U1.000|4:36-U1.000|4:36-U1.000|4:43-U0.566|2:57,,"Bonn Running",,,4375,,657,3,17072982800,0,168070,250480,30378,,86097897,,,,,,,,,,,,,,,,,,,,,,,,,,,,,,,,,,,,,,,,,
108015600,5de586bc-ab4d-43f6-a0f1-2a84819bfc20,1726817386,120,1726814919,,0,0,15.28,4407,4486,195,193,199,201,0,2.1,0.39,0.96,1,596,1008,150,162,117,154,21,56.91,43.26,57.82,1,59.4,2880,167,99,3.7,0,99,102,,1223,,13,4,131,80,12.86,12.78,12.96,-6.9,-3.4,361,360,,0,366,365,,,,,85,73,85,73,"6,9,7,8,33,30,7,0,0","0,14,84,1,0","0,0,7,80,13",,,,,130,262,,106,82,,,,,,,,,,,,,,,,,,,,,,,,,,,,,,,,46.6,12,7,101,88,0,1021,0,,0,2,4,"Bad Godesberg",1,0,U1.000|5:56-U1.000|5:29-U1.000|4:48-U1.000|6:13-U1.000|5:10-U1.000|4:46-U1.000|4:40-U1.000|4:35-U1.000|4:23-U1.000|4:29-U1.000|4:42-U1.000|4:01-U1.000|4:32-U1.000|4:13-U1.000|4:10-U0.276|1:19,,"Bonn Running",,,4375,,657,3,17081507675,0,168070,250480,30378,,86187579,,,,,,,,,,,,,,,,,,,,,,,,,,,,,,,,,,,,,,,,"4,4",
108188019,533683be-6870-4179-a096-9a20aa3e3f12,1726903560,120,1726903538,,0,0,20.02,6111,6181,194,188,210,203,0,1.5,0.28,0.96,1.02,535,1350,145,156,,146,17,55.59,41.39,56.28,1,59.43,2736,172,99,3.8,0,99,101,,1696,,13,4,163,79,12.06,11.97,12.1,-2.3,0,339,338,,0,341,340,,,,,84,68,84,72,"10,5,5,22,52,7,0,0,0","0,16,83,0,0","0,0,9,89,2",,,,,124,269,,104,84,,,,,,,,,,,,,,,,,,,,,,,,,,,,,,,,35.2,12,7,136,90,9,1021,0,,0,2,4,"Bad Godesberg",1,0,U1.000|6:07-U1.000|5:46-U1.000|4:54-U1.000|6:17-U1.000|5:54-U1.000|4:57-U1.000|4:54-U1.000|4:56-U1.000|4:55-U1.000|4:51-U1.000|4:51-U1.000|4:53-U1.000|4:54-U1.000|4:42-U1.000|4:59-U1.000|5:00-U1.000|4:26-U1.000|4:55-U1.000|4:47-U1.000|4:48-U0.016|0:07,,"Bonn Running",,,4375,,657,3,17089451298,0,168070,250480,30378,,86343644,,,,,,,,,,,,,,,,,,,,,,,,,,,,,,,,,,,,,,,,"4,4",
108289382,99cb7db0-62c1-446b-ab98-9e045b7fd772,1726990309,120,1726987639,,0,0,11.77,3748,3821,16,16,39,38,0,0,0.03,,,,768,135,162,,139,11,57.91,37.76,58.01,1,59.41,1466,94,98,3,0.4,98,100,,1033,,11,1,84,78,11.32,11.41,11.43,-2.4,-6,319,319,,0,323,323,,,,,92,66,92,85,"5,3,16,59,10,6,0,1,0","1,83,16,0,0","0,1,13,83,3",,,,,121,276,,104,86,,,,,,,,,,,,,,,,,,,,,,,,,,,,,,,,34.3,12,6,140,93,81,1017,0,,0,4,4,"Bad Godesberg",1,0,U1.000|5:44-U1.000|5:15-U1.000|5:25-U1.000|5:27-U1.000|5:22-U1.000|5:28-U1.000|5:08-U1.000|5:20-U1.000|5:11-U1.000|5:14-U1.000|4:26-U0.235|1:22-U0.087|0:18-U0.108|0:48-U0.082|0:16-U0.109|0:49-U0.085|0:16-U0.068|0:38,,"Bonn Running",,,4375,,657,3,17097896274,0,168070,250480,30378,,86436343,,,,,,,,,,,,,,,,,,,,,,,,,,,,,,,,,,,,,,,,,
108474075,f3c38993-c225-4a37-85ed-f578a9256de5,1727115983,120,1727113764,,0,0,14.01,4691,4887,251,249,255,253,0,3.6,0.45,0.96,1.04,669,950,136,164,,149,21,53.93,36.1,55.13,1,59.37,1313,107,97,3.2,0,97,100,,1302,,11,2,108,77,11.27,11.17,11.52,-3.1,-2.4,318,316,,0,323,321,,,,,90,82,90,82,"17,7,12,40,17,5,1,0,0","0,74,21,4,0","1,0,25,73,1",,,,,116,281,,101,87,,,,,,,,,,,,,,,,,,,,,,,,,,,,,,,,46.9,18,8,194,66,84,1008,0,,0,4,4,"Bad Godesberg",1,0,U1.000|5:45-U1.000|5:12-U1.000|5:13-U1.000|5:19-U1.000|5:18-U1.000|7:11-U1.000|6:37-U1.000|5:03-U1.000|5:51-U1.000|7:00-U0.002|0:01-U1.000|5:17-U1.000|4:39-U1.000|4:53-U1.000|4:51-U0.007|0:02,,"Bonn Running",,,4375,,657,3,17111844869,0,168070,250480,30378,,86598310,,,,,,,,,,,,,,,,,,,,,,,,,,,,,,,,,,,,,,,,"3,4",
108580918,4585de69-ed59-42bf-bf25-a5ca2e2c0f37,1727205466,120,1727200350,,0,0,3.12,1162,1162,0,1,14,15,0,0,0,,,,218,133,144,96,144,17,48.63,28.75,48.61,1,59.63,3069,25,96,1.7,0,96,96,,317,,7,3,23,78,9.67,9.73,9.73,-5.5,-4.9,273,273,,0,274,274,,,,,39,37,39,37,"25,39,30,5,1,0,0,0,0","0,95,5,0,0","0,0,92,8,0",,,,,103,290,,96,93,,,,,,,,,,,28,,,,,,,,,,,,,,,,,,,,,18.8,16,12,215,80,95,1004,0,,1,4,4,Nordstadt,1,0,U1.000|6:34-U1.000|6:07-U1.000|5:55-U0.120|0:46,,"Bonn Running",,,4375,,657,3,17120619398,0,168070,250480,30378,11292942,86695183,452,13,13,18,3,0.16,0.24,0.86,0.6,0.36,0.83,4,19,97,1,196,0,8.29,0,170,0,,,,,,,,,,,,,,,,,,,,
108592286,0135c30a-5a9c-4c05-83ca-2e48b9f28600,1727200651,120,1727206658,,0,0,5.24,1563,2262,9,13,21,21,0,0,0,,,,355,150,171,,163,39,54.6,38.68,54.66,1,59.47,1106,104,102,2.9,1.6,102,102,,397,,7,3,48,74,12.06,12.89,12.89,12,-0.7,355,335,,0,371,363,,,,,83,32,90,81,"17,1,2,10,24,31,8,4,2","0,13,72,15,0","9,8,3,56,25",,,,,136,256,,104,76,,,,,,,,,,,,,,,,,,,,,,,,,,,,,,,,51.1,16,16,217,78,81,1003,0,,0,4,4,Nordstadt,1,0,U1.000|4:44-U1.000|4:41-U1.000|4:30-U1.000|4:02-U0.213|1:11-U0.102|0:18-U0.057|0:30-U0.105|0:20-U0.045|0:23-U0.105|0:19-U0.039|0:21-U0.108|0:21-U0.035|0:20-U0.098|0:19-U0.043|0:21-U0.099|0:19-U0.195|3:04,,"Bonn Running",,,4375,,657,3,17121551555,0,168070,250480,30378,,86705570,,,,,,,,,,,,,,,,,,,,,,,,,,,,,,,,,,,,,,,,,
108592289,73510ddd-2fb9-4039-98e1-754d3c6bf1d0,1727202980,120,1727206665,,0,0,7.71,2142,2142,0,0,0,0,0,0,0,,,,513,161,181,110,159,62,53.81,43.04,53.81,1,59.65,3104,254,105,3.5,3.2,105,103,,557,,19,3,88,74,12.96,14.9,14.9,20.1,5.7,393,354,,0,422,410,,,,,22,1,56,41,"28,2,3,1,1,2,35,28,2","0,24,9,67,0","16,4,12,2,66",,,,,146,223,,99,68,,,,,,,,,,,37,,,,,,,,,,,,,,,,,,,,,93.6,16,13,214,78,93,1003,0,,0,4,4,Nordstadt,1,0,U1.000|3:31-U0.600|2:08-U0.400|1:22-U0.400|3:17-U1.000|3:29-U0.600|2:10-U0.400|1:25-U0.420|3:48-U1.000|3:34-U0.600|2:14-U0.400|1:26-U0.060|1:24-U0.100|0:20-U0.040|0:20-U0.100|0:19-U0.030|0:21-U0.100|0:19-U0.030|0:21-U0.100|0:19-U0.040|0:26-U0.100|0:19-U0.030|0:22-U0.100|0:19-U0.060|2:09,,"Bonn Track Running",,,4375,,657,3,17121552566,0,168070,250480,30378,11293763,86705573,372,7,6,51,22,0.23,0.9,0.92,0.44,0.2,1.09,19,67,78,1.5,,0,,0,,0,,,,,,,,,,,,,,,,,,,,
108594012,231dbdbe-a67f-4e8d-8f98-bed18f24224b,1727197944,120,1727209202,,0,0,11.54,1850,2211,17,26,19,28,0,0,0.01,,,,303,,,,,,,,,1,59.4,0,,,,,,,,,,,,27,,,23.82,,,,65,61,,1,76,74,,,,,,,,,"16,13,22,39,9,1,0",,"87,13,0,0,0",,,,,,,,,,,,,,,,,,,,,,,,,,,,,,,,,,,,,,,,,,17,14,219,75,85,1003,1,,0,4,4,"Bad Godesberg",1,0,,,"Bonn Cycling",,,Edge_130,,336,3,17121795824,0,168072,,30378,,86707119,,,,,,,,,,,,,,,,,,,,,,,,,,,,,,,,,,,,,,,,,
108594022,9e716f31-efb0-4c83-9b31-a72e47bbf13c,1727207935,120,1727209225,,0,0,11.42,2141,2424,14,15,24,22,0,0,0,,,,256,,,,,,,,,1,59.4,0,,,,,,,,,,,,31,,,19.68,,,,43,40,,1,51,50,,,,,,,,,"12,36,48,3,0,0,0",,"100,0,0,0,0",,,,,,,,,,,,,,,,,,,,,,,,,,,,,,,,,,,,,,,,,,15,11,226,85,98,1004,0,,1,4,4,Nordstadt,1,0,,,"Bonn Cycling",,,Edge_130,,336,3,17121797993,0,168072,,30378,,86707130,,,,,,,,,,,,,,,,,,,,,,,,,,,,,,,,,,,,,,,,,
108631940,f6688be2-8455-4c13-a53f-695aa2cec6b0,1727256294,120,1727250826,,0,0,1.29,328,651,9,9,8,11,0,0,0.06,1.2,,,20,79,103,,78,16,,,,1,59.65,,1,,,0,,100,,34,,,,1,,,16.03,,37.7,21.1,39,29,,1,50,45,,,,,100,100,100,100,"42,36,19,3,0,0,0","95,5,0,0,0","100,0,0,0,0",,,,,,,,,,,,,,,,,,,,,,,,,,,,,,,,,,,,,,,,,1,14,11,170,90,100,1006,,,0,4,1,"Bad Godesberg",1,0,,,"Bonn Cycling",,,4375,,657,3,17124753486,0,168072,,30378,,86738928,,,,,,,,,,,,,,,,,,,,,,,,,,,,,,,,,,,,,,,,,
108680616,3b8e7b47-f85d-433b-95dd-4336a09e3344,1727288342,120,1727285995,,0,0,14.15,4594,4755,219,215,246,244,0,2.5,0.5,0.94,1.06,468,951,139,159,,153,24,54.48,37.46,55.54,1,59.58,1323,109,98,3.2,0,98,98,,1275,,13,1,108,77,11.54,11.55,11.68,-4.9,-1.1,330,324,,0,334,331,,,,,90,82,90,82,"17,10,15,24,18,12,3,0,0","2,50,49,0,0","2,1,14,81,2",,,,,120,275,,102,85,,,,,,,,,,,,,,,,,,,,,,,,,,,,,,,,33.3,16,12,183,84,98,1003,0,,0,4,4,"Bad Godesberg",1,0,U1.000|5:28-U1.000|5:13-U1.000|6:01-U1.000|6:23-U1.000|5:56-U1.000|6:14-U1.000|5:27-U1.000|4:43-U1.000|5:30-U1.000|5:50-U1.000|5:47-U1.000|4:20-U1.000|4:10-U1.000|4:45-U0.147|0:47,,"Bonn Running",,,4375,,657,3,17129167984,0,168070,250480,30378,,86781443,,,,,,,,,,,,,,,,,,,,,,,,,,,,,,,,,,,,,,,,"4,4",
108781371,282551a5-0936-46f3-9a24-6dcc47fa509b,1727373752,120,1727371477,,0,0,14.55,4124,4504,93,93,134,133,0,0,0.06,1,0.91,,945,154,178,,152,51,56.03,43.97,56.47,1,59.57,2164,210,97,4,1,97,101,,1145,,16,3,143,78,12.75,13.3,13.37,5.1,-0.4,358,353,,0,373,371,,,,,78,53,80,66,"5,6,16,18,8,22,24,1,0","1,24,28,48,0","2,1,26,35,37",,,,,136,260,,107,79,,,,,,,,,,,34,,,,,,,,,,,,,,,,,,,,,88,18,17,199,79,95,993,0,,0,4,4,"Bad Godesberg",1,0,U1.000|5:31-U1.000|4:57-U1.000|3:58-U1.000|4:03-U1.000|4:02-U1.000|4:00-U1.000|4:04-U1.000|6:44-U1.000|5:43-U1.000|3:48-U1.000|3:54-U1.000|4:00-U1.000|5:35-U1.000|5:10-U0.553|3:15,,"Bonn Running",,,4375,,657,3,17136922450,0,168070,250480,30378,11315659,86872139,389,23,22,54,37,1.37,2.33,2.53,0.53,0.21,1.33,11,47,83,4.2,,0,,0,86,0,,,,,,,,,,,,,,,,,,,,
108840386,030327f5-0414-4bf6-b2de-9ec192576dc9,1727438745,120,1727435662,,0,0,10.03,3921,4013,63,69,85,92,0,0,0.18,0.96,0.97,279,666,122,139,,138,27,50.74,29.27,51.1,1,59.56,1170,49,,2.3,0,96,96,,1015,,7,3,58,78,9.28,9.26,9.35,2.2,-1.5,260,259,,0,263,263,,,,,94,89,94,89,"41,47,11,1,0,0,0,0,0","1,99,0,0,0","1,3,89,7,0",,,,,98,291,,94,96,,,,,,,,,,,,,,,,,,,,,,,,,,,,,,,,14.9,15,24,220,67,69,999,3,,0,4,4,"Bad Godesberg",1,0,U1.000|6:09-U1.000|6:16-U1.000|6:34-U1.000|6:39-U1.000|6:44-U1.000|6:27-U1.000|6:23-U1.000|6:43-U1.000|6:58-U1.000|6:16-U0.031|0:12,,"Bonn Running",,,4375,,657,3,17141900922,0,168070,250480,30378,,86925653,,,,,,,,,,,,,,,,,,,,,,,,,,,,,,,,,,,,,,,,5,
108916474,1d22b5c8-fb5e-4fc7-b3fa-d52842c335b6,1727510537,120,1727508619,,0,0,14.07,4812,5087,382,381,398,395,0,4.1,0.85,0.95,1.09,403,999,146,159,,150,22,47.87,35.22,49.48,1,59.45,1350,114,96,3.2,0,96,97,,1309,,11,1,134,80,11.32,11.36,11.39,-14,-2.3,309,308,,0,312,312,,,,,89,81,89,81,"43,9,10,9,5,18,5,0,0","0,11,89,0,0","0,1,36,62,1",,,,,110,276,,97,88,,,,,,,,,,,,,,,,,,,,,,,,,,,,,,,,42.8,7,11,279,91,53,1016,0,,0,3,4,Balve,1,0,U1.000|5:41-U1.000|5:52-U1.000|7:09-U1.000|7:07-U1.000|6:57-U1.000|6:29-U1.000|6:49-U1.000|6:24-U1.000|4:44-U1.000|4:09-U1.000|4:08-U1.000|4:14-U1.000|4:16-U1.000|5:49-U0.069|0:23,,"Balve Running",,,4375,,657,3,17147863482,0,168070,250480,30378,,86990342,,,,,,,,,,,,,,,,,,,,,,,,,,,,,,,,,,,,,,,,3,
109046449,a5a3c014-1368-4cb3-ac7a-6c347cbc7c51,1727594382,120,1727624620,,0,0,15.53,5443,5498,327,327,346,349,0,3.5,0.62,0.97,1.07,520,1077,139,155,,149,25,49.57,34.5,50.86,1,59.31,1360,110,96,3.2,0,96,97,,1509,,11,1,129,80,10.78,10.72,10.83,-9.8,-5,300,299,,0,303,302,,,,,89,80,89,80,"32,16,15,17,12,8,0,0,0","0,54,46,0,0","0,1,48,50,0",,,,,107,278,,96,90,,,,,,,,,,,,,,,,,,,,,,,,,,,,,,,,36.6,4,5,170,97,50,1029,0,,0,3,4,Balve,1,0,U1.000|6:20-U1.000|5:21-U1.000|5:58-U1.000|6:02-U1.000|6:08-U1.000|6:34-U1.000|6:52-U1.000|7:54-U1.000|6:16-U1.000|4:52-U1.000|4:31-U1.000|4:24-U1.000|4:52-U1.000|6:02-U1.000|5:55-U0.533|2:43,,"Balve Running",,,4375,,657,3,17161055339,0,168070,250480,30378,,87109717,,,,,,,,,,,,,,,,,,,,,,,,,,,,,,,,,,,,,,,,"4,5",
109129864,90f504f9-f59b-4ec4-b44a-8754f53250e8,1727710496,120,1727708812,,0,0,19.3,4864,5283,26,27,33,35,0,0,0,,,,1174,154,164,,158,19,64.78,51.53,64.88,1,59.51,2736,243,104,4.4,0.1,104,103,,1350,,15,4,161,82,14.29,14.34,14.35,1.7,1.7,392,391,,0,394,392,,,,,77,61,77,61,"0,1,1,2,6,74,16,0,0","0,7,83,9,0","1,0,2,68,29",,,,,145,241,,107,74,,,,,,,,,,,,,,,,,,,,,,,,,,,,,,,,52.5,16,6,155,67,69,1017,1,,0,4,4,Milbertshofen,1,0,U1.000|4:18-U1.000|4:09-U1.000|4:08-U1.000|4:03-U1.000|4:06-U1.000|4:13-U1.000|4:13-U1.000|4:14-U1.000|4:17-U1.000|4:08-U1.000|4:08-U1.000|4:12-U1.000|4:11-U1.000|4:09-U1.000|4:12-U1.000|4:07-U1.000|4:11-U1.000|4:10-U1.000|4:16-U0.296|1:40,,"Munich Running",,,4375,,657,3,17167977876,0,168070,250480,30378,,87182981,,,,,,,,,,,,,,,,,,,,,,,,,,,,,,,,,,,,,,,,,
109230094,ec7b73e1-c9cd-4e96-b120-17482d84c007,1727789111,120,1727786379,,0,0,11.04,4036,4396,506,488,515,500,0,6.6,0.74,0.96,0.95,1059,826,146,169,,148,29,44.09,31.94,46.69,0,58.35,2160,123,98,3.3,0,98,101,,1104,,,,112,80,11.79,10.84,12.32,-3.5,-1.1,316,312,,0,334,331,,,,,87,80,87,80,"43,5,7,12,18,13,2,0,0","1,34,47,18,0","2,10,19,63,6",,,,,103,273,,90,87,,,,,,,,,,,,,,,,,,,,,,,,,,,,,,,,58.5,14,3,19,66,98,1014,3,,0,4,4,Mittenwald,1,0,U1.000|7:49-U1.000|7:31-U1.000|9:32-U1.000|6:53-U1.000|5:18-U1.000|4:51-U1.000|4:32-U1.000|5:12-U1.000|4:55-U1.000|4:53-U1.000|5:39-U0.036|0:10,,"Mittenwald Trail Running",,,4375,,657,3,17175367908,0,168070,250480,30378,,87274062,,,,,,,,,,,,,,,,,,,,,,,,,,,,,,,,,,,,,,,,0,
109243613,b2baa392-82a4-4774-a67f-b427d75ab904,1727797809,120,1727796693,,0,0,5.23,6026,6036,127,131,129,134,0,2.8,0.58,,,238,305,79,117,,111,39,,,,1,58.35,1989,4,,0.2,0,,100,,626,,,,23,37,,3.71,,-29.7,,,,,,,,,,,,,,,,"96,4,0,0,0,0","93,7,0,0,0",,3964,2,,,,,,,,,,,,,,,,,,,,,,,,,,,,,,,,,,,,,,,3.9,13,3,110,77,96,1013,1,,0,4,4,Mittenwald,1,0,,,"Mittenwald Hiking",,,4375,,657,3,17176637959,0,168075,,30378,,87285985,,,,,,,,,,,,,,,,,,,,,,,,,,,,,,,,,,,,,,,,4,
109312337,00ffe2fe-96c5-4b0b-bdee-98c140f4ca43,1727854432,120,1727855558,,0,0,13.17,7983,8158,790,783,826,822,0,7.9,0.86,0.94,0.8,678,1170,132,159,,155,30,26.76,17.32,28.82,0,57.33,1468,101,100,3.1,0,100,99,,1281,,,,165,58,7.75,7.84,9.03,-32.1,-18.3,234,183,,0,266,240,,,,,89,83,89,83,"78,4,6,6,4,1,0,0,0","5,53,43,0,0","34,14,29,23,1",,,,,85,295,,75,88,,,,,,,,,,,,,,,,,,,,,,,,,,,,,,,,42.1,8,4,190,89,99,1007,1,,0,6,4,Mittenwald,1,0,U1.000|6:58-U1.000|9:17-U1.000|11:21-U1.000|13:44-U1.000|17:33-U1.000|18:07-U1.000|16:40-U1.000|9:18-U1.000|6:00-U1.000|5:04-U1.000|5:46-U1.000|6:51-U1.000|5:29-U0.168|0:55,,"Mittenwald Trail Running",,,4375,,657,3,17182087911,0,168070,250480,30378,,87345439,,,,,,,,,,,,,,,,,,,,,,,,,,,,,,,,,,,,,,,,"0,4",
109432513,04dd621b-addd-4973-91c0-917275d23b85,1727953582,120,1727957203,,0,0,8,9462,10689,288,281,304,296,0,5,0.7,,,307,628,89,127,,127,52,,,,1,57.33,303,5,,0.3,0,,100,,1029,,,,52,38,,3.57,,8.8,,,,,,,,,,,,,,,,"95,4,0,0,0,0","84,16,0,0,0",,6457,2,,,,,,,,,,,,,,,,,,,,,,,,,,,,,,,,,,,,,,,4.6,9,6,18,79,98,1012,3,,0,4,4,Mittenwald,1,0,,,"Mittenwald Hiking",,,4375,,657,3,17191942510,0,168075,,30378,,87455473,,,,,,,,,,,,,,,,,,,,,,,,,,,,,,,,,,,,,,,,"3,4",
109642575,b7b6197d-3f07-4c93-af6d-4b07ba3bc91d,1728155189,120,1728148772,,0,0,1.68,656,656,8,8,8,7,0,0,0,,,,116,126,139,,122,19,48.96,25.84,49.25,1,58.79,120,18,,1.2,0,,100,,164,,13,,11,74,9.24,9.68,9.71,14.4,4.8,259,259,,0,274,274,,,,,98,97,98,97,"20,42,36,3,0,0,0,0,0","3,97,0,0,0","9,4,78,9,0",,,,,104,289,,93,89,,,,,,,,,,,,,,,,,,,,,,,,,,,,,,,,12.7,12,6,128,75,28,1016,0,,1,2,4,"Bad Godesberg",1,0,U1.000|6:00-U0.684|4:56,,"Bonn Running",,,4375,,657,3,17211106359,0,168070,250480,30378,,87644686,,,,,,,,,,,,,,,,,,,,,,,,,,,,,,,,,,,,,,,,,
109965902,6465a847-898d-489a-8a62-047d91dde2c0,1728413197,120,1728407883,,0,0,2.98,1167,1174,12,11,12,10,0,0,0,,,,205,126,136,103,135,14,48.79,26.99,49.05,1,58.79,480,23,,1.7,0,,100,,303,,7,1,18,77,9.22,9.26,9.3,4.4,2.1,261,261,,0,263,262,,,,,98,96,98,96,"45,47,7,0,1,0,0,0,0","1,99,0,0,0","0,1,96,3,0",,,,,99,294,,94,95,,,,,,,,,,,,,,,,,,,,,,,,,,,,,,,,12.5,16,10,172,77,93,1001,0,,1,4,4,"Bad Godesberg",1,0,U1.000|6:20-U1.000|6:36-U0.980|6:31,,"Bonn Running",,,4375,,657,3,17235727498,0,168070,250480,30378,,87933213,,,,,,,,,,,,,,,,,,,,,,,,,,,,,,,,,,,,,,,,,
110075745,a7b1125c-0d92-4248-8549-fa15a1a245d8,1728496520,120,1728491795,,0,0,3.73,1384,1406,11,14,13,16,0,0,0.11,,1.03,,251,132,155,,144,19,49.31,29.21,49.44,1,58.67,807,31,94,2,0,94,95,,375,,7,1,26,77,9.69,9.72,9.72,0.6,0.6,270,269,,0,271,270,,,,,97,95,97,95,"21,47,28,3,1,0,0,0,0","1,91,8,0,0","1,0,93,6,0",,,,,105,290,,97,92,,,,,,,,,,,28,,,,,,,,,,,,,,,,,,,,,16,16,19,157,86,98,987,0,,0,6,4,"Bad Godesberg",1,0,U1.000|5:54-U1.000|6:20-U1.000|6:14-U0.725|4:36,,"Bonn Running",,,4375,,657,3,17243723722,0,168070,250480,30378,11422359,88029097,473,52,51,97,25,1.55,2.48,4.7,0.74,0.43,1.19,44,2,75,6.8,243,0,9.15,0,126,0,,,,,,,,,,,,,,,,,,,,
110175043,03f37908-fbc5-4cc6-a3a9-a1f585ba6a1e,1728587493,120,1728585993,,0,0,6.02,2089,2225,23,23,25,25,0,0,0.07,,,,402,132,152,,152,14,53.56,32.57,53.81,1,58.61,1400,51,97,2.4,0,97,95,,579,,9,2,40,77,10.41,10.41,10.44,5.9,6.3,289,289,,0,291,290,,,,,95,91,95,91,"6,21,50,22,1,0,0,0,0","1,90,9,0,0","0,1,74,25,0",,,,,112,287,,102,91,,,,,,,,,,,,,,,,,,,,,,,,,,,,,,,,21.3,12,7,305,82,83,1006,0,,1,4,4,"Bad Godesberg",1,0,U1.000|5:47-U1.000|5:32-U1.000|6:05-U1.000|5:47-U1.000|5:40-U1.000|5:51-U0.018|0:06,,"Bonn Running",,,4375,,657,3,17252816043,0,168070,250480,30378,,88118137,,,,,,,,,,,,,,,,,,,,,,,,,,,,,,,,,,,,,,,,,
110237474,346ad0d6-1bde-4e32-8ad6-70c6662e1eb2,1728650575,120,1728645953,,0,0,5.93,1748,1792,17,16,26,25,0,0,0.14,,,,406,149,164,122,163,10,55.92,39.51,56.13,1,58.9,1503,104,104,3.2,0,104,100,,485,,7,2,50,80,12.26,12.26,12.31,6.8,6.1,340,339,,0,341,341,,,,,92,83,92,83,"1,2,3,23,66,5,0,0,0","1,11,84,4,0","0,0,3,94,2",,,,,127,266,,106,83,,,,,,,,,,,,,,,,,,,,,,,,,,,,,,,,42.2,12,5,294,71,42,1018,2,,0,3,4,"Bad Godesberg",1,0,U1.000|5:04-U1.000|4:43-U1.000|5:02-U1.000|4:47-U1.000|4:51-U0.933|4:40,,"Bonn Running",,,4375,,657,3,17257261183,0,168070,250480,30378,,88173987,,,,,,,,,,,,,,,,,,,,,,,,,,,,,,,,,,,,,,,,,
110434283,38a7468a-eb38-4b92-a5e1-2a88bd3775bb,1728810906,120,1728835016,,0,0,10.56,3034,3211,27,27,40,39,0,0,0.06,,,,716,156,168,123,162,12,54.08,42.25,54.25,1,58.77,2046,152,102,3.7,0,102,98,,841,,11,2,101,80,12.56,12.6,12.61,6,5.8,346,344,,0,347,346,,,,,85,75,85,75,"2,2,6,20,46,23,1,0,0","0,4,68,28,0","1,0,4,93,2",,,,,131,259,,105,80,,,,,,,,,,,,,,,,,,,,,,,,,,,,,,,,52.3,9,5,271,89,77,1019,1,,0,4,4,Paris,1,0,U1.000|4:38-U1.000|4:38-U1.000|4:33-U1.000|4:27-U1.000|4:39-U1.000|4:45-U1.000|4:47-U1.000|5:04-U1.000|5:02-U1.000|5:05-U0.560|2:56,,"Paris Running",,,4375,,657,3,17276476931,0,168070,250480,30378,,88350131,,,,,,,,,,,,,,,,,,,,,,,,,,,,,,,,,,,,,,,,,
110540047,edd5a46d-a1f3-4a80-9195-44e09af07064,1728929251,120,1728927425,,0,0,14.71,4363,4675,36,36,39,42,0,0,0.04,,,,991,152,164,,151,13,53.97,41.75,54.13,1,58.57,2146,165,102,3.8,0,102,97,,1211,,13,2,133,79,12.15,12.17,12.18,-2,-2.6,334,333,,0,335,334,,,,,84,73,84,73,"0,1,3,37,53,6,0,0,0","0,5,92,3,0","1,0,2,97,0",,,,,128,267,,106,83,,,,,,,,,,,,,,,,,,,,,,,,,,,,,,,,47.4,11,3,54,90,98,1017,0,,1,4,4,"Bad Godesberg",1,0,U1.000|5:02-U1.000|4:51-U1.000|5:00-U1.000|5:00-U1.000|5:05-U1.000|4:58-U1.000|5:02-U1.000|5:16-U1.000|4:56-U1.000|4:58-U1.000|4:41-U1.000|4:41-U1.000|4:44-U1.000|4:50-U0.712|3:39,,"Bonn Running",,,4375,,657,3,17284724191,0,168070,250480,30378,,88444949,,,,,,,,,,,,,,,,,,,,,,,,,,,,,,,,,,,,,,,,,
110644513,2490bcfb-72d0-4818-8e26-c4e90df0d98f,1729016961,120,1729013441,,0,0,11.38,3541,3561,16,11,31,25,0,0,0.02,,,,769,146,169,,150,12,53.79,38.7,53.91,1,58.35,1586,115,100,3.3,0,100,97,,983,,11,2,94,78,11.59,11.67,11.7,1,-0.9,326,325,,0,329,329,,,,,90,81,90,81,"1,1,17,58,15,7,1,0,0","0,14,78,8,0","0,0,6,92,2",,,,,124,275,,105,85,,,,,,,,,,,,,,,,,,,,,,,,,,,,,,,,49.8,13,14,125,82,94,1018,0,,1,4,4,Venusberg,1,0,U1.000|5:24-U1.000|5:10-U1.000|5:21-U1.000|5:20-U1.000|5:24-U1.000|5:19-U1.000|5:24-U1.000|5:20-U1.000|5:21-U1.000|4:19-U1.000|4:43-U0.377|1:57,,"Bonn Running",,,4375,,657,3,17293125607,0,168070,250480,30378,,88538618,,,,,,,,,,,,,,,,,,,,,,,,,,,,,,,,,,,,,,,,,
110722129,c026b312-a4cb-4371-8ff9-be4657ab0c3c,1729085569,120,1729084966,,0,0,14.67,4030,4356,19,22,35,39,0,0,0.04,,,,961,159,171,120,157,16,55.58,45.63,55.66,1,58.26,2790,222,100,4.3,0.5,100,99,,1119,,13,2,145,80,13.11,13.17,13.18,1.6,0.7,363,362,,0,365,364,,,,,78,63,78,63,"0,0,1,8,45,45,1,0,0","0,3,51,47,0","0,0,2,93,5",,,,,137,257,,109,80,,,,,,,,,,,37,,,,,,,,,,,,,,,,,,,,,69.2,19,16,132,72,94,1013,2,,0,4,4,"Bad Godesberg",1,0,U1.000|4:46-U1.000|4:21-U1.000|4:31-U1.000|4:31-U1.000|4:32-U1.000|4:31-U1.000|4:28-U1.000|4:38-U1.000|4:21-U1.000|4:16-U1.000|4:51-U1.000|4:40-U1.000|4:35-U1.000|4:32-U0.666|3:37,,"Bonn Running",,,4375,,657,3,17299524317,0,168070,250480,30378,11473377,88607054,378,31,30,42,15,1.36,1.94,1.82,0.49,0.25,1.48,3,58,86,2.9,,0,41.87,0,,0,,,,,,,,,,,,,,,,,,,,
110839079,880489f3-fd17-49a9-a2cf-7524bbcf858d,1729169476,120,1729167289,,0,0,14,4516,4697,215,216,233,235,0,2.2,0.43,0.95,1.05,540,954,144,165,101,161,20,52.42,37.71,53.41,1,58.15,2371,132,99,3.5,0,99,97,,1254,,13,2,121,79,11.57,11.38,11.61,-1.3,2,326,324,,0,329,328,,,,,86,78,86,78,"14,7,13,32,30,4,0,0,0","1,26,71,3,0","1,0,20,79,1",,,,,118,275,,102,86,,,,,,,,,,,,,,,,,,,,,,,,,,,,,,,,41.8,21,9,210,71,71,1013,2,,0,4,4,"Bad Godesberg",1,0,U1.000|5:15-U1.000|5:03-U1.000|5:54-U1.000|6:17-U1.000|5:45-U1.000|5:10-U1.000|5:24-U1.000|5:18-U1.000|4:44-U1.000|4:53-U1.000|6:25-U1.000|5:12-U1.000|4:51-U1.000|5:03-U0.002|0:01,,"Bonn Running",,,4375,,657,3,17307279223,0,168070,250480,30378,,88707652,,,,,,,,,,,,,,,,,,,,,,,,,,,,,,,,,,,,,,,,"4,4",
110964140,1589e089-a59d-4d31-99d9-fc4f8740266c,1729274963,120,1729271361,,0,0,9,3294,3468,23,30,21,26,0,0,0.02,,0.98,,601,132,145,,136,12,50.15,31.4,50.26,1,57.75,1343,61,95,2.6,0,95,96,,886,,9,1,67,77,9.83,9.88,9.87,-0.3,-0.8,275,273,,0,276,275,,,,,93,87,93,87,"19,34,43,4,0,0,0,0,0","0,93,6,0,0","1,0,94,5,0",,,,,106,288,,97,92,,,,,,,,,,,29,,,,,,,,,,,,,,,,,,,,,23.8,17,3,114,83,98,1013,0,,1,4,4,"Bad Godesberg",1,0,U1.000|5:54-U1.000|5:47-U1.000|5:52-U1.000|5:58-U1.000|6:40-U1.000|6:24-U1.000|6:10-U1.000|6:03-U1.000|6:04-U0.004|0:02,,"Bonn Running",,,4375,,657,3,17317338823,0,168070,250480,30378,11489702,88820159,457,21,20,46,19,0.55,0.85,2.52,0.59,0.28,1.29,11,27,82,3.1,321,0,10.64,0,136,0,,,,,,,,,,,,,,,,,,,,
111001159,129d126a-c120-45a0-b1fd-eaf8e9bdb4b2,1729332129,120,1729327284,,0,0,5.89,2129,2216,123,126,131,137,0,2.3,0.56,1.01,1.1,366,429,141,167,,156,26,46.84,30.97,48.02,1,57.46,1401,79,95,3,0.1,95,98,,579,,11,2,54,76,10.62,10.51,10.71,-1.3,3.8,303,294,,0,309,302,,,,,92,87,93,87,"27,12,19,23,17,2,0,0,0","1,43,40,16,0","3,1,43,52,1",,,,,109,284,,98,90,,,,,,,,,,,,,,,,,,,,,,,,,,,,,,,,54.4,15,9,255,93,98,1015,1,,0,4,4,"Bad Godesberg",1,0,U1.000|6:17-U1.000|8:17-U1.000|5:48-U1.000|5:18-U1.000|5:04-U0.891|4:44,,"Bonn Running",,,4375,,657,3,17321193327,0,168070,250480,30378,,88853177,,,,,,,,,,,,,,,,,,,,,,,,,,,,,,,,,,,,,,,,4,
111092958,fad1f889-41e4-46cc-b993-494ae20cb4f5,1729415709,120,1729414291,,0,0,3.39,1192,1708,5,5,7,7,0,0,0,,,,246,146,173,,157,34,46.26,30.97,46.35,1,57.31,1021,73,96,2.6,1.2,96,97,,283,,7,3,33,69,10.23,11.39,11.4,18.1,-3.1,320,283,,0,334,322,,,,,90,66,93,87,"22,3,8,46,10,1,8,1,0","0,25,67,8,0","14,5,8,61,12",,,,,124,271,,101,81,,,,,,,,,,,32,,,,,,,,,,,,,,,,,,,,,40.8,12,10,145,90,85,1021,1,,0,4,4,Beuel,1,0,U1.000|5:15-U1.000|5:13-U1.000|4:44-U0.389|4:40,,"Bonn Running",,,4375,,657,3,17329475615,0,168070,250480,30378,11501702,88935766,412,14,13,42,5,0.49,1.27,1.15,0.83,0.37,1.62,62,2,72,2,248,0,8.48,0,140,0,,,,,,,,,,,,,,,,,,,,
111092983,9e42db77-f8bb-4d5d-8043-32c38756a5d4,1729417696,120,1729414304,,0,0,14.96,3716,3716,32,32,53,52,0,0,0.05,,,,952,169,182,,176,12,57.35,51.35,57.5,1,57.35,4912,325,103,5,1.3,103,97,,1031,,19,2,168,82,14.53,14.72,14.74,7.7,5.9,404,404,,0,410,410,,,,,43,9,54,34,"1,0,0,3,26,18,50,1,0","0,0,27,68,5","0,0,0,38,62",,,,,147,240,,108,73,,,,,,,,,,,39,,,,,,,,,,,,,,,,,,,,,120.4,13,11,154,87,84,1021,1,,0,4,4,Beuel,1,0,U1.000|3:44-U1.000|3:55-U1.000|3:59-U1.000|4:00-U1.000|3:46-U1.000|3:53-U1.000|3:46-U1.000|3:45-U1.000|3:48-U1.000|3:56-U1.000|4:42-U1.000|4:51-U1.000|4:42-U1.000|4:44-U0.960|4:26,,"Bonn Running",,,4375,,657,3,17329477550,0,168070,250480,30378,11501704,88935789,356,7,6,22,21,0.15,0.32,0.8,0.4,0.2,0.71,0,84,98,1,110,0,3.65,0,98,0,,,,,,,,,,,,,,,,,,,,
111094108,0e241696-b032-4a21-a4a2-d224a4ec19b8,1729422026,120,1729415244,,0,0,0.94,343,343,2,0,1,0,0,0,0,,,,64,126,131,,131,5,53.23,26.21,53.51,1,57.35,4897,11,,0.8,0,,100,,93,,7,3,6,80,10,9.94,10,-6,-8.1,276,276,,0,274,274,,,,,34,33,34,33,"15,35,44,6,0,0,0,0,0","1,99,0,0,0","0,1,89,10,0",,,,,103,280,,94,91,,,,,,,,,,,31,,,,,,,,,,,,,,,,,,,,,8.9,14,13,130,90,0,1021,,,0,2,1,Beuel,1,0,,,"Bonn Running",,,4375,,657,3,17329633078,0,168070,250480,30378,11501844,88936831,474,5,4,22,0,0,0.28,0.69,0.65,0.49,1.14,8,4,99,0.8,23,1,13.03,0,129,0,,,,,,,,,,,,,,,,,,,,
111228257,4687eb33-2ead-46ce-b61c-82ad4215d8ee,1729536995,120,1729536035,,0,0,14.01,4665,4922,16,23,27,35,0,0,0.04,,,,922,136,151,,138,24,54.3,36.34,54.34,1,57.34,2907,107,101,3.2,0,101,100,,1285,,13,1,100,77,10.8,10.87,10.88,0.2,-0.3,305,301,,0,306,304,,,,,87,77,87,77,"3,7,39,47,4,0,0,0,0","0,82,18,0,0","1,0,36,62,0",,,,,117,280,,102,87,,,,,,,,,,,,,,,,,,,,,,,,,,,,,,,,25.8,15,4,123,87,57,1022,0,,1,3,4,"Bad Godesberg",1,0,U1.000|5:34-U1.000|5:18-U1.000|5:42-U1.000|5:36-U1.000|5:40-U1.000|5:30-U1.000|5:34-U1.000|5:51-U1.000|5:47-U1.000|5:34-U1.000|5:22-U1.000|5:20-U1.000|5:17-U1.000|5:36-U0.014|0:04,,"Bonn Running",,,4375,,657,3,17342610096,0,168070,250480,30378,,89055173,,,,,,,,,,,,,,,,,,,,,,,,,,,,,,,,,,,,,,,,,
111328234,efab3a35-0b03-4ced-90ce-bf5f4aff1f47,1729618003,120,1729616954,,0,0,18.49,5816,6009,175,175,191,192,0,1.3,0.27,0.96,1.05,479,1223,142,159,,156,20,55.09,39.71,55.73,1,57.34,3168,168,99,3.9,0,99,100,,1608,,13,3,144,80,11.67,11.62,11.71,-6.3,-2,322,321,,0,324,324,,,,,83,70,83,70,"10,6,9,39,29,7,0,0,0","0,34,66,0,0","0,0,14,84,1",,,,,119,270,,101,85,,,,,,,,,,,,,,,,,,,,,,,,,,,,,,,,35.8,14,3,302,75,19,1031,0,,0,2,4,"Bad Godesberg",1,0,U1.000|6:00-U1.000|5:38-U1.000|4:51-U1.000|6:38-U1.000|5:45-U1.000|5:25-U1.000|5:13-U1.000|5:11-U1.000|5:12-U1.000|5:10-U1.000|5:02-U1.000|4:53-U1.000|4:53-U1.000|4:24-U1.000|4:42-U1.000|5:17-U1.000|4:53-U1.000|5:13-U0.488|2:38,,"Bonn Running",,,4375,,657,3,17350432392,0,168070,250480,30378,,89140189,,,,,,,,,,,,,,,,,,,,,,,,,,,,,,,,,,,,,,,,"4,4",
111421772,3133e36c-1cc5-47fb-b9b2-2198dfbd7c40,1729707815,120,1729703649,,0,0,3.61,1101,1250,0,1,0,1,0,0,0,,,,240,143,169,,90,45,56.7,36.81,56.68,1,57.43,1616,73,100,2.6,1.2,100,104,,297,,7,3,29,76,11.8,12.12,12.11,11.9,5.7,332,328,,0,341,340,,,,,92,63,94,87,"11,1,3,10,67,5,1,2,0","7,7,84,3,0","6,3,6,81,4",,,,,129,267,,105,81,,,,,,,,,,,32,,,,,,,,,,,,,,,,,,,,,31.1,14,3,77,75,2,1033,0,,1,2,4,"Bad Godesberg",1,0,U1.000|4:58-U1.000|4:41-U1.000|4:44-U0.609|3:57,,"Bonn Running",,,4375,,657,3,17359160134,0,168070,250480,30378,11528502,89222931,412,59,56,77,1,8.47,15.21,2.04,0.71,0.51,1.31,31,0,63,12,324,0,13.28,0,140,0,,,,,,,,,,,,,,,,,,,,
111421795,33609908-b689-43cd-a0ec-c463d004907b,1729709189,120,1729703653,,0,0,3.56,1093,1093,1,0,1,0,0,0,0,,,,238,156,179,,174,50,49.83,36.49,49.86,1,57.47,3347,150,105,3,2.6,105,103,,234,,15,3,40,68,11.7,14.36,14.37,32.1,1.9,381,324,,0,420,403,,,,,35,1,72,62,"32,2,3,1,1,2,46,13,0","3,18,17,61,0","25,1,12,1,61",,,,,144,230,,102,71,,,,,,,,,,,37,,,,,,,,,,,,,,,,,,,,,78.3,13,4,105,77,1,1033,0,,1,2,4,"Bad Godesberg",1,0,U1.000|3:38-U0.200|1:11-U1.000|3:38-U0.200|1:18-U1.000|3:43-U0.160|4:44,,"Bonn Track Running",,,4375,,657,3,17359160950,0,168070,250480,30378,11528504,89222939,386,9,8,74,5,0.36,0.61,0.74,0.49,0.2,1.61,18,70,83,1.2,,0,,0,,0,,,,,,,,,,,,,,,,,,,,
111421813,d91783f6-e665-4bf2-9428-47f5ed4e68f4,1729710514,120,1729703657,,0,0,0.8,269,269,3,5,2,4,0,0,0,,0.87,,53,131,138,,138,5,56.2,28.28,56.29,1,57.47,3340,10,,0.7,0,,100,,74,,7,3,5,79,10.59,10.73,10.68,-2.3,-7.1,293,288,,0,293,293,,,,,61,60,61,60,"3,3,56,39,0,0,0,0,0","1,99,0,0,0","2,0,43,55,0",,,,,113,274,,98,87,,,,,,,,,,,28,,,,,,,,,,,,,,,,,,,,,8.3,13,4,105,77,1,1033,0,,1,2,4,"Bad Godesberg",1,0,,,"Bonn Running",,,4375,,657,3,17359161458,0,168070,250480,30378,11528506,89222944,456,5,3,24,0,0,0,0.85,0.52,0.36,1.06,3,57,99,0.8,279,1,10.55,1,136,0,,,,,,,,,,,,,,,,,,,,
111524531,a505f2c2-dfa3-4bdd-92a7-db1968c89cc4,1729793198,120,1729791055,,0,0,14.67,4286,4550,30,28,37,35,0,0,0.03,,,,957,147,160,108,158,9,57.6,42.48,57.76,1,57.48,2880,162,101,3.7,0,101,100,,1190,,13,3,117,80,12.34,12.35,12.38,-0.8,-1.4,344,343,,0,345,344,,,,,83,72,83,72,"0,1,3,27,62,7,0,0,0","1,14,85,0,0","1,0,2,96,1",,,,,128,262,,104,81,,,,,,,,,,,,,,,,,,,,,,,,,,,,,,,,42.2,14,12,138,78,42,1022,0,,1,3,4,"Bad Godesberg",1,0,U1.000|4:51-U1.000|4:42-U1.000|4:44-U1.000|4:43-U1.000|4:49-U1.000|5:05-U1.000|5:03-U1.000|5:03-U1.000|4:49-U1.000|4:53-U1.000|4:45-U1.000|4:50-U1.000|4:40-U1.000|4:57-U0.667|3:31,,"Bonn Running",,,4375,,657,3,17367560489,0,168070,250480,30378,,89314708,,,,,,,,,,,,,,,,,,,,,,,,,,,,,,,,,,,,,,,,,
111587761,aeeb90da-4d47-4ed7-bbea-3ec6e891efee,1729860293,120,1729857630,,0,0,13.74,4271,4403,220,219,231,230,0,2.3,0.45,0.96,1.07,554,947,150,165,,160,15,51.89,39.32,52.92,1,57.43,2908,167,99,3.8,0,99,98,,1186,,13,3,126,80,12.01,11.84,12.05,-2.2,2.7,337,335,,0,341,339,,,,,82,71,82,71,"11,7,7,25,41,9,0,0,0","0,15,77,7,0","0,0,16,81,3",,,,,121,268,,101,83,,,,,,,,,,,,,,,,,,,,,,,,,,,,,,,,49.9,18,13,168,73,33,1019,2,,0,2,4,"Bad Godesberg",1,0,U1.000|5:05-U1.000|4:47-U1.000|5:44-U1.000|5:49-U1.000|5:29-U1.000|5:01-U1.000|5:09-U1.000|4:58-U1.000|4:40-U1.000|4:44-U1.000|6:40-U1.000|5:01-U1.000|4:32-U0.743|3:32,,"Bonn Running",,,4375,,657,3,17372843787,0,168070,250480,30378,,89364642,,,,,,,,,,,,,,,,,,,,,,,,,,,,,,,,,,,,,,,,"4,4",
111685529,fb4185db-84fe-4bc3-8630-5bf2558aac92,1729941349,120,1729951270,,0,0,13.93,14401,14401,470,476,481,487,0,5.3,0.74,,,189,1123,96,138,77,118,37,,,,1,57.37,2822,16,,1.1,0,,100,,1875,,,,104,40,,3.96,,-21.8,,,,,,,,,,,,,,,,"89,11,0,0,0,0","65,35,0,0,0",,10370,2,,,,,,,,,,,,,,,,,,,,,,,,,,,,,,,,,,,,,,,9.9,16,6,78,74,45,1018,2,,0,3,4,Greimersburg,1,0,,,"Cochem Hiking",,,4375,,657,3,17381804139,0,168075,,30378,,89452947,,,,,,,,,,,,,,,,,,,,,,,,,,,,,,,,,,,,,,,,"3,4,4",
111691307,b43e5a7d-7d8d-4304-ae90-a87c7bd94131,1729928859,120,1729955335,,0,0,0.59,192,192,12,2,13,2,0,1.1,0.68,1.33,,,39,129,150,,149,13,59.62,28.47,62.38,1,57.43,1838,9,,0.6,0,,100,,53,,7,3,4,80,11.61,11.15,12.13,31.9,31.7,351,351,,0,363,363,,,,,99,98,99,98,"8,3,30,45,15,0,0,0,0","10,55,35,0,0","1,1,21,60,18",,,,,115,271,,99,86,,,,,,,,,,,,,,,,,,,,,,,,,,,,,,,,7.5,9,5,71,94,78,1019,0,,1,4,4,"Moselhöhe Ediger-Eller",1,0,,,"Ediger-Eller Running",,,4375,,657,3,17382485935,0,168070,250480,30378,,89457742,,,,,,,,,,,,,,,,,,,,,,,,,,,,,,,,,,,,,,,,,
111692382,b664ece6-be65-47d7-b8fa-f685c4b6bd18,1729929088,120,1729956250,,0,0,12.58,4208,4858,326,332,329,340,0,3.5,0.75,0.95,1.03,610,838,140,158,,155,36,52.02,35.83,53.66,1,57.37,3204,98,100,3.1,0,100,97,,1062,,11,3,98,73,11.47,11.11,11.59,7.1,-7.3,323,293,,0,331,321,,,,,88,79,88,79,"24,10,13,26,20,7,0,0,0","0,42,57,0,0","10,1,20,66,3",,,,,123,271,,96,78,,,,,,,,,,,,,,,,,,,,,,,,,,,,,,,,34.5,9,5,69,95,84,1020,0,,0,4,4,"Moselhöhe Ediger-Eller",1,0,U1.000|5:04-U1.000|4:35-U1.000|4:44-U1.000|5:18-U1.000|5:12-U1.000|5:14-U1.000|5:12-U1.000|5:49-U1.000|7:25-U1.000|6:55-U1.000|6:09-U1.000|5:30-U0.581|3:00,,"Ediger-Eller Running",,,4375,,657,3,17382638282,0,168070,250480,30378,,89458719,,,,,,,,,,,,,,,,,,,,,,,,,,,,,,,,,,,,,,,,3,
111735037,b1bac5fa-d3e1-4842-adf5-8f9adf48c770,1730015080,60,1730017501,,0,0,15.66,5640,5879,463,458,468,460,0,4.9,0.82,0.92,1.01,559,1105,138,160,,144,22,48.38,33.43,50.17,1,57.3,2349,124,100,3.4,0,100,96,,1566,,11,4,129,80,10.83,10.4,10.98,0.3,-1.7,303,300,,0,312,311,,,,,87,75,87,75,"36,11,12,26,15,0,0,0,0","1,51,48,0,0","1,2,37,59,1",,,,,104,276,,93,89,,,,,,,,,,,,,,,,,,,,,,,,,,,,,,,,38.9,11,5,229,89,78,1021,1,,0,4,4,"Moselhöhe Ediger-Eller",1,0,U1.000|5:22-U1.000|4:59-U1.000|4:52-U1.000|5:14-U1.000|5:47-U1.000|6:50-U1.000|7:13-U1.000|8:14-U1.000|5:25-U1.000|5:10-U1.000|5:15-U1.000|5:41-U1.000|7:15-U1.000|6:49-U1.000|6:13-U0.664|3:41,,"Ediger-Eller Running",,,4375,,657,3,17387196143,0,168070,250480,30378,,89496158,,,,,,,,,,,,,,,,,,,,,,,,,,,,,,,,,,,,,,,,"3,4",
111764612,0406935f-d165-401d-a8a9-ae3d18304bbb,1730027998,60,1730034200,,0,0,8.06,9758,9758,464,471,506,514,0,6.1,0.8,,,283,845,102,141,,139,37,,,,1,57.3,2071,27,,1.9,0.1,,100,,1550,,,,88,37,,3.55,,-29.6,,,,,,,,,,,,,,,,"93,7,0,0,0,0","50,50,0,0,0",,6811,2,,,,,,,,,,,,,,,,,,,,,,,,,,,,,,,,,,,,,,,13.6,16,4,195,80,66,1022,2,,0,4,4,Ediger-Eller,1,0,,,"Ediger-Eller Hiking",,,4375,,657,3,17390230103,0,168075,,30378,,89523946,,,,,,,,,,,,,,,,,,,,,,,,,,,,,,,,,,,,,,,,"2,3",
111857789,b9f2f290-36d6-41bd-80ac-aa6d4f3925ee,1730123327,60,1730124188,,0,0,12.01,3690,4340,26,24,35,33,0,0,0.08,,,,761,134,150,,140,11,61.09,39.44,61.27,1,57.43,1435,103,102,3.2,0,102,103,,1024,,9,3,74,79,11.75,11.75,11.79,-3.9,-5.1,328,325,,0,330,326,,,,,90,81,90,81,"0,1,7,56,33,2,0,0,0","4,65,32,0,0","1,0,4,94,1",,,,,124,269,,103,83,,,,,,,,,,,,,,,,,,,,,,,,,,,,,,,,26.3,18,8,259,71,80,1024,1,,0,4,4,"Bad Godesberg",1,0,U1.000|5:17-U1.000|4:59-U1.000|5:17-U1.000|5:18-U1.000|5:12-U1.000|5:07-U1.000|5:10-U1.000|5:02-U1.000|4:59-U1.000|5:02-U1.000|5:14-U1.000|4:50-U0.013|0:05,,"Bonn Running",,,4375,,657,3,17398540548,0,168070,250480,30378,,89606817,,,,,,,,,,,,,,,,,,,,,,,,,,,,,,,,,,,,,,,,,
112001298,90db530f-1b18-4514-a5d5-ddc14c948935,1730226241,60,1730228276,,0,0,6.08,1977,2369,12,13,25,29,0,0,0.07,,,,391,133,148,,148,18,57.5,35.22,57.62,1,57.46,906,55,102,2.5,0,102,100,,463,,7,3,40,67,11.1,11.09,11.14,1.9,15,293,267,,0,306,298,,,,,94,90,94,90,"2,5,23,64,7,0,0,0,0","1,88,11,0,0","10,10,18,60,2",,,,,138,279,,99,72,,,,,,,,,,,29,,,,,,,,,,,,,,,,,,,,,21.4,14,3,183,85,67,1026,0,,1,4,4,Nordstadt,1,0,U1.000|5:25-U1.000|5:26-U1.000|5:26-U1.000|5:25-U1.000|5:22-U1.000|5:27-U0.078|0:26,,"Bonn Running",,,4375,,657,3,17409368923,0,168070,250480,30378,11579390,89731219,449,11,10,24,6,0.69,0.99,0.98,0.8,0.42,1.38,53,0,86,1.4,251,0,10.92,0,129,0,,,,,,,,,,,,,,,,,,,,
112001306,208a2000-f21e-40ab-bd48-57c511256988,1730228683,60,1730228280,,0,0,5.89,1626,1626,0,2,0,1,0,0,0,,,,406,164,183,,179,48,52.74,42.67,52.72,1,57.62,3563,280,107,3.6,3.5,107,103,,412,,18,4,68,76,13.04,14.86,14.84,21,5.4,390,362,,0,422,414,,,,,17,1,63,44,"29,1,2,2,1,2,38,26,0","0,18,15,60,8","13,5,14,2,67",,,,,143,226,,100,70,,,,,,,,,,,40,,,,,,,,,,,,,,,,,,,,,91.7,14,3,199,85,65,1026,0,,1,4,4,Nordstadt,1,0,U0.990|3:32-U0.200|1:24-U1.010|3:35-U0.200|1:36-U1.000|3:30-U0.190|1:36-U1.010|3:32-U0.200|2:06-U1.000|3:39-U0.090|2:37,,"Bonn Track Running",,,4375,,657,3,17409370100,0,168070,250480,30378,11579392,89731225,367,6,4,40,8,0.05,0.14,0.75,0.51,0.2,1.48,29,64,90,0.9,,0,,0,92,1,,,,,,,,,,,,,,,,,,,,
112001322,0ab01b6d-b077-4344-b5d7-0bcc017a73aa,1730230429,60,1730228288,,0,0,3.44,1155,1155,8,13,15,18,0,0,0.06,0.89,0.79,,240,139,156,,155,21,52.27,32.75,52.32,1,57.62,4324,45,97,2.3,0,97,102,,320,,7,3,27,80,10.71,10.81,10.81,-7,-4.2,305,305,,0,307,307,,,,,40,36,40,36,"8,12,30,44,6,0,0,0,0","0,67,33,0,0","0,0,54,45,0",,,,,112,274,,98,88,,,,,,,,,,,31,,,,,,,,,,,,,,,,,,,,,24.4,14,3,199,85,65,1026,0,,1,4,4,Nordstadt,1,0,U1.000|6:03-U1.000|5:29-U1.000|5:21-U0.439|2:22,,"Bonn Running",,,4375,,657,3,17409370968,0,168070,250480,30378,11579395,89731238,431,5,3,18,4,0,0,0.79,0.56,0.32,1.16,14,31,100,0.8,274,1,9.75,1,176,0,,,,,,,,,,,,,,,,,,,,
112092156,c38210b3-5c01-4641-946d-3439afab4d32,1730311341,60,1730313591,,0,0,15,4682,5679,12,10,12,11,0,0,0,,,,994,141,151,,141,10,56.13,39.4,56.2,1,57.61,3176,133,102,3.5,0,102,98,,1299,,11,4,110,79,11.54,11.57,11.58,3,3.1,326,326,,0,327,327,,,,,82,74,82,74,"1,2,8,64,24,0,0,0,0","1,31,68,0,0","0,0,6,94,0",,,,,122,273,,104,85,,,,,,,,,,,,,,,,,,,,,,,,,,,,,,,,32.7,13,3,338,88,84,1029,0,,1,4,4,"Bad Godesberg",1,0,U1.000|5:25-U1.000|4:56-U1.000|4:58-U1.000|4:55-U1.000|5:08-U1.000|5:07-U1.000|5:11-U1.000|5:18-U1.000|5:09-U1.000|5:16-U1.000|5:12-U1.000|5:14-U1.000|5:13-U1.000|5:17-U1.000|5:40-U0.004|0:01,,"Bonn Running",,,4375,,657,3,17417617079,0,168070,250480,30378,,89809763,,,,,,,,,,,,,,,,,,,,,,,,,,,,,,,,,,,,,,,,,
112190300,c8736e16-ce9a-4cce-b88a-9f5de22d597a,1730399611,60,1730400850,,0,0,7.88,2664,3482,17,14,24,21,0,0,0.05,,,,526,133,152,,149,11,54.8,34.18,54.97,1,57.55,1742,62,101,2.6,0,101,97,,720,,7,1,52,78,10.69,10.73,10.77,4,3.4,306,301,,0,309,304,,,,,93,87,93,87,"6,17,36,30,10,1,0,0,0","2,83,15,0,0","2,0,48,49,0",,,,,114,277,,99,87,,,,,,,,,,,,,,,,,,,,,,,,,,,,,,,,20.9,13,5,129,82,32,1027,0,,1,2,4,"Bad Godesberg",1,0,U1.000|5:32-U1.000|5:17-U1.000|5:40-U1.000|5:45-U1.000|5:56-U1.000|6:03-U1.000|5:40-U0.882|4:31,,"Bonn Running",,,4375,,657,3,17425740795,0,168070,250480,30378,,89892335,,,,,,,,,,,,,,,,,,,,,,,,,,,,,,,,,,,,,,,,,
112229256,92d48533-c000-4d9a-842e-fe918f765c33,1730454563,60,1730457635,,0,0,14.35,4680,4881,244,243,263,259,0,2.7,0.53,0.95,1.06,515,990,146,162,,162,21,50.76,37.3,51.83,1,57.43,1946,142,98,3.6,0,98,97,,1298,,13,2,128,81,11.48,11.29,11.51,-1.4,2.9,321,320,,0,325,324,,,,,85,76,85,76,"18,6,14,32,25,5,0,0,0","0,24,74,2,0","0,0,24,75,1",,,,,114,269,,97,85,,,,,,,,,,,,,,,,,,,,,,,,,,,,,,,,41,11,4,198,85,63,1025,1,,0,4,4,"Bad Godesberg",1,0,U1.000|5:23-U1.000|5:02-U1.000|5:45-U1.000|6:25-U1.000|6:02-U1.000|5:09-U1.000|5:26-U1.000|5:11-U1.000|5:03-U1.000|5:21-U1.000|6:39-U1.000|4:33-U1.000|4:50-U1.000|5:31-U0.349|1:39,,"Bonn Running",,,4375,,657,3,17429739017,0,168070,250480,30378,,89926184,,,,,,,,,,,,,,,,,,,,,,,,,,,,,,,,,,,,,,,,"4,4",
112299157,2ea77d44-c064-43a8-83a7-f7c97d5058ee,1730542101,60,1730539878,,0,0,5.43,1157,1157,24,9,39,24,0,0,0.06,1.47,,,168,115,129,93,126,39,,,,1,57.53,3433,14,,0.9,0,,100,,164,,,,15,,,19.88,,25.1,23,52,45,,1,69,66,,,,,47,46,47,46,"22,19,48,10,0,0,0","9,91,0,0,0","95,5,0,0,0",,,,,,,,,,,,,,,,,,,,28,,,,,,,,,,,,,,,,,,,,,9.8,11,4,342,94,97,1031,1,,0,4,4,"Bad Godesberg",1,0,U5.000|14:31-U0.427|4:46,,"Bonn Cycling",,,4375,,657,3,17436867125,0,168072,,30378,11606125,89985448,524,24,23,57,14,0.59,2.69,0.82,1.27,0.83,1.6,100,0,47,2.7,446,0,,0,161,0,,,,,,,,,,,,,,,,,,,,
112299158,87a02d54-f34a-4eea-a538-fc5411ec8184,1730539975,60,1730539878,,0,0,5.17,1592,1657,19,16,30,29,0,0,0.18,0.99,1.01,,355,141,157,112,156,16,57.08,37.21,57.38,1,57.53,3456,69,99,2.7,0,99,102,,441,,7,3,38,80,11.74,11.75,11.79,-7.1,-7.7,338,337,,0,341,340,,,,,53,48,53,48,"1,2,12,46,36,3,0,0,0","0,46,54,0,0","1,0,14,78,8",,,,,122,267,,102,84,,,,,,,,,,,33,,,,,,,,,,,,,,,,,,,,,28.5,11,4,342,94,97,1031,1,,0,4,4,"Bad Godesberg",1,0,U1.000|5:36-U1.000|5:16-U1.000|5:02-U1.000|4:54-U1.000|4:55-U0.168|0:49,,"Bonn Running",,,4375,,657,3,17436867018,0,168070,250480,30378,11606126,89985449,426,7,5,19,9,0.19,0.3,0.78,0.57,0.35,1,4,28,92,0.9,1089,0,38.67,0,,0,,,,,,,,,,,,,,,,,,,,
112299159,2bc72e56-9c81-41b0-bad0-e1999ea1a6a8,1730535377,60,1730539878,,0,0,5.35,980,980,5,10,18,22,0,0,0.05,,,,169,123,140,98,125,43,,,,1,57.43,484,20,,1.5,0,,100,,146,,,,15,,,20.62,,5,-4.6,49,44,,1,53,51,,,,,99,97,99,97,"10,17,71,0,0,0,3","6,94,0,0,0","100,0,0,0,0",,,,,,,,,,,,,,,,,,,,30,,,,,,,,,,,,,,,,,,,,,13.3,10,3,324,97,96,1030,0,,0,4,4,"Bad Godesberg",1,0,U5.000|14:55-U0.350|1:25,,"Bonn Cycling",,,4375,,657,3,17436866496,0,168072,,30378,11606127,89985450,488,26,25,52,36,1.11,2.63,2.86,1.24,0.8,1.66,100,0,56,4.7,81,0,49.64,0,149,0,,,,,,,,,,,,,,,,,,,,
112299160,4fb56f50-a5de-48b8-9f5a-6086aa22f2da,1730536669,60,1730539879,,0,0,3.05,895,1052,8,10,16,17,0,0,0.2,1.06,1.06,,209,149,167,115,145,28,56.23,38.03,56.37,1,57.5,1164,65,101,2.5,0.6,101,102,,239,,7,3,26,77,12.26,12.58,12.63,6.7,-0.2,369,350,,0,373,365,,,,,92,74,92,87,"7,1,2,8,52,28,1,1,0","0,15,76,10,0","5,1,5,74,14",,,,,133,256,,104,78,,,,,,,,,,,33,,,,,,,,,,,,,,,,,,,,,36.6,10,3,324,97,96,1030,0,,0,4,4,"Bad Godesberg",1,0,U1.000|4:47-U1.000|4:34-U1.000|5:23-U0.045|0:12,,"Bonn Running",,,4375,,657,3,17436866675,0,168070,250480,30378,11606128,89985451,403,11,10,32,9,0.79,1.3,1.96,0.64,0.35,1.4,9,6,44,3,284,0,6.54,0,134,0,,,,,,,,,,,,,,,,,,,,
112299161,b2e3731d-24c1-4162-9c6d-9c968f23bcc4,1730538480,60,1730539880,1730714455,0,0,5.01,1106,1106,18,16,35,33,0,0,0.28,1.04,1,,313,174,205,,205,22,63.32,54.91,63.64,1,57.51,2448,172,102,3.5,2,102,100,,306,,18,4,56,84,16.38,16.33,16.41,7.6,6.6,462,460,,0,464,464,,,,,13,1,72,59,"0,0,0,0,0,7,72,21,0","0,6,0,79,15","0,0,0,5,94",,,,,162,220,,108,67,,,,,,,,,,,41,,,,,,,,,,,,,,,,,,,,,111,11,4,338,95,95,1031,0,,0,4,4,"Parkrun Rheinaue Bonn",1,0,U1.000|3:39-U1.000|3:39-U1.000|3:44-U1.000|3:44-U1.000|3:39,,"Bonn Parkrun",,,4375,,657,3,17436866827,0,168070,250484,30378,11606129,89985452,339,14,14,18,7,0.55,1.35,3.06,0.36,0.21,1.06,0,99,84,3.1,1578,0,24.36,0,214,0,5.01,1106,,,0,"Bonn Parkrun",,,,,,,0,0,30378,112299161,,49111,,
112400670,f55bd917-2415-4b73-84ef-3adbae5d904c,1730633317,60,1730639269,,0,0,22.52,7846,8086,682,681,716,718,0,6.3,0.77,0.95,1,689,1604,141,166,,160,28,49.02,35.75,50.86,1,57.52,3753,200,100,4,0.2,100,100,,2131,,13,3,198,80,11.33,11.01,11.63,1.9,0.9,316,313,,0,328,326,,,,,79,63,79,63,"31,8,10,16,24,10,0,0,0","0,46,51,3,0","2,4,28,63,4",,,,,108,272,,93,86,,,,,,,,,,,,,,,,,,,,,,,,,,,,,,,,48.4,11,8,128,75,35,1030,2,,0,2,4,Königswinter,1,0,U1.000|5:14-U1.000|8:32-U1.000|6:49-U1.000|5:15-U1.000|4:54-U1.000|5:46-U1.000|6:19-U1.000|8:13-U1.000|4:37-U1.000|5:08-U1.000|5:01-U1.000|6:03-U1.000|6:10-U1.000|7:52-U1.000|5:17-U1.000|5:20-U1.000|5:39-U1.000|5:45-U1.000|5:45-U1.000|5:12-U1.000|4:41-U1.000|4:35-U0.517|2:39,,"Königswinter Running",,,4375,,657,3,17447451207,0,168070,250480,30378,,90075581,,,,,,,,,,,,,,,,,,,,,,,,,,,,,,,,,,,,,,,,"2,3,4",
112421876,018ae491-d8be-4c50-ba87-9fb416ccd6d3,1730649943,60,1730654139,,0,0,5.4,6093,6093,244,247,246,251,0,4.4,0.93,,,284,391,87,130,,117,42,,,,1,57.51,3511,6,,0.4,0,,100,,728,,,,34,39,,3.74,,-18.7,,,,,,,,,,,,,,,,"93,7,0,0,0,0","79,21,0,0,0",,4250,2,,,,,,,,,,,,,,,,,,,,,,,,,,,,,,,,,,,,,,,6.2,11,6,120,74,0,1028,,,0,2,1,Königswinter,1,0,,,"Königswinter Hiking",,,4375,,657,3,17449940460,0,168075,,30378,,90094659,,,,,,,,,,,,,,,,,,,,,,,,,,,,,,,,,,,,,,,,3,
112509126,3fd3aeee-9a92-488c-adaa-dc1c9661e03c,1730729897,60,1730732131,,0,0,13.68,4470,4587,186,190,187,192,0,2.2,0.43,0.99,1.06,482,942,142,155,,151,23,52.56,37.08,53.43,1,57.49,2462,123,97,3.3,0,97,99,,1234,,11,3,107,80,11.35,11.21,11.39,-2.9,1.9,323,321,,0,326,324,,,,,87,77,87,77,"16,5,11,43,25,1,0,0,0","0,28,71,0,0","0,0,17,81,2",,,,,115,271,,98,85,,,,,,,,,,,33,,,,,,,,,,,,,,,,,,,,,31.5,13,8,123,71,1,1027,1,,0,2,4,"Bad Godesberg",1,0,U1.000|5:56-U1.000|5:57-U1.000|5:36-U1.000|7:02-U1.000|5:33-U1.000|5:19-U1.000|5:14-U1.000|5:19-U1.000|5:13-U1.000|5:08-U1.000|4:54-U1.000|4:54-U1.000|4:58-U0.684|3:31,,"Bonn Running",,,4375,,657,3,17456104722,0,168070,250480,30378,11624395,90169699,424,9,8,23,14,0.35,0.56,2.38,0.64,0.35,1.35,18,14,81,3,333,0,0.1,0,144,0,,,,,,,,,,,,,,,,,,,"4,4",
112657539,5de30b84-ba01-4aa1-8d70-8d7b3fffb53b,1730829973,60,1730830847,,0,0,2.61,910,1032,5,6,11,14,0,0,0.07,,0.93,,183,133,142,100,142,11,52.75,30.7,52.85,1,57.41,762,33,99,2,0,99,100,,236,,7,3,18,78,10.32,10.34,10.37,-3.4,-4.5,295,287,,0,296,294,,,,,97,94,97,94,"8,21,49,19,2,1,0,0,0","0,98,2,0,0","3,0,63,34,0",,,,,110,282,,98,89,,,,,,,,,,,,,,,,,,,,,,,,,,,,,,,,17.4,8,6,137,86,63,1025,0,,1,4,4,Nordstadt,1,0,U1.000|5:55-U1.000|5:45-U0.611|3:30,,"Bonn Running",,,4375,,657,3,17466125532,0,168070,250480,30378,,90306093,,,,,,,,,,,,,,,,,,,,,,,,,,,,,,,,,,,,,,,,,
112657547,684b9840-bfee-4162-8944-0e1a596ec983,1730832510,60,1730830853,,0,0,6.32,1723,1723,0,0,0,7,0,0,0,,,,411,155,180,,172,51,58.24,43.49,58.24,1,57.69,1877,228,109,3.4,3.1,109,97,,440,,16,2,60,72,13.21,14.75,14.75,15.3,8.6,424,368,,0,439,421,,,,,32,1,77,57,"21,0,0,0,1,4,69,4,0","1,27,24,49,0","19,2,0,0,79",,,,,153,215,,101,66,,,,,,,,,,,,,,,,,,,,,,,,,,,,,,,,80,8,6,137,86,63,1025,0,,1,4,4,Nordstadt,1,0,U1.490|5:40-U0.080|1:14-U1.500|5:37-U0.080|1:15-U1.500|5:34-U0.070|1:17-U1.500|5:35-U0.100|2:31,,"Bonn Track Running",,,4375,,657,3,17466126648,0,168070,250480,30378,,90306101,,,,,,,,,,,,,,,,,,,,,,,,,,,,,,,,,,,,,,,,,
112659835,e41ec7c8-3fbe-4ca2-9894-3e44d99fdc51,1730834479,60,1730832161,,0,0,1.71,601,724,1,6,4,10,0,0,0.12,,,,117,130,137,103,136,11,53.71,29.26,53.56,1,57.68,1854,21,98,1.4,0,98,98,,166,,7,3,11,79,10.14,10.3,10.21,-0.9,-5,291,290,,0,292,291,,,,,55,54,55,54,"9,16,58,17,0,0,0,0,0","0,100,0,0,0","0,1,74,25,0",,,,,108,282,,97,90,,,,,,,,,,,,,,,,,,,,,,,,,,,,,,,,12.8,7,6,142,87,57,1025,0,,1,3,4,Nordstadt,1,0,U1.000|5:52-U0.706|4:08,,"Bonn Running",,,4375,,657,3,17466332079,0,168070,250480,30378,,90308233,,,,,,,,,,,,,,,,,,,,,,,,,,,,,,,,,,,,,,,,,
112744240,b215cf70-0b2a-48f7-a393-01986a50be68,1730905191,60,1730906870,,0,0,14.73,4975,5174,203,197,205,199,0,1.9,0.36,1.01,1.04,542,981,132,146,,141,31,55.38,35.88,56.35,1,57.64,1365,103,99,3.1,0,99,100,,1373,,11,2,98,79,10.97,10.9,11.09,-1.9,0.9,312,310,,0,316,315,,,,,89,78,89,78,"17,7,26,32,17,1,0,0,0","1,88,11,0,0","1,0,33,65,1",,,,,112,277,,98,88,,,,,,,,,,,,,,,,,,,,,,,,,,,,,,,,22.2,10,4,344,62,2,1030,,,0,2,1,"Bad Godesberg",1,0,U1.000|6:32-U1.000|5:43-U1.000|5:52-U1.000|7:05-U1.000|5:50-U1.000|5:29-U1.000|5:37-U1.000|5:27-U1.000|5:32-U1.000|5:04-U1.000|4:58-U1.000|5:18-U1.000|5:14-U1.000|5:00-U0.732|4:13,,"Bonn Running",,,4375,,657,3,17472976523,0,168070,250480,30378,,90382185,,,,,,,,,,,,,,,,,,,,,,,,,,,,,,,,,,,,,,,,"4,4",
112847687,555e0a25-d8f2-47bd-b0c9-f4bce77d5976,1730999156,60,1730996399,,0,0,2.33,784,784,4,5,4,7,0,0,0,0.43,,,83,100,117,,117,30,,,,1,57.64,,4,,0.3,0,,100,,116,,,,6,,,15.06,,54.6,0.7,23,18,,1,36,34,,,,,99,99,99,99,"44,19,25,0,0,0,11","44,56,0,0,0","100,0,0,0,0",,,,,,,,,,,,,,,,,,,,,,,,,,,,,,,,,,,,,,,,,3.8,8,6,128,78,42,1032,0,,1,3,4,"Bad Godesberg",1,0,,,"Bonn Cycling",,,4375,,657,3,17481371452,0,168072,,30378,,90475079,,,,,,,,,,,,,,,,,,,,,,,,,,,,,,,,,,,,,,,,,
112850972,90a88b20-fca2-445c-8a62-2f6139fe18b8,1731001963,60,1730999059,,0,0,2.12,478,478,2,4,3,5,0,0,0,,,,58,103,121,96,115,17,,,,1,57.64,,5,,0.3,0,,100,,66,,,,4,,,17.57,,6.7,,30,28,,1,41,40,,,,,100,99,100,99,"30,29,39,1,0,0,0","38,62,0,0,0","100,0,0,0,0",,,,,,,,,,,,,,,,,,,,,,,,,,,,,,,,,,,,,,,,,4,7,6,131,81,48,1032,0,,1,3,4,"Bad Godesberg",1,0,,,"Bonn Cycling",,,4375,,657,3,17481716007,0,168072,,30378,,90477593,,,,,,,,,,,,,,,,,,,,,,,,,,,,,,,,,,,,,,,,,
112893217,300c9aca-676a-42c9-912e-5b6ecfab2f55,1731053958,60,1731052681,,0,0,0.89,242,242,4,2,4,3,0,0,0.23,0.86,,,21,90,112,,112,33,,,,1,57.64,,1,,,0,,100,,26,,,,1,,,17.01,,21,40.9,39,31,,1,58,54,,,,,100,100,100,100,"39,32,29,0,0,0,0","74,26,0,0,0","100,0,0,0,0",,,,,,,,,,,,,,,,,,,,,,,,,,,,,,,,,,,,,,,,,1.2,4,9,122,91,87,1029,0,,0,4,4,"Bad Godesberg",1,0,,,"Bonn Cycling",,,4375,,657,3,17485957401,0,168072,,30378,,90514955,,,,,,,,,,,,,,,,,,,,,,,,,,,,,,,,,,,,,,,,,
112910589,849a4cad-f076-4a9b-888f-10989b6c4e6b,1731056576,60,1731068483,,0,0,13.48,4520,4598,188,186,198,191,0,2.1,0.4,0.98,1.07,591,932,141,155,,152,26,51.39,35.93,52.28,1,57.52,1409,118,96,3.3,0,96,99,,1255,,11,1,111,80,11.09,10.96,11.13,-4,0.8,310,309,,0,312,312,,,,,88,78,88,78,"19,5,20,38,16,1,0,0,0","0,40,59,0,0","0,0,31,68,0",,,,,112,274,,98,88,,,,,,,,,,,,,,,,,,,,,,,,,,,,,,,,34,5,11,122,85,85,1029,1,,0,4,4,"Bad Godesberg",1,0,U1.000|6:35-U1.000|5:45-U1.000|6:06-U1.000|7:01-U1.000|5:35-U1.000|5:28-U1.000|5:30-U1.000|5:26-U1.000|5:23-U1.000|5:15-U1.000|4:49-U1.000|4:56-U1.000|4:59-U0.481|2:33,,"Bonn Running",,,4375,,657,3,17487450122,0,168070,250480,30378,,90530449,,,,,,,,,,,,,,,,,,,,,,,,,,,,,,,,,,,,,,,,"4,4",
113097934,d6764bfa-8cc4-4c5d-a1ac-9cedce4fc7f0,1731234478,60,1731236077,,0,0,3.91,3075,3075,12,13,17,17,0,0,0.13,,,,166,79,96,,84,14,,,,1,57.52,,2,,0.1,0,,100,,353,,,,12,52,,4.68,,-2.3,,,,,,,,,,,,,,,,"77,23,0,0,0,0","100,0,0,0,0",,2742,2,,,,,,,,,,,,,,,,,,,,,,,,,,,,,,,,,,,,,,,1.7,10,7,147,88,94,1028,1,,0,4,4,"Bad Godesberg",1,0,,,"Bonn Hiking",,,4375,,657,3,17502589839,0,168075,,30378,,90698483,,,,,,,,,,,,,,,,,,,,,,,,,,,,,,,,,,,,,,,,,
113153294,3e01564e-861c-4156-a5a8-f140293c8ca8,1731257123,60,1731275100,,0,0,1.6,580,580,8,5,7,4,0,0,0.13,1.03,,,112,130,138,,138,7,51.7,28.03,52.14,1,57.48,202,18,97,1.3,0,97,97,,158,,7,1,11,79,10.02,9.98,10.05,1,-3.8,286,286,,0,287,287,,,,,98,97,98,97,"13,37,45,5,0,0,0,0,0","3,97,0,0,0","0,1,82,17,0",,,,,105,285,,97,92,,,,,,,,,,,,,,,,,,,,,,,,,,,,,,,,13.7,10,4,133,85,91,1028,0,,0,4,4,"Bad Godesberg",1,0,U1.000|6:00-U0.599|3:40,,"Bonn Running",,,4375,,657,3,17507738451,0,168070,250480,30378,,90749098,,,,,,,,,,,,,,,,,,,,,,,,,,,,,,,,,,,,,,,,,
113463201,82e13105-9fc6-458b-a670-5fe976b79abc,1731442793,60,1731568922,,0,0,1.71,618,618,4,5,6,7,0,0,0,,,,113,119,130,,130,6,57.49,28.33,57.61,1,57.48,135,17,,1.2,0,,100,,171,,7,1,9,78,9.96,10.01,10.02,7.2,4.9,279,279,,0,280,280,,,,,98,97,98,97,"10,39,45,4,1,0,0,0,0","6,94,0,0,0","0,1,91,8,0",,,,,106,286,,97,92,,,,,,,,,,,,,,,,,,,,,,,,,,,,,,,,10.2,7,5,53,87,78,1032,0,,1,4,4,"Bad Godesberg",1,0,U1.000|5:58-U0.713|4:19,,"Bonn Running",,,4375,,657,3,17533774530,0,168070,250480,30378,,91029528,,,,,,,,,,,,,,,,,,,,,,,,,,,,,,,,,,,,,,,,,
113463205,f8f9f848-3c4b-4b97-b574-39611349d042,1731523153,60,1731568927,,0,0,2.85,1056,1121,4,9,9,9,0,0,0.07,,0.95,,190,124,133,,129,10,53.21,28.75,53.19,1,57.48,409,23,,1.6,0,,100,,281,,7,1,17,77,9.69,9.78,9.74,4.3,4.4,272,268,,0,273,270,,,,,97,96,97,96,"21,42,32,3,1,0,0,0,0","1,99,0,0,0","2,1,94,3,0",,,,,105,288,,96,91,,,,,,,,,,,,,,,,,,,,,,,,,,,,,,,,12.9,8,8,275,88,97,1031,0,,1,4,4,"Bad Godesberg",1,0,U1.000|5:52-U1.000|6:12-U0.853|5:32,,"Bonn Running",,,4375,,657,3,17533775007,0,168070,250480,30378,,91029531,,,,,,,,,,,,,,,,,,,,,,,,,,,,,,,,,,,,,,,,,
113506402,4ad157e5-9d38-4688-bb75-6fd102be5730,1731605515,60,1731606740,,0,0,3.68,1345,1884,9,10,11,10,0,0,0.01,,,,252,129,146,,144,10,51.66,29.72,51.8,1,57.19,876,31,97,2,0,97,96,,358,,7,1,25,78,9.84,9.86,9.88,6,3.6,277,273,,0,278,274,,,,,97,94,97,94,"13,44,40,4,0,0,0,0,0","4,89,7,0,0","2,1,88,10,0",,,,,105,284,,95,90,,,,,,,,,,,,,,,,,,,,,,,,,,,,,,,,18.4,9,7,309,83,92,1028,0,,1,4,4,"Bad Godesberg",1,0,U1.000|6:08-U1.000|6:00-U1.000|6:09-U0.676|4:08,,"Bonn Running",,,4375,,657,3,17537780958,0,168070,250480,30378,,91066919,,,,,,,,,,,,,,,,,,,,,,,,,,,,,,,,,,,,,,,,,
113510823,9859ee27-90d8-4a1f-93f8-980f02bc2035,1731610551,60,1731609031,,0,0,2.55,1970,1970,100,103,102,106,0,2.6,0.94,,,365,188,100,116,,99,17,,,,1,57.19,793,8,,0.5,0,,100,,243,,,,16,55,,4.75,,-42.2,,,,,,,,,,,,,,,,"62,38,0,0,0,0","48,52,0,0,0",,1819,2,,,,,,,,,,,,,,,,,,,,,,,,,,,,,,,,,,,,,,,6.1,9,6,298,83,97,1028,0,,1,4,4,"Bad Godesberg",1,0,,,"Bonn Hiking",,,4375,,657,3,17538096052,0,168075,,30378,,91071109,,,,,,,,,,,,,,,,,,,,,,,,,,,,,,,,,,,,,,,,4,
113558158,05b638b6-e767-49b1-9876-e7218ea1320f,1731665765,60,1731665132,,0,0,,2783,2783,,,,,0,,,,,,317,108,145,86,133,35,,,,1,57.19,74,19,,1.1,0.1,,100,,431,,,,30,,,,,,,,,,,,,,,,,,,,,,"29,70,1,0,0",,153,1,,,,,,,,,,,,,,,,,,,,,,,,,,,,,,,,,,,,,,,10.9,,,,,,,,,,1,,,1,0,,,Strength,,,4375,,657,3,17542106573,0,168074,,30378,,91112655,,,,,,,,,,,,,,,,,,,,,,,,,,,,,,,,,,,,,,,,,
113578251,e39d5cdc-f703-4263-9376-510d4b0efc50,1731688574,60,1731685632,,0,0,1.68,586,586,8,8,9,8,0,0,0.12,1.14,,,117,134,142,,139,10,52.24,29.46,52.55,1,57.06,439,21,96,1.5,0,96,96,,162,,7,2,12,78,10.32,10.3,10.35,4.7,1.9,294,292,,0,295,294,,,,,98,96,98,96,"1,22,69,8,1,0,0,0,0","3,91,7,0,0","1,0,68,31,0",,,,,110,283,,98,89,,,,,,,,,,,,,,,,,,,,,,,,,,,,,,,,16.9,9,1,3,78,64,1027,0,,0,4,4,"Bad Godesberg",1,0,U1.000|5:50-U0.676|3:55,,"Bonn Running",,,4375,,657,3,17544417440,0,168070,250480,30378,,91130550,,,,,,,,,,,,,,,,,,,,,,,,,,,,,,,,,,,,,,,,,
113630443,46458d12-e806-4de8-9572-c2eb2b7ad73f,1731750976,60,1731749305,,0,0,3.18,1140,1154,10,6,10,5,0,0,0,,,,227,132,147,101,144,8,51.45,30.14,51.73,1,56.96,827,37,99,2.1,0,99,96,,302,,7,1,22,79,10.09,10.11,10.14,15.9,15.1,283,282,,0,285,284,,,,,96,94,96,94,"13,35,36,16,0,0,0,0,0","2,83,15,0,0","1,1,73,26,0",,,,,106,279,,94,89,,,,,,,,,,,,,,,,,,,,,,,,,,,,,,,,19.1,6,5,200,83,55,1022,1,,0,3,4,"Bad Godesberg",1,0,U1.000|5:35-U1.000|5:58-U1.000|6:18-U0.179|1:10,,"Bonn Running",,,4375,,657,3,17549097207,0,168070,250480,30378,,91177548,,,,,,,,,,,,,,,,,,,,,,,,,,,,,,,,,,,,,,,,,
113739959,a418f98d-be69-4fe2-b0bc-735882e3820c,1731844267,60,1731845040,,0,0,,3130,3130,,,,,0,,,,,,363,116,160,,152,50,,,,1,56.96,808,46,,2.2,0.4,,100,,573,,,,42,,,,,,,,,,,,,,,,,,,,,,"18,69,13,0,0",,,,,,,,,,,,,,,,,,,,,25,,,,,,,,,,,,,,,,,,,,,27,,,,,,,,,,1,,,1,0,,,Strength,,,4375,,657,3,17558641825,0,168074,,30378,11724402,91272851,522,19,17,85,65,1.31,6.14,0.97,0.86,0.41,1.62,75,9,26,5.5,,0,,0,108,0,,,,,,,,,,,,,,,,,,,,
113813374,44c10409-0ebd-42d7-b3b3-d56a95d6f083,1731915165,60,1731912906,,0,0,3.43,1154,1159,8,8,9,7,0,0,0.06,,,,251,147,185,107,182,28,48.4,32.67,48.54,1,56.81,1081,53,95,2.5,0,95,101,,317,,7,3,33,79,10.69,10.71,10.73,-11.1,-11.5,302,302,,0,302,302,,,,,95,91,95,91,"1,8,56,34,1,0,0,0,0","2,20,64,13,1","0,1,48,51,0",,,,,113,277,,99,88,,,,,,,,,,,36,,,,,,,,,,,,,,,,,,,,,36.9,6,14,280,91,83,1011,0,,1,4,4,"Bad Godesberg",1,0,U1.000|5:52-U1.000|5:35-U1.000|5:25-U0.426|2:22,,"Bonn Running",,,4375,,657,3,17564411203,0,168070,250480,30378,11730785,91334788,412,60,54,53,18,16.06,23.79,3.47,0.55,0.36,0.86,1,29,63,20.5,208,0,12.53,0,199,0,,,,,,,,,,,,,,,,,,,,
113813799,90342e87-18c3-4b76-8931-07bc6a760252,1731916639,60,1731913540,,0,0,0.89,360,360,4,4,4,4,0,0,0,3.83,,,42,105,124,,111,31,,,,1,56.81,1073,3,,0.2,0,,100,,43,,,,3,,,12.81,,35.7,54.8,21,14,,1,39,35,,,,,90,90,90,90,"68,21,11,0,0,0,0","24,76,0,0,0","99,1,0,0,0",,,,,,,,,,,,,,,,,,,,23,,,,,,,,,,,,,,,,,,,,,3.1,6,14,280,91,83,1011,0,,0,4,4,"Bad Godesberg",1,0,,,"Bonn Cycling",,,4375,,657,3,17564465168,0,168072,,30378,11730814,91335171,572,16,14,54,0,1.44,6.74,0.8,1.39,1.39,1.39,100,0,1,7,,0,,0,,0,,,,,,,,,,,,,,,,,,,,
113817506,86f98247-8742-44c3-af43-ddeae97f7dcc,1731917568,60,1731917986,,0,0,,3596,3596,,,,,0,,,,,,315,101,136,92,134,46,,,,1,56.81,998,10,,0.7,0,,100,,476,,,,31,,,,,,,,,,,,,,,,,,,,,,"51,49,0,0,0",,,,,,,,,,,,,,,,,,,,,21,,,,,,,,,,,,,,,,,,,,,7.3,,,,,,,,,,1,,,1,0,,,Strength,,,4375,,657,3,17564821092,0,168074,,30378,11731058,91338658,597,39,35,90,53,5.76,18.05,1.51,0.93,0.61,1.34,95,0,14,16.6,,0,,0,142,0,,,,,,,,,,,,,,,,,,,,
113837188,1047dd2b-3b3f-411e-a17b-7de5a8ef2ad1,1731934525,60,1731935711,,0,0,13.39,4374,4486,180,183,188,187,0,2.1,0.43,0.95,1.07,479,947,148,161,118,146,17,49.73,37.03,50.54,1,56.64,2265,146,99,3.6,0,99,98,,1215,,11,2,123,80,11.4,11.36,11.47,-5.4,-0.1,321,320,,0,325,325,,,,,84,73,84,73,"19,6,9,33,26,7,0,0,0","0,16,84,0,0","1,1,18,79,1",,,,,115,270,,98,85,,,,,,,,,,,,,,,,,,,,,,,,,,,,,,,,41.6,8,12,288,79,77,1013,1,,0,4,4,"Bad Godesberg",1,0,U1.000|6:19-U1.000|5:39-U1.000|6:58-U1.000|6:53-U1.000|5:34-U1.000|5:18-U1.000|5:09-U1.000|5:00-U1.000|5:07-U1.000|4:46-U1.000|4:32-U1.000|4:47-U1.000|4:52-U0.385|2:00,,"Bonn Running",,,4375,,657,3,17566548155,0,168070,250480,30378,,91353139,,,,,,,,,,,,,,,,,,,,,,,,,,,,,,,,,,,,,,,,"4,4",
113916690,9667675f-8b94-459f-ac90-c230494de130,1732015730,60,1732015693,,0,0,,3392,3392,,,,,0,,,,,,418,116,154,,135,68,,,,1,56.81,936,38,,2,0.5,,100,,639,,,,44,,,,,,,,,,,,,,,,,,,,,,"14,82,4,0,0",,,,,,,,,,,,,,,,,,,,,,,,,,,,,,,,,,,,,,,,,,15.7,,,,,,,,,,1,,,1,0,,,Strength,,,4375,,657,3,17573524480,0,168074,,30378,,91423793,,,,,,,,,,,,,,,,,,,,,,,,,,,,,,,,,,,,,,,,,
113950085,e9efda91-f8f4-4661-b3a2-1ceacaee16ec,1732038114,60,1732040492,,0,0,5.01,1749,3592,32,25,31,26,0,0.1,0.28,1.07,1.05,,367,141,157,,133,18,48.9,31.98,49.37,1,56.91,1222,76,100,2.8,0.4,100,101,,456,,7,3,43,74,10.41,10.85,10.92,4.2,-0.3,311,296,,0,323,317,,,,,90,80,90,84,"19,5,15,40,17,2,0,1,0","0,30,70,0,0","9,5,13,68,5",,,,,116,270,,96,83,,,,,,,,,,,,,,,,,,,,,,,,,,,,,,,,30.3,6,24,255,82,97,993,0,,1,11,4,Nordstadt,1,0,U1.000|6:26-U1.000|4:57-U1.000|5:30-U1.000|5:25-U1.000|6:49-U0.006|0:03,,"Bonn Running",,,4375,,657,3,17576470815,0,168070,250480,30378,,91454216,,,,,,,,,,,,,,,,,,,,,,,,,,,,,,,,,,,,,,,,,
113953017,33d16e36-769f-4398-8794-fd23ac0d3a5e,1732041788,60,1732041747,,0,0,7.98,2267,2267,6,9,0,9,0,0,0.05,,,,587,165,188,,176,50,50.44,42.01,50.46,1,56.92,4320,301,102,4.3,2.9,102,101,,592,,18,4,97,76,12.69,13.89,13.91,8.9,-0.4,388,370,,0,414,409,,,,,57,16,62,33,"20,0,0,0,2,40,36,1,0","0,11,16,58,16","13,6,1,1,80",,,,,139,233,,102,73,,,,,,,,,,,,,,,,,,,,,,,,,,,,,,,,118.8,5,27,254,83,91,993,0,,1,11,4,Nordstadt,1,0,U1.500|6:19-U0.100|1:21-U1.500|6:17-U0.090|1:19-U1.510|6:03-U0.100|1:15-U1.500|5:49-U0.100|1:15-U1.500|5:36-U0.080|2:32,,"Bonn Track Running",,,4375,,657,3,17576654944,0,168070,250480,30378,,91456993,,,,,,,,,,,,,,,,,,,,,,,,,,,,,,,,,,,,,,,,,
113953021,5112bbd4-c7cb-4cf1-a763-bed2d5474480,1732044170,60,1732041749,,0,0,2,667,721,6,4,7,5,0,0,0.1,,,,148,146,157,104,147,14,49.38,31.58,49.63,1,56.91,4328,35,98,2.1,0,98,97,,183,,7,3,18,79,10.86,10.98,11,0.1,0,314,309,,0,316,315,,,,,30,28,30,28,"8,6,26,52,7,2,0,0,0","0,11,89,0,0","1,2,15,81,1",,,,,114,270,,97,85,,,,,,,,,,,,,,,,,,,,,,,,,,,,,,,,25.7,5,27,257,84,86,994,0,,1,11,4,Nordstadt,1,0,U1.000|5:29-U1.000|5:37-U0.002|0:01,,"Bonn Running",,,4375,,657,3,17576655595,0,168070,250480,30378,,91456997,,,,,,,,,,,,,,,,,,,,,,,,,,,,,,,,,,,,,,,,,
114116787,6f809019-989d-4f77-b29f-e26415b8e736,1732104680,60,1732111055,,0,0,14.27,4420,4533,41,42,62,61,0,0,0.08,,,,1022,152,170,,155,12,51.16,39.6,51.34,1,56.87,4351,186,99,3.9,0.5,99,95,,1227,,15,2,134,80,11.65,11.63,11.66,2.5,2.5,335,333,,0,336,335,,,,,68,53,68,53,"0,1,8,66,24,1,0,0,0","0,9,83,8,0","0,0,3,93,3",,,,,121,267,,101,83,,,,,,,,,,,,,,,,,,,,,,,,,,,,,,,,54.4,4,23,275,82,95,1003,1,,0,4,4,"Bad Godesberg",1,0,U1.000|5:17-U1.000|5:08-U1.000|5:19-U1.000|5:11-U1.000|5:10-U1.000|5:19-U1.000|5:16-U1.000|5:05-U1.000|5:07-U1.000|5:09-U1.000|5:05-U1.000|5:07-U1.000|5:19-U1.000|4:52-U0.271|1:17,,"Bonn Running",,,4375,,657,3,17582404623,0,168070,250480,30378,,91609908,,,,,,,,,,,,,,,,,,,,,,,,,,,,,,,,,,,,,,,,,
114162785,31297f23-cb64-4e8c-935b-b08b42e60eea,1732129316,60,1732129332,,0,0,,3596,3596,,,,,0,,,,,,369,107,141,,141,53,,,,1,56.87,3958,23,,1.5,0,,100,,630,,,,36,,,,,,,,,,,,,,,,,,,,,,"39,61,0,0,0",,,,,,,,,,,,,,,,,,,,,,,,,,,,,,,,,,,,,,,,,,10.3,,,,,,,,,,1,,,1,0,,,Strength,,,4375,,657,3,17584720670,0,168074,,30378,,91649619,,,,,,,,,,,,,,,,,,,,,,,,,,,,,,,,,,,,,,,,,
114229663,059453fa-7208-4fde-94ce-bf5b5aee116a,1732176850,60,1732176607,,0,0,,3334,3334,,,,,0,,,,,,342,103,140,,117,48,,,,1,56.87,3172,15,,1.1,0,,100,,543,,,,30,,,,,,,,,,,,,,,,,,,,,,"44,56,0,0,0",,,,,,,,,,,,,,,,,,,,,,,,,,,,,,,,,,,,,,,,,,7.3,,,,,,,,,,1,,,1,0,,,Strength,,,4375,,657,3,17588002413,0,168074,,30378,,91708886,,,,,,,,,,,,,,,,,,,,,,,,,,,,,,,,,,,,,,,,,
114254784,8a5c15ec-bb86-49a3-b085-3b43cf0aafb4,1732194728,60,1732195833,,0,0,13.49,4467,4576,187,184,196,191,0,2,0.39,0.96,1.08,506,973,147,161,,158,28,49.36,36.46,50.22,1,56.82,4352,144,98,3.5,0,98,97,,1240,,11,1,123,79,11.27,11.25,11.38,-4.9,1.6,324,322,,0,330,328,,,,,80,69,80,69,"19,5,8,43,19,6,0,0,0","0,17,83,0,0","1,3,12,83,1",,,,,115,271,,98,85,,,,,,,,,,,,,,,,,,,,,,,,,,,,,,,,39.8,4,6,213,69,90,998,1,,0,4,4,"Bad Godesberg",1,0,U1.000|6:19-U1.000|5:37-U1.000|7:29-U1.000|6:53-U1.000|5:27-U1.000|5:23-U1.000|5:18-U1.000|5:08-U1.000|5:12-U1.000|5:00-U1.000|4:33-U1.000|4:41-U1.000|4:55-U0.485|2:32,,"Bonn Running",,,4375,,657,3,17589872739,0,168070,250480,30378,,91731409,,,,,,,,,,,,,,,,,,,,,,,,,,,,,,,,,,,,,,,,"4,4",
114338905,38dd8284-9b59-494f-a76e-98d4bafae5e4,1732262174,60,1732263139,,0,0,14.14,4138,4432,41,41,47,47,0,0,0.09,,,,958,154,165,,156,11,53.86,42.28,54.05,1,56.79,4336,199,100,4.1,0,100,98,,1149,,11,3,133,81,12.33,12.36,12.37,3.2,2.8,347,346,,0,349,348,,,,,74,61,74,61,"2,1,4,17,69,8,0,0,0","2,4,86,9,0","0,0,3,95,2",,,,,127,258,,102,80,,,,,,,,,,,,,,,,,,,,,,,,,,,,,,,,53.3,,15,244,89,7,1002,,,0,2,1,"Bad Godesberg",1,0,U1.000|5:01-U1.000|4:40-U1.000|4:47-U1.000|4:47-U1.000|4:42-U1.000|4:51-U1.000|4:54-U1.000|4:45-U1.000|4:40-U1.000|4:48-U1.000|4:43-U1.000|4:56-U1.000|5:37-U1.000|5:01-U0.144|0:46,,"Bonn Running",,,4375,,657,3,17595162102,0,168070,250480,30378,,91808206,,,,,,,,,,,,,,,,,,,,,,,,,,,,,,,,,,,,,,,,,
114475297,83506b4a-4829-4388-b515-dc856215f8cf,1732392098,60,1732389296,,0,0,0.89,767,767,9,0,6,4,0,0.1,0.32,,,,40,77,89,,89,12,,,,1,56.81,2206,1,,,0,,100,,104,,,,2,49,,4.69,,25.2,,,,,,,,,,,,,,,,"58,31,0,0,0,11","100,0,0,0,0",,629,2,,,,,,,,,,,,,,,,,,,,,,,,,,,,,,,,,,,,,,,0.9,6,18,178,62,92,1012,0,,1,4,4,"Bad Godesberg",1,0,,,"Bonn Hiking",,,4375,,657,3,17606462404,0,168075,,30378,,91932593,,,,,,,,,,,,,,,,,,,,,,,,,,,,,,,,,,,,,,,,,
114475298,fbba7038-15d5-43f9-ad41-a889d94b1871,1732383526,60,1732389297,,0,0,7.3,2388,2499,25,23,33,31,0,0,0.06,,,,502,139,153,,147,11,53.97,35.37,54.22,1,56.81,2317,83,97,2.9,0,97,101,,662,,7,2,54,79,11.04,11.05,11.08,1.2,-0.8,315,313,,0,316,315,,,,,90,84,90,84,"3,6,28,57,6,0,0,0,0","1,49,50,0,0","1,0,22,78,0",,,,,116,274,,100,86,,,,,,,,,,,,,,,,,,,,,,,,,,,,,,,,27.2,5,18,155,64,91,1013,0,,1,4,4,"Bad Godesberg",1,0,U1.000|5:47-U1.000|5:14-U1.000|5:20-U1.000|5:24-U1.000|5:30-U1.000|5:16-U1.000|5:30-U0.303|1:47,,"Bonn Running",,,4375,,657,3,17606462276,0,168070,250480,30378,,91932594,,,,,,,,,,,,,,,,,,,,,,,,,,,,,,,,,,,,,,,,,
114475299,d076a01d-23de-47ae-bb51-1cfb5ddce1bd,1732388189,60,1732389296,,0,0,,3028,3028,,,,,0,,,,,,282,99,141,,108,48,,,,1,56.81,2232,16,,1,0.1,,100,,464,,,,24,,,,,,,,,,,,,,,,,,,,,,"54,46,0,0,0",,,,,,,,,,,,,,,,,,,,,,,,,,,,,,,,,,,,,,,,,,9.5,,,,,,,,,,1,,,1,0,,,Strength,,,4375,,657,3,17606462364,0,168074,,30378,,91932595,,,,,,,,,,,,,,,,,,,,,,,,,,,,,,,,,,,,,,,,,
114508342,990f7e04-2acb-40f6-96d0-9cb159543bc2,1732435721,60,1732437018,,0,0,16.61,4604,4625,42,45,95,98,0,0,0.09,1.01,,,1096,152,167,110,163,18,58.67,45.6,58.84,1,56.93,4320,235,102,4.3,0.1,102,102,,1278,,11,3,144,82,13,13.03,13.06,4.1,4.6,369,369,,0,372,371,,,,,77,59,77,59,"1,0,1,8,48,41,0,0,0","0,7,80,12,0","0,0,2,89,9",,,,,132,254,,105,80,,,,,,,,,,,,,,,,,,,,,,,,,,,,,,,,56.3,12,25,204,65,87,1012,0,,0,11,4,Dottendorf,1,0,U1.000|5:05-U1.000|4:55-U1.000|4:41-U1.000|4:38-U1.000|4:37-U1.000|4:31-U1.000|4:36-U1.000|4:32-U1.000|4:28-U1.000|4:29-U1.000|4:27-U1.000|4:32-U1.000|4:27-U1.000|4:28-U1.000|4:57-U1.000|4:37-U0.612|2:47,,"Bonn Running",,,4375,,657,3,17609058155,0,168070,250480,30378,,91959239,,,,,,,,,,,,,,,,,,,,,,,,,,,,,,,,,,,,,,,,,
114525992,595ba89e-cb66-4a4e-84be-af8c0a832307,1732445135,60,1732446472,,0,0,,4897,4897,,,,,0,,,,,,541,112,142,,141,42,,,,1,56.93,4164,36,,2,0.4,,100,,978,,,,58,,,,,,,,,,,,,,,,,,,,,,"17,83,0,0,0",,,,,,,,,,,,,,,,,,,,,,,,,,,,,,,,,,,,,,,,,,10.5,,,,,,,,,,1,,,1,0,,,Strength,,,4375,,657,3,17610411098,0,168074,,30378,,91973050,,,,,,,,,,,,,,,,,,,,,,,,,,,,,,,,,,,,,,,,,
114637907,3a5e4f87-ed66-42ea-aefb-1e31a21accb1,1732522157,60,1732524861,,0,0,,3183,3183,,,,,0,,,,,,335,103,155,87,114,49,,,,1,56.93,2514,24,,1.1,0.6,,100,,485,,,,31,,,,,,,,,,,,,,,,,,,,,,"44,54,2,0,0",,,,,,,,,,,,,,,,,,,,,,,,,,,,,,,,,,,,,,,,,,11.9,,,,,,,,,,1,,,1,0,,,Strength,,,4375,,657,3,17617185047,0,168074,,30378,,92074892,,,,,,,,,,,,,,,,,,,,,,,,,,,,,,,,,,,,,,,,,
114650045,5beccb39-ac0f-4b49-afe8-b53b8b9b8983,1732535732,60,1732537499,,0,0,14.17,4177,4388,35,34,52,52,0,0,0.09,0.98,,,957,151,166,,164,12,54.89,41.93,55.06,1,56.89,4347,189,102,3.9,0,102,98,,1160,,13,2,130,80,12.24,12.25,12.27,6.3,5.8,348,347,,0,349,348,,,,,77,64,77,64,"1,1,4,26,62,6,0,0,0","3,5,87,4,0","0,0,1,96,3",,,,,127,262,,103,81,,,,,,,,,,,,,,,,,,,,,,,,,,,,,,,,53.7,17,20,186,62,80,1006,1,,0,4,4,"Bad Godesberg",1,0,U1.000|5:03-U1.000|4:47-U1.000|4:54-U1.000|4:48-U1.000|4:42-U1.000|4:47-U1.000|4:51-U1.000|4:51-U1.000|4:43-U1.000|4:48-U1.000|4:55-U1.000|5:03-U1.000|5:21-U1.000|5:09-U0.170|0:55,,"Bonn Running",,,4375,,657,3,17618370241,0,168070,250480,30378,,92086040,,,,,,,,,,,,,,,,,,,,,,,,,,,,,,,,,,,,,,,,,
114787521,5e5cecd6-1777-4cba-8d8a-7cdeb0b2f276,1732644843,60,1732646665,,0,0,3.83,1293,1752,14,13,21,17,0,0,0.1,,,,257,136,158,,149,42,53.38,32.76,53.64,1,56.97,2399,64,101,2.5,0.4,101,102,,305,,7,3,29,72,10.74,11.67,11.71,22.8,8.4,310,296,,0,340,335,,,,,91,76,92,87,"26,2,5,11,36,18,0,1,1","2,46,52,0,0","17,6,6,62,9",,,,,123,265,,97,79,,,,,,,,,,,,,,,,,,,,,,,,,,,,,,,,33,8,8,209,81,49,1020,0,,1,3,4,Nordstadt,1,0,U1.000|5:14-U1.000|4:43-U1.000|4:33-U0.833|7:03,,"Bonn Running",,,4375,,657,3,17628937745,0,168070,250480,30378,,92208818,,,,,,,,,,,,,,,,,,,,,,,,,,,,,,,,,,,,,,,,,
114787533,a4a13b81-81de-44dc-8cb5-c4970c0ab0d2,1732646822,60,1732646672,,0,0,8.78,2481,2481,7,0,0,0,0,0,0.02,,,,615,162,177,,176,50,52.21,42.54,52.31,1,57.09,5760,370,110,4,3.8,110,105,,660,,16,4,96,73,12.78,13.68,13.73,8.8,-1.7,398,359,,0,413,393,,,,,37,1,58,25,"27,1,1,1,2,4,47,17,0","0,4,39,57,0","19,6,1,1,73",,,,,145,212,,98,68,,,,,,,,,,,,,,,,,,,,,,,,,,,,,,,,75.3,8,8,209,82,43,1021,0,,1,3,4,Nordstadt,1,0,U0.400|1:32-U0.040|0:31-U0.400|1:31-U0.040|0:28-U0.400|1:28-U0.040|0:32-U0.400|1:29-U0.030|0:30-U0.410|1:29-U0.030|0:32-U0.400|1:29-U0.030|0:30-U0.400|1:31-U0.030|0:30-U0.410|1:29-U0.030|0:33-U0.400|1:28-U0.040|0:32-U0.400|1:26-U0.030|0:32-U0.410|1:27-U0.030|0:32-U0.410|1:27-U0.040|0:32-U0.400|1:25-U0.030|0:33-U0.400|1:27-U0.040|0:33-U0.410|1:24-U0.040|0:35-U0.400|1:24-U0.040|0:37-U0.400|1:26-U0.040|0:36-U0.420|1:37-U0.020|0:23-U0.400|1:26-U0.030|0:34-U0.400|1:26-U0.060|1:55,,"Bonn Track Running",,,4375,,657,3,17628939054,0,168070,250480,30378,,92208829,,,,,,,,,,,,,,,,,,,,,,,,,,,,,,,,,,,,,,,,,
114787541,c308ecc0-b559-4567-820b-86aa3f9dc03e,1732649386,60,1732646677,,0,0,2.1,729,841,6,4,7,6,0,0,0.1,0.65,,,147,135,151,,151,11,52.06,30.29,52.31,1,57.09,5745,28,99,2,0,99,99,,193,,7,3,15,79,10.41,10.75,10.76,5,-1,291,291,,0,304,304,,,,,22,20,22,20,"11,11,29,42,6,1,0,0,0","0,72,28,0,0","5,3,33,58,1",,,,,109,269,,93,85,,,,,,,,,,,,,,,,,,,,,,,,,,,,,,,,17.5,8,8,209,82,43,1021,0,,1,3,4,Nordstadt,1,0,U1.000|5:25-U1.000|5:38-U0.103|1:07,,"Bonn Running",,,4375,,657,3,17628939764,0,168070,250480,30378,,92208834,,,,,,,,,,,,,,,,,,,,,,,,,,,,,,,,,,,,,,,,,
114844990,064ddaec-9915-463d-a4cf-8d1b6f64f95e,1732694923,60,1732697987,,0,0,,3390,3390,,,,,0,,,,,,296,96,142,,139,61,,,,1,57.09,4946,11,,0.6,0.1,,100,,438,,,,25,,,,,,,,,,,,,,,,,,,,,,"65,35,0,0,0",,,,,,,,,,,,,,,,,,,,,,,,,,,,,,,,,,,,,,,,,,5.8,,,,,,,,,,1,,,1,0,,,Strength,,,4375,,657,3,17632739272,0,168074,,30378,,92261110,,,,,,,,,,,,,,,,,,,,,,,,,,,,,,,,,,,,,,,,,
114844991,689254d2-c7a6-4580-bf1c-bd4d05d4e38b,1732694128,60,1732697987,,0,0,0.93,251,251,5,4,5,4,0,0,0,,,,28,101,113,,112,24,,,,1,57.09,5009,2,,0.1,0,,100,,33,,,,2,,,14.45,,4.6,36.7,29,23,,1,36,34,,,,,66,66,66,66,"57,41,2,0,0,0,0","48,52,0,0,0","100,0,0,0,0",,,,,,,,,,,,,,,,,,,,,,,,,,,,,,,,,,,,,,,,,2,7,11,135,90,95,1019,0,,1,4,4,"Bad Godesberg",1,0,,,"Bonn Cycling",,,4375,,657,3,17632739206,0,168072,,30378,,92261111,,,,,,,,,,,,,,,,,,,,,,,,,,,,,,,,,,,,,,,,,
114872960,1b56edfb-3836-48bb-bdad-6e4897c6c5bf,1732716735,60,1732719858,,0,0,7.03,2310,3317,17,2,31,15,0,0,0.06,,,,463,135,146,,131,9,55.71,35.09,56.02,1,57.09,4584,82,100,2.9,0,100,100,,640,,11,1,48,80,11.04,10.98,11.06,2.9,2,308,307,,0,309,307,,,,,67,63,67,63,"3,4,34,54,5,0,0,0,0","1,71,28,0,0","1,1,22,76,0",,,,,114,270,,98,86,,,,,,,,,,,,,,,,,,,,,,,,,,,,,,,,23.9,11,22,185,80,94,1013,0,,0,6,4,"Bad Godesberg",1,0,U0.925|5:03-U1.000|5:33-U0.400|2:13-U1.000|5:27-U1.000|5:29-U1.000|5:33-U1.000|5:22-U0.705|3:49,,"Bonn Running",,,4375,,657,3,17634960328,0,168070,250480,30378,,92286681,,,,,,,,,,,,,,,,,,,,,,,,,,,,,,,,,,,,,,,,,
114884381,,1732718340,60,1732729239,,0,0,2.1,660,660,,,,,0,,,,,,148,,,,,,,33.97,,1,,,,,,,,,,,,,,16,,,,,,,,,,,,,,,,,,,,,,,,,,,,,,,,,,,,,,,,,,,,,,,,,,,,,,,,,,,,,,,,,,,,,,,,,,1,,,0,0,,,Running,,,connect,,,3,17636125703,0,168070,250480,30378,,92297245,,,,,,,,,,,,,,,,,,,,,,,,,,,,,,,,,,,,,,,,,
114894681,92a58daa-0fff-4895-bc84-c34c5d939bd3,1732732973,60,1732734761,,0,0,,1729,1729,,,,,0,,,,,,201,106,162,,162,64,,,,1,57.09,4342,31,,0.8,1.3,,100,,328,,,,17,,,,,,,,,,,,,,,,,,,,,,"29,71,0,1,0",,,,,,,,,,,,,,,,,,,,,,,,,,,,,,,,,,,,,,,,,,8.2,,,,,,,,,,1,,,1,0,,,Strength,,,4375,,657,3,17636912849,0,168074,,30378,,92306969,,,,,,,,,,,,,,,,,,,,,,,,,,,,,,,,,,,,,,,,,
114968754,7e5ad49f-f7cc-4418-b922-b5b5fd16a8cc,1732797767,60,1732812102,,0,0,2.1,603,638,,,,,0,,,,,,83,110,124,,124,17,,,,1,57.09,3042,6,,0.4,0,,100,,72,,,,7,28,,12.57,,-1.2,-9.3,121,120,,0,122,122,,,,,,,,,"0,1,99,0,0,0","1,99,0,0,0","6,94,0,0,0",285,1,2096,,,,,,,,,,,,,,,,,,,,,,,,,,,,,,,,,,,,,,5.8,,,,,,,,,,1,,,1,0,,,"Indoor Rowing",,,4375,,657,3,17643215732,0,168075,,30378,,92374263,,,,,,,,,,,,,,,,,,,,,,,,,,,,,,,,,,,,,,,,,
114968759,b9348745-2e68-420c-a3a9-bfef3f73b20d,1732798555,60,1732812106,,0,0,,2398,2398,,,,,0,,,,,,236,101,146,,142,51,,,,1,57.09,3000,23,,1.3,0.3,,100,,400,,,,22,,,,,,,,,,,,,,,,,,,,,,"60,36,3,0,0",,,,2096,,,,,,,,,,,,,,,,,,,,,,,,,,,,,,,,,,,,,,13.2,,,,,,,,,,1,,,1,0,,,Strength,,,4375,,657,3,17643216381,0,168074,,30378,,92374267,,,,,,,,,,,,,,,,,,,,,,,,,,,,,,,,,,,,,,,,,
114979545,19c528d8-877e-4195-ad38-3f2de7019270,1732816983,60,1732818384,,0,0,13.71,4570,4920,133,134,139,139,0,0.9,0.32,0.96,1.04,351,952,139,155,,146,74,52.74,36.23,53.36,1,57.09,4322,136,100,3.4,0,100,100,,1267,,11,4,108,78,10.99,11.08,11.17,9.5,3.5,319,312,,0,322,319,,,,,82,72,82,72,"13,11,15,37,23,1,0,0,0","1,39,61,0,0","2,1,19,77,1",,,2096,,115,274,,100,87,,,,,,,,,,,,,,,,,,,,,,,,,,,,,,,,31.9,6,8,290,86,68,1029,0,,1,4,4,Venusberg,1,0,U1.000|5:33-U1.000|4:55-U1.000|5:11-U1.000|4:57-U1.000|5:14-U1.000|5:07-U1.000|4:58-U1.000|5:12-U1.000|5:25-U1.000|6:47-U1.000|5:32-U1.000|6:54-U1.000|6:09-U0.705|4:15,,"Bonn Running",,,4375,,657,3,17644109515,0,168070,250480,30378,,92384340,,,,,,,,,,,,,,,,,,,,,,,,,,,,,,,,,,,,,,,,4,
114980632,,1732822740,60,1732819203,1733236969,0,0,1,300,18000,,,,,0,,,,,,73,,,,,,,32.99,,1,,,,,,,,,,,,,,8,,,,,,,,,,,,,,,,,,,,,,,,,,,,,,,,,,,,,,,,,,,,,,,,,,,,,,,,,,,,,,,,,,,,,,,,,,1,,,0,0,,,"Uhr angehalten",,,connect,,,3,17644224095,0,168070,250480,30378,,92385342,,,,,,,,,,,,,,,,,,,,,,,,,,,,,,,,,,,,,,,,,
115040359,c3bc293a-f92a-4bb3-8987-289b6048c195,1732892947,60,1732893568,,0,0,14.15,3812,4077,39,36,46,43,0,0,0.07,,,,913,152,166,,160,16,60.77,46.54,61,1,57.12,4320,221,104,4.1,0.7,104,100,,1058,,13,3,116,81,13.41,13.44,13.46,3,1.9,379,378,,0,381,380,,,,,76,58,76,59,"1,1,1,4,35,53,5,0,0","1,6,86,6,0","0,0,0,81,18",,,2096,,137,250,,106,77,,,,,,,,,,,,,,,,,,,,,,,,,,,,,,,,49.2,7,10,133,76,52,1032,0,,0,3,4,"Bad Godesberg",1,0,U1.000|4:43-U1.000|4:12-U1.000|4:24-U1.000|4:23-U1.000|4:24-U1.000|4:31-U1.000|4:34-U1.000|4:33-U1.000|4:31-U1.000|4:36-U1.000|4:31-U1.000|4:19-U1.000|4:51-U1.000|4:15-U0.151|0:44,,"Bonn Running",,,4375,,657,3,17649617546,0,168070,250480,30378,,92438116,,,,,,,,,,,,,,,,,,,,,,,,,,,,,,,,,,,,,,,,,
115056121,a416d5a6-b7fe-4f3a-8a38-7cd08cbcb697,1732909352,60,1732906276,,0,0,1.67,500,500,,,,,0,,,,,,76,115,122,,121,7,,,,1,57.11,4108,8,,0.5,0,,100,,57,,,,6,28,,12.1,,5.6,12.7,106,106,,0,107,107,,,,,,,,,"0,1,99,0,0,0","2,98,0,0,0","36,64,0,0,0",236,1,2096,,,,,,,,,,,,,,,,,,,,,,,,,,,,,,,,,,,,,,5.7,,,,,,,,,,1,,,1,0,,,"Indoor Rowing",,,4375,,657,3,17651031061,0,168075,,30378,,92451875,,,,,,,,,,,,,,,,,,,,,,,,,,,,,,,,,,,,,,,,,
115068319,2b4b710c-b1f7-476a-8662-7edf7dcd81d1,1732909979,60,1732912015,,0,0,,3086,3086,,,,,0,,,,,,315,103,135,,112,40,,,,1,57.11,4054,11,,0.7,0,,100,,568,,,,26,,,,,,,,,,,,,,,,,,,,,,"36,64,0,0,0",,,,2096,,,,,,,,,,,,,,,,,,,,,,,,,,,,,,,,,,,,,,5.3,,,,,,,,,,1,,,1,0,,,Strength,,,4375,,657,3,17651507790,0,168074,,30378,,92463259,,,,,,,,,,,,,,,,,,,,,,,,,,,,,,,,,,,,,,,,,
115148600,f61be408-a243-47ed-8192-f9a94cebfc1c,1732995095,60,1732992071,,0,0,1.55,549,549,0,2,6,7,0,0,0.09,,0.96,,107,128,139,,133,11,54.2,28.7,54.12,1,57.11,2681,19,99,1.3,0,99,98,,151,,7,1,10,80,10.13,10.2,10.19,0,-4.6,289,289,,0,290,290,,,,,95,94,95,94,"3,32,53,11,0,0,0,0,0","5,95,0,0,0","0,1,71,28,0",,,,,106,279,,96,91,,,,,,,,,,,,,,,,,,,,,,,,,,,,,,,,12,4,9,143,75,21,1028,0,,1,2,4,"Bad Godesberg",1,0,U1.000|5:54-U0.552|3:15,,"Bonn Running",,,4375,,657,3,17658507807,0,168070,250480,30378,,92534696,,,,,,,,,,,,,,,,,,,,,,,,,,,,,,,,,,,,,,,,,
115194536,e4129ab4-a44f-4b8b-be1c-6f079aa68af6,1733048245,60,1733046863,,0,0,3.67,1314,1911,17,13,19,15,0,0,0.11,1.44,0.53,,263,136,164,106,148,25,49.65,30.46,50,1,57.15,1709,70,104,2.6,0.2,104,98,,290,,7,3,30,69,10.04,11.7,11.81,36.3,15.3,328,277,,0,348,330,,,,,92,87,93,88,"26,1,3,6,53,10,1,0,0","1,52,41,6,0","18,6,5,65,5",,,,,121,248,,92,76,,,,,,,,,,,,,,,,,,,,,,,,,,,,,,,,37.5,6,11,181,55,0,1022,1,,0,2,4,Venwegen,1,0,U1.000|4:40-U1.000|4:45-U1.000|4:43-U0.667|7:46,,"Stolberg (Rheinland) Running",,,4375,,657,3,17661887178,0,168070,250480,30378,,92577657,,,,,,,,,,,,,,,,,,,,,,,,,,,,,,,,,,,,,,,,,
115203613,53a0574e-df8f-46a9-baf9-65f3cca72984,1733050834,60,1733051737,,0,0,16.08,3714,3714,100,207,112,214,0,0.9,0.4,0.95,1.05,,1051,175,182,,178,9,59.33,56.17,59.3,1,57.11,5495,526,101,5,2.5,101,98,,1031,,20,4,190,85,15.49,15.77,15.52,7.5,4.1,425,425,,0,428,428,,,,,36,1,39,1,"0,0,0,3,6,19,54,18,0","0,1,0,97,2","0,0,0,23,77",,,,,153,224,,105,69,,,,,,,,,,,,,,,,,,,,,,,,,,,,,,,,113,7,9,177,60,10,1022,1,,0,2,4,Venwegen,1,0,U1.000|3:23-U1.000|3:28-U1.000|3:23-U1.000|3:34-U1.000|4:04-U1.000|3:53-U1.000|3:52-U1.000|3:57-U1.000|3:50-U1.000|4:14-U1.000|3:55-U1.000|3:44-U1.000|4:26-U1.000|4:05-U1.000|4:04-U1.000|3:44-U0.083|0:18,,"Stolberg (Rheinland) Running",,,4375,,657,3,17662755424,0,168070,250480,30378,,92585624,,,,,,,,,,,,,,,,,,,,,,,,,,,,,,,,,,,,,,,,,
115206102,8f429fb9-fc79-434e-98e1-77c8c17df372,1733056195,60,1733053441,,0,0,2.31,724,724,17,16,17,19,0,0.3,0.35,1.01,1.01,,165,144,161,,161,20,54.31,34.4,54.84,1,57.16,5426,43,99,2.2,0,99,100,,201,,7,1,19,84,11.53,11.47,11.59,-1.1,3.7,327,327,,0,330,330,,,,,1,1,1,1,"0,3,14,59,23,0,0,0,0","0,23,77,0,0","0,0,20,76,3",,,,,114,258,,94,82,,,,,,,,,,,,,,,,,,,,,,,,,,,,,,,,26.9,9,10,177,58,52,1021,1,,0,3,4,Aachen-Mitte,1,0,U1.000|5:26-U1.000|5:07-U0.305|1:31,,"Aachen Running",,,4375,,657,3,17663067174,0,168070,250480,30378,,92587888,,,,,,,,,,,,,,,,,,,,,,,,,,,,,,,,,,,,,,,,,
115285028,48676153-cce4-4ce9-af7b-27f8ce4bd3dc,1733121619,60,1733122423,,0,0,10.14,3351,4323,21,20,29,28,0,0,0.05,,,,719,143,152,,147,12,51.35,35.75,51.49,1,57.12,4327,98,96,3.1,0,96,98,,915,,11,1,84,81,10.92,10.95,10.97,4.2,2.6,311,310,,0,313,312,,,,,71,66,71,66,"2,9,34,49,5,1,0,0,0","1,15,84,0,0","1,0,31,68,0",,,,,112,269,,96,86,,,,,,,,,,,,,,,,,,,,,,,,,,,,,,,,31.3,6,11,152,93,62,1016,0,,1,3,4,"Bad Godesberg",1,0,U1.000|5:30-U1.000|5:15-U1.000|5:17-U1.000|5:22-U1.000|5:20-U1.000|5:34-U1.000|5:50-U1.000|5:46-U1.000|6:02-U1.000|5:13-U0.138|0:43,,"Bonn Running",,,4375,,657,3,17668800541,0,168070,250480,30378,,92659638,,,,,,,,,,,,,,,,,,,,,,,,,,,,,,,,,,,,,,,,,
115322289,217820ea-5190-49e0-bc20-baf744871ed4,1733147049,60,1733154610,,0,0,5.59,1933,2085,80,75,84,79,0,1.5,0.6,0.99,1.03,229,394,138,151,,147,14,50.87,32.56,51.83,1,57.1,4333,61,99,2.5,0,99,98,,529,,9,1,43,81,10.66,10.56,10.69,-4,2.3,301,300,,0,304,304,,,,,78,74,78,74,"18,22,23,25,11,1,0,0,0","1,51,48,0,0","0,1,47,52,0",,,,,107,274,,94,88,,,,,,,,,,,,,,,,,,,,,,,,,,,,,,,,26.2,10,21,227,86,67,1013,0,,0,4,4,Aachen-Mitte,1,0,U1.000|6:17-U1.000|6:15-U1.000|6:11-U1.000|5:18-U1.000|5:15-U0.586|2:58,,"Aachen Running",,,4375,,657,3,17671870483,0,168070,250480,30378,,92694303,,,,,,,,,,,,,,,,,,,,,,,,,,,,,,,,,,,,,,,,5,
115329215,5cb8c792-aa41-450f-baee-7fa67b0ea371,1733163712,60,1733160777,,0,0,,646,646,,,,,0,,,,,,103,117,139,,136,33,,,,1,57.12,4081,13,,0.9,0,,100,,134,,,,9,29,,,,,,,,,,,,,,,,,,,,,"6,94,0,0,0",,304,1,,,,,,,,,,,,,,,,,,,,,,,,,,,,,,,,,,,,,,,10,,,,,,,,,,1,,,1,0,,,"Indoor Rowing",,,4375,,657,3,17672609245,0,168075,,30378,,92700694,,,,,,,,,,,,,,,,,,,,,,,,,,,,,,,,,,,,,,,,,
115340706,e8fa3be2-b648-4a17-8a11-c6ce6cc17b29,1733164464,60,1733169222,,0,0,,3830,3830,,,,,0,,,,,,288,89,123,,112,54,,,,1,57.12,4016,7,,0.4,0,,100,,609,,,,22,,,,,,,,,,,,,,,,,,,,,,"73,27,0,0,0",,,,,,,,,,,,,,,,,,,,,,,,,,,,,,,,,,,,,,,,,,4.7,,,,,,,,,,1,,,1,0,,,Strength,,,4375,,657,3,17673764378,0,168074,,30378,,92711249,,,,,,,,,,,,,,,,,,,,,,,,,,,,,,,,,,,,,,,,,
115396235,8749513e-c4ee-43e4-ad3e-fe8cd83c4020,1733230208,60,1733229560,,0,0,,2853,2853,,,,,0,,,,,,275,100,142,,142,63,,,,1,57.12,2579,20,,1.1,0.2,,100,,466,,,,25,,,,,,,,,,,,,,,,,,,,,,"49,50,1,0,0",,,,,,,,,,,,,,,,,,,,,,,,,,,,,,,,,,,,,,,,,,10.9,,,,,,,,,,1,,,1,0,,,Strength,,,4375,,657,3,17678422214,0,168074,,30378,,92761883,,,,,,,,,,,,,,,,,,,,,,,,,,,,,,,,,,,,,,,,,
115432766,1ccb14df-0c90-4e19-9cee-9a709e6b2fc1,1733249327,60,1733252887,,0,0,3.38,1331,2092,3,5,9,13,0,0,0.06,,0.82,,242,126,145,98,126,36,48.45,27.02,48.47,1,57.17,2736,44,102,2.2,0.3,102,102,,296,,7,3,24,68,9.16,10.26,10.28,21.6,4,281,252,,0,303,293,,,,,95,89,95,92,"30,4,15,42,7,1,0,1,0","8,86,6,0,0","20,7,14,57,3",,,,,112,272,,91,81,,,,,,,,,,,,,,,,,,,,,,,,,,,,,,,,19.5,5,7,277,88,70,1022,0,,1,4,4,Nordstadt,1,0,U1.000|5:27-U1.000|5:23-U1.000|6:26-U0.378|4:56,,"Bonn Running",,,4375,,657,3,17681333688,0,168070,250480,30378,,92790541,,,,,,,,,,,,,,,,,,,,,,,,,,,,,,,,,,,,,,,,,
115432779,260f12d4-46bf-4785-8596-8dee96856bd6,1733251752,60,1733252895,,0,0,8.07,2217,2217,6,8,0,7,0,0,0.05,,,,561,161,181,,177,51,54.56,43.73,54.59,1,57.46,5760,283,109,3.9,3,109,103,,584,,18,3,88,75,13.12,14.1,14.1,14.1,3.5,397,370,,0,420,405,,,,,53,21,73,53,"24,1,1,1,1,3,56,13,0","1,7,28,64,0","20,4,1,0,75",,,,,146,211,,96,66,,,,,,,,,,,,,,,,,,,,,,,,,,,,,,,,85.7,3,6,278,91,60,1022,0,,1,3,4,Nordstadt,1,0,U0.490|1:52-U0.030|0:30-U0.500|1:51-U0.030|0:28-U0.500|1:51-U0.030|0:33-U0.500|1:51-U0.030|0:29-U0.500|1:49-U0.030|0:30-U0.500|1:50-U0.040|0:32-U0.500|1:49-U0.030|0:30-U0.500|1:50-U0.030|0:29-U0.500|1:51-U0.030|0:32-U0.500|1:49-U0.040|0:31-U0.500|1:50-U0.030|0:30-U0.500|1:48-U0.030|0:31-U0.500|1:45-U0.030|0:38-U0.500|1:50-U0.040|0:31-U0.500|1:46-U0.130|2:24,,"Bonn Track Running",,,4375,,657,3,17681334831,0,168070,250480,30378,,92790554,,,,,,,,,,,,,,,,,,,,,,,,,,,,,,,,,,,,,,,,,
115432794,99868535-ea16-4f8e-9e0d-c45753ba7d6b,1733254263,60,1733252913,,0,0,3.3,1170,1170,0,4,6,10,0,0,0.06,,0.93,,237,134,143,,141,12,51.2,30.61,51.12,1,57.42,5736,35,97,2.1,0,97,98,,301,,7,3,24,81,10.14,10.22,10.19,2,3.9,288,287,,0,290,290,,,,,50,48,50,48,"7,29,48,16,0,0,0,0,0","0,95,5,0,0","0,0,81,18,0",,,,,104,273,,92,88,,,,,,,,,,,,,,,,,,,,,,,,,,,,,,,,18.3,3,6,278,91,60,1022,0,,1,3,4,Nordstadt,1,0,U1.000|5:53-U1.000|5:45-U1.000|5:59-U0.304|1:53,,"Bonn Running",,,4375,,657,3,17681337830,0,168070,250480,30378,,92790567,,,,,,,,,,,,,,,,,,,,,,,,,,,,,,,,,,,,,,,,,
115504718,d1775898-0c90-4b46-b11b-0be91759ef14,1733319032,60,1733320843,,0,0,13.43,4543,4749,181,185,184,186,0,2,0.41,0.91,1.07,509,930,141,163,,152,27,50.83,35.55,51.66,1,57.43,4597,113,96,3.2,0,96,99,,1260,,11,1,109,79,11,11.06,11.14,-10.3,-2.5,312,308,,0,318,316,,,,,80,71,80,71,"21,5,18,33,17,5,0,0,0","0,34,65,1,0","1,3,27,68,1",,,,,112,271,,96,86,,,,,,,,,,,,,,,,,,,,,,,,,,,,,,,,32.5,4,6,287,88,95,1027,0,,0,4,4,"Bad Godesberg",1,0,U1.000|6:33-U1.000|5:49-U1.000|7:50-U1.000|6:57-U1.000|5:41-U1.000|5:34-U1.000|5:27-U1.000|5:15-U1.000|5:05-U1.000|5:01-U1.000|4:43-U1.000|4:40-U1.000|4:54-U0.427|2:13,,"Bonn Running",,,4375,,657,3,17686860095,0,168070,250480,30378,,92855831,,,,,,,,,,,,,,,,,,,,,,,,,,,,,,,,,,,,,,,,"4,4",
115531247,532b7f30-569e-430d-9f77-590dbc49815a,1733338049,60,1733341610,,0,0,,4065,4065,,,,,0,,,,,,351,97,144,,111,43,,,,1,57.43,4292,19,,0.8,0.5,,100,,674,,,,30,,,,,,,,,,,,,,,,,,,,,,"59,41,0,0,0",,,,,,,,,,,,,,,,,,,,,,,,,,,,,,,,,,,,,,,,,,7.5,,,,,,,,,,1,,,1,0,,,Strength,,,4375,,657,3,17689421129,0,168074,,30378,,92879980,,,,,,,,,,,,,,,,,,,,,,,,,,,,,,,,,,,,,,,,,
115624640,a1f847e1-a960-4d01-8bbc-e0a28481539f,1733420402,60,1733422623,1733428902,0,0,14,3908,3908,,,,,0,,,,,,858,151,182,,180,38,58.71,44.63,58.71,1,57.43,4320,228,,3.8,2.3,,100,,1085,,,,120,81,,13.19,,10,6.4,356,353,,0,365,364,,,,,79,38,82,67,"5,5,6,12,37,15,19,0,0","1,22,49,27,1","1,1,14,60,24",,,,,133,254,,102,77,,,,,,,,,,,,,,,,,,,,,,,,,,,,,,,,71.5,,,,,,,,,,1,,,1,1,U1.000|5:11-U1.000|4:51-U1.000|4:14-U1.000|4:42-U1.000|4:05-U1.000|4:52-U1.000|4:06-U1.000|4:51-U1.000|4:03-U1.000|4:45-U1.000|3:59-U1.000|5:39-U1.000|4:59-U0.825|4:53,,"6x 1km with 1km jogg 
3:45 3:45 3:45 3:30 3:30 3:20",,,4375,,657,3,17695967182,0,168070,250480,30378,,92962991,,,,,,,,,,,,,,,,,,,,,,,,,,,,,,,,,,,,,,,,,
115624642,6d7818ab-f714-4714-8024-47ca713ae215,1733424936,60,1733422623,,0,0,,1124,1124,,,,,0,,,,,,101,92,147,95,125,65,,,,1,57.43,4290,13,,0.3,0.6,,100,,186,,,,7,,,,,,,,,,,,,,,,,,,,,,"75,24,0,0,0",,,,,,,,,,,,,,,,,,,,,,,,,,,,,,,,,,,,,,,,,,3.6,,,,,,,,,,1,,,1,0,,,Strength,,,4375,,657,3,17695967655,0,168074,,30378,,92962993,,,,,,,,,,,,,,,,,,,,,,,,,,,,,,,,,,,,,,,,,
115668704,edcebd4c-e3a6-4d6a-92dd-2a3467d1317f,1733474429,60,1733474397,,0,0,,3425,3425,,,,,0,,,,,,357,104,145,,131,58,,,,1,57.43,3419,30,,1.8,0.2,,100,,515,,,,33,,,,,,,,,,,,,,,,,,,,,,"41,58,1,0,0",,,,,,,,,,,,,,,,,,,,,,,,,,,,,,,,,,,,,,,,,,14.9,,,,,,,,,,1,,,1,0,,,Strength,,,4375,,657,3,17699429649,0,168074,,30378,,93002529,,,,,,,,,,,,,,,,,,,,,,,,,,,,,,,,,,,,,,,,,
115699724,0eb2155f-f561-404c-bb0a-a685c13d525d,1733497282,60,1733497748,,0,0,11.37,3844,3926,26,27,45,48,0,0,0.06,,,,791,138,148,,148,10,52.31,35.11,52.45,1,57.38,4352,94,100,3.1,0,100,97,,1067,,9,1,84,80,10.67,10.67,10.69,2.3,1.5,305,304,,0,306,305,,,,,87,80,87,80,"3,8,55,32,2,0,0,0,0","0,73,27,0,0","0,0,45,54,0",,,,,111,275,,97,87,,,,,,,,,,,,,,,,,,,,,,,,,,,,,,,,24.7,9,29,281,76,94,1013,0,,0,11,4,"Bad Godesberg",1,0,U1.000|5:38-U1.000|5:25-U1.000|5:17-U1.000|5:39-U1.000|5:44-U1.000|5:42-U1.000|5:39-U1.000|5:35-U1.000|6:00-U1.000|5:33-U1.000|5:41-U0.366|2:10,,"Bonn Running",,,4375,,657,3,17701777956,0,168070,250480,30378,,93031131,,,,,,,,,,,,,,,,,,,,,,,,,,,,,,,,,,,,,,,,,
115748815,7950b0bd-6907-4266-a13c-1f259b6b7dea,1733559885,60,1733562670,,0,0,6.01,1822,1826,5,13,13,22,0,0,0.03,,,,426,153,160,,157,18,52.05,38.25,52.01,1,57.31,3286,102,96,3.1,0,96,98,,505,,9,2,57,81,11.85,11.91,11.87,-2.8,-4,335,335,,0,336,336,,,,,90,83,90,83,"1,1,4,49,46,0,0,0,0","0,3,97,0,0","0,0,4,95,0",,,,,122,263,,101,83,,,,,,,,,,,,,,,,,,,,,,,,,,,,,,,,45.4,7,21,179,89,99,1001,0,,0,6,4,"Bad Godesberg",1,0,U1.000|5:16-U1.000|5:05-U1.000|5:03-U1.000|5:04-U1.000|4:58-U1.000|4:52-U0.014|0:05,,"Bonn Running",,,4375,,657,3,17706164670,0,168070,250480,30378,,93075612,,,,,,,,,,,,,,,,,,,,,,,,,,,,,,,,,,,,,,,,,
115748819,abb68bc8-ed27-4b26-8a81-7c5aca49ac2d,1733562258,60,1733562678,,0,0,5,1180,1188,24,21,38,36,0,0,0.24,1.01,0.99,,327,172,182,,181,7,59.41,50.79,59.8,1,57.3,4331,171,100,3.6,1.5,100,98,,323,,17,3,58,83,15.34,15.4,15.49,8.7,6.6,434,431,,0,438,438,,,,,70,58,71,60,"1,0,0,0,3,29,63,4,0","1,3,1,85,9","1,1,0,22,76",,,,,153,228,,107,70,,,,,,,,,,,,,,,,,,,,,,,,,,,,,,,,106.9,7,21,188,87,100,1000,0,,0,6,4,"Bad Godesberg",1,0,U1.000|3:52-U1.000|3:55-U1.000|3:52-U1.000|4:00-U1.000|4:00-U0.003|0:01,,"Bonn Running",,,4375,,657,3,17706165384,0,168070,250480,30378,,93075616,,,,,,,,,,,,,,,,,,,,,,,,,,,,,,,,,,,,,,,,,
115748834,0a243ddd-cda6-4239-8656-fb0c46c03fdf,1733564069,60,1733562690,,0,0,6.01,2036,2036,17,8,23,14,0,0,0.07,,,,426,140,150,,149,12,51.22,33.52,51.49,1,57.26,4353,63,97,2.6,0,97,95,,542,,11,1,48,81,10.71,10.68,10.74,3.7,1.6,302,302,,0,303,303,,,,,55,51,55,51,"3,8,55,30,3,0,0,0,0","0,52,48,0,0","0,0,51,49,0",,,,,109,271,,95,87,,,,,,,,,,,,,,,,,,,,,,,,,,,,,,,,25.8,7,18,180,88,100,1000,0,,0,4,4,"Bad Godesberg",1,0,U1.000|5:24-U1.000|5:27-U1.000|5:38-U1.000|5:56-U1.000|5:38-U1.000|5:48-U0.014|0:06,,"Bonn Running",,,4375,,657,3,17706166985,0,168070,250480,30378,,93075631,,,,,,,,,,,,,,,,,,,,,,,,,,,,,,,,,,,,,,,,,
115797310,3fc528fa-4ee9-4c37-bbd6-4410b427b1f3,1733596722,60,1733597875,,0,0,,3470,3470,,,,,0,,,,,,288,96,160,,114,40,,,,1,57.31,3786,44,,2,0.9,,100,,595,,,,30,,,,,,,,,,,,,,,,,,,,,,"69,21,10,0,0",,,,,,,,,,,,,,,,,,,,,,,,,,,,,,,,,,,,,,,,,,23.9,,,,,,,,,,1,,,1,0,,,Strength,,,4375,,657,3,17710243529,0,168074,,30378,,93120763,,,,,,,,,,,,,,,,,,,,,,,,,,,,,,,,,,,,,,,,,
115844852,b964732e-d6d6-4cea-babf-fc1989c10ee4,1733659295,60,1733662224,,0,0,21.52,5999,6079,160,159,168,168,0,0,0.2,1.03,1,442,1457,158,170,136,164,13,55.1,46.25,55.61,1,57.26,4352,298,100,4.9,0,100,97,,1666,,13,4,214,82,13.02,12.97,13.08,1.3,4.1,367,367,,0,370,370,,,,,74,57,74,57,"0,0,1,13,51,35,0,0,0","0,2,61,36,0","0,0,2,85,13",,,,,131,252,,103,79,,,,,,,,,,,,,,,,,,,,,,,,,,,,,,,,67,7,15,100,82,100,1008,,,0,4,1,Poppelsdorf,1,0,U1.000|5:12-U1.000|5:09-U1.000|5:01-U1.000|4:46-U1.000|4:45-U1.000|4:41-U1.000|4:39-U1.000|4:32-U1.000|4:45-U1.000|4:34-U1.000|4:34-U1.000|4:35-U1.000|4:34-U1.000|4:27-U1.000|4:30-U1.000|4:34-U1.000|4:24-U1.000|4:26-U1.000|4:29-U1.000|4:29-U1.000|4:20-U0.520|2:32,,"Bonn Running",,,4375,,657,3,17714947068,0,168070,250480,30378,,93161499,,,,,,,,,,,,,,,,,,,,,,,,,,,,,,,,,,,,,,,,5,
115872921,36b510f1-efa3-4bbe-bd0a-99373ee2ea46,1733681542,60,1733680579,,0,0,,2558,2570,,,,,0,,,,,,203,91,121,,96,34,,,,1,57.26,4047,7,,0.5,0,,100,,383,,,,17,,,,,,,,,,,,,,,,,,,,,,"68,32,0,0,0",,,,,,,,,,,,,,,,,,,,,,,,,,,,,,,,,,,,,,,,,,5.8,,,,,,,,,,1,,,1,0,,,Strength,,,4375,,657,3,17717174149,0,168074,,30378,,93185110,,,,,,,,,,,,,,,,,,,,,,,,,,,,,,,,,,,,,,,,,
115945165,324f8bc4-b2e9-4908-918c-7c5fc09f2ea2,1733756780,60,1733757964,,0,0,14.47,4445,4625,30,36,49,52,0,0,0.1,,,,966,142,156,,150,20,56.72,40.03,56.84,1,57.27,3168,145,103,3.5,0,103,100,,1234,,11,3,109,81,11.73,11.75,11.75,1.4,0.4,330,330,,0,332,331,,,,,85,72,85,72,"1,3,15,42,34,5,0,0,0","0,21,79,0,0","0,0,4,95,1",,,,,121,265,,101,83,,,,,,,,,,,,,,,,,,,,,,,,,,,,,,,,32.4,6,11,56,85,87,1023,0,,0,4,4,"Bad Godesberg",1,0,U1.000|5:07-U1.000|4:59-U1.000|4:58-U1.000|5:05-U1.000|5:01-U1.000|5:12-U1.000|5:17-U1.000|5:07-U1.000|5:03-U1.000|5:12-U1.000|4:47-U1.000|5:31-U1.000|5:07-U1.000|5:09-U0.466|2:31,,"Bonn Running",,,4375,,657,3,17722640403,0,168070,250480,30378,,93248770,,,,,,,,,,,,,,,,,,,,,,,,,,,,,,,,,,,,,,,,,
115971107,462c630f-f8a1-42e5-800e-b8203db36450,1733773700,60,1733776256,,0,0,,2696,2696,,,,,0,,,,,,263,101,137,,116,42,,,,1,57.26,2920,18,,0.8,0.4,,100,,461,,,,23,,,,,,,,,,,,,,,,,,,,,,"47,53,0,0,0",,,,,,,,,,,,,,,,,,,,,,,,,,,,,,,,,,,,,,,,,,7,,,,,,,,,,1,,,1,0,,,Strength,,,4375,,657,3,17724879594,0,168074,,30378,,93269790,,,,,,,,,,,,,,,,,,,,,,,,,,,,,,,,,,,,,,,,,
116024916,0b621a64-1ebe-41c1-a662-e056fb04a402,1733834585,60,1733833975,,0,0,,2759,2759,,,,,0,,,,,,266,98,137,,132,35,,,,1,57.26,1897,12,,0.8,0,,100,,427,,,,21,,,,,,,,,,,,,,,,,,,,,,"73,27,0,0,0",,,,,,,,,,,,,,,,,,,,,,,,,,,,,,,,,,,,,,,,,,8.7,,,,,,,,,,1,,,1,0,,,Strength,,,4375,,657,3,17729098008,0,168074,,30378,,93319056,,,,,,,,,,,,,,,,,,,,,,,,,,,,,,,,,,,,,,,,,
116056195,34f143ac-dcca-4be7-907b-69ed296d1031,1733854448,60,1733855634,,0,0,8.27,3266,4595,21,18,23,23,0,0,0.02,,,,548,124,171,,170,40,49.19,28.5,49.36,1,57.47,2448,79,98,2.7,0.8,98,104,,682,,13,3,57,69,9.13,10.9,10.9,22.3,10.2,285,250,,0,322,309,,,,,92,86,92,86,"48,8,13,12,2,3,14,0,1","12,73,5,10,0","20,6,37,20,17",,,,,110,265,,88,80,,,,,,,,,,,,,,,,,,,,,,,,,,,,,,,,51.7,5,9,54,86,96,1028,0,,1,4,4,Nordstadt,1,0,U1.000|5:16-U1.000|5:30-U0.703|5:52-U2.095|8:04-U0.182|1:58-U0.713|9:02-U0.061|0:15-U2.512|18:28,,"Bonn Running",,,4375,,657,3,17731639315,0,168070,250480,30378,,93347285,,,,,,,,,,,,,,,,,,,,,,,,,,,,,,,,,,,,,,,,,
116098392,0b07acce-1f67-44b0-b7e7-8711f46ed9b8,1733907101,60,1733907176,,0,0,,3289,3289,,,,,0,,,,,,234,87,125,106,123,53,,,,1,57.47,1534,5,,0.3,0,,100,,431,,,,19,,,,,,,,,,,,,,,,,,,,,,"79,21,0,0,0",,,,,,,,,,,,,,,,,,,,,,,,,,,,,,,,,,,,,,,,,,5.4,,,,,,,,,,1,,,1,0,,,Strength,,,4375,,657,3,17735439358,0,168074,,30378,,93384750,,,,,,,,,,,,,,,,,,,,,,,,,,,,,,,,,,,,,,,,,
116122561,c36242d3-c8f3-4675-8ef2-42b233c53b1a,1733924943,60,1733930597,,0,0,10.06,3269,3446,22,19,31,26,0,0,0.04,,,,680,138,148,,142,8,54.93,36.44,55.1,1,57.34,2236,93,100,3,0,100,98,,896,,11,2,75,81,11.12,11.1,11.13,1.2,-0.5,313,311,,0,314,312,,,,,91,82,91,82,"2,4,27,60,7,0,0,0,0","0,57,42,0,0","1,0,14,85,0",,,,,114,267,,97,85,,,,,,,,,,,,,,,,,,,,,,,,,,,,,,,,26.7,4,4,28,82,85,1030,0,,0,4,4,"Bad Godesberg",1,0,U5.038|26:48-U1.000|5:28-U1.000|5:29-U1.000|5:45-U1.000|5:24-U1.000|5:27-U0.026|0:09,,"Bonn Running",,,4375,,657,3,17737829418,0,168070,250480,30378,,93406278,,,,,,,,,,,,,,,,,,,,,,,,,,,,,,,,,,,,,,,,,
116138078,606d56fa-1f80-4317-9d29-33978d7fd00d,1733945182,60,1733942740,,0,0,3.97,1139,1139,,,,,0,,,,,,245,139,166,,166,29,63.46,39.8,63.46,1,57.34,2448,64,,2.4,0.8,,100,,314,,,,28,80,,12.87,,5.5,5.4,358,349,,0,362,357,,,,,90,84,91,86,"2,0,8,7,60,19,4,1,0","4,56,35,5,0","3,0,7,85,6",,,,,131,257,,106,81,,,,,,,,,,,,,,,,,,,,,,,,,,,,,,,,34.5,,,,,,,,,,1,,,1,1,U1.000|5:03-U1.000|4:40-U1.000|4:37-U0.966|4:39,,"Treadmill Running",,,4375,,657,3,17739299178,0,168070,250480,30378,,93420513,,,,,,,,,,,,,,,,,,,,,,,,,,,,,,,,,,,,,,,,,
116139616,51230132-2740-4476-bcb8-1f425ddd56d6,1733946653,60,1733943954,,0,0,,855,855,,,,,0,,,,,,156,125,135,,135,10,,,,1,57.34,2429,20,,1.3,0,,100,,191,,,,14,,,,,,,,,,,,,,,,,,,,,,"0,100,0,0,0",,391,1,,,,,,,,,,,,,,,,,,,,,,,,,,,,,,,,,,,,,,,12.8,,,,,,,,,,1,,,1,0,,,Cardio,,,4375,,657,3,17739465610,0,168075,,30378,,93421812,,,,,,,,,,,,,,,,,,,,,,,,,,,,,,,,,,,,,,,,,
116179025,2776ff46-0dd8-476f-9843-8adc36abc1e1,1733989949,60,1733990012,,0,0,2,584,584,0,0,3,4,0,0,0,,,,72,104,118,,115,31,,,,1,57.34,1594,5,,0.3,0,,100,,87,,,,5,,,14.44,,24.4,-38.4,20,18,,1,28,27,,,,,99,98,99,98,"63,24,13,0,0,0,0","32,68,0,0,0","100,0,0,0,0",,,,,,,,,,,,,,,,,,,,,,,,,,,,,,,,,,,,,,,,,4.6,1,0,153,91,100,1031,,,1,7,1,"Bad Godesberg",1,0,,,"Bonn Cycling",,,4375,,657,3,17742486309,0,168072,,30378,,93457683,,,,,,,,,,,,,,,,,,,,,,,,,,,,,,,,,,,,,,,,,
116214182,a91b435f-9094-43f3-9bc3-cdd3237aea16,1734025452,60,1734023931,,0,0,0.8,269,269,,,,,0,,,,,,50,124,141,,133,9,59.99,28.28,59.99,1,57.34,1008,10,,0.7,0,,100,,72,,,,5,72,,11.78,,-0.7,0.3,354,300,,0,360,332,,,,,99,98,99,98,"8,3,3,4,77,3,0,0,2","17,76,7,0,0","15,1,6,78,0",,,,,124,258,,105,85,,,,,,,,,,,,,,,,,,,,,,,,,,,,,,,,8.2,,,,,,,,,,1,,,1,1,,,"Treadmill Running",,,4375,,657,3,17745814462,0,168070,250480,30378,,93490090,,,,,,,,,,,,,,,,,,,,,,,,,,,,,,,,,,,,,,,,,
116214189,8e67d1d1-3786-43ec-9df8-f939bf2cf0b6,1734025812,60,1734023937,,0,0,2.32,666,666,,,,,0,,,,,,142,135,153,,142,9,65.83,38.06,65.83,1,57.34,997,31,,2,0.1,,100,,185,,,,14,79,,12.66,,1,6.6,361,349,,0,361,360,,,,,96,94,96,94,"1,0,1,4,87,7,0,0,0","0,78,22,0,0","3,0,2,95,0",,,,,132,258,,107,81,,,,,,,,,,,,,,,,,,,,,,,,,,,,,,,,19.7,,,,,,,,,,1,,,1,1,U1.000|4:58-U1.000|4:44-U0.316|1:24,,"Treadmill Running",,,4375,,657,3,17745814943,0,168070,250480,30378,,93490097,,,,,,,,,,,,,,,,,,,,,,,,,,,,,,,,,,,,,,,,,
116220447,f38c9a08-d8b7-419e-8635-8da44ed19cea,1734028054,60,1734028614,,0,0,10.17,3798,4120,16,19,25,27,0,0,0.05,,,,669,119,137,,128,12,55.21,30.94,55.3,1,57.35,1338,60,101,2.5,0,101,100,,959,,11,1,55,78,9.65,9.76,9.75,5.4,3.5,276,274,,0,279,277,,,,,89,85,89,85,"36,26,23,13,1,0,0,0,0","9,91,0,0,0","1,1,76,22,0",,,,,103,285,,93,90,,,,,,,,,,,,,,,,,,,,,,,,,,,,,,,,13.5,2,3,135,88,62,1030,0,,1,3,4,"Bad Godesberg",1,0,U1.000|5:34-U1.000|5:28-U1.000|5:39-U1.000|5:52-U1.000|6:08-U1.000|6:57-U1.000|7:06-U1.000|6:49-U1.000|6:21-U1.000|6:19-U0.165|1:04,,"Bonn Running",,,4375,,657,3,17746380666,0,168070,250480,30378,,93495444,,,,,,,,,,,,,,,,,,,,,,,,,,,,,,,,,,,,,,,,,
116256619,50d317b2-261c-4dbe-88db-659f4d19b63f,1734080937,60,1734082472,,0,0,14.53,4794,4887,179,179,186,187,0,1.8,0.36,0.94,1.03,512,1005,139,155,104,149,19,53.41,36.84,54.22,1,57.17,1505,115,96,3.2,0,96,99,,1330,,11,3,108,81,11.23,11.15,11.24,-5,0.7,325,324,,0,327,326,,,,,88,75,88,75,"18,4,12,47,16,3,0,0,0","0,65,35,0,0","0,0,15,84,1",,,,,112,268,,95,85,,,,,,,,,,,,,,,,,,,,,,,,,,,,,,,,29.3,0,12,135,87,,1030,1,,0,3,5,"Bad Godesberg",1,0,U1.000|6:49-U1.000|5:56-U1.000|5:20-U1.000|7:02-U1.000|5:41-U1.000|5:29-U1.000|5:14-U1.000|5:19-U1.000|5:25-U1.000|5:22-U1.000|5:08-U1.000|4:42-U1.000|4:42-U1.000|4:57-U0.530|2:49,,"Bonn Running",,,4375,,657,3,17749949336,0,168070,250480,30378,,93527804,,,,,,,,,,,,,,,,,,,,,,,,,,,,,,,,,,,,,,,,"4,4",
116273531,a8c768f1-badb-48a1-9b73-64505371bdb5,1734100105,60,1734100574,,0,0,,3860,3860,,,,,0,,,,,,304,92,136,,121,45,,,,1,57.17,1207,10,,0.5,0.1,,100,,610,,,,24,,,,,,,,,,,,,,,,,,,,,,"66,34,0,0,0",,,,,,,,,,,,,,,,,,,,,,,,,,,,,,,,,,,,,,,,,,4.8,,,,,,,,,,1,,,1,0,,,Strength,,,4375,,657,3,17751723097,0,168074,,30378,,93542552,,,,,,,,,,,,,,,,,,,,,,,,,,,,,,,,,,,,,,,,,
116328920,9e421d77-284a-4cc6-9075-1817f9521967,1734165777,60,1734162923,,0,0,1.21,449,691,6,5,7,6,0,0.6,0.5,1.16,1.08,,85,127,143,,141,10,51.65,26.46,52.02,1,57.17,179,19,100,1.3,0,100,100,,112,,7,3,8,76,9.71,9.96,10.04,13.2,6.9,289,273,,0,299,282,,,,,98,97,98,97,"32,8,30,30,0,0,0,0,0","10,82,8,0,0","6,1,52,39,1",,,,,106,274,,92,87,,,,,,,,,,,,,,,,,,,,,,,,,,,,,,,,11.1,1,6,240,87,96,1022,0,,0,4,4,"Bad Godesberg",1,0,U1.000|5:54-U0.210|1:35,,"Bonn Running",,,4375,,657,3,17755859166,0,168070,250480,30378,,93593857,,,,,,,,,,,,,,,,,,,,,,,,,,,,,,,,,,,,,,,,,
116330385,1c68e46b-3302-4562-99bd-fdf6d74c72f7,1734167075,60,1734164650,,0,0,5,1140,1140,16,16,34,34,0,0,0.24,1.01,0.98,,304,167,175,,175,6,64.95,52.88,65.21,1,57.29,1454,143,102,3.3,1.2,102,100,,316,,18,3,50,86,15.85,15.81,15.87,5.8,5.7,442,440,,0,444,444,,,,,87,78,88,79,"0,0,0,0,0,17,76,7,0","1,2,7,90,0","0,0,0,13,87",,,,,153,220,,103,67,,,,,,,,,,,,,,,,,,,,,,,,,,,,,,,,85.6,1,6,240,87,96,1022,0,,0,4,4,"Bad Godesberg",1,0,U1.000|3:50-U1.000|3:48-U1.000|3:48-U1.000|3:51-U0.997|3:44,,"Bonn Running",,,4375,,657,3,17755988751,0,168070,250480,30378,,93595226,,,,,,,,,,,,,,,,,,,,,,,,,,,,,,,,,,,,,,,,,
116330667,7f8be5dd-8f6b-48e9-87f0-a0942b465c65,1734168366,60,1734165041,,0,0,0.32,147,147,0,0,0,0,0,0,0,,,,24,124,133,,133,21,40.81,17.93,40.81,1,57.29,1448,4,,0.2,0,,100,,27,,7,3,2,72,7.86,8.66,8.64,30.5,22.5,217,217,,0,246,246,,,,,78,78,78,78,"58,21,21,0,0,0,0,0,0","0,100,0,0,0","2,34,62,2,0",,,,,91,299,,81,89,,,,,,,,,,,,,,,,,,,,,,,,,,,,,,,,3.9,1,7,238,87,96,1022,0,,0,4,4,"Bad Godesberg",1,0,,,"Bonn Running",,,4375,,657,3,17756019947,0,168070,250480,30378,,93595488,,,,,,,,,,,,,,,,,,,,,,,,,,,,,,,,,,,,,,,,,
116334288,a5e849fd-63cb-4753-ad52-c4191c2384e4,1734169399,60,1734167481,,0,0,5.09,1631,1631,9,0,15,7,0,0,0.01,,,,346,136,143,,143,11,56.93,35.46,57.18,1,57.34,2016,59,101,2.5,0,101,101,,427,,11,3,35,83,11.3,11.27,11.33,-0.2,-1.7,317,317,,0,317,317,,,,,74,71,74,71,"1,1,21,70,7,0,0,0,0","0,95,4,0,0","0,0,8,92,0",,,,,113,263,,95,84,,,,,,,,,,,,,,,,,,,,,,,,,,,,,,,,21.3,1,7,238,87,96,1022,0,,0,4,4,"Bad Godesberg",1,0,U1.000|5:30-U1.000|5:08-U1.000|5:18-U1.000|5:14-U1.000|5:30-U0.091|0:31,,"Bonn Running",,,4375,,657,3,17756246350,0,168070,250480,30378,,93598974,,,,,,,,,,,,,,,,,,,,,,,,,,,,,,,,,,,,,,,,,
116393145,b97b282d-6431-4031-b1d7-85a0acaf86a8,1734201373,60,1734203646,,0,0,,5855,5855,,,,,0,,,,,,258,73,127,,127,38,,,,1,57.34,1414,3,,0.1,0,,100,,763,,,,18,,,,,,,,,,,,,,,,,,,,,,"98,2,0,0,0",,,,,,,,,,,,,,,,,,,,,,,,,,,,,,,,,,,,,,,,,,2.1,,,,,,,,,,1,,,1,0,,,Strength,,,4375,,657,3,17760499068,0,168074,,30378,,93653297,,,,,,,,,,,,,,,,,,,,,,,,,,,,,,,,,,,,,,,,,
116451850,a859a433-d0a3-4998-b1a4-e16ca9801fdb,1734260746,60,1734264216,,0,0,23.73,6695,6955,140,136,157,153,0,0,0.18,1.01,1.02,527,1602,153,171,,154,16,56.87,45.96,57.3,1,57.28,4357,292,102,4.9,0,102,99,,1859,,15,4,221,83,12.85,12.8,12.92,1.7,5.2,367,366,,0,370,369,,,,,75,59,75,59,"0,0,1,13,64,22,0,0,0","0,10,75,14,0","0,0,3,83,13",,,,,128,252,,101,79,,,,,,,,,,,,,,,,,,,,,,,,,,,,,,,,66.3,6,10,239,84,91,1028,1,,0,4,4,Weststadt,1,0,U1.000|4:59-U1.000|4:48-U1.000|5:05-U1.000|5:03-U1.000|4:43-U1.000|4:39-U1.000|4:44-U1.000|4:34-U1.000|4:31-U1.000|4:32-U1.000|4:36-U1.000|4:40-U1.000|4:46-U1.000|4:39-U1.000|4:35-U1.000|4:40-U1.000|4:46-U1.000|4:38-U1.000|4:34-U1.000|4:37-U1.000|4:33-U1.000|4:35-U1.000|4:45-U0.730|3:31,,"Bonn Running",,,4375,,657,3,17764862327,0,168070,250480,30378,,93707730,,,,,,,,,,,,,,,,,,,,,,,,,,,,,,,,,,,,,,,,5,
116484059,75ce5ef3-e203-4b41-98eb-c5e5edccbc7e,1734285716,60,1734286545,,0,0,,2244,2244,,,,,0,,,,,,305,115,170,,140,38,,,,1,57.28,4320,65,,2.3,1.1,,100,,399,,,,35,,,,,,,,,,,,,,,,,,,,,,"34,45,15,5,0",,,,,,,,,,,,,,,,,,,,,,,,,,,,,,,,,,,,,,,,,,40.6,,,,,,,,,,1,,,1,0,,,Strength,,,4375,,657,3,17767651417,0,168074,,30378,,93734433,,,,,,,,,,,,,,,,,,,,,,,,,,,,,,,,,,,,,,,,,
116485035,a3b2b4c0-28b3-4628-87b7-4b7b37a705ea,1734290973,60,1734287441,,0,0,0.1,50,50,0,3,0,2,0,1.2,1,,,,6,93,102,,,,49.05,15.11,47.25,1,57.28,4271,0,,,0,,100,,9,,7,3,0,74,6.99,7.51,6.98,6.9,13.8,201,189,,0,201,201,,,,,70,70,70,70,"100,0,0,0,0,0,0,0,0","94,6,0,0,0","10,40,50,0,0",,,,,81,294,,80,99,,,,,,,,,,,,,,,,,,,,,,,,,,,,,,,,0.2,8,12,237,89,98,1029,0,,1,4,4,"Bad Godesberg",1,0,,,"Bonn Running",,,4375,,657,3,17767732970,0,168070,250480,30378,,93735319,,,,,,,,,,,,,,,,,,,,,,,,,,,,,,,,,,,,,,,,,
116588032,465398dc-9ad6-4861-83fc-3e9d5af10059,1734371553,60,1734373509,,0,0,14.73,4930,5166,28,28,53,50,0,0,0.06,,,,995,135,150,110,147,15,54.46,36.26,54.59,1,57.25,2751,117,100,3.3,0,100,99,,1369,,11,3,105,80,10.78,10.79,10.82,3.4,2.7,305,304,,0,307,306,,,,,87,76,87,76,"2,9,47,39,3,0,0,0,0","0,85,15,0,0","0,0,46,53,0",,,,,112,275,,98,88,,,,,,,,,,,,,,,,,,,,,,,,,,,,,,,,23.8,10,14,248,85,98,1031,0,,1,4,4,"Bad Godesberg",1,0,U1.000|5:31-U1.000|5:15-U1.000|5:10-U1.000|5:15-U1.000|5:26-U1.000|5:36-U1.000|5:40-U1.000|5:41-U1.000|5:36-U1.000|5:41-U1.000|5:45-U1.000|5:51-U1.000|5:45-U1.000|5:39-U0.729|4:18,,"Bonn Running",,,4375,,657,3,17774133836,0,168070,250480,30378,,93829418,,,,,,,,,,,,,,,,,,,,,,,,,,,,,,,,,,,,,,,,,
116645655,0a6e9a1e-dcf3-4177-bef0-461e339bc3ce,1734432622,60,1734433985,,0,0,14.51,4541,4755,180,177,189,184,0,1.9,0.38,0.98,1.07,516,1042,153,166,,161,21,50.04,39.18,50.82,1,57.12,3248,185,96,3.9,0,96,97,,1261,,11,3,145,81,11.83,11.83,11.88,-5.9,0.4,333,333,,0,336,335,,,,,85,73,85,73,"16,5,8,28,29,12,1,0,0","0,6,77,17,0","0,0,10,87,2",,,,,118,264,,98,83,,,,,,,,,,,,,,,,,,,,,,,,,,,,,,,,54.5,9,7,234,86,86,1030,1,,0,4,4,"Bad Godesberg",1,0,U1.000|6:23-U1.000|5:43-U1.000|5:01-U1.000|6:41-U1.000|5:39-U1.000|5:32-U1.000|5:26-U1.000|5:11-U1.000|4:59-U1.000|4:41-U1.000|4:36-U1.000|4:14-U1.000|4:23-U1.000|4:40-U0.511|2:32,,"Bonn Running",,,4375,,657,3,17778606345,0,168070,250480,30378,,93879357,,,,,,,,,,,,,,,,,,,,,,,,,,,,,,,,,,,,,,,,"4,4",
116734614,e7a0e6ca-9f63-409f-a0a6-7736ef2cfb7b,1734511309,60,1734511315,,0,0,,3450,3450,,,,,0,,,,,,301,98,117,,112,38,,,,1,57.12,1962,11,,0.7,0,,100,,451,,,,28,51,,,,,,,,,,,,,,,,,,,,,"47,53,0,0,0",,1191,1,,,,,,,,,,,,,,,,,,17,,,,,,,,,,,,,,,,,,,,,6.3,23,,,,,,,,,1,,,1,0,,,Gym,,,3113,,250,3,17785422623,0,168075,,30378,,93957887,,,,,,,,,,,,,,,,,,,,,,,,,,,,,,,,,,,,,,,,,
116771491,abe23f2b-2d19-43f8-aab5-f05098f34bdb,1734537243,60,1734537910,,0,0,14.77,4025,4111,42,40,49,48,0,0,0.06,,,,949,153,173,,163,15,59.36,46.08,59.58,1,57.22,4320,246,104,4.4,0,104,99,,1117,,15,4,133,82,13.25,13.48,13.49,8.6,7.4,368,367,,0,375,375,,,,,80,65,80,65,"1,1,7,19,18,39,15,0,0","0,12,46,42,0","0,0,4,66,30",,,,,134,249,,103,77,,,,,,,,,,,,,,,,,,,,,,,,,,,,,,,,74.3,11,17,219,79,80,1014,0,,0,4,4,"Bad Godesberg",1,0,U1.000|4:49-U1.000|4:30-U1.000|4:37-U1.000|4:05-U1.000|4:03-U1.000|4:05-U1.000|4:09-U1.000|4:12-U1.000|3:57-U1.000|4:06-U1.000|4:16-U1.000|5:24-U1.000|5:13-U1.000|5:19-U0.774|4:17,,"Bonn Running",,,4375,,657,3,17788171313,0,168070,250480,30378,,93990677,,,,,,,,,,,,,,,,,,,,,,,,,,,,,,,,,,,,,,,,,
116850323,f2e7b481-e947-45fa-b7b4-2687446915da,1734619330,60,1734619995,,0,0,10.02,3335,3335,136,135,150,151,0,1.4,0.32,1.03,1.07,628,685,139,153,,152,14,52.83,35.42,53.73,1,57.18,2889,99,98,3.1,0,98,97,,899,,11,1,77,81,11.18,11.01,11.24,-1.2,4.8,311,311,,0,315,315,,,,,89,84,89,84,"15,6,22,37,19,1,0,0,0","1,43,56,0,0","0,0,33,66,1",,,,,111,270,,97,87,,,,,,,,,,,,,,,,,,,,,,,,,,,,,,,,29.6,7,24,290,88,99,1001,0,,0,6,4,"Bad Godesberg",1,0,U1.000|6:29-U1.000|6:46-U1.000|5:37-U1.000|5:25-U1.000|5:27-U1.000|5:21-U1.000|5:06-U1.000|5:08-U1.000|5:14-U1.000|4:57-U0.018|0:05,,"Bonn Running",,,4375,,657,3,17794686544,0,168070,250480,30378,,94061628,,,,,,,,,,,,,,,,,,,,,,,,,,,,,,,,,,,,,,,,4,
116872510,4dbca458-7a2e-48dc-b659-bddc74a1c8e1,1734636888,60,1734636724,,0,0,,3420,3420,,,,,0,,,,,,319,100,157,,117,49,,,,1,57.18,2596,30,,1.1,1,,100,,576,,,,30,,,,,,,,,,,,,,,,,,,,,,"51,48,1,0,0",,,,,,,,,,,,,,,,,,,,,,,,,,,,,,,,,,,,,,,,,,10.3,,,,,,,,,,1,,,1,0,,,Strength,,,4375,,657,3,17796458184,0,168074,,30378,,94081813,,,,,,,,,,,,,,,,,,,,,,,,,,,,,,,,,,,,,,,,,
116872727,c819a5a4-717d-4281-b074-2fe8ab455944,1734640339,60,1734636976,,0,0,0.39,219,219,,,,,0,,,,,,37,119,129,,126,4,33.33,,33.33,1,57.18,2593,6,,0.4,0,,100,,51,,,,3,75,,8.8,,,-54.7,308,177,,0,307,247,,,,,87,87,87,87,"13,2,1,58,27,0,0,0,0","10,90,0,0,0","42,5,3,50,0",,,,,71,274,,102,144,,,,,,,,,,,,,,,,,,,,,,,,,,,,,,,,4.8,,,,,,,,,,1,,,1,1,,,"Treadmill Running",,,4375,,657,3,17796485132,0,168070,250480,30378,,94082006,,,,,,,,,,,,,,,,,,,,,,,,,,,,,,,,,,,,,,,,,
116954226,650eccff-8b22-4102-9adb-34a9b008ccac,1734704635,60,1734705863,,0,0,14.28,4376,4567,196,193,203,201,0,2.1,0.4,0.96,0.98,591,956,142,158,108,154,17,56.89,40.1,57.87,1,57.22,2304,144,100,3.5,0.1,100,100,,1164,,11,3,109,81,12.15,12.02,12.21,-6.8,-0.8,343,341,,0,347,345,,,,,87,79,88,79,"10,6,7,27,33,16,1,0,0","1,25,74,0,0","0,0,10,85,4",,,,,121,263,,100,83,,,,,,,,,,,,,,,,,,,,,,,,,,,,,,,,32.7,5,12,256,74,75,1021,0,,0,4,4,"Bad Godesberg",1,0,U1.000|6:06-U1.000|6:13-U1.000|5:19-U1.000|5:05-U1.000|4:52-U1.000|6:20-U1.000|5:11-U1.000|5:01-U1.000|4:42-U1.000|4:45-U1.000|4:26-U1.000|4:16-U1.000|4:38-U1.000|4:38-U0.276|1:23,,"Bonn Running",,,4375,,657,3,17801334872,0,168070,250480,30378,,94155154,,,,,,,,,,,,,,,,,,,,,,,,,,,,,,,,,,,,,,,,"4,4",
116980472,cb10b7cc-a0be-4eef-b9cf-2e5f002e8b3f,1734722984,60,1734723640,,0,0,,3235,3235,,,,,0,,,,,,261,92,123,,117,50,,,,1,57.22,2025,7,,0.4,0,,100,,498,,,,21,,,,,,,,,,,,,,,,,,,,,,"73,27,0,0,0",,,,,,,,,,,,,,,,,,,,,,,,,,,,,,,,,,,,,,,,,,5,,,,,,,,,,1,,,1,0,,,Strength,,,4375,,657,3,17803052017,0,168074,,30378,,94178221,,,,,,,,,,,,,,,,,,,,,,,,,,,,,,,,,,,,,,,,,
117022339,ccef3208-16a0-4c35-b6a8-c3a0b59908d1,1734769670,60,1734771885,,0,0,5.2,1474,1474,4,9,10,16,0,0,0.04,,,,335,142,155,,136,13,62.64,41.06,62.63,1,57.35,1454,85,105,3,0,105,98,,401,,11,3,38,82,12.67,12.73,12.7,11.8,10.6,353,353,,0,354,354,,,,,94,88,94,88,"1,0,0,9,72,18,0,0,0","1,42,57,0,0","0,0,0,97,2",,,,,129,254,,103,80,,,,,,,,,,,,,,,,,,,,,,,,,,,,,,,,37.9,6,15,224,88,89,1017,0,,0,4,4,"Bad Godesberg",1,0,U1.000|4:53-U1.000|4:43-U1.000|4:37-U1.000|4:47-U1.000|4:36-U0.200|0:59,,"Bonn Running",,,4375,,657,3,17805690170,0,168070,250480,30378,,94214540,,,,,,,,,,,,,,,,,,,,,,,,,,,,,,,,,,,,,,,,,
117022351,0e338a16-b8ac-4e24-99db-495f8064895a,1734771978,60,1734771890,,0,0,5,1161,1161,29,28,34,34,0,0.1,0.28,0.99,0.94,,298,161,175,,170,7,67.15,51.76,67.65,1,57.41,2736,127,101,3.3,0.7,101,94,,322,,17,2,46,86,15.57,15.53,15.59,11.6,11,430,429,,0,433,433,,,,,79,71,80,71,"0,0,0,0,1,25,71,2,0","1,12,13,75,0","0,0,0,24,76",,,,,150,221,,103,69,,,,,,,,,,,,,,,,,,,,,,,,,,,,,,,,77.4,7,13,210,83,100,1018,,,0,4,1,"Bad Godesberg",1,0,U1.000|3:51-U1.000|3:53-U1.000|3:51-U1.000|3:57-U0.998|3:49,,"Bonn Running",,,4375,,657,3,17805690799,0,168070,250480,30378,,94214552,,,,,,,,,,,,,,,,,,,,,,,,,,,,,,,,,,,,,,,,,
117022357,bf464c83-a42f-48a2-9194-d9e3d1cea75b,1734773694,60,1734771895,,0,0,5.23,1634,1637,9,1,18,9,0,0,0.04,,,,354,139,147,,145,7,57.12,36.6,57.35,1,57.41,4032,70,100,2.7,0,100,100,,411,,7,2,38,82,11.59,11.55,11.61,3.1,3.6,323,322,,0,324,324,,,,,66,61,66,61,"0,2,11,63,22,1,0,0,0","1,36,63,0,0","0,0,6,94,0",,,,,117,262,,98,84,,,,,,,,,,,,,,,,,,,,,,,,,,,,,,,,26.8,7,13,210,83,100,1018,,,0,4,1,"Bad Godesberg",1,0,U1.000|5:20-U1.000|5:08-U1.000|5:07-U1.000|5:05-U1.000|5:19-U0.229|1:16,,"Bonn Running",,,4375,,657,3,17805691402,0,168070,250480,30378,,94214558,,,,,,,,,,,,,,,,,,,,,,,,,,,,,,,,,,,,,,,,,
117130750,a887b957-54cb-4e22-a037-a2e549eebd16,1734853822,60,1734859457,,0,0,10.01,3629,3629,132,130,144,143,0,1.8,0.42,1.03,1.09,584,711,136,148,,140,11,48.89,32.01,49.7,1,57.36,2665,75,97,2.8,0,97,96,,927,,11,1,78,80,10.28,10.18,10.34,-6.5,1.7,294,294,,0,297,297,,,,,91,86,91,86,"26,28,24,12,9,1,0,0,0","1,77,22,0,0","0,0,66,33,0",,,,,103,279,,93,90,,,,,,,,,,,,,,,,,,,,,,,,,,,,,,,,27.9,6,18,266,90,90,999,0,,1,6,4,"Bad Godesberg",1,0,U1.000|7:03-U1.000|7:18-U1.000|6:27-U1.000|6:14-U1.000|6:04-U1.000|5:58-U1.000|5:46-U1.000|5:27-U1.000|5:13-U1.000|4:54-U0.014|0:05,,"Bonn Running",,,4375,,657,3,17812640347,0,168070,250480,30378,,94315630,,,,,,,,,,,,,,,,,,,,,,,,,,,,,,,,,,,,,,,,4,
